,survey_id,pack_type,total packs owned,number free,Percent Free,Purchased
0,1,Expansion Packs,6,0,0.0,6
1,1,Kits,1,1,1.0,0
2,1,Stuff Packs,2,1,0.5,1
3,2,Expansion Packs,9,0,0.0,9
4,2,Game Packs,4,0,0.0,4
5,2,Stuff Packs,7,1,0.14285714285714285,6
6,3,Expansion Packs,16,0,0.0,16
7,3,Game Packs,12,1,0.08333333333333333,11
8,3,Kits,28,2,0.07142857142857142,26
9,3,Stuff Packs,20,1,0.05,19
10,4,Expansion Packs,16,0,0.0,16
11,4,Game Packs,12,0,0.0,12
12,4,Kits,33,0,0.0,33
13,4,Stuff Packs,20,0,0.0,20
14,5,Expansion Packs,15,0,0.0,15
15,5,Game Packs,10,0,0.0,10
16,5,Stuff Packs,18,0,0.0,18
17,6,Expansion Packs,12,0,0.0,12
18,6,Game Packs,9,0,0.0,9
19,6,Kits,1,1,1.0,0
20,6,Stuff Packs,17,1,0.058823529411764705,16
21,7,Expansion Packs,16,0,0.0,16
22,7,Game Packs,12,0,0.0,12
23,7,Kits,16,1,0.0625,15
24,7,Stuff Packs,15,0,0.0,15
25,8,Expansion Packs,16,0,0.0,16
26,8,Game Packs,12,1,0.08333333333333333,11
27,8,Kits,33,0,0.0,33
28,8,Stuff Packs,20,1,0.05,19
29,9,Expansion Packs,16,12,0.75,4
30,9,Game Packs,12,6,0.5,6
31,9,Kits,33,33,1.0,0
32,9,Stuff Packs,20,6,0.3,14
33,10,Expansion Packs,13,0,0.0,13
34,10,Game Packs,7,0,0.0,7
35,10,Kits,5,1,0.2,4
36,10,Stuff Packs,10,3,0.3,7
37,11,Expansion Packs,9,0,0.0,9
38,11,Game Packs,6,0,0.0,6
39,11,Kits,2,1,0.5,1
40,11,Stuff Packs,8,4,0.5,4
41,12,Expansion Packs,2,0,0.0,2
42,12,Game Packs,2,0,0.0,2
43,12,Kits,2,1,0.5,1
44,12,Stuff Packs,5,2,0.4,3
45,13,Expansion Packs,16,0,0.0,16
46,13,Game Packs,12,0,0.0,12
47,13,Kits,33,1,0.030303030303030304,32
48,13,Stuff Packs,20,0,0.0,20
49,14,Expansion Packs,3,1,0.3333333333333333,2
50,14,Game Packs,1,1,1.0,0
51,14,Stuff Packs,2,1,0.5,1
52,15,Expansion Packs,13,0,0.0,13
53,15,Game Packs,5,0,0.0,5
54,15,Kits,4,1,0.25,3
55,15,Stuff Packs,9,3,0.3333333333333333,6
56,16,Expansion Packs,16,0,0.0,16
57,16,Game Packs,12,0,0.0,12
58,16,Kits,33,0,0.0,33
59,16,Stuff Packs,20,1,0.05,19
60,17,Expansion Packs,9,0,0.0,9
61,17,Game Packs,3,0,0.0,3
62,17,Stuff Packs,6,1,0.16666666666666666,5
63,18,Expansion Packs,13,0,0.0,13
64,18,Game Packs,7,0,0.0,7
65,18,Kits,2,2,1.0,0
66,18,Stuff Packs,12,3,0.25,9
67,19,Expansion Packs,11,0,0.0,11
68,19,Game Packs,4,0,0.0,4
69,19,Kits,5,0,0.0,5
70,19,Stuff Packs,8,1,0.125,7
71,20,Expansion Packs,8,0,0.0,8
72,20,Game Packs,4,1,0.25,3
73,20,Kits,2,1,0.5,1
74,20,Stuff Packs,7,2,0.2857142857142857,5
75,21,Expansion Packs,15,0,0.0,15
76,21,Game Packs,12,0,0.0,12
77,21,Kits,13,0,0.0,13
78,21,Stuff Packs,16,0,0.0,16
79,22,Expansion Packs,14,0,0.0,14
80,22,Game Packs,10,0,0.0,10
81,22,Kits,5,0,0.0,5
82,22,Stuff Packs,19,0,0.0,19
83,23,Expansion Packs,15,0,0.0,15
84,23,Game Packs,11,0,0.0,11
85,23,Kits,7,0,0.0,7
86,23,Stuff Packs,12,0,0.0,12
87,24,Expansion Packs,12,0,0.0,12
88,24,Game Packs,4,0,0.0,4
89,24,Kits,3,0,0.0,3
90,24,Stuff Packs,7,3,0.42857142857142855,4
91,25,Expansion Packs,16,0,0.0,16
92,25,Game Packs,12,0,0.0,12
93,25,Kits,33,0,0.0,33
94,25,Stuff Packs,20,0,0.0,20
95,26,Expansion Packs,16,0,0.0,16
96,26,Game Packs,12,0,0.0,12
97,26,Kits,33,0,0.0,33
98,26,Stuff Packs,20,0,0.0,20
99,27,Expansion Packs,16,0,0.0,16
100,27,Game Packs,11,0,0.0,11
101,27,Kits,33,1,0.030303030303030304,32
102,27,Stuff Packs,20,0,0.0,20
103,28,Expansion Packs,16,0,0.0,16
104,28,Game Packs,12,0,0.0,12
105,28,Kits,33,0,0.0,33
106,28,Stuff Packs,20,0,0.0,20
107,29,Expansion Packs,16,1,0.0625,15
108,29,Game Packs,12,1,0.08333333333333333,11
109,29,Kits,33,0,0.0,33
110,29,Stuff Packs,20,0,0.0,20
111,30,Expansion Packs,15,0,0.0,15
112,30,Game Packs,6,1,0.16666666666666666,5
113,30,Kits,4,2,0.5,2
114,30,Stuff Packs,4,1,0.25,3
115,31,Expansion Packs,5,0,0.0,5
116,31,Game Packs,2,0,0.0,2
117,31,Kits,1,1,1.0,0
118,32,Expansion Packs,16,0,0.0,16
119,32,Game Packs,12,0,0.0,12
120,32,Kits,31,0,0.0,31
121,32,Stuff Packs,20,0,0.0,20
122,33,Expansion Packs,7,0,0.0,7
123,33,Game Packs,5,1,0.2,4
124,33,Kits,3,3,1.0,0
125,33,Stuff Packs,4,3,0.75,1
126,34,Expansion Packs,12,0,0.0,12
127,34,Game Packs,4,0,0.0,4
128,34,Kits,1,1,1.0,0
129,34,Stuff Packs,6,2,0.3333333333333333,4
130,35,Expansion Packs,15,0,0.0,15
131,35,Game Packs,11,0,0.0,11
132,35,Kits,15,1,0.06666666666666667,14
133,35,Stuff Packs,16,0,0.0,16
134,36,Expansion Packs,16,0,0.0,16
135,36,Game Packs,12,0,0.0,12
136,36,Kits,4,1,0.25,3
137,36,Stuff Packs,16,2,0.125,14
138,37,Expansion Packs,15,0,0.0,15
139,37,Game Packs,7,0,0.0,7
140,37,Kits,2,1,0.5,1
141,37,Stuff Packs,11,2,0.18181818181818182,9
142,38,Expansion Packs,6,0,0.0,6
143,38,Game Packs,5,1,0.2,4
144,38,Stuff Packs,4,2,0.5,2
145,39,Expansion Packs,15,0,0.0,15
146,39,Game Packs,8,1,0.125,7
147,39,Kits,5,0,0.0,5
148,39,Stuff Packs,12,0,0.0,12
149,40,Expansion Packs,8,0,0.0,8
150,40,Game Packs,3,0,0.0,3
151,40,Kits,1,1,1.0,0
152,40,Stuff Packs,6,2,0.3333333333333333,4
153,41,Expansion Packs,8,0,0.0,8
154,41,Game Packs,6,0,0.0,6
155,41,Stuff Packs,17,0,0.0,17
156,42,Expansion Packs,16,0,0.0,16
157,42,Game Packs,12,0,0.0,12
158,42,Kits,33,1,0.030303030303030304,32
159,42,Stuff Packs,20,0,0.0,20
160,43,Expansion Packs,6,0,0.0,6
161,43,Game Packs,2,1,0.5,1
162,43,Kits,3,3,1.0,0
163,43,Stuff Packs,6,4,0.6666666666666666,2
164,44,Expansion Packs,16,0,0.0,16
165,44,Game Packs,9,0,0.0,9
166,44,Kits,3,1,0.3333333333333333,2
167,44,Stuff Packs,13,3,0.23076923076923078,10
168,45,Expansion Packs,14,0,0.0,14
169,45,Game Packs,10,0,0.0,10
170,45,Kits,16,1,0.0625,15
171,45,Stuff Packs,18,0,0.0,18
172,46,Expansion Packs,11,0,0.0,11
173,46,Game Packs,7,0,0.0,7
174,46,Kits,1,1,1.0,0
175,46,Stuff Packs,8,3,0.375,5
176,47,Expansion Packs,14,0,0.0,14
177,47,Game Packs,6,0,0.0,6
178,47,Kits,5,0,0.0,5
179,47,Stuff Packs,9,2,0.2222222222222222,7
180,48,Expansion Packs,12,0,0.0,12
181,48,Game Packs,9,0,0.0,9
182,48,Kits,1,1,1.0,0
183,48,Stuff Packs,16,0,0.0,16
184,49,Expansion Packs,4,0,0.0,4
185,49,Game Packs,2,0,0.0,2
186,49,Kits,1,1,1.0,0
187,49,Stuff Packs,2,1,0.5,1
188,50,Expansion Packs,16,0,0.0,16
189,50,Game Packs,12,0,0.0,12
190,50,Kits,33,1,0.030303030303030304,32
191,50,Stuff Packs,20,0,0.0,20
192,51,Expansion Packs,8,0,0.0,8
193,51,Game Packs,7,0,0.0,7
194,51,Kits,3,2,0.6666666666666666,1
195,51,Stuff Packs,14,0,0.0,14
196,52,Expansion Packs,15,0,0.0,15
197,52,Game Packs,7,0,0.0,7
198,52,Kits,14,1,0.07142857142857142,13
199,52,Stuff Packs,14,0,0.0,14
200,53,Expansion Packs,16,0,0.0,16
201,53,Game Packs,12,0,0.0,12
202,53,Kits,4,1,0.25,3
203,53,Stuff Packs,19,0,0.0,19
204,54,Expansion Packs,10,0,0.0,10
205,54,Game Packs,4,0,0.0,4
206,54,Kits,4,0,0.0,4
207,54,Stuff Packs,8,0,0.0,8
208,55,Expansion Packs,16,0,0.0,16
209,55,Game Packs,12,0,0.0,12
210,55,Kits,33,0,0.0,33
211,55,Stuff Packs,20,0,0.0,20
212,56,Expansion Packs,1,0,0.0,1
213,56,Kits,1,1,1.0,0
214,56,Stuff Packs,1,1,1.0,0
215,57,Expansion Packs,16,0,0.0,16
216,57,Game Packs,12,0,0.0,12
217,57,Kits,10,0,0.0,10
218,57,Stuff Packs,20,0,0.0,20
219,58,Expansion Packs,16,0,0.0,16
220,58,Game Packs,12,1,0.08333333333333333,11
221,58,Kits,13,1,0.07692307692307693,12
222,58,Stuff Packs,16,4,0.25,12
223,59,Expansion Packs,16,0,0.0,16
224,59,Game Packs,12,0,0.0,12
225,59,Kits,21,1,0.047619047619047616,20
226,59,Stuff Packs,19,0,0.0,19
227,60,Expansion Packs,10,0,0.0,10
228,60,Game Packs,4,0,0.0,4
229,60,Kits,3,0,0.0,3
230,60,Stuff Packs,4,2,0.5,2
231,61,Expansion Packs,13,0,0.0,13
232,61,Game Packs,7,1,0.14285714285714285,6
233,61,Kits,3,3,1.0,0
234,61,Stuff Packs,9,2,0.2222222222222222,7
235,62,Expansion Packs,16,0,0.0,16
236,62,Game Packs,12,0,0.0,12
237,62,Kits,10,0,0.0,10
238,62,Stuff Packs,14,3,0.21428571428571427,11
239,63,Expansion Packs,5,0,0.0,5
240,63,Game Packs,3,0,0.0,3
241,63,Kits,2,1,0.5,1
242,63,Stuff Packs,8,0,0.0,8
243,64,Expansion Packs,9,0,0.0,9
244,64,Game Packs,5,0,0.0,5
245,64,Kits,1,0,0.0,1
246,64,Stuff Packs,2,0,0.0,2
247,65,Expansion Packs,16,0,0.0,16
248,65,Game Packs,11,1,0.09090909090909091,10
249,65,Kits,19,0,0.0,19
250,65,Stuff Packs,20,0,0.0,20
251,66,Expansion Packs,3,0,0.0,3
252,66,Game Packs,3,1,0.3333333333333333,2
253,66,Kits,4,2,0.5,2
254,66,Stuff Packs,6,4,0.6666666666666666,2
255,67,Expansion Packs,16,0,0.0,16
256,67,Game Packs,12,1,0.08333333333333333,11
257,67,Kits,13,3,0.23076923076923078,10
258,67,Stuff Packs,20,0,0.0,20
259,68,Expansion Packs,16,0,0.0,16
260,68,Game Packs,11,0,0.0,11
261,68,Kits,7,1,0.14285714285714285,6
262,68,Stuff Packs,20,0,0.0,20
263,69,Expansion Packs,7,0,0.0,7
264,69,Game Packs,1,0,0.0,1
265,69,Kits,2,1,0.5,1
266,69,Stuff Packs,5,3,0.6,2
267,70,Expansion Packs,16,0,0.0,16
268,70,Game Packs,9,0,0.0,9
269,70,Kits,14,0,0.0,14
270,70,Stuff Packs,14,2,0.14285714285714285,12
271,71,Expansion Packs,16,0,0.0,16
272,71,Game Packs,12,0,0.0,12
273,71,Kits,28,1,0.03571428571428571,27
274,71,Stuff Packs,19,0,0.0,19
275,72,Expansion Packs,16,0,0.0,16
276,72,Game Packs,12,0,0.0,12
277,72,Kits,33,2,0.06060606060606061,31
278,72,Stuff Packs,20,0,0.0,20
279,73,Expansion Packs,9,0,0.0,9
280,73,Game Packs,5,2,0.4,3
281,73,Kits,4,0,0.0,4
282,73,Stuff Packs,4,1,0.25,3
283,74,Expansion Packs,5,0,0.0,5
284,74,Game Packs,3,0,0.0,3
285,74,Kits,1,1,1.0,0
286,74,Stuff Packs,5,0,0.0,5
287,75,Expansion Packs,15,0,0.0,15
288,75,Game Packs,12,0,0.0,12
289,75,Kits,15,1,0.06666666666666667,14
290,75,Stuff Packs,20,0,0.0,20
291,76,Expansion Packs,9,0,0.0,9
292,76,Game Packs,7,0,0.0,7
293,76,Kits,3,2,0.6666666666666666,1
294,76,Stuff Packs,10,3,0.3,7
295,77,Expansion Packs,16,0,0.0,16
296,77,Game Packs,12,0,0.0,12
297,77,Kits,33,0,0.0,33
298,77,Stuff Packs,20,0,0.0,20
299,78,Expansion Packs,4,0,0.0,4
300,78,Game Packs,2,0,0.0,2
301,78,Kits,1,0,0.0,1
302,78,Stuff Packs,5,2,0.4,3
303,79,Expansion Packs,5,0,0.0,5
304,79,Game Packs,2,1,0.5,1
305,79,Kits,2,1,0.5,1
306,79,Stuff Packs,2,2,1.0,0
307,80,Expansion Packs,16,0,0.0,16
308,80,Game Packs,12,0,0.0,12
309,80,Kits,33,1,0.030303030303030304,32
310,80,Stuff Packs,20,0,0.0,20
311,81,Expansion Packs,16,0,0.0,16
312,81,Game Packs,10,0,0.0,10
313,81,Kits,19,0,0.0,19
314,81,Stuff Packs,12,0,0.0,12
315,82,Expansion Packs,13,0,0.0,13
316,82,Game Packs,12,0,0.0,12
317,82,Kits,7,1,0.14285714285714285,6
318,82,Stuff Packs,12,0,0.0,12
319,83,Expansion Packs,2,0,0.0,2
320,83,Kits,1,1,1.0,0
321,83,Stuff Packs,2,1,0.5,1
322,84,Expansion Packs,16,0,0.0,16
323,84,Game Packs,11,0,0.0,11
324,84,Kits,8,2,0.25,6
325,84,Stuff Packs,16,1,0.0625,15
326,85,Expansion Packs,16,0,0.0,16
327,85,Game Packs,12,0,0.0,12
328,85,Kits,33,0,0.0,33
329,85,Stuff Packs,20,0,0.0,20
330,86,Expansion Packs,16,0,0.0,16
331,86,Game Packs,9,0,0.0,9
332,86,Kits,4,0,0.0,4
333,86,Stuff Packs,7,0,0.0,7
334,87,Expansion Packs,15,0,0.0,15
335,87,Game Packs,11,0,0.0,11
336,87,Kits,5,2,0.4,3
337,87,Stuff Packs,18,1,0.05555555555555555,17
338,88,Expansion Packs,10,0,0.0,10
339,88,Game Packs,5,0,0.0,5
340,88,Kits,1,1,1.0,0
341,88,Stuff Packs,7,3,0.42857142857142855,4
342,89,Expansion Packs,15,0,0.0,15
343,89,Game Packs,9,0,0.0,9
344,89,Kits,3,2,0.6666666666666666,1
345,89,Stuff Packs,14,5,0.35714285714285715,9
346,90,Expansion Packs,8,4,0.5,4
347,90,Game Packs,2,1,0.5,1
348,90,Kits,1,0,0.0,1
349,90,Stuff Packs,5,3,0.6,2
350,91,Expansion Packs,11,0,0.0,11
351,91,Game Packs,8,0,0.0,8
352,91,Kits,3,2,0.6666666666666666,1
353,91,Stuff Packs,9,3,0.3333333333333333,6
354,92,Expansion Packs,16,0,0.0,16
355,92,Game Packs,12,0,0.0,12
356,92,Kits,33,1,0.030303030303030304,32
357,92,Stuff Packs,20,0,0.0,20
358,93,Expansion Packs,16,0,0.0,16
359,93,Game Packs,12,0,0.0,12
360,93,Kits,22,0,0.0,22
361,93,Stuff Packs,20,0,0.0,20
362,94,Expansion Packs,15,0,0.0,15
363,94,Game Packs,10,0,0.0,10
364,94,Kits,31,0,0.0,31
365,94,Stuff Packs,19,0,0.0,19
366,95,Expansion Packs,16,0,0.0,16
367,95,Game Packs,12,0,0.0,12
368,95,Kits,33,0,0.0,33
369,95,Stuff Packs,20,0,0.0,20
370,96,Expansion Packs,15,0,0.0,15
371,96,Game Packs,12,0,0.0,12
372,96,Kits,25,1,0.04,24
373,96,Stuff Packs,20,0,0.0,20
374,97,Expansion Packs,16,0,0.0,16
375,97,Game Packs,12,0,0.0,12
376,97,Kits,32,0,0.0,32
377,97,Stuff Packs,20,0,0.0,20
378,98,Expansion Packs,8,0,0.0,8
379,98,Game Packs,3,0,0.0,3
380,98,Kits,4,4,1.0,0
381,98,Stuff Packs,8,3,0.375,5
382,99,Expansion Packs,4,0,0.0,4
383,99,Game Packs,4,0,0.0,4
384,99,Kits,5,1,0.2,4
385,99,Stuff Packs,6,1,0.16666666666666666,5
386,100,Expansion Packs,15,0,0.0,15
387,100,Game Packs,6,2,0.3333333333333333,4
388,100,Kits,1,0,0.0,1
389,100,Stuff Packs,7,5,0.7142857142857143,2
390,101,Expansion Packs,16,0,0.0,16
391,101,Game Packs,12,0,0.0,12
392,101,Kits,33,2,0.06060606060606061,31
393,101,Stuff Packs,20,0,0.0,20
394,102,Expansion Packs,15,0,0.0,15
395,102,Game Packs,12,0,0.0,12
396,102,Kits,21,0,0.0,21
397,102,Stuff Packs,20,0,0.0,20
398,103,Expansion Packs,9,1,0.1111111111111111,8
399,103,Game Packs,6,1,0.16666666666666666,5
400,103,Stuff Packs,3,0,0.0,3
401,104,Expansion Packs,9,0,0.0,9
402,104,Game Packs,5,0,0.0,5
403,104,Kits,4,1,0.25,3
404,104,Stuff Packs,2,0,0.0,2
405,105,Expansion Packs,16,0,0.0,16
406,105,Game Packs,12,0,0.0,12
407,105,Kits,33,1,0.030303030303030304,32
408,105,Stuff Packs,20,0,0.0,20
409,106,Expansion Packs,14,0,0.0,14
410,106,Game Packs,6,0,0.0,6
411,106,Stuff Packs,12,0,0.0,12
412,107,Expansion Packs,14,0,0.0,14
413,107,Game Packs,10,0,0.0,10
414,107,Kits,6,1,0.16666666666666666,5
415,107,Stuff Packs,14,3,0.21428571428571427,11
416,108,Expansion Packs,4,0,0.0,4
417,108,Game Packs,5,0,0.0,5
418,108,Kits,4,0,0.0,4
419,108,Stuff Packs,5,0,0.0,5
420,109,Expansion Packs,6,0,0.0,6
421,109,Game Packs,5,1,0.2,4
422,109,Kits,5,1,0.2,4
423,109,Stuff Packs,7,3,0.42857142857142855,4
424,110,Expansion Packs,10,0,0.0,10
425,110,Game Packs,4,0,0.0,4
426,110,Stuff Packs,6,2,0.3333333333333333,4
427,111,Expansion Packs,16,0,0.0,16
428,111,Game Packs,12,1,0.08333333333333333,11
429,111,Kits,33,2,0.06060606060606061,31
430,111,Stuff Packs,20,3,0.15,17
431,112,Expansion Packs,9,0,0.0,9
432,112,Game Packs,5,0,0.0,5
433,112,Kits,8,0,0.0,8
434,112,Stuff Packs,1,0,0.0,1
435,113,Expansion Packs,10,0,0.0,10
436,113,Game Packs,8,0,0.0,8
437,113,Kits,2,0,0.0,2
438,113,Stuff Packs,9,0,0.0,9
439,114,Expansion Packs,11,0,0.0,11
440,114,Game Packs,10,0,0.0,10
441,114,Kits,4,1,0.25,3
442,114,Stuff Packs,14,1,0.07142857142857142,13
443,115,Expansion Packs,11,0,0.0,11
444,115,Game Packs,9,0,0.0,9
445,115,Kits,3,2,0.6666666666666666,1
446,115,Stuff Packs,16,0,0.0,16
447,116,Expansion Packs,10,0,0.0,10
448,116,Game Packs,8,1,0.125,7
449,116,Stuff Packs,13,0,0.0,13
450,117,Expansion Packs,16,0,0.0,16
451,117,Game Packs,12,0,0.0,12
452,117,Kits,22,1,0.045454545454545456,21
453,117,Stuff Packs,20,0,0.0,20
454,118,Expansion Packs,10,0,0.0,10
455,118,Game Packs,7,0,0.0,7
456,118,Kits,5,2,0.4,3
457,118,Stuff Packs,14,4,0.2857142857142857,10
458,119,Expansion Packs,13,0,0.0,13
459,119,Game Packs,5,0,0.0,5
460,119,Kits,2,2,1.0,0
461,119,Stuff Packs,10,3,0.3,7
462,120,Expansion Packs,16,0,0.0,16
463,120,Game Packs,11,0,0.0,11
464,120,Kits,23,0,0.0,23
465,120,Stuff Packs,15,0,0.0,15
466,121,Expansion Packs,10,0,0.0,10
467,121,Game Packs,6,1,0.16666666666666666,5
468,121,Kits,2,1,0.5,1
469,121,Stuff Packs,11,2,0.18181818181818182,9
470,122,Expansion Packs,16,0,0.0,16
471,122,Game Packs,12,0,0.0,12
472,122,Kits,33,1,0.030303030303030304,32
473,122,Stuff Packs,20,0,0.0,20
474,123,Expansion Packs,6,0,0.0,6
475,123,Game Packs,4,0,0.0,4
476,123,Kits,2,2,1.0,0
477,123,Stuff Packs,4,1,0.25,3
478,124,Expansion Packs,6,0,0.0,6
479,124,Game Packs,3,1,0.3333333333333333,2
480,124,Kits,11,2,0.18181818181818182,9
481,124,Stuff Packs,7,4,0.5714285714285714,3
482,125,Expansion Packs,6,0,0.0,6
483,125,Game Packs,4,0,0.0,4
484,125,Kits,1,1,1.0,0
485,125,Stuff Packs,5,1,0.2,4
486,126,Expansion Packs,7,0,0.0,7
487,126,Game Packs,8,0,0.0,8
488,126,Kits,2,0,0.0,2
489,126,Stuff Packs,14,0,0.0,14
490,127,Expansion Packs,7,0,0.0,7
491,127,Game Packs,5,1,0.2,4
492,127,Kits,3,2,0.6666666666666666,1
493,127,Stuff Packs,6,2,0.3333333333333333,4
494,128,Expansion Packs,7,0,0.0,7
495,128,Game Packs,4,0,0.0,4
496,128,Stuff Packs,5,2,0.4,3
497,129,Expansion Packs,14,0,0.0,14
498,129,Game Packs,11,0,0.0,11
499,129,Kits,14,1,0.07142857142857142,13
500,129,Stuff Packs,17,1,0.058823529411764705,16
501,130,Expansion Packs,5,0,0.0,5
502,130,Game Packs,2,0,0.0,2
503,130,Kits,11,1,0.09090909090909091,10
504,130,Stuff Packs,12,3,0.25,9
505,131,Expansion Packs,15,0,0.0,15
506,131,Game Packs,8,1,0.125,7
507,131,Kits,2,2,1.0,0
508,131,Stuff Packs,14,2,0.14285714285714285,12
509,132,Expansion Packs,12,0,0.0,12
510,132,Game Packs,4,0,0.0,4
511,132,Kits,2,1,0.5,1
512,132,Stuff Packs,4,1,0.25,3
513,133,Expansion Packs,15,0,0.0,15
514,133,Game Packs,11,0,0.0,11
515,133,Kits,17,2,0.11764705882352941,15
516,133,Stuff Packs,20,1,0.05,19
517,134,Expansion Packs,10,0,0.0,10
518,134,Game Packs,5,0,0.0,5
519,134,Kits,8,0,0.0,8
520,134,Stuff Packs,5,0,0.0,5
521,135,Expansion Packs,15,0,0.0,15
522,135,Game Packs,12,0,0.0,12
523,135,Kits,21,0,0.0,21
524,135,Stuff Packs,19,0,0.0,19
525,136,Expansion Packs,15,0,0.0,15
526,136,Game Packs,11,0,0.0,11
527,136,Kits,30,0,0.0,30
528,136,Stuff Packs,20,0,0.0,20
529,137,Expansion Packs,8,0,0.0,8
530,137,Game Packs,2,1,0.5,1
531,137,Kits,9,1,0.1111111111111111,8
532,137,Stuff Packs,7,0,0.0,7
533,138,Expansion Packs,8,0,0.0,8
534,138,Game Packs,4,0,0.0,4
535,138,Stuff Packs,2,0,0.0,2
536,139,Expansion Packs,16,0,0.0,16
537,139,Game Packs,12,0,0.0,12
538,139,Kits,33,1,0.030303030303030304,32
539,139,Stuff Packs,20,0,0.0,20
540,140,Expansion Packs,2,1,0.5,1
541,140,Game Packs,4,0,0.0,4
542,140,Stuff Packs,2,0,0.0,2
543,141,Expansion Packs,14,0,0.0,14
544,141,Game Packs,10,0,0.0,10
545,141,Kits,9,3,0.3333333333333333,6
546,141,Stuff Packs,17,3,0.17647058823529413,14
547,142,Expansion Packs,16,0,0.0,16
548,142,Game Packs,11,0,0.0,11
549,142,Kits,19,2,0.10526315789473684,17
550,142,Stuff Packs,20,4,0.2,16
551,143,Expansion Packs,16,0,0.0,16
552,143,Game Packs,11,0,0.0,11
553,143,Kits,19,1,0.05263157894736842,18
554,143,Stuff Packs,13,1,0.07692307692307693,12
555,144,Expansion Packs,9,0,0.0,9
556,144,Game Packs,4,0,0.0,4
557,144,Kits,5,3,0.6,2
558,144,Stuff Packs,9,3,0.3333333333333333,6
559,145,Expansion Packs,15,0,0.0,15
560,145,Game Packs,9,0,0.0,9
561,145,Kits,9,2,0.2222222222222222,7
562,145,Stuff Packs,14,1,0.07142857142857142,13
563,146,Expansion Packs,13,0,0.0,13
564,146,Game Packs,7,0,0.0,7
565,146,Kits,5,2,0.4,3
566,146,Stuff Packs,11,1,0.09090909090909091,10
567,147,Expansion Packs,14,0,0.0,14
568,147,Game Packs,5,0,0.0,5
569,147,Kits,5,0,0.0,5
570,147,Stuff Packs,9,1,0.1111111111111111,8
571,148,Expansion Packs,4,0,0.0,4
572,148,Kits,1,1,1.0,0
573,148,Stuff Packs,3,3,1.0,0
574,149,Expansion Packs,12,0,0.0,12
575,149,Game Packs,7,1,0.14285714285714285,6
576,149,Kits,4,1,0.25,3
577,149,Stuff Packs,7,3,0.42857142857142855,4
578,150,Expansion Packs,16,0,0.0,16
579,150,Game Packs,12,0,0.0,12
580,150,Kits,26,0,0.0,26
581,150,Stuff Packs,20,0,0.0,20
582,151,Expansion Packs,16,0,0.0,16
583,151,Game Packs,12,0,0.0,12
584,151,Kits,33,0,0.0,33
585,151,Stuff Packs,20,0,0.0,20
586,152,Expansion Packs,16,0,0.0,16
587,152,Game Packs,12,0,0.0,12
588,152,Kits,30,0,0.0,30
589,152,Stuff Packs,20,0,0.0,20
590,153,Expansion Packs,10,0,0.0,10
591,153,Game Packs,5,1,0.2,4
592,153,Kits,6,1,0.16666666666666666,5
593,153,Stuff Packs,10,3,0.3,7
594,154,Expansion Packs,15,0,0.0,15
595,154,Game Packs,12,0,0.0,12
596,154,Kits,7,0,0.0,7
597,154,Stuff Packs,18,0,0.0,18
598,155,Expansion Packs,14,0,0.0,14
599,155,Game Packs,6,1,0.16666666666666666,5
600,155,Kits,10,3,0.3,7
601,155,Stuff Packs,12,5,0.4166666666666667,7
602,156,Expansion Packs,15,0,0.0,15
603,156,Game Packs,8,0,0.0,8
604,156,Kits,14,0,0.0,14
605,156,Stuff Packs,18,0,0.0,18
606,157,Expansion Packs,15,0,0.0,15
607,157,Game Packs,11,0,0.0,11
608,157,Kits,12,2,0.16666666666666666,10
609,157,Stuff Packs,20,0,0.0,20
610,158,Expansion Packs,14,6,0.42857142857142855,8
611,158,Game Packs,8,3,0.375,5
612,158,Kits,20,18,0.9,2
613,158,Stuff Packs,18,15,0.8333333333333334,3
614,159,Expansion Packs,5,0,0.0,5
615,159,Game Packs,2,0,0.0,2
616,159,Kits,1,0,0.0,1
617,159,Stuff Packs,2,0,0.0,2
618,160,Expansion Packs,11,0,0.0,11
619,160,Game Packs,1,0,0.0,1
620,160,Kits,1,1,1.0,0
621,160,Stuff Packs,2,2,1.0,0
622,161,Expansion Packs,12,0,0.0,12
623,161,Game Packs,7,0,0.0,7
624,161,Kits,2,2,1.0,0
625,161,Stuff Packs,17,1,0.058823529411764705,16
626,162,Expansion Packs,16,0,0.0,16
627,162,Game Packs,12,0,0.0,12
628,162,Kits,33,0,0.0,33
629,162,Stuff Packs,20,1,0.05,19
630,163,Expansion Packs,9,0,0.0,9
631,163,Game Packs,4,0,0.0,4
632,164,Expansion Packs,16,0,0.0,16
633,164,Game Packs,11,0,0.0,11
634,164,Kits,33,2,0.06060606060606061,31
635,164,Stuff Packs,19,0,0.0,19
636,165,Expansion Packs,15,0,0.0,15
637,165,Game Packs,9,0,0.0,9
638,165,Kits,14,0,0.0,14
639,165,Stuff Packs,14,0,0.0,14
640,166,Expansion Packs,12,0,0.0,12
641,166,Game Packs,5,0,0.0,5
642,166,Kits,4,0,0.0,4
643,166,Stuff Packs,11,2,0.18181818181818182,9
644,167,Expansion Packs,6,0,0.0,6
645,167,Game Packs,6,1,0.16666666666666666,5
646,167,Kits,1,1,1.0,0
647,167,Stuff Packs,9,4,0.4444444444444444,5
648,168,Expansion Packs,15,0,0.0,15
649,168,Game Packs,8,0,0.0,8
650,168,Kits,9,0,0.0,9
651,168,Stuff Packs,14,0,0.0,14
652,169,Expansion Packs,16,0,0.0,16
653,169,Game Packs,12,0,0.0,12
654,169,Kits,33,1,0.030303030303030304,32
655,169,Stuff Packs,20,1,0.05,19
656,170,Expansion Packs,16,0,0.0,16
657,170,Game Packs,10,0,0.0,10
658,170,Kits,12,0,0.0,12
659,170,Stuff Packs,16,0,0.0,16
660,171,Expansion Packs,6,1,0.16666666666666666,5
661,171,Game Packs,2,0,0.0,2
662,171,Kits,1,1,1.0,0
663,171,Stuff Packs,2,2,1.0,0
664,172,Expansion Packs,15,0,0.0,15
665,172,Game Packs,8,0,0.0,8
666,172,Kits,2,0,0.0,2
667,172,Stuff Packs,6,0,0.0,6
668,173,Expansion Packs,9,0,0.0,9
669,173,Game Packs,4,0,0.0,4
670,173,Kits,19,3,0.15789473684210525,16
671,173,Stuff Packs,9,0,0.0,9
672,174,Expansion Packs,15,0,0.0,15
673,174,Game Packs,12,0,0.0,12
674,174,Kits,3,1,0.3333333333333333,2
675,174,Stuff Packs,16,0,0.0,16
676,175,Expansion Packs,9,0,0.0,9
677,175,Game Packs,3,0,0.0,3
678,175,Kits,1,1,1.0,0
679,175,Stuff Packs,5,1,0.2,4
680,176,Expansion Packs,16,0,0.0,16
681,176,Game Packs,12,0,0.0,12
682,176,Kits,32,0,0.0,32
683,176,Stuff Packs,20,0,0.0,20
684,177,Expansion Packs,13,0,0.0,13
685,177,Game Packs,11,0,0.0,11
686,177,Kits,1,1,1.0,0
687,177,Stuff Packs,18,0,0.0,18
688,178,Expansion Packs,16,0,0.0,16
689,178,Game Packs,11,0,0.0,11
690,178,Kits,27,0,0.0,27
691,178,Stuff Packs,20,0,0.0,20
692,179,Expansion Packs,16,0,0.0,16
693,179,Game Packs,12,0,0.0,12
694,179,Kits,5,0,0.0,5
695,179,Stuff Packs,13,1,0.07692307692307693,12
696,180,Expansion Packs,13,0,0.0,13
697,180,Game Packs,8,1,0.125,7
698,180,Kits,1,1,1.0,0
699,180,Stuff Packs,5,3,0.6,2
700,181,Expansion Packs,16,3,0.1875,13
701,181,Game Packs,12,1,0.08333333333333333,11
702,181,Kits,33,31,0.9393939393939394,2
703,181,Stuff Packs,20,6,0.3,14
704,182,Expansion Packs,12,0,0.0,12
705,182,Game Packs,10,0,0.0,10
706,182,Kits,8,2,0.25,6
707,182,Stuff Packs,13,4,0.3076923076923077,9
708,183,Expansion Packs,16,0,0.0,16
709,183,Game Packs,9,0,0.0,9
710,183,Kits,5,1,0.2,4
711,183,Stuff Packs,10,1,0.1,9
712,184,Expansion Packs,6,0,0.0,6
713,184,Game Packs,3,0,0.0,3
714,184,Kits,2,2,1.0,0
715,184,Stuff Packs,5,3,0.6,2
716,185,Expansion Packs,8,0,0.0,8
717,185,Game Packs,8,0,0.0,8
718,185,Kits,18,0,0.0,18
719,185,Stuff Packs,9,0,0.0,9
720,186,Expansion Packs,16,0,0.0,16
721,186,Game Packs,12,0,0.0,12
722,186,Kits,33,1,0.030303030303030304,32
723,186,Stuff Packs,20,0,0.0,20
724,187,Expansion Packs,10,0,0.0,10
725,187,Game Packs,10,0,0.0,10
726,187,Kits,4,3,0.75,1
727,187,Stuff Packs,14,4,0.2857142857142857,10
728,188,Expansion Packs,16,0,0.0,16
729,188,Game Packs,12,0,0.0,12
730,188,Kits,33,1,0.030303030303030304,32
731,188,Stuff Packs,20,0,0.0,20
732,189,Expansion Packs,16,0,0.0,16
733,189,Game Packs,12,0,0.0,12
734,189,Kits,19,0,0.0,19
735,189,Stuff Packs,17,1,0.058823529411764705,16
736,190,Expansion Packs,16,0,0.0,16
737,190,Game Packs,6,0,0.0,6
738,190,Kits,9,1,0.1111111111111111,8
739,190,Stuff Packs,12,2,0.16666666666666666,10
740,191,Expansion Packs,16,0,0.0,16
741,191,Game Packs,11,0,0.0,11
742,191,Kits,23,1,0.043478260869565216,22
743,191,Stuff Packs,19,1,0.05263157894736842,18
744,192,Expansion Packs,16,0,0.0,16
745,192,Game Packs,12,0,0.0,12
746,192,Kits,33,0,0.0,33
747,192,Stuff Packs,20,0,0.0,20
748,193,Expansion Packs,16,0,0.0,16
749,193,Game Packs,12,0,0.0,12
750,193,Kits,33,2,0.06060606060606061,31
751,193,Stuff Packs,20,2,0.1,18
752,194,Expansion Packs,10,0,0.0,10
753,194,Game Packs,8,0,0.0,8
754,194,Kits,2,2,1.0,0
755,194,Stuff Packs,11,0,0.0,11
756,195,Expansion Packs,5,0,0.0,5
757,195,Game Packs,3,1,0.3333333333333333,2
758,195,Stuff Packs,5,3,0.6,2
759,196,Expansion Packs,9,0,0.0,9
760,196,Game Packs,5,0,0.0,5
761,196,Kits,1,0,0.0,1
762,196,Stuff Packs,4,0,0.0,4
763,197,Expansion Packs,1,0,0.0,1
764,197,Game Packs,1,1,1.0,0
765,197,Kits,1,0,0.0,1
766,198,Expansion Packs,15,0,0.0,15
767,198,Game Packs,8,0,0.0,8
768,198,Kits,12,1,0.08333333333333333,11
769,198,Stuff Packs,15,3,0.2,12
770,199,Expansion Packs,16,0,0.0,16
771,199,Game Packs,8,0,0.0,8
772,199,Kits,8,0,0.0,8
773,199,Stuff Packs,11,1,0.09090909090909091,10
774,200,Expansion Packs,14,0,0.0,14
775,200,Game Packs,11,0,0.0,11
776,200,Kits,4,1,0.25,3
777,200,Stuff Packs,15,1,0.06666666666666667,14
778,201,Expansion Packs,4,0,0.0,4
779,201,Game Packs,6,1,0.16666666666666666,5
780,201,Kits,1,1,1.0,0
781,201,Stuff Packs,3,0,0.0,3
782,202,Expansion Packs,12,0,0.0,12
783,202,Game Packs,5,1,0.2,4
784,202,Kits,10,2,0.2,8
785,202,Stuff Packs,7,2,0.2857142857142857,5
786,203,Expansion Packs,9,0,0.0,9
787,203,Game Packs,7,0,0.0,7
788,203,Kits,2,2,1.0,0
789,203,Stuff Packs,6,2,0.3333333333333333,4
790,204,Expansion Packs,11,0,0.0,11
791,204,Game Packs,8,0,0.0,8
792,204,Kits,3,1,0.3333333333333333,2
793,204,Stuff Packs,10,1,0.1,9
794,205,Expansion Packs,9,0,0.0,9
795,205,Game Packs,9,0,0.0,9
796,205,Kits,3,1,0.3333333333333333,2
797,205,Stuff Packs,8,0,0.0,8
798,206,Expansion Packs,15,0,0.0,15
799,206,Game Packs,11,0,0.0,11
800,206,Kits,7,1,0.14285714285714285,6
801,206,Stuff Packs,19,0,0.0,19
802,207,Expansion Packs,16,0,0.0,16
803,207,Game Packs,12,0,0.0,12
804,207,Kits,33,0,0.0,33
805,207,Stuff Packs,20,0,0.0,20
806,208,Expansion Packs,15,0,0.0,15
807,208,Game Packs,9,0,0.0,9
808,208,Kits,7,1,0.14285714285714285,6
809,208,Stuff Packs,20,2,0.1,18
810,209,Expansion Packs,15,0,0.0,15
811,209,Game Packs,9,0,0.0,9
812,209,Kits,5,2,0.4,3
813,209,Stuff Packs,13,3,0.23076923076923078,10
814,210,Expansion Packs,16,0,0.0,16
815,210,Game Packs,11,0,0.0,11
816,210,Kits,28,0,0.0,28
817,210,Stuff Packs,15,3,0.2,12
818,211,Expansion Packs,8,0,0.0,8
819,211,Game Packs,3,0,0.0,3
820,211,Kits,1,1,1.0,0
821,211,Stuff Packs,8,1,0.125,7
822,212,Expansion Packs,15,0,0.0,15
823,212,Game Packs,11,1,0.09090909090909091,10
824,212,Kits,17,1,0.058823529411764705,16
825,212,Stuff Packs,19,0,0.0,19
826,213,Expansion Packs,13,0,0.0,13
827,213,Game Packs,5,0,0.0,5
828,213,Kits,2,0,0.0,2
829,213,Stuff Packs,4,0,0.0,4
830,214,Expansion Packs,12,0,0.0,12
831,214,Game Packs,4,0,0.0,4
832,214,Kits,1,1,1.0,0
833,214,Stuff Packs,7,2,0.2857142857142857,5
834,215,Expansion Packs,12,0,0.0,12
835,215,Game Packs,6,1,0.16666666666666666,5
836,215,Kits,2,0,0.0,2
837,215,Stuff Packs,7,2,0.2857142857142857,5
838,216,Expansion Packs,16,0,0.0,16
839,216,Game Packs,12,0,0.0,12
840,216,Kits,33,0,0.0,33
841,216,Stuff Packs,20,0,0.0,20
842,217,Expansion Packs,16,0,0.0,16
843,217,Game Packs,11,0,0.0,11
844,217,Kits,17,1,0.058823529411764705,16
845,217,Stuff Packs,19,1,0.05263157894736842,18
846,218,Expansion Packs,15,0,0.0,15
847,218,Game Packs,8,1,0.125,7
848,218,Kits,6,1,0.16666666666666666,5
849,218,Stuff Packs,12,3,0.25,9
850,219,Expansion Packs,16,0,0.0,16
851,219,Game Packs,12,0,0.0,12
852,219,Kits,33,0,0.0,33
853,219,Stuff Packs,20,0,0.0,20
854,220,Expansion Packs,1,0,0.0,1
855,220,Stuff Packs,4,0,0.0,4
856,221,Expansion Packs,14,0,0.0,14
857,221,Game Packs,11,0,0.0,11
858,221,Kits,16,1,0.0625,15
859,221,Stuff Packs,19,0,0.0,19
860,222,Expansion Packs,6,0,0.0,6
861,222,Game Packs,3,1,0.3333333333333333,2
862,222,Kits,2,1,0.5,1
863,222,Stuff Packs,4,3,0.75,1
864,223,Expansion Packs,16,0,0.0,16
865,223,Game Packs,12,0,0.0,12
866,223,Kits,33,2,0.06060606060606061,31
867,223,Stuff Packs,20,0,0.0,20
868,224,Expansion Packs,6,0,0.0,6
869,224,Game Packs,3,1,0.3333333333333333,2
870,224,Kits,3,3,1.0,0
871,224,Stuff Packs,6,3,0.5,3
872,225,Expansion Packs,16,0,0.0,16
873,225,Game Packs,12,0,0.0,12
874,225,Kits,33,1,0.030303030303030304,32
875,225,Stuff Packs,20,2,0.1,18
876,226,Expansion Packs,4,0,0.0,4
877,226,Game Packs,3,0,0.0,3
878,226,Kits,2,2,1.0,0
879,226,Stuff Packs,5,2,0.4,3
880,227,Expansion Packs,16,1,0.0625,15
881,227,Game Packs,9,0,0.0,9
882,227,Kits,8,2,0.25,6
883,227,Stuff Packs,19,5,0.2631578947368421,14
884,228,Expansion Packs,15,0,0.0,15
885,228,Game Packs,9,0,0.0,9
886,228,Kits,6,0,0.0,6
887,228,Stuff Packs,6,0,0.0,6
888,229,Expansion Packs,14,0,0.0,14
889,229,Game Packs,6,0,0.0,6
890,229,Kits,2,1,0.5,1
891,229,Stuff Packs,11,2,0.18181818181818182,9
892,230,Expansion Packs,10,0,0.0,10
893,230,Game Packs,2,0,0.0,2
894,230,Kits,6,0,0.0,6
895,230,Stuff Packs,10,3,0.3,7
896,231,Expansion Packs,16,0,0.0,16
897,231,Game Packs,10,0,0.0,10
898,231,Kits,18,0,0.0,18
899,231,Stuff Packs,18,3,0.16666666666666666,15
900,232,Expansion Packs,4,0,0.0,4
901,232,Game Packs,2,0,0.0,2
902,232,Kits,1,1,1.0,0
903,232,Stuff Packs,3,2,0.6666666666666666,1
904,233,Expansion Packs,11,3,0.2727272727272727,8
905,233,Game Packs,9,3,0.3333333333333333,6
906,233,Stuff Packs,13,4,0.3076923076923077,9
907,234,Expansion Packs,10,0,0.0,10
908,234,Game Packs,8,0,0.0,8
909,234,Kits,4,2,0.5,2
910,234,Stuff Packs,13,1,0.07692307692307693,12
911,235,Expansion Packs,13,0,0.0,13
912,235,Game Packs,11,0,0.0,11
913,235,Kits,14,1,0.07142857142857142,13
914,235,Stuff Packs,17,1,0.058823529411764705,16
915,236,Expansion Packs,10,0,0.0,10
916,236,Game Packs,3,0,0.0,3
917,236,Kits,10,0,0.0,10
918,236,Stuff Packs,8,2,0.25,6
919,237,Expansion Packs,16,0,0.0,16
920,237,Game Packs,10,0,0.0,10
921,237,Kits,12,1,0.08333333333333333,11
922,237,Stuff Packs,16,3,0.1875,13
923,238,Expansion Packs,9,0,0.0,9
924,238,Game Packs,6,0,0.0,6
925,238,Kits,11,1,0.09090909090909091,10
926,238,Stuff Packs,8,0,0.0,8
927,239,Expansion Packs,15,0,0.0,15
928,239,Game Packs,12,0,0.0,12
929,239,Kits,22,1,0.045454545454545456,21
930,239,Stuff Packs,20,0,0.0,20
931,240,Expansion Packs,5,0,0.0,5
932,240,Game Packs,1,0,0.0,1
933,240,Stuff Packs,2,1,0.5,1
934,241,Expansion Packs,15,0,0.0,15
935,241,Game Packs,11,0,0.0,11
936,241,Kits,3,2,0.6666666666666666,1
937,241,Stuff Packs,14,2,0.14285714285714285,12
938,242,Expansion Packs,16,0,0.0,16
939,242,Game Packs,10,0,0.0,10
940,242,Kits,18,1,0.05555555555555555,17
941,242,Stuff Packs,15,2,0.13333333333333333,13
942,243,Expansion Packs,16,0,0.0,16
943,243,Game Packs,12,0,0.0,12
944,243,Kits,33,0,0.0,33
945,243,Stuff Packs,20,0,0.0,20
946,244,Expansion Packs,11,0,0.0,11
947,244,Game Packs,7,2,0.2857142857142857,5
948,244,Kits,2,2,1.0,0
949,244,Stuff Packs,7,4,0.5714285714285714,3
950,245,Expansion Packs,13,0,0.0,13
951,245,Game Packs,3,0,0.0,3
952,245,Kits,13,1,0.07692307692307693,12
953,245,Stuff Packs,8,2,0.25,6
954,246,Expansion Packs,11,0,0.0,11
955,246,Game Packs,5,0,0.0,5
956,246,Kits,4,1,0.25,3
957,246,Stuff Packs,5,2,0.4,3
958,247,Expansion Packs,15,0,0.0,15
959,247,Game Packs,10,0,0.0,10
960,247,Kits,17,1,0.058823529411764705,16
961,247,Stuff Packs,18,3,0.16666666666666666,15
962,248,Expansion Packs,16,0,0.0,16
963,248,Game Packs,12,0,0.0,12
964,248,Kits,33,1,0.030303030303030304,32
965,248,Stuff Packs,20,0,0.0,20
966,249,Expansion Packs,15,0,0.0,15
967,249,Game Packs,10,0,0.0,10
968,249,Kits,14,0,0.0,14
969,249,Stuff Packs,14,1,0.07142857142857142,13
970,250,Expansion Packs,4,0,0.0,4
971,250,Game Packs,3,0,0.0,3
972,250,Kits,7,0,0.0,7
973,250,Stuff Packs,6,0,0.0,6
974,251,Expansion Packs,16,0,0.0,16
975,251,Game Packs,8,1,0.125,7
976,251,Kits,7,2,0.2857142857142857,5
977,251,Stuff Packs,12,4,0.3333333333333333,8
978,252,Expansion Packs,15,0,0.0,15
979,252,Game Packs,11,0,0.0,11
980,252,Kits,28,0,0.0,28
981,252,Stuff Packs,17,0,0.0,17
982,253,Expansion Packs,9,0,0.0,9
983,253,Game Packs,1,0,0.0,1
984,253,Kits,5,1,0.2,4
985,253,Stuff Packs,5,1,0.2,4
986,254,Expansion Packs,7,0,0.0,7
987,254,Game Packs,5,0,0.0,5
988,254,Kits,2,2,1.0,0
989,254,Stuff Packs,7,3,0.42857142857142855,4
990,255,Expansion Packs,12,0,0.0,12
991,255,Game Packs,9,0,0.0,9
992,255,Stuff Packs,3,0,0.0,3
993,256,Expansion Packs,16,0,0.0,16
994,256,Game Packs,11,0,0.0,11
995,256,Kits,13,1,0.07692307692307693,12
996,256,Stuff Packs,18,1,0.05555555555555555,17
997,257,Expansion Packs,16,0,0.0,16
998,257,Game Packs,12,0,0.0,12
999,257,Kits,32,0,0.0,32
1000,257,Stuff Packs,20,0,0.0,20
1001,258,Expansion Packs,14,0,0.0,14
1002,258,Game Packs,11,0,0.0,11
1003,258,Kits,10,1,0.1,9
1004,258,Stuff Packs,17,1,0.058823529411764705,16
1005,259,Expansion Packs,16,0,0.0,16
1006,259,Game Packs,11,0,0.0,11
1007,259,Kits,7,0,0.0,7
1008,259,Stuff Packs,15,0,0.0,15
1009,260,Expansion Packs,16,1,0.0625,15
1010,260,Game Packs,12,0,0.0,12
1011,260,Kits,33,1,0.030303030303030304,32
1012,260,Stuff Packs,20,0,0.0,20
1013,261,Expansion Packs,16,0,0.0,16
1014,261,Game Packs,12,0,0.0,12
1015,261,Kits,33,0,0.0,33
1016,261,Stuff Packs,20,0,0.0,20
1017,262,Expansion Packs,13,0,0.0,13
1018,262,Game Packs,10,0,0.0,10
1019,263,Expansion Packs,6,1,0.16666666666666666,5
1020,263,Game Packs,3,0,0.0,3
1021,263,Kits,1,1,1.0,0
1022,263,Stuff Packs,4,3,0.75,1
1023,264,Expansion Packs,9,0,0.0,9
1024,264,Game Packs,4,0,0.0,4
1025,264,Kits,4,1,0.25,3
1026,264,Stuff Packs,7,0,0.0,7
1027,265,Expansion Packs,3,0,0.0,3
1028,265,Game Packs,4,0,0.0,4
1029,265,Kits,1,1,1.0,0
1030,265,Stuff Packs,7,2,0.2857142857142857,5
1031,266,Expansion Packs,3,0,0.0,3
1032,266,Game Packs,4,0,0.0,4
1033,266,Kits,3,2,0.6666666666666666,1
1034,266,Stuff Packs,5,1,0.2,4
1035,267,Game Packs,1,1,1.0,0
1036,268,Expansion Packs,3,0,0.0,3
1037,268,Game Packs,1,0,0.0,1
1038,269,Expansion Packs,12,0,0.0,12
1039,269,Game Packs,5,0,0.0,5
1040,269,Kits,3,2,0.6666666666666666,1
1041,269,Stuff Packs,8,3,0.375,5
1042,270,Expansion Packs,11,0,0.0,11
1043,270,Game Packs,8,0,0.0,8
1044,270,Kits,3,1,0.3333333333333333,2
1045,270,Stuff Packs,9,1,0.1111111111111111,8
1046,271,Expansion Packs,16,0,0.0,16
1047,271,Game Packs,11,2,0.18181818181818182,9
1048,271,Kits,6,1,0.16666666666666666,5
1049,271,Stuff Packs,16,6,0.375,10
1050,272,Expansion Packs,12,0,0.0,12
1051,272,Game Packs,6,0,0.0,6
1052,272,Kits,12,1,0.08333333333333333,11
1053,272,Stuff Packs,16,2,0.125,14
1054,273,Expansion Packs,15,0,0.0,15
1055,273,Game Packs,12,0,0.0,12
1056,273,Kits,13,1,0.07692307692307693,12
1057,273,Stuff Packs,17,0,0.0,17
1058,274,Expansion Packs,14,0,0.0,14
1059,274,Game Packs,5,0,0.0,5
1060,274,Kits,3,0,0.0,3
1061,274,Stuff Packs,8,0,0.0,8
1062,275,Expansion Packs,5,0,0.0,5
1063,275,Game Packs,2,0,0.0,2
1064,275,Kits,7,1,0.14285714285714285,6
1065,275,Stuff Packs,7,2,0.2857142857142857,5
1066,276,Expansion Packs,11,0,0.0,11
1067,276,Game Packs,4,0,0.0,4
1068,276,Stuff Packs,8,2,0.25,6
1069,277,Expansion Packs,12,0,0.0,12
1070,277,Game Packs,11,1,0.09090909090909091,10
1071,277,Kits,1,0,0.0,1
1072,277,Stuff Packs,6,1,0.16666666666666666,5
1073,278,Expansion Packs,16,0,0.0,16
1074,278,Game Packs,8,0,0.0,8
1075,278,Kits,13,0,0.0,13
1076,278,Stuff Packs,13,0,0.0,13
1077,279,Expansion Packs,16,0,0.0,16
1078,279,Game Packs,12,3,0.25,9
1079,279,Kits,33,2,0.06060606060606061,31
1080,279,Stuff Packs,20,4,0.2,16
1081,280,Expansion Packs,14,0,0.0,14
1082,280,Game Packs,9,0,0.0,9
1083,280,Kits,4,1,0.25,3
1084,280,Stuff Packs,12,0,0.0,12
1085,281,Expansion Packs,16,0,0.0,16
1086,281,Game Packs,10,0,0.0,10
1087,281,Kits,14,0,0.0,14
1088,281,Stuff Packs,17,0,0.0,17
1089,282,Expansion Packs,16,0,0.0,16
1090,282,Game Packs,11,0,0.0,11
1091,282,Kits,20,0,0.0,20
1092,282,Stuff Packs,20,0,0.0,20
1093,283,Expansion Packs,11,0,0.0,11
1094,283,Game Packs,1,0,0.0,1
1095,283,Kits,3,1,0.3333333333333333,2
1096,283,Stuff Packs,6,3,0.5,3
1097,284,Expansion Packs,12,0,0.0,12
1098,284,Game Packs,5,1,0.2,4
1099,284,Kits,4,4,1.0,0
1100,284,Stuff Packs,10,3,0.3,7
1101,285,Expansion Packs,13,0,0.0,13
1102,285,Game Packs,10,0,0.0,10
1103,285,Kits,7,1,0.14285714285714285,6
1104,285,Stuff Packs,16,0,0.0,16
1105,286,Expansion Packs,12,0,0.0,12
1106,286,Game Packs,9,0,0.0,9
1107,286,Kits,3,0,0.0,3
1108,286,Stuff Packs,16,1,0.0625,15
1109,287,Expansion Packs,15,0,0.0,15
1110,287,Game Packs,5,0,0.0,5
1111,287,Kits,6,1,0.16666666666666666,5
1112,287,Stuff Packs,7,4,0.5714285714285714,3
1113,288,Expansion Packs,3,0,0.0,3
1114,288,Game Packs,2,1,0.5,1
1115,288,Kits,7,1,0.14285714285714285,6
1116,288,Stuff Packs,6,4,0.6666666666666666,2
1117,289,Expansion Packs,16,0,0.0,16
1118,289,Game Packs,10,0,0.0,10
1119,289,Kits,28,0,0.0,28
1120,289,Stuff Packs,20,0,0.0,20
1121,290,Expansion Packs,11,0,0.0,11
1122,290,Game Packs,6,0,0.0,6
1123,290,Kits,1,1,1.0,0
1124,290,Stuff Packs,9,2,0.2222222222222222,7
1125,291,Expansion Packs,7,0,0.0,7
1126,291,Game Packs,1,0,0.0,1
1127,291,Kits,1,1,1.0,0
1128,291,Stuff Packs,3,3,1.0,0
1129,292,Expansion Packs,16,0,0.0,16
1130,292,Game Packs,11,1,0.09090909090909091,10
1131,292,Kits,2,2,1.0,0
1132,292,Stuff Packs,12,3,0.25,9
1133,293,Expansion Packs,6,0,0.0,6
1134,293,Game Packs,1,0,0.0,1
1135,293,Kits,5,1,0.2,4
1136,293,Stuff Packs,6,2,0.3333333333333333,4
1137,294,Expansion Packs,8,0,0.0,8
1138,294,Game Packs,7,0,0.0,7
1139,294,Kits,5,0,0.0,5
1140,294,Stuff Packs,8,0,0.0,8
1141,295,Expansion Packs,16,0,0.0,16
1142,295,Game Packs,12,0,0.0,12
1143,295,Kits,33,0,0.0,33
1144,295,Stuff Packs,20,0,0.0,20
1145,296,Expansion Packs,13,0,0.0,13
1146,296,Game Packs,9,0,0.0,9
1147,296,Kits,8,0,0.0,8
1148,296,Stuff Packs,8,1,0.125,7
1149,297,Expansion Packs,11,0,0.0,11
1150,297,Game Packs,6,1,0.16666666666666666,5
1151,297,Stuff Packs,10,0,0.0,10
1152,298,Expansion Packs,13,0,0.0,13
1153,298,Game Packs,10,0,0.0,10
1154,298,Kits,6,0,0.0,6
1155,298,Stuff Packs,15,0,0.0,15
1156,299,Expansion Packs,2,0,0.0,2
1157,299,Game Packs,2,0,0.0,2
1158,299,Kits,2,2,1.0,0
1159,299,Stuff Packs,5,3,0.6,2
1160,300,Expansion Packs,14,0,0.0,14
1161,300,Game Packs,12,0,0.0,12
1162,300,Kits,23,2,0.08695652173913043,21
1163,300,Stuff Packs,19,3,0.15789473684210525,16
1164,301,Expansion Packs,10,0,0.0,10
1165,301,Game Packs,2,0,0.0,2
1166,301,Kits,5,3,0.6,2
1167,301,Stuff Packs,7,4,0.5714285714285714,3
1168,302,Expansion Packs,14,0,0.0,14
1169,302,Game Packs,10,0,0.0,10
1170,302,Kits,8,2,0.25,6
1171,302,Stuff Packs,17,0,0.0,17
1172,303,Expansion Packs,13,0,0.0,13
1173,303,Game Packs,9,0,0.0,9
1174,303,Kits,6,1,0.16666666666666666,5
1175,303,Stuff Packs,14,1,0.07142857142857142,13
1176,304,Expansion Packs,5,0,0.0,5
1177,304,Game Packs,3,0,0.0,3
1178,304,Kits,5,1,0.2,4
1179,304,Stuff Packs,4,1,0.25,3
1180,305,Expansion Packs,16,0,0.0,16
1181,305,Game Packs,12,0,0.0,12
1182,305,Kits,33,0,0.0,33
1183,305,Stuff Packs,20,0,0.0,20
1184,306,Expansion Packs,16,0,0.0,16
1185,306,Game Packs,12,0,0.0,12
1186,306,Kits,33,0,0.0,33
1187,306,Stuff Packs,20,0,0.0,20
1188,307,Expansion Packs,15,0,0.0,15
1189,307,Game Packs,7,0,0.0,7
1190,307,Stuff Packs,6,1,0.16666666666666666,5
1191,308,Expansion Packs,15,0,0.0,15
1192,308,Game Packs,12,0,0.0,12
1193,308,Kits,31,0,0.0,31
1194,308,Stuff Packs,20,0,0.0,20
1195,309,Expansion Packs,16,0,0.0,16
1196,309,Game Packs,11,0,0.0,11
1197,309,Kits,3,1,0.3333333333333333,2
1198,309,Stuff Packs,20,0,0.0,20
1199,310,Expansion Packs,13,0,0.0,13
1200,310,Game Packs,7,1,0.14285714285714285,6
1201,310,Kits,8,2,0.25,6
1202,310,Stuff Packs,11,0,0.0,11
1203,311,Expansion Packs,16,0,0.0,16
1204,311,Game Packs,12,0,0.0,12
1205,311,Kits,21,0,0.0,21
1206,311,Stuff Packs,20,0,0.0,20
1207,312,Expansion Packs,9,0,0.0,9
1208,312,Game Packs,4,0,0.0,4
1209,312,Kits,8,0,0.0,8
1210,312,Stuff Packs,8,3,0.375,5
1211,313,Expansion Packs,15,14,0.9333333333333333,1
1212,313,Game Packs,8,8,1.0,0
1213,313,Kits,8,4,0.5,4
1214,313,Stuff Packs,12,12,1.0,0
1215,314,Expansion Packs,16,0,0.0,16
1216,314,Game Packs,12,0,0.0,12
1217,314,Kits,33,0,0.0,33
1218,314,Stuff Packs,20,0,0.0,20
1219,315,Expansion Packs,16,0,0.0,16
1220,315,Game Packs,12,0,0.0,12
1221,315,Kits,33,1,0.030303030303030304,32
1222,315,Stuff Packs,20,0,0.0,20
1223,316,Expansion Packs,16,0,0.0,16
1224,316,Game Packs,12,0,0.0,12
1225,316,Kits,33,0,0.0,33
1226,316,Stuff Packs,20,0,0.0,20
1227,317,Expansion Packs,16,0,0.0,16
1228,317,Game Packs,12,0,0.0,12
1229,317,Kits,33,0,0.0,33
1230,317,Stuff Packs,20,0,0.0,20
1231,318,Expansion Packs,13,0,0.0,13
1232,318,Game Packs,8,0,0.0,8
1233,318,Kits,6,0,0.0,6
1234,318,Stuff Packs,10,0,0.0,10
1235,319,Expansion Packs,16,0,0.0,16
1236,319,Game Packs,7,0,0.0,7
1237,319,Kits,1,1,1.0,0
1238,319,Stuff Packs,7,2,0.2857142857142857,5
1239,320,Expansion Packs,12,0,0.0,12
1240,320,Game Packs,5,0,0.0,5
1241,320,Kits,11,3,0.2727272727272727,8
1242,320,Stuff Packs,13,3,0.23076923076923078,10
1243,321,Expansion Packs,8,0,0.0,8
1244,321,Game Packs,1,0,0.0,1
1245,321,Kits,2,1,0.5,1
1246,321,Stuff Packs,6,3,0.5,3
1247,322,Expansion Packs,2,0,0.0,2
1248,322,Game Packs,1,0,0.0,1
1249,322,Kits,1,1,1.0,0
1250,322,Stuff Packs,2,2,1.0,0
1251,323,Expansion Packs,14,0,0.0,14
1252,323,Game Packs,6,0,0.0,6
1253,323,Kits,3,0,0.0,3
1254,323,Stuff Packs,8,3,0.375,5
1255,324,Expansion Packs,11,0,0.0,11
1256,324,Game Packs,4,0,0.0,4
1257,324,Kits,1,0,0.0,1
1258,324,Stuff Packs,2,2,1.0,0
1259,325,Expansion Packs,16,0,0.0,16
1260,325,Game Packs,11,0,0.0,11
1261,325,Kits,20,2,0.1,18
1262,325,Stuff Packs,17,2,0.11764705882352941,15
1263,326,Expansion Packs,16,0,0.0,16
1264,326,Game Packs,10,1,0.1,9
1265,326,Kits,10,3,0.3,7
1266,326,Stuff Packs,19,2,0.10526315789473684,17
1267,327,Expansion Packs,16,0,0.0,16
1268,327,Game Packs,12,0,0.0,12
1269,327,Kits,33,0,0.0,33
1270,327,Stuff Packs,20,0,0.0,20
1271,328,Expansion Packs,16,0,0.0,16
1272,328,Game Packs,12,1,0.08333333333333333,11
1273,328,Kits,33,0,0.0,33
1274,328,Stuff Packs,20,0,0.0,20
1275,329,Expansion Packs,16,0,0.0,16
1276,329,Game Packs,12,0,0.0,12
1277,329,Kits,33,3,0.09090909090909091,30
1278,329,Stuff Packs,20,0,0.0,20
1279,330,Expansion Packs,9,0,0.0,9
1280,330,Game Packs,5,1,0.2,4
1281,330,Kits,10,2,0.2,8
1282,330,Stuff Packs,8,4,0.5,4
1283,331,Expansion Packs,15,0,0.0,15
1284,331,Game Packs,12,0,0.0,12
1285,331,Kits,9,1,0.1111111111111111,8
1286,331,Stuff Packs,19,1,0.05263157894736842,18
1287,332,Expansion Packs,16,0,0.0,16
1288,332,Game Packs,12,0,0.0,12
1289,332,Kits,32,1,0.03125,31
1290,332,Stuff Packs,20,0,0.0,20
1291,333,Expansion Packs,14,0,0.0,14
1292,333,Game Packs,8,0,0.0,8
1293,333,Kits,17,1,0.058823529411764705,16
1294,333,Stuff Packs,18,0,0.0,18
1295,334,Expansion Packs,15,0,0.0,15
1296,334,Game Packs,10,0,0.0,10
1297,334,Kits,8,1,0.125,7
1298,334,Stuff Packs,18,1,0.05555555555555555,17
1299,335,Expansion Packs,2,0,0.0,2
1300,335,Kits,2,0,0.0,2
1301,335,Stuff Packs,3,0,0.0,3
1302,336,Expansion Packs,16,0,0.0,16
1303,336,Game Packs,12,0,0.0,12
1304,336,Stuff Packs,11,3,0.2727272727272727,8
1305,337,Expansion Packs,16,0,0.0,16
1306,337,Game Packs,11,0,0.0,11
1307,337,Kits,30,1,0.03333333333333333,29
1308,337,Stuff Packs,20,0,0.0,20
1309,338,Expansion Packs,16,0,0.0,16
1310,338,Game Packs,12,0,0.0,12
1311,338,Kits,33,1,0.030303030303030304,32
1312,338,Stuff Packs,20,0,0.0,20
1313,339,Expansion Packs,15,0,0.0,15
1314,339,Game Packs,11,0,0.0,11
1315,339,Kits,5,2,0.4,3
1316,339,Stuff Packs,19,2,0.10526315789473684,17
1317,340,Expansion Packs,12,0,0.0,12
1318,340,Game Packs,6,0,0.0,6
1319,340,Kits,5,0,0.0,5
1320,340,Stuff Packs,6,0,0.0,6
1321,341,Expansion Packs,15,0,0.0,15
1322,341,Game Packs,12,0,0.0,12
1323,341,Kits,24,1,0.041666666666666664,23
1324,341,Stuff Packs,19,0,0.0,19
1325,342,Expansion Packs,13,0,0.0,13
1326,342,Game Packs,10,0,0.0,10
1327,342,Kits,2,2,1.0,0
1328,342,Stuff Packs,9,4,0.4444444444444444,5
1329,343,Expansion Packs,4,4,1.0,0
1330,343,Game Packs,1,1,1.0,0
1331,343,Stuff Packs,4,4,1.0,0
1332,344,Expansion Packs,10,1,0.1,9
1333,344,Game Packs,7,0,0.0,7
1334,344,Kits,2,2,1.0,0
1335,344,Stuff Packs,9,3,0.3333333333333333,6
1336,345,Expansion Packs,2,1,0.5,1
1337,346,Expansion Packs,16,0,0.0,16
1338,346,Game Packs,12,0,0.0,12
1339,346,Kits,33,0,0.0,33
1340,346,Stuff Packs,20,0,0.0,20
1341,347,Expansion Packs,16,0,0.0,16
1342,347,Game Packs,12,0,0.0,12
1343,347,Kits,22,0,0.0,22
1344,347,Stuff Packs,20,0,0.0,20
1345,348,Expansion Packs,16,1,0.0625,15
1346,348,Game Packs,12,0,0.0,12
1347,348,Kits,14,0,0.0,14
1348,348,Stuff Packs,18,1,0.05555555555555555,17
1349,349,Expansion Packs,14,0,0.0,14
1350,349,Game Packs,5,0,0.0,5
1351,349,Kits,6,1,0.16666666666666666,5
1352,349,Stuff Packs,13,0,0.0,13
1353,350,Expansion Packs,16,0,0.0,16
1354,350,Game Packs,12,0,0.0,12
1355,350,Kits,33,0,0.0,33
1356,350,Stuff Packs,20,0,0.0,20
1357,351,Expansion Packs,16,0,0.0,16
1358,351,Game Packs,11,0,0.0,11
1359,351,Kits,11,2,0.18181818181818182,9
1360,351,Stuff Packs,20,0,0.0,20
1361,352,Expansion Packs,16,0,0.0,16
1362,352,Game Packs,12,0,0.0,12
1363,352,Kits,26,0,0.0,26
1364,352,Stuff Packs,20,1,0.05,19
1365,353,Expansion Packs,16,0,0.0,16
1366,353,Game Packs,12,1,0.08333333333333333,11
1367,353,Kits,33,4,0.12121212121212122,29
1368,353,Stuff Packs,20,1,0.05,19
1369,354,Expansion Packs,16,0,0.0,16
1370,354,Game Packs,12,0,0.0,12
1371,354,Kits,20,1,0.05,19
1372,354,Stuff Packs,20,0,0.0,20
1373,355,Expansion Packs,9,0,0.0,9
1374,355,Game Packs,6,0,0.0,6
1375,355,Kits,1,0,0.0,1
1376,355,Stuff Packs,8,0,0.0,8
1377,356,Expansion Packs,16,0,0.0,16
1378,356,Game Packs,12,0,0.0,12
1379,356,Kits,33,0,0.0,33
1380,356,Stuff Packs,20,0,0.0,20
1381,357,Expansion Packs,15,0,0.0,15
1382,357,Game Packs,10,0,0.0,10
1383,357,Kits,6,1,0.16666666666666666,5
1384,357,Stuff Packs,12,3,0.25,9
1385,358,Expansion Packs,8,5,0.625,3
1386,358,Game Packs,6,3,0.5,3
1387,358,Kits,3,3,1.0,0
1388,358,Stuff Packs,6,6,1.0,0
1389,359,Expansion Packs,16,0,0.0,16
1390,359,Game Packs,11,0,0.0,11
1391,359,Kits,25,1,0.04,24
1392,359,Stuff Packs,20,0,0.0,20
1393,360,Expansion Packs,16,0,0.0,16
1394,360,Game Packs,6,1,0.16666666666666666,5
1395,360,Kits,13,1,0.07692307692307693,12
1396,360,Stuff Packs,7,2,0.2857142857142857,5
1397,361,Expansion Packs,7,0,0.0,7
1398,361,Game Packs,5,0,0.0,5
1399,361,Kits,5,1,0.2,4
1400,361,Stuff Packs,6,0,0.0,6
1401,362,Expansion Packs,10,0,0.0,10
1402,362,Game Packs,6,0,0.0,6
1403,362,Kits,2,0,0.0,2
1404,362,Stuff Packs,6,0,0.0,6
1405,363,Expansion Packs,14,0,0.0,14
1406,363,Game Packs,11,0,0.0,11
1407,363,Kits,9,1,0.1111111111111111,8
1408,363,Stuff Packs,13,2,0.15384615384615385,11
1409,364,Expansion Packs,10,0,0.0,10
1410,364,Game Packs,3,1,0.3333333333333333,2
1411,364,Kits,7,2,0.2857142857142857,5
1412,364,Stuff Packs,7,3,0.42857142857142855,4
1413,365,Expansion Packs,11,0,0.0,11
1414,365,Game Packs,3,1,0.3333333333333333,2
1415,365,Kits,7,3,0.42857142857142855,4
1416,365,Stuff Packs,10,3,0.3,7
1417,366,Expansion Packs,14,9,0.6428571428571429,5
1418,366,Game Packs,11,7,0.6363636363636364,4
1419,366,Kits,6,3,0.5,3
1420,366,Stuff Packs,15,14,0.9333333333333333,1
1421,367,Expansion Packs,10,0,0.0,10
1422,367,Game Packs,5,0,0.0,5
1423,367,Kits,9,3,0.3333333333333333,6
1424,367,Stuff Packs,10,4,0.4,6
1425,368,Expansion Packs,8,0,0.0,8
1426,368,Game Packs,4,0,0.0,4
1427,368,Stuff Packs,7,0,0.0,7
1428,369,Expansion Packs,14,0,0.0,14
1429,369,Game Packs,11,0,0.0,11
1430,369,Kits,8,0,0.0,8
1431,369,Stuff Packs,16,2,0.125,14
1432,370,Expansion Packs,15,0,0.0,15
1433,370,Game Packs,12,1,0.08333333333333333,11
1434,370,Kits,33,2,0.06060606060606061,31
1435,370,Stuff Packs,20,1,0.05,19
1436,371,Expansion Packs,16,0,0.0,16
1437,371,Game Packs,7,0,0.0,7
1438,371,Kits,3,1,0.3333333333333333,2
1439,371,Stuff Packs,7,3,0.42857142857142855,4
1440,372,Expansion Packs,16,0,0.0,16
1441,372,Game Packs,8,0,0.0,8
1442,372,Kits,4,0,0.0,4
1443,372,Stuff Packs,12,0,0.0,12
1444,373,Expansion Packs,12,0,0.0,12
1445,373,Game Packs,2,0,0.0,2
1446,373,Stuff Packs,4,2,0.5,2
1447,374,Expansion Packs,3,0,0.0,3
1448,374,Kits,1,1,1.0,0
1449,374,Stuff Packs,4,4,1.0,0
1450,375,Expansion Packs,5,0,0.0,5
1451,376,Expansion Packs,16,0,0.0,16
1452,376,Game Packs,12,0,0.0,12
1453,376,Kits,4,0,0.0,4
1454,376,Stuff Packs,18,0,0.0,18
1455,377,Expansion Packs,14,0,0.0,14
1456,377,Game Packs,9,0,0.0,9
1457,377,Kits,13,1,0.07692307692307693,12
1458,377,Stuff Packs,18,1,0.05555555555555555,17
1459,378,Expansion Packs,6,0,0.0,6
1460,378,Game Packs,3,1,0.3333333333333333,2
1461,378,Kits,3,3,1.0,0
1462,378,Stuff Packs,4,4,1.0,0
1463,379,Expansion Packs,9,1,0.1111111111111111,8
1464,379,Game Packs,5,0,0.0,5
1465,379,Stuff Packs,5,5,1.0,0
1466,380,Expansion Packs,15,0,0.0,15
1467,380,Game Packs,12,3,0.25,9
1468,380,Kits,19,1,0.05263157894736842,18
1469,380,Stuff Packs,20,0,0.0,20
1470,381,Expansion Packs,14,0,0.0,14
1471,381,Game Packs,12,0,0.0,12
1472,381,Kits,2,1,0.5,1
1473,381,Stuff Packs,14,0,0.0,14
1474,382,Expansion Packs,11,0,0.0,11
1475,382,Game Packs,5,0,0.0,5
1476,382,Kits,10,2,0.2,8
1477,382,Stuff Packs,13,0,0.0,13
1478,383,Expansion Packs,16,0,0.0,16
1479,383,Game Packs,12,0,0.0,12
1480,383,Kits,29,1,0.034482758620689655,28
1481,383,Stuff Packs,20,0,0.0,20
1482,384,Expansion Packs,4,0,0.0,4
1483,384,Game Packs,4,0,0.0,4
1484,384,Stuff Packs,2,0,0.0,2
1485,385,Expansion Packs,7,0,0.0,7
1486,385,Game Packs,3,0,0.0,3
1487,386,Expansion Packs,16,0,0.0,16
1488,386,Game Packs,11,0,0.0,11
1489,386,Kits,22,1,0.045454545454545456,21
1490,386,Stuff Packs,20,0,0.0,20
1491,387,Expansion Packs,16,0,0.0,16
1492,387,Game Packs,12,0,0.0,12
1493,387,Kits,8,1,0.125,7
1494,387,Stuff Packs,16,0,0.0,16
1495,388,Expansion Packs,13,0,0.0,13
1496,388,Game Packs,9,0,0.0,9
1497,388,Kits,2,1,0.5,1
1498,388,Stuff Packs,9,2,0.2222222222222222,7
1499,389,Expansion Packs,7,0,0.0,7
1500,389,Game Packs,3,0,0.0,3
1501,389,Kits,8,1,0.125,7
1502,389,Stuff Packs,8,3,0.375,5
1503,390,Expansion Packs,4,0,0.0,4
1504,390,Game Packs,1,0,0.0,1
1505,390,Kits,2,0,0.0,2
1506,390,Stuff Packs,3,0,0.0,3
1507,391,Expansion Packs,11,0,0.0,11
1508,391,Game Packs,5,0,0.0,5
1509,391,Stuff Packs,5,0,0.0,5
1510,392,Expansion Packs,11,0,0.0,11
1511,392,Game Packs,6,0,0.0,6
1512,392,Kits,1,0,0.0,1
1513,392,Stuff Packs,6,3,0.5,3
1514,393,Expansion Packs,3,0,0.0,3
1515,393,Game Packs,1,0,0.0,1
1516,393,Stuff Packs,1,0,0.0,1
1517,394,Expansion Packs,15,0,0.0,15
1518,394,Game Packs,9,0,0.0,9
1519,394,Kits,16,2,0.125,14
1520,394,Stuff Packs,13,6,0.46153846153846156,7
1521,395,Expansion Packs,15,0,0.0,15
1522,395,Game Packs,11,0,0.0,11
1523,395,Kits,10,0,0.0,10
1524,395,Stuff Packs,12,0,0.0,12
1525,396,Expansion Packs,13,0,0.0,13
1526,396,Game Packs,5,0,0.0,5
1527,396,Kits,1,1,1.0,0
1528,396,Stuff Packs,18,1,0.05555555555555555,17
1529,397,Expansion Packs,16,0,0.0,16
1530,397,Game Packs,12,0,0.0,12
1531,397,Kits,28,0,0.0,28
1532,397,Stuff Packs,20,0,0.0,20
1533,398,Expansion Packs,13,0,0.0,13
1534,398,Game Packs,6,0,0.0,6
1535,398,Kits,3,3,1.0,0
1536,398,Stuff Packs,8,5,0.625,3
1537,399,Expansion Packs,13,0,0.0,13
1538,399,Game Packs,11,0,0.0,11
1539,399,Kits,2,1,0.5,1
1540,399,Stuff Packs,18,0,0.0,18
1541,400,Expansion Packs,15,0,0.0,15
1542,400,Game Packs,12,0,0.0,12
1543,400,Kits,14,0,0.0,14
1544,400,Stuff Packs,18,0,0.0,18
1545,401,Expansion Packs,4,0,0.0,4
1546,401,Game Packs,2,0,0.0,2
1547,401,Kits,1,1,1.0,0
1548,401,Stuff Packs,2,2,1.0,0
1549,402,Expansion Packs,14,0,0.0,14
1550,402,Game Packs,10,0,0.0,10
1551,402,Kits,6,1,0.16666666666666666,5
1552,402,Stuff Packs,20,1,0.05,19
1553,403,Expansion Packs,16,2,0.125,14
1554,403,Game Packs,11,11,1.0,0
1555,403,Kits,31,0,0.0,31
1556,403,Stuff Packs,18,1,0.05555555555555555,17
1557,404,Expansion Packs,16,1,0.0625,15
1558,404,Game Packs,12,1,0.08333333333333333,11
1559,404,Kits,32,1,0.03125,31
1560,404,Stuff Packs,20,0,0.0,20
1561,405,Expansion Packs,16,0,0.0,16
1562,405,Game Packs,9,0,0.0,9
1563,405,Kits,25,0,0.0,25
1564,405,Stuff Packs,9,3,0.3333333333333333,6
1565,406,Expansion Packs,13,0,0.0,13
1566,406,Game Packs,6,0,0.0,6
1567,406,Kits,3,0,0.0,3
1568,406,Stuff Packs,8,0,0.0,8
1569,407,Expansion Packs,7,0,0.0,7
1570,407,Game Packs,6,0,0.0,6
1571,407,Kits,1,0,0.0,1
1572,407,Stuff Packs,10,3,0.3,7
1573,408,Expansion Packs,6,1,0.16666666666666666,5
1574,408,Game Packs,2,0,0.0,2
1575,408,Stuff Packs,3,1,0.3333333333333333,2
1576,409,Expansion Packs,6,0,0.0,6
1577,409,Game Packs,2,0,0.0,2
1578,409,Kits,4,1,0.25,3
1579,409,Stuff Packs,7,3,0.42857142857142855,4
1580,410,Expansion Packs,1,0,0.0,1
1581,410,Game Packs,1,0,0.0,1
1582,411,Expansion Packs,13,0,0.0,13
1583,411,Game Packs,8,0,0.0,8
1584,411,Kits,3,2,0.6666666666666666,1
1585,411,Stuff Packs,12,3,0.25,9
1586,412,Expansion Packs,7,0,0.0,7
1587,412,Game Packs,2,0,0.0,2
1588,412,Kits,1,1,1.0,0
1589,412,Stuff Packs,4,3,0.75,1
1590,413,Expansion Packs,16,0,0.0,16
1591,413,Game Packs,12,0,0.0,12
1592,413,Kits,33,0,0.0,33
1593,413,Stuff Packs,20,0,0.0,20
1594,414,Expansion Packs,10,0,0.0,10
1595,414,Game Packs,4,0,0.0,4
1596,414,Kits,3,1,0.3333333333333333,2
1597,414,Stuff Packs,9,1,0.1111111111111111,8
1598,415,Expansion Packs,1,0,0.0,1
1599,415,Kits,1,1,1.0,0
1600,416,Expansion Packs,12,0,0.0,12
1601,416,Game Packs,5,0,0.0,5
1602,416,Kits,7,1,0.14285714285714285,6
1603,416,Stuff Packs,3,2,0.6666666666666666,1
1604,417,Expansion Packs,16,0,0.0,16
1605,417,Game Packs,12,0,0.0,12
1606,417,Kits,33,0,0.0,33
1607,417,Stuff Packs,20,0,0.0,20
1608,418,Expansion Packs,6,0,0.0,6
1609,418,Game Packs,4,0,0.0,4
1610,418,Kits,1,1,1.0,0
1611,418,Stuff Packs,3,0,0.0,3
1612,419,Expansion Packs,16,0,0.0,16
1613,419,Game Packs,12,0,0.0,12
1614,419,Kits,33,0,0.0,33
1615,419,Stuff Packs,20,0,0.0,20
1616,420,Expansion Packs,9,0,0.0,9
1617,420,Game Packs,5,1,0.2,4
1618,420,Kits,4,1,0.25,3
1619,420,Stuff Packs,9,3,0.3333333333333333,6
1620,421,Expansion Packs,9,0,0.0,9
1621,421,Game Packs,2,0,0.0,2
1622,421,Kits,2,1,0.5,1
1623,421,Stuff Packs,4,2,0.5,2
1624,422,Expansion Packs,13,0,0.0,13
1625,422,Game Packs,8,0,0.0,8
1626,422,Kits,2,1,0.5,1
1627,422,Stuff Packs,11,0,0.0,11
1628,423,Expansion Packs,11,0,0.0,11
1629,423,Game Packs,10,0,0.0,10
1630,423,Kits,2,1,0.5,1
1631,423,Stuff Packs,10,1,0.1,9
1632,424,Expansion Packs,12,0,0.0,12
1633,424,Game Packs,2,0,0.0,2
1634,424,Kits,10,1,0.1,9
1635,424,Stuff Packs,11,4,0.36363636363636365,7
1636,425,Expansion Packs,5,0,0.0,5
1637,425,Game Packs,3,0,0.0,3
1638,425,Stuff Packs,1,0,0.0,1
1639,426,Expansion Packs,16,0,0.0,16
1640,426,Game Packs,11,0,0.0,11
1641,426,Kits,32,1,0.03125,31
1642,426,Stuff Packs,19,3,0.15789473684210525,16
1643,427,Expansion Packs,16,0,0.0,16
1644,427,Game Packs,11,0,0.0,11
1645,427,Kits,10,2,0.2,8
1646,427,Stuff Packs,19,0,0.0,19
1647,428,Expansion Packs,13,0,0.0,13
1648,428,Game Packs,8,1,0.125,7
1649,428,Kits,4,1,0.25,3
1650,428,Stuff Packs,10,3,0.3,7
1651,429,Expansion Packs,5,0,0.0,5
1652,429,Game Packs,3,0,0.0,3
1653,429,Kits,2,2,1.0,0
1654,429,Stuff Packs,7,1,0.14285714285714285,6
1655,430,Expansion Packs,11,0,0.0,11
1656,430,Game Packs,9,0,0.0,9
1657,430,Stuff Packs,17,0,0.0,17
1658,431,Expansion Packs,15,0,0.0,15
1659,431,Game Packs,6,0,0.0,6
1660,431,Kits,8,0,0.0,8
1661,432,Expansion Packs,16,0,0.0,16
1662,432,Game Packs,12,0,0.0,12
1663,432,Kits,33,0,0.0,33
1664,432,Stuff Packs,20,0,0.0,20
1665,433,Expansion Packs,15,0,0.0,15
1666,433,Game Packs,12,0,0.0,12
1667,433,Kits,30,0,0.0,30
1668,433,Stuff Packs,20,0,0.0,20
1669,434,Expansion Packs,4,0,0.0,4
1670,434,Game Packs,2,0,0.0,2
1671,434,Kits,2,1,0.5,1
1672,434,Stuff Packs,4,2,0.5,2
1673,435,Expansion Packs,10,0,0.0,10
1674,435,Game Packs,5,0,0.0,5
1675,435,Kits,2,2,1.0,0
1676,435,Stuff Packs,10,0,0.0,10
1677,436,Expansion Packs,16,1,0.0625,15
1678,436,Game Packs,12,0,0.0,12
1679,436,Kits,33,0,0.0,33
1680,436,Stuff Packs,20,0,0.0,20
1681,437,Expansion Packs,15,0,0.0,15
1682,437,Game Packs,5,0,0.0,5
1683,437,Kits,14,1,0.07142857142857142,13
1684,437,Stuff Packs,10,2,0.2,8
1685,438,Expansion Packs,16,0,0.0,16
1686,438,Game Packs,9,0,0.0,9
1687,438,Kits,3,3,1.0,0
1688,438,Stuff Packs,12,2,0.16666666666666666,10
1689,439,Expansion Packs,16,0,0.0,16
1690,439,Game Packs,11,0,0.0,11
1691,439,Kits,6,1,0.16666666666666666,5
1692,439,Stuff Packs,19,1,0.05263157894736842,18
1693,440,Expansion Packs,8,0,0.0,8
1694,440,Game Packs,3,0,0.0,3
1695,440,Kits,1,1,1.0,0
1696,440,Stuff Packs,4,3,0.75,1
1697,441,Expansion Packs,16,0,0.0,16
1698,441,Game Packs,12,0,0.0,12
1699,441,Kits,3,2,0.6666666666666666,1
1700,441,Stuff Packs,18,0,0.0,18
1701,442,Expansion Packs,16,0,0.0,16
1702,442,Game Packs,10,0,0.0,10
1703,442,Kits,21,0,0.0,21
1704,442,Stuff Packs,19,0,0.0,19
1705,443,Expansion Packs,13,0,0.0,13
1706,443,Game Packs,5,0,0.0,5
1707,443,Kits,2,1,0.5,1
1708,443,Stuff Packs,8,3,0.375,5
1709,444,Expansion Packs,14,0,0.0,14
1710,444,Game Packs,11,0,0.0,11
1711,444,Kits,7,2,0.2857142857142857,5
1712,444,Stuff Packs,16,1,0.0625,15
1713,445,Expansion Packs,16,0,0.0,16
1714,445,Game Packs,12,0,0.0,12
1715,445,Kits,32,1,0.03125,31
1716,445,Stuff Packs,20,0,0.0,20
1717,446,Expansion Packs,13,0,0.0,13
1718,446,Game Packs,9,0,0.0,9
1719,446,Kits,8,1,0.125,7
1720,446,Stuff Packs,8,1,0.125,7
1721,447,Expansion Packs,10,0,0.0,10
1722,447,Game Packs,2,0,0.0,2
1723,447,Kits,3,0,0.0,3
1724,447,Stuff Packs,7,2,0.2857142857142857,5
1725,448,Expansion Packs,9,0,0.0,9
1726,448,Game Packs,11,0,0.0,11
1727,448,Kits,9,1,0.1111111111111111,8
1728,448,Stuff Packs,12,0,0.0,12
1729,449,Expansion Packs,12,0,0.0,12
1730,449,Game Packs,9,0,0.0,9
1731,449,Kits,13,1,0.07692307692307693,12
1732,449,Stuff Packs,15,0,0.0,15
1733,450,Expansion Packs,15,0,0.0,15
1734,450,Game Packs,11,0,0.0,11
1735,450,Kits,7,2,0.2857142857142857,5
1736,450,Stuff Packs,10,1,0.1,9
1737,451,Expansion Packs,9,0,0.0,9
1738,451,Game Packs,1,0,0.0,1
1739,451,Kits,3,2,0.6666666666666666,1
1740,451,Stuff Packs,5,3,0.6,2
1741,452,Expansion Packs,3,0,0.0,3
1742,452,Game Packs,3,0,0.0,3
1743,452,Kits,1,1,1.0,0
1744,452,Stuff Packs,5,1,0.2,4
1745,453,Expansion Packs,13,0,0.0,13
1746,453,Game Packs,6,4,0.6666666666666666,2
1747,453,Stuff Packs,2,1,0.5,1
1748,454,Expansion Packs,14,0,0.0,14
1749,454,Game Packs,11,0,0.0,11
1750,454,Kits,9,0,0.0,9
1751,454,Stuff Packs,16,0,0.0,16
1752,455,Expansion Packs,14,0,0.0,14
1753,455,Game Packs,12,0,0.0,12
1754,455,Kits,23,0,0.0,23
1755,455,Stuff Packs,18,0,0.0,18
1756,456,Expansion Packs,12,0,0.0,12
1757,456,Game Packs,9,0,0.0,9
1758,456,Kits,2,2,1.0,0
1759,456,Stuff Packs,17,0,0.0,17
1760,457,Expansion Packs,15,0,0.0,15
1761,457,Game Packs,12,0,0.0,12
1762,457,Kits,32,0,0.0,32
1763,457,Stuff Packs,20,0,0.0,20
1764,458,Expansion Packs,15,1,0.06666666666666667,14
1765,458,Game Packs,10,1,0.1,9
1766,458,Kits,13,1,0.07692307692307693,12
1767,458,Stuff Packs,16,2,0.125,14
1768,459,Expansion Packs,7,0,0.0,7
1769,459,Game Packs,5,1,0.2,4
1770,459,Kits,3,3,1.0,0
1771,459,Stuff Packs,5,3,0.6,2
1772,460,Expansion Packs,8,0,0.0,8
1773,460,Game Packs,4,0,0.0,4
1774,460,Kits,1,1,1.0,0
1775,460,Stuff Packs,7,2,0.2857142857142857,5
1776,461,Expansion Packs,14,0,0.0,14
1777,461,Game Packs,7,0,0.0,7
1778,461,Kits,9,0,0.0,9
1779,461,Stuff Packs,15,2,0.13333333333333333,13
1780,462,Expansion Packs,13,0,0.0,13
1781,462,Game Packs,7,1,0.14285714285714285,6
1782,462,Kits,7,1,0.14285714285714285,6
1783,462,Stuff Packs,8,3,0.375,5
1784,463,Expansion Packs,15,0,0.0,15
1785,463,Game Packs,7,1,0.14285714285714285,6
1786,463,Kits,2,2,1.0,0
1787,463,Stuff Packs,6,4,0.6666666666666666,2
1788,464,Expansion Packs,4,0,0.0,4
1789,464,Game Packs,1,0,0.0,1
1790,464,Kits,2,2,1.0,0
1791,464,Stuff Packs,4,3,0.75,1
1792,465,Expansion Packs,6,0,0.0,6
1793,465,Game Packs,3,0,0.0,3
1794,465,Kits,1,1,1.0,0
1795,465,Stuff Packs,5,0,0.0,5
1796,466,Expansion Packs,13,0,0.0,13
1797,466,Game Packs,11,0,0.0,11
1798,466,Kits,2,0,0.0,2
1799,466,Stuff Packs,19,0,0.0,19
1800,467,Expansion Packs,15,0,0.0,15
1801,467,Game Packs,10,0,0.0,10
1802,467,Kits,7,1,0.14285714285714285,6
1803,467,Stuff Packs,13,0,0.0,13
1804,468,Expansion Packs,5,0,0.0,5
1805,468,Game Packs,2,0,0.0,2
1806,468,Stuff Packs,3,1,0.3333333333333333,2
1807,469,Expansion Packs,16,0,0.0,16
1808,469,Game Packs,12,0,0.0,12
1809,469,Kits,33,0,0.0,33
1810,469,Stuff Packs,20,0,0.0,20
1811,470,Expansion Packs,12,0,0.0,12
1812,470,Game Packs,10,0,0.0,10
1813,470,Kits,7,1,0.14285714285714285,6
1814,470,Stuff Packs,18,0,0.0,18
1815,471,Expansion Packs,9,0,0.0,9
1816,471,Game Packs,6,0,0.0,6
1817,471,Kits,4,1,0.25,3
1818,471,Stuff Packs,15,3,0.2,12
1819,472,Expansion Packs,16,1,0.0625,15
1820,472,Game Packs,12,0,0.0,12
1821,472,Kits,32,0,0.0,32
1822,472,Stuff Packs,20,0,0.0,20
1823,473,Expansion Packs,16,0,0.0,16
1824,473,Game Packs,12,0,0.0,12
1825,473,Kits,33,0,0.0,33
1826,473,Stuff Packs,20,0,0.0,20
1827,474,Expansion Packs,9,0,0.0,9
1828,474,Game Packs,2,0,0.0,2
1829,474,Kits,2,2,1.0,0
1830,474,Stuff Packs,6,3,0.5,3
1831,475,Expansion Packs,9,0,0.0,9
1832,475,Game Packs,6,0,0.0,6
1833,475,Kits,7,3,0.42857142857142855,4
1834,475,Stuff Packs,7,4,0.5714285714285714,3
1835,476,Expansion Packs,15,0,0.0,15
1836,476,Game Packs,12,0,0.0,12
1837,476,Kits,29,0,0.0,29
1838,476,Stuff Packs,20,0,0.0,20
1839,477,Expansion Packs,16,0,0.0,16
1840,477,Game Packs,12,0,0.0,12
1841,477,Kits,33,1,0.030303030303030304,32
1842,477,Stuff Packs,20,1,0.05,19
1843,478,Expansion Packs,12,0,0.0,12
1844,478,Game Packs,9,0,0.0,9
1845,478,Kits,8,1,0.125,7
1846,478,Stuff Packs,11,0,0.0,11
1847,479,Expansion Packs,15,0,0.0,15
1848,479,Game Packs,12,0,0.0,12
1849,479,Kits,26,0,0.0,26
1850,479,Stuff Packs,20,0,0.0,20
1851,480,Expansion Packs,6,0,0.0,6
1852,480,Game Packs,1,0,0.0,1
1853,480,Kits,3,1,0.3333333333333333,2
1854,480,Stuff Packs,5,3,0.6,2
1855,481,Expansion Packs,16,0,0.0,16
1856,481,Game Packs,11,0,0.0,11
1857,481,Kits,27,2,0.07407407407407407,25
1858,481,Stuff Packs,20,0,0.0,20
1859,482,Expansion Packs,11,0,0.0,11
1860,482,Game Packs,9,0,0.0,9
1861,482,Kits,1,1,1.0,0
1862,482,Stuff Packs,7,0,0.0,7
1863,483,Expansion Packs,12,0,0.0,12
1864,483,Game Packs,9,0,0.0,9
1865,483,Kits,9,2,0.2222222222222222,7
1866,483,Stuff Packs,10,3,0.3,7
1867,484,Expansion Packs,14,0,0.0,14
1868,484,Game Packs,9,0,0.0,9
1869,484,Kits,3,2,0.6666666666666666,1
1870,484,Stuff Packs,13,1,0.07692307692307693,12
1871,485,Expansion Packs,16,0,0.0,16
1872,485,Game Packs,12,0,0.0,12
1873,485,Kits,33,0,0.0,33
1874,485,Stuff Packs,20,1,0.05,19
1875,486,Expansion Packs,15,0,0.0,15
1876,486,Game Packs,9,0,0.0,9
1877,486,Kits,5,1,0.2,4
1878,486,Stuff Packs,9,3,0.3333333333333333,6
1879,487,Expansion Packs,16,3,0.1875,13
1880,487,Game Packs,12,3,0.25,9
1881,487,Kits,33,2,0.06060606060606061,31
1882,487,Stuff Packs,20,7,0.35,13
1883,488,Expansion Packs,7,0,0.0,7
1884,488,Game Packs,4,0,0.0,4
1885,488,Kits,3,3,1.0,0
1886,488,Stuff Packs,7,4,0.5714285714285714,3
1887,489,Expansion Packs,15,0,0.0,15
1888,489,Game Packs,10,0,0.0,10
1889,489,Kits,4,1,0.25,3
1890,489,Stuff Packs,13,2,0.15384615384615385,11
1891,490,Expansion Packs,16,0,0.0,16
1892,490,Game Packs,11,0,0.0,11
1893,490,Kits,32,2,0.0625,30
1894,490,Stuff Packs,19,0,0.0,19
1895,491,Expansion Packs,15,0,0.0,15
1896,491,Game Packs,11,1,0.09090909090909091,10
1897,491,Kits,20,0,0.0,20
1898,491,Stuff Packs,16,3,0.1875,13
1899,492,Expansion Packs,16,0,0.0,16
1900,492,Game Packs,10,0,0.0,10
1901,492,Kits,2,2,1.0,0
1902,492,Stuff Packs,13,2,0.15384615384615385,11
1903,493,Expansion Packs,9,0,0.0,9
1904,493,Game Packs,5,0,0.0,5
1905,493,Kits,3,1,0.3333333333333333,2
1906,493,Stuff Packs,5,2,0.4,3
1907,494,Expansion Packs,13,0,0.0,13
1908,494,Game Packs,11,0,0.0,11
1909,494,Kits,8,1,0.125,7
1910,494,Stuff Packs,18,0,0.0,18
1911,495,Expansion Packs,13,0,0.0,13
1912,495,Game Packs,9,0,0.0,9
1913,495,Kits,9,0,0.0,9
1914,495,Stuff Packs,10,1,0.1,9
1915,496,Expansion Packs,14,0,0.0,14
1916,496,Game Packs,7,0,0.0,7
1917,496,Kits,9,2,0.2222222222222222,7
1918,496,Stuff Packs,6,0,0.0,6
1919,497,Expansion Packs,11,0,0.0,11
1920,497,Game Packs,7,0,0.0,7
1921,497,Kits,3,2,0.6666666666666666,1
1922,497,Stuff Packs,12,3,0.25,9
1923,498,Expansion Packs,3,1,0.3333333333333333,2
1924,498,Game Packs,2,1,0.5,1
1925,498,Kits,3,1,0.3333333333333333,2
1926,498,Stuff Packs,2,1,0.5,1
1927,499,Expansion Packs,13,0,0.0,13
1928,499,Game Packs,8,0,0.0,8
1929,499,Kits,10,0,0.0,10
1930,499,Stuff Packs,8,1,0.125,7
1931,500,Expansion Packs,14,0,0.0,14
1932,500,Game Packs,9,0,0.0,9
1933,500,Kits,6,0,0.0,6
1934,500,Stuff Packs,7,0,0.0,7
1935,501,Expansion Packs,16,0,0.0,16
1936,501,Game Packs,12,0,0.0,12
1937,501,Kits,27,1,0.037037037037037035,26
1938,501,Stuff Packs,20,0,0.0,20
1939,502,Expansion Packs,16,0,0.0,16
1940,502,Game Packs,12,0,0.0,12
1941,502,Kits,27,0,0.0,27
1942,502,Stuff Packs,20,0,0.0,20
1943,503,Expansion Packs,11,0,0.0,11
1944,503,Game Packs,8,0,0.0,8
1945,503,Kits,4,3,0.75,1
1946,503,Stuff Packs,12,1,0.08333333333333333,11
1947,504,Expansion Packs,10,0,0.0,10
1948,504,Game Packs,3,1,0.3333333333333333,2
1949,504,Kits,3,1,0.3333333333333333,2
1950,504,Stuff Packs,5,3,0.6,2
1951,505,Expansion Packs,15,0,0.0,15
1952,505,Game Packs,3,0,0.0,3
1953,505,Kits,14,1,0.07142857142857142,13
1954,505,Stuff Packs,5,0,0.0,5
1955,506,Expansion Packs,9,0,0.0,9
1956,506,Game Packs,2,0,0.0,2
1957,506,Kits,6,0,0.0,6
1958,506,Stuff Packs,9,3,0.3333333333333333,6
1959,507,Expansion Packs,16,2,0.125,14
1960,507,Game Packs,12,0,0.0,12
1961,507,Kits,33,1,0.030303030303030304,32
1962,507,Stuff Packs,20,1,0.05,19
1963,508,Expansion Packs,16,0,0.0,16
1964,508,Game Packs,12,0,0.0,12
1965,508,Kits,33,1,0.030303030303030304,32
1966,508,Stuff Packs,20,0,0.0,20
1967,509,Expansion Packs,16,0,0.0,16
1968,509,Game Packs,12,0,0.0,12
1969,509,Kits,32,0,0.0,32
1970,509,Stuff Packs,20,0,0.0,20
1971,510,Expansion Packs,16,0,0.0,16
1972,510,Game Packs,11,0,0.0,11
1973,510,Kits,4,2,0.5,2
1974,510,Stuff Packs,19,0,0.0,19
1975,511,Expansion Packs,12,0,0.0,12
1976,511,Game Packs,10,0,0.0,10
1977,511,Kits,2,2,1.0,0
1978,511,Stuff Packs,12,1,0.08333333333333333,11
1979,512,Expansion Packs,14,0,0.0,14
1980,512,Game Packs,10,0,0.0,10
1981,512,Kits,1,1,1.0,0
1982,512,Stuff Packs,12,0,0.0,12
1983,513,Expansion Packs,12,0,0.0,12
1984,513,Game Packs,3,1,0.3333333333333333,2
1985,513,Kits,6,2,0.3333333333333333,4
1986,513,Stuff Packs,11,5,0.45454545454545453,6
1987,514,Expansion Packs,16,0,0.0,16
1988,514,Game Packs,8,0,0.0,8
1989,514,Kits,4,3,0.75,1
1990,514,Stuff Packs,8,2,0.25,6
1991,515,Expansion Packs,16,0,0.0,16
1992,515,Game Packs,8,0,0.0,8
1993,515,Kits,5,2,0.4,3
1994,515,Stuff Packs,10,3,0.3,7
1995,516,Expansion Packs,16,0,0.0,16
1996,516,Game Packs,9,0,0.0,9
1997,516,Kits,3,3,1.0,0
1998,516,Stuff Packs,9,2,0.2222222222222222,7
1999,517,Expansion Packs,16,0,0.0,16
2000,517,Game Packs,12,0,0.0,12
2001,517,Kits,33,0,0.0,33
2002,517,Stuff Packs,20,0,0.0,20
2003,518,Expansion Packs,16,0,0.0,16
2004,518,Game Packs,11,1,0.09090909090909091,10
2005,518,Kits,17,1,0.058823529411764705,16
2006,518,Stuff Packs,15,1,0.06666666666666667,14
2007,519,Expansion Packs,6,1,0.16666666666666666,5
2008,519,Game Packs,5,1,0.2,4
2009,519,Kits,3,3,1.0,0
2010,519,Stuff Packs,7,4,0.5714285714285714,3
2011,520,Expansion Packs,16,0,0.0,16
2012,520,Game Packs,12,0,0.0,12
2013,520,Kits,33,1,0.030303030303030304,32
2014,520,Stuff Packs,20,0,0.0,20
2015,521,Expansion Packs,7,0,0.0,7
2016,521,Game Packs,4,0,0.0,4
2017,521,Kits,2,1,0.5,1
2018,521,Stuff Packs,2,1,0.5,1
2019,522,Expansion Packs,11,1,0.09090909090909091,10
2020,522,Game Packs,5,0,0.0,5
2021,522,Kits,5,1,0.2,4
2022,522,Stuff Packs,13,1,0.07692307692307693,12
2023,523,Expansion Packs,10,0,0.0,10
2024,523,Game Packs,10,0,0.0,10
2025,523,Kits,3,1,0.3333333333333333,2
2026,523,Stuff Packs,13,0,0.0,13
2027,524,Expansion Packs,15,0,0.0,15
2028,524,Game Packs,10,0,0.0,10
2029,524,Kits,1,1,1.0,0
2030,524,Stuff Packs,11,0,0.0,11
2031,525,Expansion Packs,5,0,0.0,5
2032,525,Game Packs,1,0,0.0,1
2033,525,Kits,2,2,1.0,0
2034,525,Stuff Packs,4,3,0.75,1
2035,526,Expansion Packs,16,0,0.0,16
2036,526,Game Packs,12,0,0.0,12
2037,526,Kits,33,0,0.0,33
2038,526,Stuff Packs,20,0,0.0,20
2039,527,Expansion Packs,16,0,0.0,16
2040,527,Game Packs,12,0,0.0,12
2041,527,Kits,33,0,0.0,33
2042,527,Stuff Packs,20,0,0.0,20
2043,528,Expansion Packs,10,0,0.0,10
2044,528,Game Packs,7,1,0.14285714285714285,6
2045,528,Kits,1,1,1.0,0
2046,528,Stuff Packs,6,3,0.5,3
2047,529,Expansion Packs,16,0,0.0,16
2048,529,Game Packs,11,0,0.0,11
2049,529,Kits,13,1,0.07692307692307693,12
2050,529,Stuff Packs,20,0,0.0,20
2051,530,Expansion Packs,13,0,0.0,13
2052,530,Game Packs,4,0,0.0,4
2053,530,Kits,9,2,0.2222222222222222,7
2054,530,Stuff Packs,9,1,0.1111111111111111,8
2055,531,Expansion Packs,12,0,0.0,12
2056,531,Game Packs,6,0,0.0,6
2057,531,Kits,2,1,0.5,1
2058,531,Stuff Packs,8,2,0.25,6
2059,532,Expansion Packs,11,0,0.0,11
2060,532,Game Packs,10,0,0.0,10
2061,532,Kits,1,1,1.0,0
2062,532,Stuff Packs,4,0,0.0,4
2063,533,Kits,1,1,1.0,0
2064,533,Stuff Packs,1,0,0.0,1
2065,534,Expansion Packs,14,0,0.0,14
2066,534,Game Packs,12,0,0.0,12
2067,534,Kits,7,0,0.0,7
2068,534,Stuff Packs,18,0,0.0,18
2069,535,Expansion Packs,13,0,0.0,13
2070,535,Game Packs,7,0,0.0,7
2071,535,Kits,3,0,0.0,3
2072,535,Stuff Packs,10,2,0.2,8
2073,536,Expansion Packs,16,0,0.0,16
2074,536,Game Packs,11,0,0.0,11
2075,536,Kits,32,1,0.03125,31
2076,536,Stuff Packs,19,1,0.05263157894736842,18
2077,537,Expansion Packs,6,0,0.0,6
2078,537,Game Packs,5,0,0.0,5
2079,537,Kits,5,0,0.0,5
2080,537,Stuff Packs,7,1,0.14285714285714285,6
2081,538,Expansion Packs,8,0,0.0,8
2082,538,Game Packs,7,0,0.0,7
2083,538,Kits,1,1,1.0,0
2084,538,Stuff Packs,10,4,0.4,6
2085,539,Expansion Packs,5,0,0.0,5
2086,539,Game Packs,4,0,0.0,4
2087,539,Kits,4,2,0.5,2
2088,539,Stuff Packs,4,3,0.75,1
2089,540,Expansion Packs,14,0,0.0,14
2090,540,Game Packs,8,0,0.0,8
2091,540,Kits,16,0,0.0,16
2092,540,Stuff Packs,10,0,0.0,10
2093,541,Expansion Packs,16,0,0.0,16
2094,541,Game Packs,7,0,0.0,7
2095,541,Stuff Packs,10,4,0.4,6
2096,542,Expansion Packs,2,0,0.0,2
2097,542,Game Packs,1,0,0.0,1
2098,542,Kits,2,2,1.0,0
2099,542,Stuff Packs,3,3,1.0,0
2100,543,Expansion Packs,16,0,0.0,16
2101,543,Game Packs,12,0,0.0,12
2102,543,Kits,33,1,0.030303030303030304,32
2103,543,Stuff Packs,20,0,0.0,20
2104,544,Expansion Packs,16,0,0.0,16
2105,544,Game Packs,12,0,0.0,12
2106,544,Kits,17,1,0.058823529411764705,16
2107,544,Stuff Packs,19,1,0.05263157894736842,18
2108,545,Expansion Packs,14,0,0.0,14
2109,545,Game Packs,8,0,0.0,8
2110,545,Kits,3,0,0.0,3
2111,545,Stuff Packs,8,0,0.0,8
2112,546,Expansion Packs,8,0,0.0,8
2113,546,Game Packs,5,0,0.0,5
2114,546,Kits,2,1,0.5,1
2115,546,Stuff Packs,3,0,0.0,3
2116,547,Expansion Packs,10,0,0.0,10
2117,547,Game Packs,9,0,0.0,9
2118,547,Kits,3,0,0.0,3
2119,547,Stuff Packs,12,0,0.0,12
2120,548,Expansion Packs,3,0,0.0,3
2121,548,Game Packs,2,1,0.5,1
2122,548,Kits,3,3,1.0,0
2123,548,Stuff Packs,5,3,0.6,2
2124,549,Expansion Packs,15,0,0.0,15
2125,549,Game Packs,9,2,0.2222222222222222,7
2126,549,Kits,3,3,1.0,0
2127,549,Stuff Packs,8,4,0.5,4
2128,550,Expansion Packs,16,2,0.125,14
2129,550,Game Packs,12,1,0.08333333333333333,11
2130,550,Kits,33,10,0.30303030303030304,23
2131,550,Stuff Packs,20,1,0.05,19
2132,551,Expansion Packs,16,0,0.0,16
2133,551,Game Packs,10,0,0.0,10
2134,551,Kits,19,0,0.0,19
2135,551,Stuff Packs,17,0,0.0,17
2136,552,Expansion Packs,9,0,0.0,9
2137,552,Game Packs,5,0,0.0,5
2138,552,Kits,4,1,0.25,3
2139,552,Stuff Packs,9,1,0.1111111111111111,8
2140,553,Expansion Packs,10,0,0.0,10
2141,553,Game Packs,7,0,0.0,7
2142,553,Kits,1,0,0.0,1
2143,553,Stuff Packs,11,0,0.0,11
2144,554,Expansion Packs,15,0,0.0,15
2145,554,Game Packs,12,0,0.0,12
2146,554,Kits,9,0,0.0,9
2147,554,Stuff Packs,19,0,0.0,19
2148,555,Expansion Packs,14,0,0.0,14
2149,555,Game Packs,9,0,0.0,9
2150,555,Kits,20,1,0.05,19
2151,555,Stuff Packs,17,0,0.0,17
2152,556,Expansion Packs,11,3,0.2727272727272727,8
2153,556,Game Packs,6,0,0.0,6
2154,556,Kits,2,2,1.0,0
2155,556,Stuff Packs,7,3,0.42857142857142855,4
2156,557,Expansion Packs,16,1,0.0625,15
2157,557,Game Packs,12,0,0.0,12
2158,557,Kits,19,1,0.05263157894736842,18
2159,557,Stuff Packs,18,0,0.0,18
2160,558,Expansion Packs,12,0,0.0,12
2161,558,Game Packs,7,0,0.0,7
2162,558,Kits,2,2,1.0,0
2163,558,Stuff Packs,8,1,0.125,7
2164,559,Expansion Packs,14,0,0.0,14
2165,559,Game Packs,12,0,0.0,12
2166,559,Kits,19,1,0.05263157894736842,18
2167,559,Stuff Packs,20,0,0.0,20
2168,560,Expansion Packs,2,0,0.0,2
2169,560,Kits,1,1,1.0,0
2170,560,Stuff Packs,2,2,1.0,0
2171,561,Expansion Packs,16,0,0.0,16
2172,561,Game Packs,12,0,0.0,12
2173,561,Kits,8,1,0.125,7
2174,561,Stuff Packs,18,2,0.1111111111111111,16
2175,562,Expansion Packs,16,0,0.0,16
2176,562,Game Packs,12,0,0.0,12
2177,562,Kits,33,0,0.0,33
2178,562,Stuff Packs,20,0,0.0,20
2179,563,Expansion Packs,7,0,0.0,7
2180,563,Game Packs,5,0,0.0,5
2181,563,Kits,4,0,0.0,4
2182,563,Stuff Packs,9,0,0.0,9
2183,564,Expansion Packs,2,0,0.0,2
2184,564,Game Packs,1,1,1.0,0
2185,564,Kits,3,3,1.0,0
2186,564,Stuff Packs,3,3,1.0,0
2187,565,Expansion Packs,15,0,0.0,15
2188,565,Game Packs,11,0,0.0,11
2189,565,Kits,6,2,0.3333333333333333,4
2190,565,Stuff Packs,14,3,0.21428571428571427,11
2191,566,Expansion Packs,12,0,0.0,12
2192,566,Game Packs,4,1,0.25,3
2193,566,Kits,10,2,0.2,8
2194,566,Stuff Packs,12,4,0.3333333333333333,8
2195,567,Expansion Packs,12,0,0.0,12
2196,567,Game Packs,6,0,0.0,6
2197,567,Kits,3,1,0.3333333333333333,2
2198,567,Stuff Packs,11,3,0.2727272727272727,8
2199,568,Expansion Packs,9,0,0.0,9
2200,568,Game Packs,9,0,0.0,9
2201,568,Kits,4,0,0.0,4
2202,568,Stuff Packs,19,0,0.0,19
2203,569,Expansion Packs,16,0,0.0,16
2204,569,Game Packs,11,0,0.0,11
2205,569,Kits,10,0,0.0,10
2206,569,Stuff Packs,12,0,0.0,12
2207,570,Expansion Packs,16,0,0.0,16
2208,570,Game Packs,12,0,0.0,12
2209,570,Kits,31,0,0.0,31
2210,570,Stuff Packs,20,0,0.0,20
2211,571,Expansion Packs,16,0,0.0,16
2212,571,Game Packs,11,0,0.0,11
2213,571,Kits,14,3,0.21428571428571427,11
2214,571,Stuff Packs,18,2,0.1111111111111111,16
2215,572,Expansion Packs,7,0,0.0,7
2216,572,Game Packs,3,1,0.3333333333333333,2
2217,572,Kits,4,1,0.25,3
2218,572,Stuff Packs,6,4,0.6666666666666666,2
2219,573,Expansion Packs,16,0,0.0,16
2220,573,Game Packs,12,0,0.0,12
2221,573,Kits,33,2,0.06060606060606061,31
2222,573,Stuff Packs,20,0,0.0,20
2223,574,Expansion Packs,15,0,0.0,15
2224,574,Game Packs,4,0,0.0,4
2225,574,Kits,1,0,0.0,1
2226,574,Stuff Packs,5,1,0.2,4
2227,575,Expansion Packs,16,0,0.0,16
2228,575,Game Packs,12,0,0.0,12
2229,575,Kits,23,1,0.043478260869565216,22
2230,575,Stuff Packs,20,1,0.05,19
2231,576,Expansion Packs,10,0,0.0,10
2232,576,Game Packs,4,1,0.25,3
2233,576,Kits,4,2,0.5,2
2234,576,Stuff Packs,10,3,0.3,7
2235,577,Expansion Packs,16,0,0.0,16
2236,577,Game Packs,11,0,0.0,11
2237,577,Kits,31,2,0.06451612903225806,29
2238,577,Stuff Packs,18,2,0.1111111111111111,16
2239,578,Expansion Packs,16,0,0.0,16
2240,578,Game Packs,12,0,0.0,12
2241,578,Kits,11,0,0.0,11
2242,578,Stuff Packs,20,2,0.1,18
2243,579,Expansion Packs,7,0,0.0,7
2244,579,Game Packs,3,0,0.0,3
2245,579,Kits,2,2,1.0,0
2246,579,Stuff Packs,9,3,0.3333333333333333,6
2247,580,Expansion Packs,12,0,0.0,12
2248,580,Game Packs,8,0,0.0,8
2249,580,Kits,2,0,0.0,2
2250,580,Stuff Packs,10,2,0.2,8
2251,581,Expansion Packs,16,0,0.0,16
2252,581,Game Packs,12,0,0.0,12
2253,581,Kits,28,1,0.03571428571428571,27
2254,581,Stuff Packs,20,0,0.0,20
2255,582,Expansion Packs,6,0,0.0,6
2256,582,Game Packs,6,0,0.0,6
2257,582,Kits,2,2,1.0,0
2258,582,Stuff Packs,12,0,0.0,12
2259,583,Expansion Packs,14,0,0.0,14
2260,583,Game Packs,6,0,0.0,6
2261,583,Kits,2,2,1.0,0
2262,583,Stuff Packs,6,2,0.3333333333333333,4
2263,584,Expansion Packs,16,0,0.0,16
2264,584,Game Packs,12,0,0.0,12
2265,584,Kits,31,1,0.03225806451612903,30
2266,584,Stuff Packs,20,0,0.0,20
2267,585,Expansion Packs,2,0,0.0,2
2268,586,Expansion Packs,12,0,0.0,12
2269,586,Game Packs,7,0,0.0,7
2270,586,Kits,5,0,0.0,5
2271,586,Stuff Packs,7,0,0.0,7
2272,587,Expansion Packs,16,0,0.0,16
2273,587,Game Packs,12,0,0.0,12
2274,587,Kits,33,0,0.0,33
2275,587,Stuff Packs,20,0,0.0,20
2276,588,Expansion Packs,8,0,0.0,8
2277,588,Game Packs,6,0,0.0,6
2278,588,Kits,2,2,1.0,0
2279,588,Stuff Packs,8,3,0.375,5
2280,589,Expansion Packs,6,0,0.0,6
2281,589,Game Packs,1,0,0.0,1
2282,589,Kits,1,0,0.0,1
2283,589,Stuff Packs,3,0,0.0,3
2284,590,Expansion Packs,15,0,0.0,15
2285,590,Game Packs,11,0,0.0,11
2286,590,Kits,15,1,0.06666666666666667,14
2287,590,Stuff Packs,19,1,0.05263157894736842,18
2288,591,Expansion Packs,6,0,0.0,6
2289,591,Game Packs,2,0,0.0,2
2290,591,Kits,2,1,0.5,1
2291,591,Stuff Packs,4,3,0.75,1
2292,592,Expansion Packs,16,0,0.0,16
2293,592,Game Packs,11,0,0.0,11
2294,592,Kits,19,0,0.0,19
2295,592,Stuff Packs,16,0,0.0,16
2296,593,Expansion Packs,10,0,0.0,10
2297,593,Game Packs,5,0,0.0,5
2298,593,Kits,2,1,0.5,1
2299,593,Stuff Packs,6,2,0.3333333333333333,4
2300,594,Expansion Packs,13,0,0.0,13
2301,594,Game Packs,4,0,0.0,4
2302,594,Kits,1,0,0.0,1
2303,594,Stuff Packs,6,1,0.16666666666666666,5
2304,595,Expansion Packs,16,0,0.0,16
2305,595,Game Packs,12,0,0.0,12
2306,595,Kits,16,2,0.125,14
2307,595,Stuff Packs,20,0,0.0,20
2308,596,Expansion Packs,10,0,0.0,10
2309,596,Game Packs,9,0,0.0,9
2310,596,Kits,11,0,0.0,11
2311,596,Stuff Packs,14,0,0.0,14
2312,597,Expansion Packs,15,0,0.0,15
2313,597,Game Packs,12,0,0.0,12
2314,597,Kits,8,1,0.125,7
2315,597,Stuff Packs,18,2,0.1111111111111111,16
2316,598,Expansion Packs,16,0,0.0,16
2317,598,Game Packs,12,0,0.0,12
2318,598,Kits,18,0,0.0,18
2319,598,Stuff Packs,18,0,0.0,18
2320,599,Expansion Packs,16,0,0.0,16
2321,599,Game Packs,10,0,0.0,10
2322,599,Kits,16,0,0.0,16
2323,599,Stuff Packs,15,0,0.0,15
2324,600,Expansion Packs,15,0,0.0,15
2325,600,Game Packs,11,0,0.0,11
2326,600,Kits,6,1,0.16666666666666666,5
2327,600,Stuff Packs,13,3,0.23076923076923078,10
2328,601,Expansion Packs,16,0,0.0,16
2329,601,Game Packs,12,0,0.0,12
2330,601,Kits,33,0,0.0,33
2331,601,Stuff Packs,20,0,0.0,20
2332,602,Expansion Packs,5,0,0.0,5
2333,602,Game Packs,4,0,0.0,4
2334,602,Kits,1,1,1.0,0
2335,602,Stuff Packs,5,5,1.0,0
2336,603,Expansion Packs,15,0,0.0,15
2337,603,Game Packs,12,0,0.0,12
2338,603,Kits,4,0,0.0,4
2339,603,Stuff Packs,20,0,0.0,20
2340,604,Expansion Packs,6,0,0.0,6
2341,604,Game Packs,3,0,0.0,3
2342,604,Kits,2,1,0.5,1
2343,604,Stuff Packs,6,2,0.3333333333333333,4
2344,605,Expansion Packs,15,0,0.0,15
2345,605,Game Packs,12,0,0.0,12
2346,605,Kits,16,1,0.0625,15
2347,605,Stuff Packs,20,0,0.0,20
2348,606,Expansion Packs,12,0,0.0,12
2349,606,Game Packs,10,0,0.0,10
2350,606,Kits,2,2,1.0,0
2351,606,Stuff Packs,15,1,0.06666666666666667,14
2352,607,Expansion Packs,10,0,0.0,10
2353,607,Game Packs,4,1,0.25,3
2354,607,Kits,7,3,0.42857142857142855,4
2355,607,Stuff Packs,8,4,0.5,4
2356,608,Expansion Packs,15,0,0.0,15
2357,608,Game Packs,10,0,0.0,10
2358,608,Kits,3,0,0.0,3
2359,608,Stuff Packs,18,0,0.0,18
2360,609,Expansion Packs,10,0,0.0,10
2361,609,Game Packs,3,0,0.0,3
2362,609,Kits,3,2,0.6666666666666666,1
2363,609,Stuff Packs,9,3,0.3333333333333333,6
2364,610,Expansion Packs,16,0,0.0,16
2365,610,Game Packs,12,0,0.0,12
2366,610,Kits,33,1,0.030303030303030304,32
2367,610,Stuff Packs,20,0,0.0,20
2368,611,Expansion Packs,12,0,0.0,12
2369,611,Game Packs,6,0,0.0,6
2370,611,Kits,5,2,0.4,3
2371,611,Stuff Packs,12,2,0.16666666666666666,10
2372,612,Expansion Packs,16,0,0.0,16
2373,612,Game Packs,8,0,0.0,8
2374,612,Kits,11,1,0.09090909090909091,10
2375,612,Stuff Packs,13,0,0.0,13
2376,613,Expansion Packs,16,0,0.0,16
2377,613,Game Packs,12,0,0.0,12
2378,613,Kits,33,1,0.030303030303030304,32
2379,613,Stuff Packs,20,0,0.0,20
2380,614,Expansion Packs,16,0,0.0,16
2381,614,Game Packs,11,0,0.0,11
2382,614,Kits,10,1,0.1,9
2383,614,Stuff Packs,20,0,0.0,20
2384,615,Expansion Packs,8,0,0.0,8
2385,615,Game Packs,5,1,0.2,4
2386,615,Kits,2,1,0.5,1
2387,615,Stuff Packs,10,4,0.4,6
2388,616,Expansion Packs,13,0,0.0,13
2389,616,Game Packs,10,0,0.0,10
2390,616,Kits,3,3,1.0,0
2391,616,Stuff Packs,15,2,0.13333333333333333,13
2392,617,Expansion Packs,16,0,0.0,16
2393,617,Game Packs,12,0,0.0,12
2394,617,Kits,33,0,0.0,33
2395,617,Stuff Packs,20,0,0.0,20
2396,618,Expansion Packs,16,0,0.0,16
2397,618,Game Packs,12,0,0.0,12
2398,618,Kits,32,1,0.03125,31
2399,618,Stuff Packs,20,0,0.0,20
2400,619,Kits,1,0,0.0,1
2401,619,Stuff Packs,2,0,0.0,2
2402,620,Expansion Packs,7,0,0.0,7
2403,620,Game Packs,4,0,0.0,4
2404,620,Kits,9,2,0.2222222222222222,7
2405,620,Stuff Packs,13,3,0.23076923076923078,10
2406,621,Expansion Packs,12,0,0.0,12
2407,621,Game Packs,8,1,0.125,7
2408,621,Kits,1,1,1.0,0
2409,621,Stuff Packs,7,4,0.5714285714285714,3
2410,622,Expansion Packs,14,0,0.0,14
2411,622,Game Packs,10,0,0.0,10
2412,622,Kits,1,1,1.0,0
2413,622,Stuff Packs,13,1,0.07692307692307693,12
2414,623,Expansion Packs,13,0,0.0,13
2415,623,Game Packs,7,0,0.0,7
2416,623,Kits,1,0,0.0,1
2417,623,Stuff Packs,5,0,0.0,5
2418,624,Expansion Packs,16,0,0.0,16
2419,624,Game Packs,6,0,0.0,6
2420,624,Kits,12,1,0.08333333333333333,11
2421,624,Stuff Packs,16,1,0.0625,15
2422,625,Expansion Packs,16,0,0.0,16
2423,625,Game Packs,12,0,0.0,12
2424,625,Kits,32,0,0.0,32
2425,625,Stuff Packs,20,0,0.0,20
2426,626,Expansion Packs,7,0,0.0,7
2427,626,Game Packs,3,0,0.0,3
2428,626,Kits,1,1,1.0,0
2429,626,Stuff Packs,4,2,0.5,2
2430,627,Expansion Packs,7,0,0.0,7
2431,627,Game Packs,6,0,0.0,6
2432,627,Kits,2,0,0.0,2
2433,627,Stuff Packs,14,0,0.0,14
2434,628,Expansion Packs,16,0,0.0,16
2435,628,Game Packs,12,0,0.0,12
2436,628,Kits,33,0,0.0,33
2437,628,Stuff Packs,20,0,0.0,20
2438,629,Expansion Packs,15,0,0.0,15
2439,629,Game Packs,11,0,0.0,11
2440,629,Kits,7,0,0.0,7
2441,629,Stuff Packs,18,0,0.0,18
2442,630,Expansion Packs,16,0,0.0,16
2443,630,Game Packs,12,0,0.0,12
2444,630,Kits,30,1,0.03333333333333333,29
2445,630,Stuff Packs,18,0,0.0,18
2446,631,Expansion Packs,16,0,0.0,16
2447,631,Game Packs,11,0,0.0,11
2448,631,Kits,28,1,0.03571428571428571,27
2449,631,Stuff Packs,19,0,0.0,19
2450,632,Expansion Packs,4,0,0.0,4
2451,632,Game Packs,4,0,0.0,4
2452,632,Stuff Packs,5,3,0.6,2
2453,633,Expansion Packs,16,0,0.0,16
2454,633,Game Packs,12,0,0.0,12
2455,633,Kits,32,0,0.0,32
2456,633,Stuff Packs,20,0,0.0,20
2457,634,Expansion Packs,13,0,0.0,13
2458,634,Game Packs,6,1,0.16666666666666666,5
2459,634,Kits,2,1,0.5,1
2460,634,Stuff Packs,3,0,0.0,3
2461,635,Expansion Packs,13,0,0.0,13
2462,635,Game Packs,5,0,0.0,5
2463,635,Kits,2,1,0.5,1
2464,635,Stuff Packs,6,3,0.5,3
2465,636,Expansion Packs,16,0,0.0,16
2466,636,Game Packs,8,0,0.0,8
2467,636,Kits,19,1,0.05263157894736842,18
2468,636,Stuff Packs,15,1,0.06666666666666667,14
2469,637,Expansion Packs,15,0,0.0,15
2470,637,Game Packs,5,0,0.0,5
2471,637,Kits,2,2,1.0,0
2472,637,Stuff Packs,7,3,0.42857142857142855,4
2473,638,Expansion Packs,16,0,0.0,16
2474,638,Game Packs,12,0,0.0,12
2475,638,Kits,33,0,0.0,33
2476,638,Stuff Packs,20,0,0.0,20
2477,639,Expansion Packs,15,0,0.0,15
2478,639,Game Packs,11,0,0.0,11
2479,639,Kits,6,2,0.3333333333333333,4
2480,639,Stuff Packs,20,1,0.05,19
2481,640,Expansion Packs,5,0,0.0,5
2482,640,Game Packs,4,0,0.0,4
2483,640,Kits,1,1,1.0,0
2484,640,Stuff Packs,4,3,0.75,1
2485,641,Expansion Packs,16,0,0.0,16
2486,641,Game Packs,11,0,0.0,11
2487,641,Kits,2,0,0.0,2
2488,641,Stuff Packs,15,0,0.0,15
2489,642,Expansion Packs,16,0,0.0,16
2490,642,Game Packs,12,0,0.0,12
2491,642,Kits,26,1,0.038461538461538464,25
2492,642,Stuff Packs,20,0,0.0,20
2493,643,Expansion Packs,6,0,0.0,6
2494,643,Game Packs,1,0,0.0,1
2495,643,Kits,1,1,1.0,0
2496,643,Stuff Packs,2,1,0.5,1
2497,644,Expansion Packs,6,0,0.0,6
2498,644,Game Packs,3,0,0.0,3
2499,644,Kits,5,2,0.4,3
2500,644,Stuff Packs,6,2,0.3333333333333333,4
2501,645,Expansion Packs,16,0,0.0,16
2502,645,Game Packs,12,0,0.0,12
2503,645,Kits,33,1,0.030303030303030304,32
2504,645,Stuff Packs,20,0,0.0,20
2505,646,Expansion Packs,7,0,0.0,7
2506,646,Game Packs,2,0,0.0,2
2507,646,Kits,2,0,0.0,2
2508,646,Stuff Packs,7,2,0.2857142857142857,5
2509,647,Expansion Packs,15,0,0.0,15
2510,647,Game Packs,11,0,0.0,11
2511,647,Kits,7,2,0.2857142857142857,5
2512,647,Stuff Packs,7,1,0.14285714285714285,6
2513,648,Expansion Packs,2,0,0.0,2
2514,649,Expansion Packs,16,0,0.0,16
2515,649,Game Packs,11,0,0.0,11
2516,649,Kits,16,1,0.0625,15
2517,649,Stuff Packs,11,3,0.2727272727272727,8
2518,650,Expansion Packs,9,0,0.0,9
2519,650,Game Packs,1,1,1.0,0
2520,650,Kits,1,1,1.0,0
2521,650,Stuff Packs,2,2,1.0,0
2522,651,Expansion Packs,10,0,0.0,10
2523,651,Game Packs,8,0,0.0,8
2524,651,Kits,11,2,0.18181818181818182,9
2525,651,Stuff Packs,18,1,0.05555555555555555,17
2526,652,Expansion Packs,11,0,0.0,11
2527,652,Game Packs,5,0,0.0,5
2528,652,Kits,4,0,0.0,4
2529,652,Stuff Packs,8,0,0.0,8
2530,653,Expansion Packs,16,0,0.0,16
2531,653,Game Packs,11,0,0.0,11
2532,653,Kits,9,2,0.2222222222222222,7
2533,653,Stuff Packs,17,3,0.17647058823529413,14
2534,654,Expansion Packs,11,0,0.0,11
2535,654,Game Packs,5,0,0.0,5
2536,654,Kits,4,0,0.0,4
2537,654,Stuff Packs,9,0,0.0,9
2538,655,Expansion Packs,9,0,0.0,9
2539,655,Game Packs,2,0,0.0,2
2540,655,Kits,5,1,0.2,4
2541,655,Stuff Packs,4,1,0.25,3
2542,656,Expansion Packs,7,0,0.0,7
2543,656,Game Packs,5,0,0.0,5
2544,656,Kits,7,0,0.0,7
2545,656,Stuff Packs,10,2,0.2,8
2546,657,Expansion Packs,9,0,0.0,9
2547,657,Game Packs,9,0,0.0,9
2548,657,Kits,2,2,1.0,0
2549,657,Stuff Packs,10,2,0.2,8
2550,658,Expansion Packs,8,0,0.0,8
2551,658,Game Packs,3,1,0.3333333333333333,2
2552,658,Kits,2,2,1.0,0
2553,658,Stuff Packs,6,4,0.6666666666666666,2
2554,659,Expansion Packs,16,0,0.0,16
2555,659,Game Packs,11,0,0.0,11
2556,659,Kits,21,0,0.0,21
2557,659,Stuff Packs,20,0,0.0,20
2558,660,Expansion Packs,11,0,0.0,11
2559,660,Game Packs,4,0,0.0,4
2560,660,Kits,2,2,1.0,0
2561,660,Stuff Packs,7,2,0.2857142857142857,5
2562,661,Expansion Packs,16,0,0.0,16
2563,661,Game Packs,12,0,0.0,12
2564,661,Kits,17,0,0.0,17
2565,661,Stuff Packs,20,1,0.05,19
2566,662,Kits,2,2,1.0,0
2567,662,Stuff Packs,3,3,1.0,0
2568,663,Expansion Packs,16,0,0.0,16
2569,663,Game Packs,11,0,0.0,11
2570,663,Kits,24,0,0.0,24
2571,663,Stuff Packs,18,0,0.0,18
2572,664,Expansion Packs,14,0,0.0,14
2573,664,Game Packs,7,1,0.14285714285714285,6
2574,664,Kits,2,2,1.0,0
2575,664,Stuff Packs,7,3,0.42857142857142855,4
2576,665,Expansion Packs,16,0,0.0,16
2577,665,Game Packs,8,0,0.0,8
2578,665,Kits,13,2,0.15384615384615385,11
2579,665,Stuff Packs,15,2,0.13333333333333333,13
2580,666,Expansion Packs,16,0,0.0,16
2581,666,Game Packs,12,0,0.0,12
2582,666,Kits,33,1,0.030303030303030304,32
2583,666,Stuff Packs,20,0,0.0,20
2584,667,Expansion Packs,4,0,0.0,4
2585,667,Game Packs,2,0,0.0,2
2586,667,Kits,4,1,0.25,3
2587,667,Stuff Packs,9,2,0.2222222222222222,7
2588,668,Expansion Packs,16,0,0.0,16
2589,668,Game Packs,11,0,0.0,11
2590,668,Kits,30,1,0.03333333333333333,29
2591,668,Stuff Packs,20,0,0.0,20
2592,669,Expansion Packs,7,1,0.14285714285714285,6
2593,669,Game Packs,7,1,0.14285714285714285,6
2594,669,Kits,6,3,0.5,3
2595,669,Stuff Packs,7,3,0.42857142857142855,4
2596,670,Expansion Packs,11,0,0.0,11
2597,670,Game Packs,1,0,0.0,1
2598,670,Kits,1,0,0.0,1
2599,670,Stuff Packs,5,0,0.0,5
2600,671,Expansion Packs,14,0,0.0,14
2601,671,Game Packs,7,0,0.0,7
2602,671,Kits,10,0,0.0,10
2603,671,Stuff Packs,8,0,0.0,8
2604,672,Expansion Packs,8,0,0.0,8
2605,672,Game Packs,3,0,0.0,3
2606,672,Kits,3,3,1.0,0
2607,672,Stuff Packs,6,3,0.5,3
2608,673,Expansion Packs,15,0,0.0,15
2609,673,Game Packs,8,0,0.0,8
2610,673,Stuff Packs,5,2,0.4,3
2611,674,Game Packs,3,0,0.0,3
2612,674,Kits,22,0,0.0,22
2613,674,Stuff Packs,6,0,0.0,6
2614,675,Expansion Packs,6,0,0.0,6
2615,675,Game Packs,3,0,0.0,3
2616,675,Kits,3,1,0.3333333333333333,2
2617,675,Stuff Packs,6,3,0.5,3
2618,676,Expansion Packs,5,0,0.0,5
2619,676,Game Packs,2,0,0.0,2
2620,677,Expansion Packs,15,0,0.0,15
2621,677,Game Packs,11,0,0.0,11
2622,677,Kits,16,1,0.0625,15
2623,677,Stuff Packs,20,1,0.05,19
2624,678,Expansion Packs,15,0,0.0,15
2625,678,Game Packs,5,0,0.0,5
2626,678,Kits,16,1,0.0625,15
2627,678,Stuff Packs,10,2,0.2,8
2628,679,Expansion Packs,16,0,0.0,16
2629,679,Game Packs,12,0,0.0,12
2630,679,Kits,33,0,0.0,33
2631,679,Stuff Packs,20,0,0.0,20
2632,680,Expansion Packs,15,2,0.13333333333333333,13
2633,680,Game Packs,10,0,0.0,10
2634,680,Kits,22,1,0.045454545454545456,21
2635,680,Stuff Packs,18,0,0.0,18
2636,681,Expansion Packs,14,0,0.0,14
2637,681,Game Packs,6,0,0.0,6
2638,681,Stuff Packs,4,0,0.0,4
2639,682,Expansion Packs,3,0,0.0,3
2640,682,Game Packs,1,0,0.0,1
2641,682,Kits,1,1,1.0,0
2642,683,Expansion Packs,16,0,0.0,16
2643,683,Game Packs,9,0,0.0,9
2644,683,Kits,21,1,0.047619047619047616,20
2645,683,Stuff Packs,18,1,0.05555555555555555,17
2646,684,Expansion Packs,16,2,0.125,14
2647,684,Game Packs,8,1,0.125,7
2648,684,Kits,16,2,0.125,14
2649,684,Stuff Packs,12,4,0.3333333333333333,8
2650,685,Expansion Packs,9,0,0.0,9
2651,685,Game Packs,2,1,0.5,1
2652,685,Kits,3,3,1.0,0
2653,685,Stuff Packs,9,4,0.4444444444444444,5
2654,686,Expansion Packs,16,0,0.0,16
2655,686,Game Packs,12,0,0.0,12
2656,686,Kits,33,0,0.0,33
2657,686,Stuff Packs,20,0,0.0,20
2658,687,Expansion Packs,16,0,0.0,16
2659,687,Game Packs,11,0,0.0,11
2660,687,Kits,23,1,0.043478260869565216,22
2661,687,Stuff Packs,18,0,0.0,18
2662,688,Expansion Packs,6,1,0.16666666666666666,5
2663,688,Game Packs,6,1,0.16666666666666666,5
2664,688,Kits,2,2,1.0,0
2665,688,Stuff Packs,11,2,0.18181818181818182,9
2666,689,Expansion Packs,7,0,0.0,7
2667,689,Game Packs,7,0,0.0,7
2668,689,Kits,1,0,0.0,1
2669,689,Stuff Packs,5,0,0.0,5
2670,690,Expansion Packs,15,0,0.0,15
2671,690,Game Packs,12,0,0.0,12
2672,690,Kits,18,1,0.05555555555555555,17
2673,690,Stuff Packs,20,0,0.0,20
2674,691,Expansion Packs,12,0,0.0,12
2675,691,Game Packs,5,1,0.2,4
2676,691,Kits,3,1,0.3333333333333333,2
2677,691,Stuff Packs,7,4,0.5714285714285714,3
2678,692,Expansion Packs,11,0,0.0,11
2679,692,Game Packs,8,0,0.0,8
2680,692,Stuff Packs,4,0,0.0,4
2681,693,Expansion Packs,15,0,0.0,15
2682,693,Game Packs,11,0,0.0,11
2683,693,Kits,19,1,0.05263157894736842,18
2684,693,Stuff Packs,19,2,0.10526315789473684,17
2685,694,Expansion Packs,16,0,0.0,16
2686,694,Game Packs,11,0,0.0,11
2687,694,Kits,18,0,0.0,18
2688,694,Stuff Packs,20,0,0.0,20
2689,695,Expansion Packs,6,0,0.0,6
2690,695,Game Packs,4,0,0.0,4
2691,695,Stuff Packs,6,1,0.16666666666666666,5
2692,696,Expansion Packs,15,0,0.0,15
2693,696,Game Packs,10,0,0.0,10
2694,696,Kits,17,0,0.0,17
2695,696,Stuff Packs,19,1,0.05263157894736842,18
2696,697,Expansion Packs,15,0,0.0,15
2697,697,Game Packs,9,0,0.0,9
2698,697,Kits,4,1,0.25,3
2699,697,Stuff Packs,12,2,0.16666666666666666,10
2700,698,Expansion Packs,16,0,0.0,16
2701,698,Game Packs,11,0,0.0,11
2702,698,Kits,20,3,0.15,17
2703,698,Stuff Packs,20,2,0.1,18
2704,699,Expansion Packs,16,0,0.0,16
2705,699,Game Packs,12,0,0.0,12
2706,699,Kits,33,0,0.0,33
2707,699,Stuff Packs,20,0,0.0,20
2708,700,Expansion Packs,14,0,0.0,14
2709,700,Game Packs,10,0,0.0,10
2710,700,Kits,17,2,0.11764705882352941,15
2711,700,Stuff Packs,18,0,0.0,18
2712,701,Expansion Packs,14,0,0.0,14
2713,701,Game Packs,6,1,0.16666666666666666,5
2714,701,Kits,3,3,1.0,0
2715,701,Stuff Packs,10,4,0.4,6
2716,702,Expansion Packs,14,0,0.0,14
2717,702,Game Packs,10,0,0.0,10
2718,702,Kits,5,1,0.2,4
2719,702,Stuff Packs,17,1,0.058823529411764705,16
2720,703,Expansion Packs,12,0,0.0,12
2721,703,Game Packs,4,0,0.0,4
2722,703,Kits,1,1,1.0,0
2723,703,Stuff Packs,3,1,0.3333333333333333,2
2724,704,Expansion Packs,14,0,0.0,14
2725,704,Game Packs,10,0,0.0,10
2726,704,Stuff Packs,17,0,0.0,17
2727,705,Expansion Packs,5,0,0.0,5
2728,705,Game Packs,3,0,0.0,3
2729,705,Kits,2,2,1.0,0
2730,705,Stuff Packs,4,3,0.75,1
2731,706,Expansion Packs,16,0,0.0,16
2732,706,Game Packs,12,0,0.0,12
2733,706,Kits,33,0,0.0,33
2734,706,Stuff Packs,20,0,0.0,20
2735,707,Expansion Packs,3,0,0.0,3
2736,707,Stuff Packs,1,0,0.0,1
2737,708,Expansion Packs,5,0,0.0,5
2738,709,Expansion Packs,14,0,0.0,14
2739,709,Game Packs,7,0,0.0,7
2740,709,Kits,2,0,0.0,2
2741,709,Stuff Packs,12,0,0.0,12
2742,710,Expansion Packs,16,0,0.0,16
2743,710,Game Packs,11,0,0.0,11
2744,710,Kits,3,2,0.6666666666666666,1
2745,710,Stuff Packs,15,1,0.06666666666666667,14
2746,711,Expansion Packs,16,0,0.0,16
2747,711,Game Packs,12,0,0.0,12
2748,711,Kits,31,1,0.03225806451612903,30
2749,711,Stuff Packs,20,0,0.0,20
2750,712,Expansion Packs,6,0,0.0,6
2751,712,Game Packs,1,0,0.0,1
2752,712,Kits,2,2,1.0,0
2753,712,Stuff Packs,3,1,0.3333333333333333,2
2754,713,Expansion Packs,14,0,0.0,14
2755,713,Game Packs,5,0,0.0,5
2756,713,Kits,10,1,0.1,9
2757,713,Stuff Packs,13,3,0.23076923076923078,10
2758,714,Expansion Packs,16,0,0.0,16
2759,714,Game Packs,11,0,0.0,11
2760,714,Kits,11,1,0.09090909090909091,10
2761,714,Stuff Packs,19,1,0.05263157894736842,18
2762,715,Expansion Packs,12,0,0.0,12
2763,715,Game Packs,5,0,0.0,5
2764,715,Kits,2,0,0.0,2
2765,715,Stuff Packs,7,1,0.14285714285714285,6
2766,716,Expansion Packs,16,0,0.0,16
2767,716,Game Packs,12,0,0.0,12
2768,716,Kits,33,1,0.030303030303030304,32
2769,716,Stuff Packs,20,0,0.0,20
2770,717,Expansion Packs,11,0,0.0,11
2771,717,Game Packs,8,0,0.0,8
2772,717,Kits,24,1,0.041666666666666664,23
2773,717,Stuff Packs,20,3,0.15,17
2774,718,Expansion Packs,14,0,0.0,14
2775,718,Game Packs,7,0,0.0,7
2776,718,Kits,3,0,0.0,3
2777,718,Stuff Packs,9,0,0.0,9
2778,719,Expansion Packs,16,0,0.0,16
2779,719,Game Packs,12,0,0.0,12
2780,719,Kits,33,0,0.0,33
2781,719,Stuff Packs,20,0,0.0,20
2782,720,Expansion Packs,7,0,0.0,7
2783,720,Game Packs,5,0,0.0,5
2784,720,Kits,6,2,0.3333333333333333,4
2785,720,Stuff Packs,8,0,0.0,8
2786,721,Expansion Packs,16,0,0.0,16
2787,721,Game Packs,12,0,0.0,12
2788,721,Kits,28,0,0.0,28
2789,721,Stuff Packs,20,0,0.0,20
2790,722,Expansion Packs,16,0,0.0,16
2791,722,Game Packs,12,0,0.0,12
2792,722,Kits,33,2,0.06060606060606061,31
2793,722,Stuff Packs,20,0,0.0,20
2794,723,Expansion Packs,12,0,0.0,12
2795,723,Game Packs,4,0,0.0,4
2796,723,Kits,3,2,0.6666666666666666,1
2797,723,Stuff Packs,4,2,0.5,2
2798,724,Expansion Packs,11,0,0.0,11
2799,724,Game Packs,9,1,0.1111111111111111,8
2800,724,Stuff Packs,9,0,0.0,9
2801,725,Expansion Packs,16,0,0.0,16
2802,725,Game Packs,12,0,0.0,12
2803,725,Kits,33,1,0.030303030303030304,32
2804,725,Stuff Packs,20,0,0.0,20
2805,726,Expansion Packs,12,0,0.0,12
2806,726,Game Packs,6,0,0.0,6
2807,726,Kits,1,1,1.0,0
2808,726,Stuff Packs,5,2,0.4,3
2809,727,Expansion Packs,16,0,0.0,16
2810,727,Game Packs,10,0,0.0,10
2811,727,Kits,17,1,0.058823529411764705,16
2812,727,Stuff Packs,11,1,0.09090909090909091,10
2813,728,Expansion Packs,5,1,0.2,4
2814,728,Game Packs,4,1,0.25,3
2815,728,Kits,3,3,1.0,0
2816,728,Stuff Packs,8,3,0.375,5
2817,729,Expansion Packs,7,0,0.0,7
2818,729,Game Packs,4,0,0.0,4
2819,729,Kits,3,2,0.6666666666666666,1
2820,729,Stuff Packs,10,3,0.3,7
2821,730,Expansion Packs,16,0,0.0,16
2822,730,Game Packs,12,0,0.0,12
2823,730,Kits,33,0,0.0,33
2824,730,Stuff Packs,20,0,0.0,20
2825,731,Expansion Packs,7,0,0.0,7
2826,731,Game Packs,3,1,0.3333333333333333,2
2827,731,Kits,2,2,1.0,0
2828,731,Stuff Packs,5,4,0.8,1
2829,732,Expansion Packs,16,4,0.25,12
2830,732,Game Packs,11,0,0.0,11
2831,732,Kits,6,0,0.0,6
2832,732,Stuff Packs,19,3,0.15789473684210525,16
2833,733,Expansion Packs,11,0,0.0,11
2834,733,Game Packs,9,1,0.1111111111111111,8
2835,733,Kits,8,3,0.375,5
2836,733,Stuff Packs,12,4,0.3333333333333333,8
2837,734,Expansion Packs,12,0,0.0,12
2838,734,Game Packs,9,0,0.0,9
2839,734,Kits,3,2,0.6666666666666666,1
2840,734,Stuff Packs,9,2,0.2222222222222222,7
2841,735,Expansion Packs,14,0,0.0,14
2842,735,Game Packs,10,0,0.0,10
2843,735,Kits,15,0,0.0,15
2844,735,Stuff Packs,18,0,0.0,18
2845,736,Expansion Packs,12,0,0.0,12
2846,736,Game Packs,5,0,0.0,5
2847,736,Stuff Packs,6,0,0.0,6
2848,737,Expansion Packs,3,0,0.0,3
2849,737,Game Packs,2,0,0.0,2
2850,737,Kits,2,0,0.0,2
2851,737,Stuff Packs,7,4,0.5714285714285714,3
2852,738,Expansion Packs,16,0,0.0,16
2853,738,Game Packs,12,0,0.0,12
2854,738,Kits,33,1,0.030303030303030304,32
2855,738,Stuff Packs,20,0,0.0,20
2856,739,Expansion Packs,16,0,0.0,16
2857,739,Game Packs,12,0,0.0,12
2858,739,Kits,23,1,0.043478260869565216,22
2859,739,Stuff Packs,19,1,0.05263157894736842,18
2860,740,Expansion Packs,16,0,0.0,16
2861,740,Game Packs,8,0,0.0,8
2862,740,Kits,11,2,0.18181818181818182,9
2863,740,Stuff Packs,16,2,0.125,14
2864,741,Expansion Packs,9,0,0.0,9
2865,741,Game Packs,5,0,0.0,5
2866,741,Kits,1,0,0.0,1
2867,741,Stuff Packs,6,0,0.0,6
2868,742,Expansion Packs,14,0,0.0,14
2869,742,Game Packs,12,0,0.0,12
2870,742,Kits,23,1,0.043478260869565216,22
2871,742,Stuff Packs,19,1,0.05263157894736842,18
2872,743,Expansion Packs,11,0,0.0,11
2873,743,Game Packs,5,0,0.0,5
2874,743,Kits,6,0,0.0,6
2875,743,Stuff Packs,5,0,0.0,5
2876,744,Expansion Packs,6,0,0.0,6
2877,744,Game Packs,5,0,0.0,5
2878,744,Stuff Packs,4,0,0.0,4
2879,745,Expansion Packs,8,0,0.0,8
2880,745,Game Packs,6,1,0.16666666666666666,5
2881,745,Stuff Packs,8,1,0.125,7
2882,746,Expansion Packs,16,6,0.375,10
2883,746,Game Packs,12,8,0.6666666666666666,4
2884,746,Kits,32,17,0.53125,15
2885,746,Stuff Packs,20,6,0.3,14
2886,747,Expansion Packs,9,0,0.0,9
2887,747,Game Packs,4,0,0.0,4
2888,747,Kits,6,1,0.16666666666666666,5
2889,747,Stuff Packs,4,1,0.25,3
2890,748,Expansion Packs,12,0,0.0,12
2891,748,Game Packs,9,0,0.0,9
2892,748,Kits,1,0,0.0,1
2893,748,Stuff Packs,10,1,0.1,9
2894,749,Expansion Packs,16,0,0.0,16
2895,749,Game Packs,12,0,0.0,12
2896,749,Kits,33,1,0.030303030303030304,32
2897,749,Stuff Packs,20,2,0.1,18
2898,750,Expansion Packs,16,0,0.0,16
2899,750,Game Packs,11,0,0.0,11
2900,750,Kits,28,0,0.0,28
2901,750,Stuff Packs,20,0,0.0,20
2902,751,Expansion Packs,13,0,0.0,13
2903,751,Game Packs,9,0,0.0,9
2904,751,Stuff Packs,5,0,0.0,5
2905,752,Expansion Packs,12,0,0.0,12
2906,752,Game Packs,5,0,0.0,5
2907,752,Kits,3,0,0.0,3
2908,752,Stuff Packs,6,2,0.3333333333333333,4
2909,753,Expansion Packs,6,0,0.0,6
2910,753,Game Packs,3,0,0.0,3
2911,753,Kits,2,2,1.0,0
2912,753,Stuff Packs,6,2,0.3333333333333333,4
2913,754,Expansion Packs,3,0,0.0,3
2914,754,Game Packs,1,0,0.0,1
2915,754,Kits,1,1,1.0,0
2916,754,Stuff Packs,5,3,0.6,2
2917,755,Expansion Packs,8,0,0.0,8
2918,755,Stuff Packs,1,0,0.0,1
2919,756,Expansion Packs,16,0,0.0,16
2920,756,Game Packs,12,0,0.0,12
2921,756,Kits,33,1,0.030303030303030304,32
2922,756,Stuff Packs,20,2,0.1,18
2923,757,Expansion Packs,6,0,0.0,6
2924,757,Game Packs,4,0,0.0,4
2925,757,Kits,5,1,0.2,4
2926,757,Stuff Packs,11,0,0.0,11
2927,758,Expansion Packs,16,0,0.0,16
2928,758,Game Packs,11,0,0.0,11
2929,758,Kits,6,2,0.3333333333333333,4
2930,758,Stuff Packs,19,0,0.0,19
2931,759,Expansion Packs,5,0,0.0,5
2932,759,Game Packs,1,0,0.0,1
2933,759,Kits,1,1,1.0,0
2934,759,Stuff Packs,2,2,1.0,0
2935,760,Expansion Packs,10,0,0.0,10
2936,760,Game Packs,8,0,0.0,8
2937,760,Kits,3,1,0.3333333333333333,2
2938,760,Stuff Packs,11,3,0.2727272727272727,8
2939,761,Expansion Packs,16,0,0.0,16
2940,761,Game Packs,12,0,0.0,12
2941,761,Kits,18,0,0.0,18
2942,761,Stuff Packs,20,0,0.0,20
2943,762,Expansion Packs,16,0,0.0,16
2944,762,Game Packs,11,1,0.09090909090909091,10
2945,762,Kits,33,1,0.030303030303030304,32
2946,762,Stuff Packs,20,0,0.0,20
2947,763,Expansion Packs,13,0,0.0,13
2948,763,Game Packs,4,1,0.25,3
2949,763,Kits,10,1,0.1,9
2950,763,Stuff Packs,7,4,0.5714285714285714,3
2951,764,Expansion Packs,11,1,0.09090909090909091,10
2952,764,Game Packs,3,1,0.3333333333333333,2
2953,764,Kits,6,2,0.3333333333333333,4
2954,764,Stuff Packs,7,3,0.42857142857142855,4
2955,765,Expansion Packs,12,0,0.0,12
2956,765,Game Packs,8,1,0.125,7
2957,765,Kits,1,1,1.0,0
2958,765,Stuff Packs,9,2,0.2222222222222222,7
2959,766,Expansion Packs,16,0,0.0,16
2960,766,Game Packs,12,0,0.0,12
2961,766,Kits,33,1,0.030303030303030304,32
2962,766,Stuff Packs,20,0,0.0,20
2963,767,Expansion Packs,14,0,0.0,14
2964,767,Game Packs,12,0,0.0,12
2965,767,Kits,13,1,0.07692307692307693,12
2966,767,Stuff Packs,13,3,0.23076923076923078,10
2967,768,Expansion Packs,1,0,0.0,1
2968,768,Kits,1,1,1.0,0
2969,768,Stuff Packs,1,0,0.0,1
2970,769,Expansion Packs,10,0,0.0,10
2971,769,Game Packs,6,0,0.0,6
2972,769,Kits,11,0,0.0,11
2973,769,Stuff Packs,10,3,0.3,7
2974,770,Expansion Packs,16,0,0.0,16
2975,770,Game Packs,11,0,0.0,11
2976,770,Kits,26,1,0.038461538461538464,25
2977,770,Stuff Packs,20,0,0.0,20
2978,771,Expansion Packs,6,0,0.0,6
2979,772,Expansion Packs,16,0,0.0,16
2980,772,Game Packs,12,0,0.0,12
2981,772,Kits,33,0,0.0,33
2982,772,Stuff Packs,20,0,0.0,20
2983,773,Expansion Packs,8,0,0.0,8
2984,773,Game Packs,2,0,0.0,2
2985,773,Kits,3,2,0.6666666666666666,1
2986,773,Stuff Packs,4,3,0.75,1
2987,774,Expansion Packs,16,0,0.0,16
2988,774,Game Packs,12,0,0.0,12
2989,774,Kits,33,0,0.0,33
2990,774,Stuff Packs,20,0,0.0,20
2991,775,Expansion Packs,12,0,0.0,12
2992,775,Game Packs,10,0,0.0,10
2993,775,Kits,3,2,0.6666666666666666,1
2994,775,Stuff Packs,19,0,0.0,19
2995,776,Expansion Packs,16,16,1.0,0
2996,776,Game Packs,12,12,1.0,0
2997,776,Kits,33,33,1.0,0
2998,776,Stuff Packs,20,20,1.0,0
2999,777,Expansion Packs,3,0,0.0,3
3000,777,Game Packs,2,1,0.5,1
3001,777,Kits,1,1,1.0,0
3002,777,Stuff Packs,1,1,1.0,0
3003,778,Expansion Packs,4,0,0.0,4
3004,778,Game Packs,3,0,0.0,3
3005,778,Kits,12,0,0.0,12
3006,778,Stuff Packs,8,1,0.125,7
3007,779,Expansion Packs,6,0,0.0,6
3008,779,Game Packs,4,0,0.0,4
3009,779,Kits,6,2,0.3333333333333333,4
3010,779,Stuff Packs,7,2,0.2857142857142857,5
3011,780,Expansion Packs,6,0,0.0,6
3012,780,Game Packs,4,0,0.0,4
3013,780,Kits,1,1,1.0,0
3014,780,Stuff Packs,3,2,0.6666666666666666,1
3015,781,Expansion Packs,16,0,0.0,16
3016,781,Game Packs,10,1,0.1,9
3017,781,Kits,10,3,0.3,7
3018,781,Stuff Packs,19,3,0.15789473684210525,16
3019,782,Expansion Packs,8,0,0.0,8
3020,782,Game Packs,3,0,0.0,3
3021,782,Stuff Packs,7,0,0.0,7
3022,783,Expansion Packs,4,0,0.0,4
3023,783,Game Packs,1,0,0.0,1
3024,783,Kits,2,2,1.0,0
3025,783,Stuff Packs,2,2,1.0,0
3026,784,Expansion Packs,16,0,0.0,16
3027,784,Game Packs,12,0,0.0,12
3028,784,Kits,8,1,0.125,7
3029,784,Stuff Packs,19,1,0.05263157894736842,18
3030,785,Expansion Packs,1,0,0.0,1
3031,785,Game Packs,1,0,0.0,1
3032,785,Stuff Packs,4,1,0.25,3
3033,786,Expansion Packs,12,0,0.0,12
3034,786,Game Packs,9,0,0.0,9
3035,786,Kits,4,4,1.0,0
3036,786,Stuff Packs,15,3,0.2,12
3037,787,Expansion Packs,8,0,0.0,8
3038,787,Game Packs,2,0,0.0,2
3039,787,Kits,1,1,1.0,0
3040,787,Stuff Packs,6,2,0.3333333333333333,4
3041,788,Expansion Packs,15,0,0.0,15
3042,788,Game Packs,11,0,0.0,11
3043,788,Kits,5,0,0.0,5
3044,788,Stuff Packs,16,0,0.0,16
3045,789,Expansion Packs,16,0,0.0,16
3046,789,Game Packs,11,0,0.0,11
3047,789,Kits,23,0,0.0,23
3048,789,Stuff Packs,20,0,0.0,20
3049,790,Expansion Packs,9,0,0.0,9
3050,790,Game Packs,6,0,0.0,6
3051,790,Kits,1,1,1.0,0
3052,790,Stuff Packs,7,2,0.2857142857142857,5
3053,791,Expansion Packs,14,0,0.0,14
3054,791,Game Packs,11,0,0.0,11
3055,791,Kits,1,1,1.0,0
3056,791,Stuff Packs,17,2,0.11764705882352941,15
3057,792,Expansion Packs,15,0,0.0,15
3058,792,Game Packs,12,0,0.0,12
3059,792,Kits,8,0,0.0,8
3060,792,Stuff Packs,17,1,0.058823529411764705,16
3061,793,Expansion Packs,15,0,0.0,15
3062,793,Game Packs,4,0,0.0,4
3063,793,Kits,3,0,0.0,3
3064,793,Stuff Packs,6,0,0.0,6
3065,794,Expansion Packs,14,0,0.0,14
3066,794,Game Packs,9,0,0.0,9
3067,794,Kits,7,0,0.0,7
3068,794,Stuff Packs,17,0,0.0,17
3069,795,Expansion Packs,13,13,1.0,0
3070,795,Game Packs,12,12,1.0,0
3071,795,Kits,21,1,0.047619047619047616,20
3072,795,Stuff Packs,18,18,1.0,0
3073,796,Expansion Packs,8,0,0.0,8
3074,796,Game Packs,6,2,0.3333333333333333,4
3075,796,Kits,9,4,0.4444444444444444,5
3076,796,Stuff Packs,13,5,0.38461538461538464,8
3077,797,Expansion Packs,16,0,0.0,16
3078,797,Game Packs,12,0,0.0,12
3079,797,Kits,7,0,0.0,7
3080,797,Stuff Packs,20,0,0.0,20
3081,798,Expansion Packs,16,0,0.0,16
3082,798,Game Packs,12,0,0.0,12
3083,798,Kits,10,2,0.2,8
3084,798,Stuff Packs,20,0,0.0,20
3085,799,Expansion Packs,16,0,0.0,16
3086,799,Game Packs,11,0,0.0,11
3087,799,Kits,33,1,0.030303030303030304,32
3088,799,Stuff Packs,20,0,0.0,20
3089,800,Expansion Packs,5,0,0.0,5
3090,800,Game Packs,2,0,0.0,2
3091,800,Kits,6,0,0.0,6
3092,800,Stuff Packs,5,3,0.6,2
3093,801,Expansion Packs,5,5,1.0,0
3094,801,Game Packs,2,2,1.0,0
3095,801,Kits,3,3,1.0,0
3096,801,Stuff Packs,5,5,1.0,0
3097,802,Expansion Packs,9,0,0.0,9
3098,802,Game Packs,8,0,0.0,8
3099,802,Kits,2,0,0.0,2
3100,802,Stuff Packs,11,1,0.09090909090909091,10
3101,803,Expansion Packs,16,0,0.0,16
3102,803,Game Packs,12,0,0.0,12
3103,803,Kits,33,0,0.0,33
3104,803,Stuff Packs,20,0,0.0,20
3105,804,Expansion Packs,14,0,0.0,14
3106,804,Game Packs,5,0,0.0,5
3107,804,Kits,9,1,0.1111111111111111,8
3108,804,Stuff Packs,10,1,0.1,9
3109,805,Expansion Packs,11,0,0.0,11
3110,805,Game Packs,4,0,0.0,4
3111,805,Kits,11,0,0.0,11
3112,805,Stuff Packs,3,0,0.0,3
3113,806,Expansion Packs,15,0,0.0,15
3114,806,Game Packs,12,0,0.0,12
3115,806,Kits,5,2,0.4,3
3116,806,Stuff Packs,18,0,0.0,18
3117,807,Expansion Packs,16,0,0.0,16
3118,807,Game Packs,11,0,0.0,11
3119,807,Kits,11,0,0.0,11
3120,807,Stuff Packs,20,0,0.0,20
3121,808,Expansion Packs,16,7,0.4375,9
3122,808,Game Packs,12,5,0.4166666666666667,7
3123,808,Kits,33,7,0.21212121212121213,26
3124,808,Stuff Packs,20,12,0.6,8
3125,809,Expansion Packs,16,0,0.0,16
3126,809,Game Packs,11,0,0.0,11
3127,809,Kits,16,0,0.0,16
3128,809,Stuff Packs,20,0,0.0,20
3129,810,Expansion Packs,16,0,0.0,16
3130,810,Game Packs,12,0,0.0,12
3131,810,Kits,22,2,0.09090909090909091,20
3132,810,Stuff Packs,20,0,0.0,20
3133,811,Expansion Packs,16,0,0.0,16
3134,811,Game Packs,12,0,0.0,12
3135,811,Kits,27,0,0.0,27
3136,811,Stuff Packs,19,0,0.0,19
3137,812,Expansion Packs,15,0,0.0,15
3138,812,Game Packs,6,0,0.0,6
3139,812,Kits,13,1,0.07692307692307693,12
3140,812,Stuff Packs,13,1,0.07692307692307693,12
3141,813,Expansion Packs,16,0,0.0,16
3142,813,Game Packs,12,0,0.0,12
3143,813,Kits,33,0,0.0,33
3144,813,Stuff Packs,20,0,0.0,20
3145,814,Expansion Packs,16,1,0.0625,15
3146,814,Game Packs,11,0,0.0,11
3147,814,Kits,14,2,0.14285714285714285,12
3148,814,Stuff Packs,17,1,0.058823529411764705,16
3149,815,Expansion Packs,14,0,0.0,14
3150,815,Game Packs,6,0,0.0,6
3151,815,Kits,10,2,0.2,8
3152,815,Stuff Packs,12,2,0.16666666666666666,10
3153,816,Expansion Packs,2,0,0.0,2
3154,816,Game Packs,2,0,0.0,2
3155,816,Kits,1,1,1.0,0
3156,816,Stuff Packs,5,2,0.4,3
3157,817,Expansion Packs,6,0,0.0,6
3158,817,Game Packs,2,1,0.5,1
3159,817,Kits,3,3,1.0,0
3160,817,Stuff Packs,6,4,0.6666666666666666,2
3161,818,Expansion Packs,16,0,0.0,16
3162,818,Game Packs,10,0,0.0,10
3163,818,Kits,7,3,0.42857142857142855,4
3164,818,Stuff Packs,16,1,0.0625,15
3165,819,Expansion Packs,14,0,0.0,14
3166,819,Game Packs,3,1,0.3333333333333333,2
3167,819,Kits,9,2,0.2222222222222222,7
3168,819,Stuff Packs,16,2,0.125,14
3169,820,Expansion Packs,15,0,0.0,15
3170,820,Game Packs,12,0,0.0,12
3171,820,Kits,21,1,0.047619047619047616,20
3172,820,Stuff Packs,14,1,0.07142857142857142,13
3173,821,Expansion Packs,14,0,0.0,14
3174,821,Game Packs,11,0,0.0,11
3175,821,Kits,6,2,0.3333333333333333,4
3176,821,Stuff Packs,10,1,0.1,9
3177,822,Expansion Packs,13,13,1.0,0
3178,822,Game Packs,9,9,1.0,0
3179,822,Kits,2,1,0.5,1
3180,822,Stuff Packs,9,7,0.7777777777777778,2
3181,823,Expansion Packs,15,0,0.0,15
3182,823,Game Packs,11,0,0.0,11
3183,823,Kits,21,1,0.047619047619047616,20
3184,823,Stuff Packs,17,0,0.0,17
3185,824,Kits,1,1,1.0,0
3186,824,Stuff Packs,3,3,1.0,0
3187,825,Expansion Packs,15,0,0.0,15
3188,825,Game Packs,9,0,0.0,9
3189,825,Kits,7,2,0.2857142857142857,5
3190,825,Stuff Packs,12,3,0.25,9
3191,826,Expansion Packs,14,1,0.07142857142857142,13
3192,826,Game Packs,7,0,0.0,7
3193,826,Kits,11,1,0.09090909090909091,10
3194,826,Stuff Packs,12,1,0.08333333333333333,11
3195,827,Expansion Packs,7,0,0.0,7
3196,827,Game Packs,4,0,0.0,4
3197,827,Kits,4,2,0.5,2
3198,827,Stuff Packs,9,2,0.2222222222222222,7
3199,828,Expansion Packs,6,0,0.0,6
3200,828,Game Packs,1,0,0.0,1
3201,828,Kits,3,1,0.3333333333333333,2
3202,828,Stuff Packs,5,3,0.6,2
3203,829,Expansion Packs,2,0,0.0,2
3204,829,Game Packs,4,0,0.0,4
3205,829,Kits,2,2,1.0,0
3206,829,Stuff Packs,8,2,0.25,6
3207,830,Expansion Packs,16,0,0.0,16
3208,830,Game Packs,9,0,0.0,9
3209,830,Kits,7,1,0.14285714285714285,6
3210,830,Stuff Packs,15,0,0.0,15
3211,831,Expansion Packs,15,1,0.06666666666666667,14
3212,831,Game Packs,8,2,0.25,6
3213,831,Kits,3,3,1.0,0
3214,831,Stuff Packs,7,3,0.42857142857142855,4
3215,832,Expansion Packs,7,0,0.0,7
3216,832,Game Packs,4,0,0.0,4
3217,832,Kits,2,1,0.5,1
3218,832,Stuff Packs,7,2,0.2857142857142857,5
3219,833,Expansion Packs,16,0,0.0,16
3220,833,Game Packs,12,0,0.0,12
3221,833,Kits,33,1,0.030303030303030304,32
3222,833,Stuff Packs,20,0,0.0,20
3223,834,Expansion Packs,1,1,1.0,0
3224,834,Game Packs,1,1,1.0,0
3225,834,Kits,2,2,1.0,0
3226,834,Stuff Packs,4,4,1.0,0
3227,835,Expansion Packs,13,0,0.0,13
3228,835,Game Packs,9,0,0.0,9
3229,835,Kits,15,1,0.06666666666666667,14
3230,835,Stuff Packs,11,0,0.0,11
3231,836,Expansion Packs,14,0,0.0,14
3232,836,Game Packs,6,0,0.0,6
3233,836,Kits,6,2,0.3333333333333333,4
3234,836,Stuff Packs,10,3,0.3,7
3235,837,Expansion Packs,16,0,0.0,16
3236,837,Game Packs,12,0,0.0,12
3237,837,Kits,13,1,0.07692307692307693,12
3238,837,Stuff Packs,19,1,0.05263157894736842,18
3239,838,Expansion Packs,8,0,0.0,8
3240,838,Game Packs,4,0,0.0,4
3241,838,Kits,4,1,0.25,3
3242,838,Stuff Packs,11,2,0.18181818181818182,9
3243,839,Expansion Packs,5,0,0.0,5
3244,839,Game Packs,2,0,0.0,2
3245,839,Kits,1,1,1.0,0
3246,839,Stuff Packs,7,3,0.42857142857142855,4
3247,840,Expansion Packs,16,0,0.0,16
3248,840,Game Packs,6,0,0.0,6
3249,840,Kits,1,0,0.0,1
3250,840,Stuff Packs,7,0,0.0,7
3251,841,Expansion Packs,14,0,0.0,14
3252,841,Game Packs,11,0,0.0,11
3253,841,Kits,19,1,0.05263157894736842,18
3254,841,Stuff Packs,17,0,0.0,17
3255,842,Expansion Packs,16,0,0.0,16
3256,842,Game Packs,12,0,0.0,12
3257,842,Kits,33,1,0.030303030303030304,32
3258,842,Stuff Packs,20,0,0.0,20
3259,843,Expansion Packs,11,0,0.0,11
3260,843,Game Packs,7,1,0.14285714285714285,6
3261,843,Kits,4,3,0.75,1
3262,843,Stuff Packs,11,4,0.36363636363636365,7
3263,844,Expansion Packs,16,0,0.0,16
3264,844,Game Packs,11,0,0.0,11
3265,844,Kits,28,2,0.07142857142857142,26
3266,844,Stuff Packs,20,0,0.0,20
3267,845,Expansion Packs,16,0,0.0,16
3268,845,Game Packs,12,0,0.0,12
3269,845,Kits,33,1,0.030303030303030304,32
3270,845,Stuff Packs,20,0,0.0,20
3271,846,Expansion Packs,14,0,0.0,14
3272,846,Game Packs,12,0,0.0,12
3273,846,Kits,25,0,0.0,25
3274,846,Stuff Packs,19,0,0.0,19
3275,847,Expansion Packs,13,0,0.0,13
3276,847,Game Packs,12,0,0.0,12
3277,847,Kits,2,2,1.0,0
3278,847,Stuff Packs,18,0,0.0,18
3279,848,Expansion Packs,15,0,0.0,15
3280,848,Game Packs,11,0,0.0,11
3281,848,Kits,13,1,0.07692307692307693,12
3282,848,Stuff Packs,20,1,0.05,19
3283,849,Expansion Packs,14,0,0.0,14
3284,849,Game Packs,12,0,0.0,12
3285,849,Kits,24,1,0.041666666666666664,23
3286,849,Stuff Packs,19,0,0.0,19
3287,850,Expansion Packs,14,0,0.0,14
3288,850,Game Packs,11,0,0.0,11
3289,850,Kits,1,1,1.0,0
3290,850,Stuff Packs,18,0,0.0,18
3291,851,Expansion Packs,9,0,0.0,9
3292,851,Game Packs,6,0,0.0,6
3293,851,Kits,1,1,1.0,0
3294,851,Stuff Packs,12,1,0.08333333333333333,11
3295,852,Expansion Packs,5,0,0.0,5
3296,852,Game Packs,4,0,0.0,4
3297,852,Kits,1,1,1.0,0
3298,852,Stuff Packs,5,2,0.4,3
3299,853,Stuff Packs,3,3,1.0,0
3300,854,Expansion Packs,16,0,0.0,16
3301,854,Game Packs,11,0,0.0,11
3302,854,Kits,32,0,0.0,32
3303,854,Stuff Packs,20,1,0.05,19
3304,855,Expansion Packs,6,0,0.0,6
3305,855,Game Packs,4,0,0.0,4
3306,855,Kits,2,2,1.0,0
3307,855,Stuff Packs,5,2,0.4,3
3308,856,Expansion Packs,13,0,0.0,13
3309,856,Game Packs,8,0,0.0,8
3310,856,Kits,10,1,0.1,9
3311,856,Stuff Packs,15,1,0.06666666666666667,14
3312,857,Expansion Packs,16,0,0.0,16
3313,857,Game Packs,11,0,0.0,11
3314,857,Kits,10,1,0.1,9
3315,857,Stuff Packs,19,3,0.15789473684210525,16
3316,858,Expansion Packs,16,0,0.0,16
3317,858,Game Packs,11,0,0.0,11
3318,858,Kits,11,1,0.09090909090909091,10
3319,858,Stuff Packs,17,0,0.0,17
3320,859,Expansion Packs,11,0,0.0,11
3321,859,Game Packs,3,0,0.0,3
3322,859,Kits,1,1,1.0,0
3323,859,Stuff Packs,2,1,0.5,1
3324,860,Expansion Packs,13,0,0.0,13
3325,860,Game Packs,9,0,0.0,9
3326,860,Kits,7,0,0.0,7
3327,860,Stuff Packs,17,0,0.0,17
3328,861,Expansion Packs,4,0,0.0,4
3329,861,Game Packs,1,0,0.0,1
3330,861,Kits,5,1,0.2,4
3331,861,Stuff Packs,4,0,0.0,4
3332,862,Expansion Packs,15,0,0.0,15
3333,862,Game Packs,11,0,0.0,11
3334,862,Kits,2,2,1.0,0
3335,862,Stuff Packs,19,0,0.0,19
3336,863,Expansion Packs,12,0,0.0,12
3337,863,Game Packs,6,0,0.0,6
3338,863,Kits,3,0,0.0,3
3339,863,Stuff Packs,4,0,0.0,4
3340,864,Expansion Packs,11,0,0.0,11
3341,864,Game Packs,10,0,0.0,10
3342,864,Kits,3,1,0.3333333333333333,2
3343,864,Stuff Packs,11,1,0.09090909090909091,10
3344,865,Expansion Packs,4,0,0.0,4
3345,865,Game Packs,2,0,0.0,2
3346,865,Kits,1,1,1.0,0
3347,865,Stuff Packs,3,1,0.3333333333333333,2
3348,866,Expansion Packs,8,0,0.0,8
3349,866,Game Packs,6,0,0.0,6
3350,866,Kits,2,0,0.0,2
3351,866,Stuff Packs,5,3,0.6,2
3352,867,Expansion Packs,16,0,0.0,16
3353,867,Game Packs,8,0,0.0,8
3354,867,Kits,24,0,0.0,24
3355,867,Stuff Packs,13,0,0.0,13
3356,868,Expansion Packs,15,0,0.0,15
3357,868,Game Packs,11,0,0.0,11
3358,868,Kits,3,0,0.0,3
3359,868,Stuff Packs,17,0,0.0,17
3360,869,Expansion Packs,10,0,0.0,10
3361,869,Game Packs,5,0,0.0,5
3362,869,Kits,4,0,0.0,4
3363,869,Stuff Packs,8,3,0.375,5
3364,870,Expansion Packs,14,6,0.42857142857142855,8
3365,870,Game Packs,12,8,0.6666666666666666,4
3366,870,Kits,23,22,0.9565217391304348,1
3367,870,Stuff Packs,18,15,0.8333333333333334,3
3368,871,Expansion Packs,13,0,0.0,13
3369,871,Game Packs,9,0,0.0,9
3370,871,Kits,3,3,1.0,0
3371,871,Stuff Packs,16,2,0.125,14
3372,872,Expansion Packs,13,0,0.0,13
3373,872,Game Packs,6,0,0.0,6
3374,872,Kits,3,0,0.0,3
3375,872,Stuff Packs,8,0,0.0,8
3376,873,Expansion Packs,16,0,0.0,16
3377,873,Game Packs,12,0,0.0,12
3378,873,Kits,33,0,0.0,33
3379,873,Stuff Packs,20,1,0.05,19
3380,874,Expansion Packs,10,0,0.0,10
3381,874,Game Packs,3,0,0.0,3
3382,874,Kits,3,2,0.6666666666666666,1
3383,874,Stuff Packs,9,4,0.4444444444444444,5
3384,875,Expansion Packs,12,2,0.16666666666666666,10
3385,875,Game Packs,8,0,0.0,8
3386,875,Kits,21,0,0.0,21
3387,875,Stuff Packs,14,0,0.0,14
3388,876,Expansion Packs,16,0,0.0,16
3389,876,Game Packs,12,0,0.0,12
3390,876,Kits,33,0,0.0,33
3391,876,Stuff Packs,20,1,0.05,19
3392,877,Expansion Packs,7,0,0.0,7
3393,877,Game Packs,5,1,0.2,4
3394,877,Kits,5,2,0.4,3
3395,877,Stuff Packs,5,4,0.8,1
3396,878,Expansion Packs,16,0,0.0,16
3397,878,Game Packs,12,0,0.0,12
3398,878,Kits,33,1,0.030303030303030304,32
3399,878,Stuff Packs,20,0,0.0,20
3400,879,Expansion Packs,14,0,0.0,14
3401,879,Game Packs,10,0,0.0,10
3402,879,Kits,3,1,0.3333333333333333,2
3403,879,Stuff Packs,17,0,0.0,17
3404,880,Expansion Packs,11,0,0.0,11
3405,880,Game Packs,7,1,0.14285714285714285,6
3406,880,Kits,3,3,1.0,0
3407,880,Stuff Packs,14,1,0.07142857142857142,13
3408,881,Expansion Packs,11,0,0.0,11
3409,881,Game Packs,4,0,0.0,4
3410,881,Kits,2,1,0.5,1
3411,881,Stuff Packs,5,0,0.0,5
3412,882,Expansion Packs,7,0,0.0,7
3413,882,Game Packs,2,1,0.5,1
3414,882,Kits,3,3,1.0,0
3415,882,Stuff Packs,5,3,0.6,2
3416,883,Expansion Packs,16,0,0.0,16
3417,883,Game Packs,12,1,0.08333333333333333,11
3418,883,Kits,33,3,0.09090909090909091,30
3419,883,Stuff Packs,20,2,0.1,18
3420,884,Expansion Packs,16,0,0.0,16
3421,884,Game Packs,12,0,0.0,12
3422,884,Kits,33,1,0.030303030303030304,32
3423,884,Stuff Packs,20,0,0.0,20
3424,885,Expansion Packs,15,0,0.0,15
3425,885,Game Packs,12,0,0.0,12
3426,885,Kits,13,1,0.07692307692307693,12
3427,885,Stuff Packs,17,5,0.29411764705882354,12
3428,886,Expansion Packs,12,0,0.0,12
3429,886,Game Packs,3,0,0.0,3
3430,886,Kits,5,1,0.2,4
3431,886,Stuff Packs,8,3,0.375,5
3432,887,Expansion Packs,8,0,0.0,8
3433,887,Game Packs,2,1,0.5,1
3434,887,Kits,9,2,0.2222222222222222,7
3435,887,Stuff Packs,6,4,0.6666666666666666,2
3436,888,Expansion Packs,16,0,0.0,16
3437,888,Game Packs,10,0,0.0,10
3438,888,Kits,9,2,0.2222222222222222,7
3439,888,Stuff Packs,12,2,0.16666666666666666,10
3440,889,Expansion Packs,10,0,0.0,10
3441,889,Game Packs,7,0,0.0,7
3442,889,Kits,5,0,0.0,5
3443,889,Stuff Packs,4,0,0.0,4
3444,890,Expansion Packs,16,0,0.0,16
3445,890,Game Packs,11,0,0.0,11
3446,890,Kits,14,0,0.0,14
3447,890,Stuff Packs,20,0,0.0,20
3448,891,Expansion Packs,16,0,0.0,16
3449,891,Game Packs,12,0,0.0,12
3450,891,Kits,33,1,0.030303030303030304,32
3451,891,Stuff Packs,19,0,0.0,19
3452,892,Expansion Packs,16,0,0.0,16
3453,892,Game Packs,12,1,0.08333333333333333,11
3454,892,Kits,33,3,0.09090909090909091,30
3455,892,Stuff Packs,20,0,0.0,20
3456,893,Expansion Packs,16,0,0.0,16
3457,893,Game Packs,12,0,0.0,12
3458,893,Kits,25,1,0.04,24
3459,893,Stuff Packs,20,0,0.0,20
3460,894,Expansion Packs,16,0,0.0,16
3461,894,Game Packs,11,0,0.0,11
3462,894,Kits,12,2,0.16666666666666666,10
3463,894,Stuff Packs,15,1,0.06666666666666667,14
3464,895,Expansion Packs,11,0,0.0,11
3465,895,Game Packs,5,0,0.0,5
3466,895,Kits,4,2,0.5,2
3467,895,Stuff Packs,13,2,0.15384615384615385,11
3468,896,Expansion Packs,15,0,0.0,15
3469,896,Game Packs,12,0,0.0,12
3470,896,Kits,5,1,0.2,4
3471,896,Stuff Packs,18,1,0.05555555555555555,17
3472,897,Expansion Packs,16,0,0.0,16
3473,897,Game Packs,12,0,0.0,12
3474,897,Kits,21,0,0.0,21
3475,897,Stuff Packs,20,0,0.0,20
3476,898,Expansion Packs,15,0,0.0,15
3477,898,Game Packs,8,0,0.0,8
3478,898,Kits,2,0,0.0,2
3479,898,Stuff Packs,12,0,0.0,12
3480,899,Expansion Packs,15,0,0.0,15
3481,899,Game Packs,8,0,0.0,8
3482,899,Kits,9,2,0.2222222222222222,7
3483,899,Stuff Packs,14,3,0.21428571428571427,11
3484,900,Expansion Packs,16,0,0.0,16
3485,900,Game Packs,12,0,0.0,12
3486,900,Kits,31,0,0.0,31
3487,900,Stuff Packs,19,0,0.0,19
3488,901,Expansion Packs,15,0,0.0,15
3489,901,Game Packs,11,0,0.0,11
3490,901,Kits,24,2,0.08333333333333333,22
3491,901,Stuff Packs,19,0,0.0,19
3492,902,Expansion Packs,16,0,0.0,16
3493,902,Game Packs,12,0,0.0,12
3494,902,Kits,25,1,0.04,24
3495,902,Stuff Packs,20,0,0.0,20
3496,903,Expansion Packs,15,0,0.0,15
3497,903,Game Packs,11,0,0.0,11
3498,903,Kits,26,1,0.038461538461538464,25
3499,903,Stuff Packs,19,0,0.0,19
3500,904,Expansion Packs,8,0,0.0,8
3501,904,Game Packs,2,0,0.0,2
3502,904,Kits,1,0,0.0,1
3503,904,Stuff Packs,4,3,0.75,1
3504,905,Expansion Packs,1,0,0.0,1
3505,905,Game Packs,1,0,0.0,1
3506,905,Stuff Packs,1,1,1.0,0
3507,906,Expansion Packs,3,0,0.0,3
3508,906,Game Packs,2,0,0.0,2
3509,906,Kits,1,1,1.0,0
3510,906,Stuff Packs,2,2,1.0,0
3511,907,Expansion Packs,16,0,0.0,16
3512,907,Game Packs,12,0,0.0,12
3513,907,Kits,33,1,0.030303030303030304,32
3514,907,Stuff Packs,20,4,0.2,16
3515,908,Expansion Packs,16,1,0.0625,15
3516,908,Game Packs,11,0,0.0,11
3517,908,Kits,7,1,0.14285714285714285,6
3518,908,Stuff Packs,8,2,0.25,6
3519,909,Expansion Packs,11,0,0.0,11
3520,909,Game Packs,4,0,0.0,4
3521,909,Kits,2,1,0.5,1
3522,909,Stuff Packs,4,0,0.0,4
3523,910,Expansion Packs,1,0,0.0,1
3524,910,Game Packs,1,0,0.0,1
3525,910,Kits,1,1,1.0,0
3526,910,Stuff Packs,4,3,0.75,1
3527,911,Expansion Packs,16,0,0.0,16
3528,911,Game Packs,8,0,0.0,8
3529,911,Kits,9,0,0.0,9
3530,911,Stuff Packs,13,0,0.0,13
3531,912,Expansion Packs,11,0,0.0,11
3532,912,Game Packs,3,0,0.0,3
3533,912,Kits,2,2,1.0,0
3534,912,Stuff Packs,4,3,0.75,1
3535,913,Expansion Packs,9,0,0.0,9
3536,913,Game Packs,4,0,0.0,4
3537,913,Kits,8,0,0.0,8
3538,913,Stuff Packs,13,3,0.23076923076923078,10
3539,914,Expansion Packs,6,0,0.0,6
3540,914,Game Packs,3,1,0.3333333333333333,2
3541,914,Kits,3,3,1.0,0
3542,914,Stuff Packs,7,4,0.5714285714285714,3
3543,915,Expansion Packs,6,0,0.0,6
3544,915,Game Packs,1,0,0.0,1
3545,915,Kits,3,0,0.0,3
3546,915,Stuff Packs,7,3,0.42857142857142855,4
3547,916,Expansion Packs,16,0,0.0,16
3548,916,Game Packs,11,0,0.0,11
3549,916,Kits,20,1,0.05,19
3550,916,Stuff Packs,20,1,0.05,19
3551,917,Expansion Packs,10,0,0.0,10
3552,917,Game Packs,7,0,0.0,7
3553,917,Kits,3,1,0.3333333333333333,2
3554,917,Stuff Packs,6,1,0.16666666666666666,5
3555,918,Expansion Packs,14,0,0.0,14
3556,918,Game Packs,12,0,0.0,12
3557,918,Kits,24,0,0.0,24
3558,918,Stuff Packs,20,0,0.0,20
3559,919,Expansion Packs,16,0,0.0,16
3560,919,Game Packs,12,0,0.0,12
3561,919,Kits,33,0,0.0,33
3562,919,Stuff Packs,20,0,0.0,20
3563,920,Expansion Packs,15,0,0.0,15
3564,920,Game Packs,11,0,0.0,11
3565,920,Kits,18,0,0.0,18
3566,920,Stuff Packs,20,0,0.0,20
3567,921,Expansion Packs,15,0,0.0,15
3568,921,Game Packs,5,0,0.0,5
3569,921,Kits,1,1,1.0,0
3570,921,Stuff Packs,2,1,0.5,1
3571,922,Expansion Packs,7,0,0.0,7
3572,922,Game Packs,2,1,0.5,1
3573,922,Kits,2,2,1.0,0
3574,922,Stuff Packs,4,3,0.75,1
3575,923,Expansion Packs,16,0,0.0,16
3576,923,Game Packs,12,0,0.0,12
3577,923,Kits,24,1,0.041666666666666664,23
3578,923,Stuff Packs,19,0,0.0,19
3579,924,Expansion Packs,10,0,0.0,10
3580,924,Game Packs,7,0,0.0,7
3581,924,Kits,1,1,1.0,0
3582,924,Stuff Packs,6,0,0.0,6
3583,925,Expansion Packs,16,1,0.0625,15
3584,925,Game Packs,12,0,0.0,12
3585,925,Kits,33,0,0.0,33
3586,925,Stuff Packs,20,0,0.0,20
3587,926,Expansion Packs,1,0,0.0,1
3588,927,Expansion Packs,7,0,0.0,7
3589,927,Game Packs,4,1,0.25,3
3590,927,Kits,2,2,1.0,0
3591,927,Stuff Packs,8,4,0.5,4
3592,928,Expansion Packs,10,0,0.0,10
3593,928,Game Packs,8,0,0.0,8
3594,928,Kits,11,1,0.09090909090909091,10
3595,928,Stuff Packs,7,2,0.2857142857142857,5
3596,929,Expansion Packs,15,0,0.0,15
3597,929,Game Packs,8,2,0.25,6
3598,929,Kits,10,2,0.2,8
3599,929,Stuff Packs,9,2,0.2222222222222222,7
3600,930,Expansion Packs,16,0,0.0,16
3601,930,Game Packs,12,0,0.0,12
3602,930,Kits,33,1,0.030303030303030304,32
3603,930,Stuff Packs,20,0,0.0,20
3604,931,Expansion Packs,14,0,0.0,14
3605,931,Game Packs,9,0,0.0,9
3606,931,Kits,11,0,0.0,11
3607,931,Stuff Packs,14,0,0.0,14
3608,932,Expansion Packs,16,0,0.0,16
3609,932,Game Packs,12,0,0.0,12
3610,932,Kits,33,3,0.09090909090909091,30
3611,932,Stuff Packs,20,0,0.0,20
3612,933,Expansion Packs,5,0,0.0,5
3613,933,Game Packs,4,1,0.25,3
3614,933,Kits,2,2,1.0,0
3615,933,Stuff Packs,4,3,0.75,1
3616,934,Expansion Packs,6,0,0.0,6
3617,934,Game Packs,4,0,0.0,4
3618,934,Kits,1,1,1.0,0
3619,934,Stuff Packs,4,2,0.5,2
3620,935,Expansion Packs,5,0,0.0,5
3621,935,Game Packs,3,0,0.0,3
3622,935,Stuff Packs,4,1,0.25,3
3623,936,Expansion Packs,13,0,0.0,13
3624,936,Game Packs,12,0,0.0,12
3625,936,Kits,25,0,0.0,25
3626,936,Stuff Packs,19,0,0.0,19
3627,937,Expansion Packs,16,0,0.0,16
3628,937,Game Packs,11,0,0.0,11
3629,937,Kits,25,0,0.0,25
3630,937,Stuff Packs,16,0,0.0,16
3631,938,Expansion Packs,2,0,0.0,2
3632,938,Game Packs,3,0,0.0,3
3633,938,Kits,1,1,1.0,0
3634,938,Stuff Packs,2,2,1.0,0
3635,939,Expansion Packs,16,0,0.0,16
3636,939,Game Packs,12,0,0.0,12
3637,939,Kits,33,2,0.06060606060606061,31
3638,939,Stuff Packs,19,3,0.15789473684210525,16
3639,940,Stuff Packs,2,1,0.5,1
3640,941,Expansion Packs,13,0,0.0,13
3641,941,Game Packs,8,0,0.0,8
3642,941,Kits,4,1,0.25,3
3643,941,Stuff Packs,7,2,0.2857142857142857,5
3644,942,Expansion Packs,16,0,0.0,16
3645,942,Game Packs,12,0,0.0,12
3646,942,Kits,8,0,0.0,8
3647,942,Stuff Packs,20,0,0.0,20
3648,943,Expansion Packs,16,1,0.0625,15
3649,943,Game Packs,12,1,0.08333333333333333,11
3650,943,Kits,33,3,0.09090909090909091,30
3651,943,Stuff Packs,20,4,0.2,16
3652,944,Expansion Packs,15,0,0.0,15
3653,944,Game Packs,11,0,0.0,11
3654,944,Kits,25,0,0.0,25
3655,944,Stuff Packs,19,0,0.0,19
3656,945,Expansion Packs,5,0,0.0,5
3657,945,Game Packs,1,0,0.0,1
3658,945,Kits,1,1,1.0,0
3659,945,Stuff Packs,4,2,0.5,2
3660,946,Expansion Packs,16,0,0.0,16
3661,946,Game Packs,11,0,0.0,11
3662,946,Kits,3,0,0.0,3
3663,946,Stuff Packs,11,0,0.0,11
3664,947,Expansion Packs,15,0,0.0,15
3665,947,Game Packs,11,0,0.0,11
3666,947,Kits,17,0,0.0,17
3667,947,Stuff Packs,20,0,0.0,20
3668,948,Expansion Packs,16,0,0.0,16
3669,948,Game Packs,11,0,0.0,11
3670,948,Kits,29,1,0.034482758620689655,28
3671,948,Stuff Packs,18,0,0.0,18
3672,949,Expansion Packs,10,0,0.0,10
3673,949,Game Packs,3,0,0.0,3
3674,949,Stuff Packs,5,0,0.0,5
3675,950,Expansion Packs,9,0,0.0,9
3676,950,Game Packs,3,0,0.0,3
3677,950,Kits,6,0,0.0,6
3678,950,Stuff Packs,7,0,0.0,7
3679,951,Expansion Packs,13,0,0.0,13
3680,951,Game Packs,10,0,0.0,10
3681,951,Stuff Packs,15,1,0.06666666666666667,14
3682,952,Expansion Packs,9,0,0.0,9
3683,952,Game Packs,3,0,0.0,3
3684,952,Kits,13,2,0.15384615384615385,11
3685,952,Stuff Packs,10,3,0.3,7
3686,953,Expansion Packs,16,0,0.0,16
3687,953,Game Packs,11,0,0.0,11
3688,953,Kits,27,0,0.0,27
3689,953,Stuff Packs,20,0,0.0,20
3690,954,Expansion Packs,13,0,0.0,13
3691,954,Game Packs,8,0,0.0,8
3692,954,Kits,4,0,0.0,4
3693,954,Stuff Packs,16,0,0.0,16
3694,955,Expansion Packs,6,0,0.0,6
3695,955,Game Packs,3,0,0.0,3
3696,955,Stuff Packs,5,2,0.4,3
3697,956,Expansion Packs,13,0,0.0,13
3698,956,Game Packs,9,0,0.0,9
3699,956,Kits,5,1,0.2,4
3700,956,Stuff Packs,16,2,0.125,14
3701,957,Expansion Packs,16,0,0.0,16
3702,957,Game Packs,12,1,0.08333333333333333,11
3703,957,Kits,32,7,0.21875,25
3704,957,Stuff Packs,20,3,0.15,17
3705,958,Expansion Packs,16,0,0.0,16
3706,958,Game Packs,12,0,0.0,12
3707,958,Kits,27,1,0.037037037037037035,26
3708,958,Stuff Packs,20,0,0.0,20
3709,959,Expansion Packs,14,0,0.0,14
3710,959,Game Packs,12,0,0.0,12
3711,959,Kits,11,1,0.09090909090909091,10
3712,959,Stuff Packs,12,0,0.0,12
3713,960,Expansion Packs,13,0,0.0,13
3714,960,Game Packs,8,0,0.0,8
3715,960,Kits,10,0,0.0,10
3716,960,Stuff Packs,11,0,0.0,11
3717,961,Expansion Packs,8,0,0.0,8
3718,961,Game Packs,4,0,0.0,4
3719,961,Kits,1,0,0.0,1
3720,961,Stuff Packs,6,1,0.16666666666666666,5
3721,962,Expansion Packs,16,1,0.0625,15
3722,962,Game Packs,12,0,0.0,12
3723,962,Kits,28,0,0.0,28
3724,962,Stuff Packs,18,0,0.0,18
3725,963,Expansion Packs,16,0,0.0,16
3726,963,Game Packs,12,0,0.0,12
3727,963,Kits,33,2,0.06060606060606061,31
3728,963,Stuff Packs,20,1,0.05,19
3729,964,Expansion Packs,14,0,0.0,14
3730,964,Game Packs,8,0,0.0,8
3731,964,Kits,4,0,0.0,4
3732,964,Stuff Packs,12,0,0.0,12
3733,965,Expansion Packs,16,0,0.0,16
3734,965,Game Packs,12,0,0.0,12
3735,965,Kits,12,0,0.0,12
3736,965,Stuff Packs,20,0,0.0,20
3737,966,Expansion Packs,5,0,0.0,5
3738,966,Game Packs,3,0,0.0,3
3739,966,Kits,6,1,0.16666666666666666,5
3740,966,Stuff Packs,7,2,0.2857142857142857,5
3741,967,Expansion Packs,11,0,0.0,11
3742,967,Game Packs,5,0,0.0,5
3743,967,Kits,4,0,0.0,4
3744,967,Stuff Packs,6,0,0.0,6
3745,968,Expansion Packs,15,0,0.0,15
3746,968,Game Packs,8,0,0.0,8
3747,968,Kits,14,1,0.07142857142857142,13
3748,968,Stuff Packs,13,2,0.15384615384615385,11
3749,969,Expansion Packs,2,0,0.0,2
3750,969,Game Packs,2,0,0.0,2
3751,969,Kits,2,0,0.0,2
3752,969,Stuff Packs,4,1,0.25,3
3753,970,Expansion Packs,15,0,0.0,15
3754,970,Game Packs,7,0,0.0,7
3755,970,Kits,4,2,0.5,2
3756,970,Stuff Packs,10,2,0.2,8
3757,971,Expansion Packs,16,0,0.0,16
3758,971,Game Packs,11,0,0.0,11
3759,971,Kits,23,1,0.043478260869565216,22
3760,971,Stuff Packs,19,3,0.15789473684210525,16
3761,972,Expansion Packs,13,0,0.0,13
3762,972,Game Packs,5,1,0.2,4
3763,972,Kits,8,1,0.125,7
3764,972,Stuff Packs,15,1,0.06666666666666667,14
3765,973,Expansion Packs,11,0,0.0,11
3766,973,Game Packs,10,1,0.1,9
3767,973,Kits,1,1,1.0,0
3768,973,Stuff Packs,18,0,0.0,18
3769,974,Expansion Packs,13,0,0.0,13
3770,974,Game Packs,11,0,0.0,11
3771,974,Kits,5,3,0.6,2
3772,974,Stuff Packs,17,4,0.23529411764705882,13
3773,975,Expansion Packs,16,0,0.0,16
3774,975,Game Packs,11,0,0.0,11
3775,975,Kits,12,0,0.0,12
3776,975,Stuff Packs,16,0,0.0,16
3777,976,Expansion Packs,15,0,0.0,15
3778,976,Game Packs,11,0,0.0,11
3779,976,Kits,14,1,0.07142857142857142,13
3780,976,Stuff Packs,20,0,0.0,20
3781,977,Expansion Packs,15,0,0.0,15
3782,977,Game Packs,12,0,0.0,12
3783,977,Kits,4,0,0.0,4
3784,977,Stuff Packs,18,1,0.05555555555555555,17
3785,978,Expansion Packs,16,0,0.0,16
3786,978,Game Packs,11,0,0.0,11
3787,978,Kits,8,0,0.0,8
3788,978,Stuff Packs,15,0,0.0,15
3789,979,Expansion Packs,16,0,0.0,16
3790,979,Game Packs,12,0,0.0,12
3791,979,Kits,33,0,0.0,33
3792,979,Stuff Packs,20,0,0.0,20
3793,980,Expansion Packs,9,0,0.0,9
3794,980,Game Packs,6,0,0.0,6
3795,980,Kits,3,2,0.6666666666666666,1
3796,980,Stuff Packs,8,2,0.25,6
3797,981,Expansion Packs,13,0,0.0,13
3798,981,Game Packs,9,0,0.0,9
3799,981,Kits,1,0,0.0,1
3800,981,Stuff Packs,7,0,0.0,7
3801,982,Expansion Packs,11,0,0.0,11
3802,982,Game Packs,4,1,0.25,3
3803,982,Kits,1,1,1.0,0
3804,982,Stuff Packs,6,4,0.6666666666666666,2
3805,983,Expansion Packs,1,0,0.0,1
3806,983,Game Packs,2,0,0.0,2
3807,983,Stuff Packs,5,3,0.6,2
3808,984,Expansion Packs,16,0,0.0,16
3809,984,Game Packs,12,0,0.0,12
3810,984,Kits,33,0,0.0,33
3811,984,Stuff Packs,20,0,0.0,20
3812,985,Expansion Packs,14,0,0.0,14
3813,985,Game Packs,12,0,0.0,12
3814,985,Kits,7,1,0.14285714285714285,6
3815,985,Stuff Packs,19,0,0.0,19
3816,986,Kits,2,2,1.0,0
3817,986,Stuff Packs,3,3,1.0,0
3818,987,Expansion Packs,16,0,0.0,16
3819,987,Game Packs,11,0,0.0,11
3820,987,Kits,4,0,0.0,4
3821,987,Stuff Packs,14,1,0.07142857142857142,13
3822,988,Expansion Packs,16,0,0.0,16
3823,988,Game Packs,11,0,0.0,11
3824,988,Kits,14,1,0.07142857142857142,13
3825,988,Stuff Packs,20,1,0.05,19
3826,989,Expansion Packs,16,0,0.0,16
3827,989,Game Packs,12,0,0.0,12
3828,989,Kits,29,1,0.034482758620689655,28
3829,989,Stuff Packs,20,0,0.0,20
3830,990,Expansion Packs,13,0,0.0,13
3831,990,Game Packs,7,0,0.0,7
3832,990,Kits,1,0,0.0,1
3833,990,Stuff Packs,10,0,0.0,10
3834,991,Expansion Packs,4,0,0.0,4
3835,991,Game Packs,2,1,0.5,1
3836,991,Kits,2,2,1.0,0
3837,991,Stuff Packs,2,2,1.0,0
3838,992,Expansion Packs,16,0,0.0,16
3839,992,Game Packs,11,0,0.0,11
3840,992,Kits,27,1,0.037037037037037035,26
3841,992,Stuff Packs,20,1,0.05,19
3842,993,Expansion Packs,14,0,0.0,14
3843,993,Game Packs,8,0,0.0,8
3844,993,Kits,7,1,0.14285714285714285,6
3845,993,Stuff Packs,9,3,0.3333333333333333,6
3846,994,Expansion Packs,14,0,0.0,14
3847,994,Game Packs,11,0,0.0,11
3848,994,Kits,17,1,0.058823529411764705,16
3849,994,Stuff Packs,19,0,0.0,19
3850,995,Expansion Packs,15,0,0.0,15
3851,995,Game Packs,11,0,0.0,11
3852,995,Kits,16,2,0.125,14
3853,995,Stuff Packs,19,1,0.05263157894736842,18
3854,996,Expansion Packs,16,0,0.0,16
3855,996,Game Packs,12,0,0.0,12
3856,996,Kits,28,0,0.0,28
3857,996,Stuff Packs,20,0,0.0,20
3858,997,Expansion Packs,16,0,0.0,16
3859,997,Game Packs,4,0,0.0,4
3860,997,Kits,1,0,0.0,1
3861,997,Stuff Packs,5,0,0.0,5
3862,998,Expansion Packs,15,0,0.0,15
3863,998,Game Packs,10,0,0.0,10
3864,998,Kits,6,1,0.16666666666666666,5
3865,998,Stuff Packs,10,2,0.2,8
3866,999,Expansion Packs,13,0,0.0,13
3867,999,Game Packs,7,0,0.0,7
3868,999,Kits,4,0,0.0,4
3869,999,Stuff Packs,7,1,0.14285714285714285,6
3870,1000,Expansion Packs,4,0,0.0,4
3871,1000,Game Packs,1,0,0.0,1
3872,1000,Stuff Packs,1,0,0.0,1
3873,1001,Expansion Packs,12,0,0.0,12
3874,1001,Game Packs,9,0,0.0,9
3875,1001,Kits,1,1,1.0,0
3876,1001,Stuff Packs,16,0,0.0,16
3877,1002,Expansion Packs,16,0,0.0,16
3878,1002,Game Packs,12,0,0.0,12
3879,1002,Kits,25,0,0.0,25
3880,1002,Stuff Packs,20,0,0.0,20
3881,1003,Expansion Packs,16,0,0.0,16
3882,1003,Game Packs,12,0,0.0,12
3883,1003,Kits,33,0,0.0,33
3884,1003,Stuff Packs,20,0,0.0,20
3885,1004,Expansion Packs,16,0,0.0,16
3886,1004,Game Packs,12,0,0.0,12
3887,1004,Kits,27,2,0.07407407407407407,25
3888,1004,Stuff Packs,20,1,0.05,19
3889,1005,Expansion Packs,6,0,0.0,6
3890,1005,Game Packs,2,0,0.0,2
3891,1005,Kits,1,1,1.0,0
3892,1005,Stuff Packs,5,4,0.8,1
3893,1006,Expansion Packs,15,0,0.0,15
3894,1006,Game Packs,11,1,0.09090909090909091,10
3895,1006,Kits,16,2,0.125,14
3896,1006,Stuff Packs,15,4,0.26666666666666666,11
3897,1007,Expansion Packs,14,0,0.0,14
3898,1007,Game Packs,8,0,0.0,8
3899,1007,Kits,10,1,0.1,9
3900,1007,Stuff Packs,13,1,0.07692307692307693,12
3901,1008,Expansion Packs,15,0,0.0,15
3902,1008,Game Packs,12,0,0.0,12
3903,1008,Kits,32,0,0.0,32
3904,1008,Stuff Packs,20,0,0.0,20
3905,1009,Expansion Packs,7,0,0.0,7
3906,1009,Game Packs,2,1,0.5,1
3907,1009,Kits,3,3,1.0,0
3908,1009,Stuff Packs,4,4,1.0,0
3909,1010,Expansion Packs,13,0,0.0,13
3910,1010,Game Packs,11,1,0.09090909090909091,10
3911,1010,Kits,5,3,0.6,2
3912,1010,Stuff Packs,13,2,0.15384615384615385,11
3913,1011,Expansion Packs,15,0,0.0,15
3914,1011,Game Packs,12,0,0.0,12
3915,1011,Kits,27,0,0.0,27
3916,1011,Stuff Packs,20,0,0.0,20
3917,1012,Expansion Packs,10,0,0.0,10
3918,1012,Game Packs,3,0,0.0,3
3919,1012,Kits,2,2,1.0,0
3920,1012,Stuff Packs,4,0,0.0,4
3921,1013,Expansion Packs,8,0,0.0,8
3922,1013,Game Packs,3,0,0.0,3
3923,1013,Kits,1,1,1.0,0
3924,1013,Stuff Packs,4,0,0.0,4
3925,1014,Expansion Packs,10,0,0.0,10
3926,1014,Game Packs,5,0,0.0,5
3927,1014,Kits,5,1,0.2,4
3928,1014,Stuff Packs,6,1,0.16666666666666666,5
3929,1015,Expansion Packs,16,0,0.0,16
3930,1015,Game Packs,12,0,0.0,12
3931,1015,Kits,17,0,0.0,17
3932,1015,Stuff Packs,20,0,0.0,20
3933,1016,Expansion Packs,8,0,0.0,8
3934,1016,Game Packs,7,0,0.0,7
3935,1016,Stuff Packs,9,2,0.2222222222222222,7
3936,1017,Expansion Packs,11,0,0.0,11
3937,1017,Game Packs,7,0,0.0,7
3938,1017,Stuff Packs,9,0,0.0,9
3939,1018,Expansion Packs,11,0,0.0,11
3940,1018,Game Packs,3,0,0.0,3
3941,1018,Stuff Packs,4,0,0.0,4
3942,1019,Expansion Packs,13,0,0.0,13
3943,1019,Game Packs,7,1,0.14285714285714285,6
3944,1019,Kits,9,1,0.1111111111111111,8
3945,1019,Stuff Packs,8,2,0.25,6
3946,1020,Expansion Packs,13,0,0.0,13
3947,1020,Game Packs,9,0,0.0,9
3948,1020,Kits,3,1,0.3333333333333333,2
3949,1020,Stuff Packs,16,0,0.0,16
3950,1021,Expansion Packs,16,0,0.0,16
3951,1021,Game Packs,12,0,0.0,12
3952,1021,Kits,33,0,0.0,33
3953,1021,Stuff Packs,20,0,0.0,20
3954,1022,Expansion Packs,13,0,0.0,13
3955,1022,Game Packs,8,0,0.0,8
3956,1022,Kits,6,1,0.16666666666666666,5
3957,1022,Stuff Packs,15,0,0.0,15
3958,1023,Expansion Packs,13,0,0.0,13
3959,1023,Game Packs,9,0,0.0,9
3960,1023,Kits,3,2,0.6666666666666666,1
3961,1023,Stuff Packs,18,0,0.0,18
3962,1024,Expansion Packs,16,0,0.0,16
3963,1024,Game Packs,11,0,0.0,11
3964,1024,Kits,18,0,0.0,18
3965,1024,Stuff Packs,13,1,0.07692307692307693,12
3966,1025,Expansion Packs,9,0,0.0,9
3967,1025,Game Packs,2,1,0.5,1
3968,1025,Stuff Packs,2,1,0.5,1
3969,1026,Expansion Packs,11,0,0.0,11
3970,1026,Game Packs,3,0,0.0,3
3971,1026,Kits,3,2,0.6666666666666666,1
3972,1026,Stuff Packs,8,3,0.375,5
3973,1027,Expansion Packs,16,0,0.0,16
3974,1027,Game Packs,12,0,0.0,12
3975,1027,Kits,33,0,0.0,33
3976,1027,Stuff Packs,20,2,0.1,18
3977,1028,Expansion Packs,16,0,0.0,16
3978,1028,Game Packs,12,0,0.0,12
3979,1028,Kits,33,1,0.030303030303030304,32
3980,1028,Stuff Packs,20,0,0.0,20
3981,1029,Expansion Packs,11,0,0.0,11
3982,1029,Game Packs,6,0,0.0,6
3983,1029,Kits,3,1,0.3333333333333333,2
3984,1029,Stuff Packs,11,4,0.36363636363636365,7
3985,1030,Expansion Packs,11,0,0.0,11
3986,1030,Game Packs,5,0,0.0,5
3987,1030,Kits,3,1,0.3333333333333333,2
3988,1030,Stuff Packs,11,0,0.0,11
3989,1031,Expansion Packs,12,0,0.0,12
3990,1031,Game Packs,9,0,0.0,9
3991,1031,Kits,3,2,0.6666666666666666,1
3992,1031,Stuff Packs,17,0,0.0,17
3993,1032,Expansion Packs,15,0,0.0,15
3994,1032,Game Packs,11,0,0.0,11
3995,1032,Stuff Packs,16,0,0.0,16
3996,1033,Expansion Packs,16,0,0.0,16
3997,1033,Game Packs,12,1,0.08333333333333333,11
3998,1033,Kits,33,2,0.06060606060606061,31
3999,1033,Stuff Packs,20,0,0.0,20
4000,1034,Expansion Packs,6,0,0.0,6
4001,1034,Game Packs,1,0,0.0,1
4002,1034,Stuff Packs,3,1,0.3333333333333333,2
4003,1035,Expansion Packs,16,0,0.0,16
4004,1035,Game Packs,11,0,0.0,11
4005,1035,Kits,8,0,0.0,8
4006,1035,Stuff Packs,20,0,0.0,20
4007,1036,Expansion Packs,15,0,0.0,15
4008,1036,Game Packs,8,0,0.0,8
4009,1036,Kits,19,1,0.05263157894736842,18
4010,1036,Stuff Packs,19,0,0.0,19
4011,1037,Expansion Packs,16,0,0.0,16
4012,1037,Game Packs,10,0,0.0,10
4013,1037,Kits,13,2,0.15384615384615385,11
4014,1037,Stuff Packs,18,2,0.1111111111111111,16
4015,1038,Expansion Packs,14,0,0.0,14
4016,1038,Game Packs,8,1,0.125,7
4017,1038,Kits,13,1,0.07692307692307693,12
4018,1038,Stuff Packs,11,4,0.36363636363636365,7
4019,1039,Expansion Packs,15,0,0.0,15
4020,1039,Game Packs,8,0,0.0,8
4021,1039,Kits,18,0,0.0,18
4022,1039,Stuff Packs,15,0,0.0,15
4023,1040,Expansion Packs,14,0,0.0,14
4024,1040,Game Packs,12,0,0.0,12
4025,1040,Kits,12,2,0.16666666666666666,10
4026,1040,Stuff Packs,19,0,0.0,19
4027,1041,Expansion Packs,16,0,0.0,16
4028,1041,Game Packs,8,0,0.0,8
4029,1041,Kits,25,0,0.0,25
4030,1041,Stuff Packs,15,0,0.0,15
4031,1042,Expansion Packs,15,0,0.0,15
4032,1042,Game Packs,12,0,0.0,12
4033,1042,Kits,31,0,0.0,31
4034,1042,Stuff Packs,20,0,0.0,20
4035,1043,Expansion Packs,16,0,0.0,16
4036,1043,Game Packs,11,0,0.0,11
4037,1043,Kits,22,1,0.045454545454545456,21
4038,1043,Stuff Packs,15,2,0.13333333333333333,13
4039,1044,Expansion Packs,15,0,0.0,15
4040,1044,Game Packs,6,0,0.0,6
4041,1044,Kits,6,1,0.16666666666666666,5
4042,1044,Stuff Packs,13,2,0.15384615384615385,11
4043,1045,Expansion Packs,16,0,0.0,16
4044,1045,Game Packs,12,0,0.0,12
4045,1045,Kits,32,0,0.0,32
4046,1045,Stuff Packs,20,0,0.0,20
4047,1046,Expansion Packs,15,0,0.0,15
4048,1046,Game Packs,10,0,0.0,10
4049,1046,Kits,2,0,0.0,2
4050,1046,Stuff Packs,12,0,0.0,12
4051,1047,Expansion Packs,5,0,0.0,5
4052,1047,Game Packs,1,0,0.0,1
4053,1047,Kits,1,0,0.0,1
4054,1047,Stuff Packs,1,0,0.0,1
4055,1048,Expansion Packs,16,0,0.0,16
4056,1048,Game Packs,12,0,0.0,12
4057,1048,Kits,33,0,0.0,33
4058,1048,Stuff Packs,20,0,0.0,20
4059,1049,Expansion Packs,16,0,0.0,16
4060,1049,Game Packs,12,0,0.0,12
4061,1049,Kits,33,0,0.0,33
4062,1049,Stuff Packs,20,0,0.0,20
4063,1050,Expansion Packs,16,0,0.0,16
4064,1050,Game Packs,11,0,0.0,11
4065,1050,Kits,3,0,0.0,3
4066,1050,Stuff Packs,20,0,0.0,20
4067,1051,Game Packs,1,1,1.0,0
4068,1051,Kits,2,2,1.0,0
4069,1051,Stuff Packs,2,2,1.0,0
4070,1052,Expansion Packs,13,1,0.07692307692307693,12
4071,1052,Game Packs,7,0,0.0,7
4072,1052,Kits,9,0,0.0,9
4073,1052,Stuff Packs,9,3,0.3333333333333333,6
4074,1053,Expansion Packs,11,0,0.0,11
4075,1053,Game Packs,5,1,0.2,4
4076,1053,Kits,14,2,0.14285714285714285,12
4077,1053,Stuff Packs,15,5,0.3333333333333333,10
4078,1054,Expansion Packs,16,0,0.0,16
4079,1054,Game Packs,12,0,0.0,12
4080,1054,Kits,33,0,0.0,33
4081,1054,Stuff Packs,20,0,0.0,20
4082,1055,Game Packs,1,1,1.0,0
4083,1055,Stuff Packs,2,2,1.0,0
4084,1056,Expansion Packs,16,0,0.0,16
4085,1056,Game Packs,11,0,0.0,11
4086,1056,Kits,3,2,0.6666666666666666,1
4087,1056,Stuff Packs,10,0,0.0,10
4088,1057,Expansion Packs,10,0,0.0,10
4089,1057,Game Packs,6,0,0.0,6
4090,1057,Stuff Packs,6,0,0.0,6
4091,1058,Expansion Packs,16,0,0.0,16
4092,1058,Game Packs,11,0,0.0,11
4093,1058,Kits,10,1,0.1,9
4094,1058,Stuff Packs,16,2,0.125,14
4095,1059,Expansion Packs,15,0,0.0,15
4096,1059,Game Packs,12,0,0.0,12
4097,1059,Kits,4,0,0.0,4
4098,1059,Stuff Packs,10,0,0.0,10
4099,1060,Expansion Packs,10,0,0.0,10
4100,1060,Game Packs,7,0,0.0,7
4101,1060,Kits,4,3,0.75,1
4102,1060,Stuff Packs,9,5,0.5555555555555556,4
4103,1061,Expansion Packs,1,0,0.0,1
4104,1061,Game Packs,2,0,0.0,2
4105,1061,Kits,2,2,1.0,0
4106,1061,Stuff Packs,3,2,0.6666666666666666,1
4107,1062,Expansion Packs,16,0,0.0,16
4108,1062,Game Packs,12,0,0.0,12
4109,1062,Kits,33,0,0.0,33
4110,1062,Stuff Packs,20,0,0.0,20
4111,1063,Expansion Packs,14,0,0.0,14
4112,1063,Game Packs,9,1,0.1111111111111111,8
4113,1063,Kits,15,2,0.13333333333333333,13
4114,1063,Stuff Packs,10,3,0.3,7
4115,1064,Expansion Packs,14,0,0.0,14
4116,1064,Game Packs,9,0,0.0,9
4117,1064,Kits,2,2,1.0,0
4118,1064,Stuff Packs,7,2,0.2857142857142857,5
4119,1065,Expansion Packs,8,0,0.0,8
4120,1065,Game Packs,2,0,0.0,2
4121,1065,Kits,1,1,1.0,0
4122,1065,Stuff Packs,2,1,0.5,1
4123,1066,Expansion Packs,15,0,0.0,15
4124,1066,Game Packs,11,0,0.0,11
4125,1066,Kits,11,0,0.0,11
4126,1066,Stuff Packs,14,0,0.0,14
4127,1067,Expansion Packs,16,0,0.0,16
4128,1067,Game Packs,11,0,0.0,11
4129,1067,Kits,29,0,0.0,29
4130,1067,Stuff Packs,19,0,0.0,19
4131,1068,Expansion Packs,16,0,0.0,16
4132,1068,Game Packs,12,0,0.0,12
4133,1068,Kits,33,0,0.0,33
4134,1068,Stuff Packs,20,0,0.0,20
4135,1069,Expansion Packs,13,0,0.0,13
4136,1069,Game Packs,6,0,0.0,6
4137,1069,Kits,14,0,0.0,14
4138,1069,Stuff Packs,15,0,0.0,15
4139,1070,Expansion Packs,4,0,0.0,4
4140,1070,Game Packs,2,0,0.0,2
4141,1070,Kits,2,2,1.0,0
4142,1070,Stuff Packs,5,4,0.8,1
4143,1071,Expansion Packs,12,0,0.0,12
4144,1071,Game Packs,8,0,0.0,8
4145,1071,Stuff Packs,5,0,0.0,5
4146,1072,Expansion Packs,15,0,0.0,15
4147,1072,Game Packs,10,0,0.0,10
4148,1072,Stuff Packs,20,0,0.0,20
4149,1073,Expansion Packs,9,0,0.0,9
4150,1073,Game Packs,6,0,0.0,6
4151,1073,Kits,1,1,1.0,0
4152,1073,Stuff Packs,9,0,0.0,9
4153,1074,Expansion Packs,13,0,0.0,13
4154,1074,Game Packs,11,0,0.0,11
4155,1074,Kits,3,1,0.3333333333333333,2
4156,1074,Stuff Packs,10,2,0.2,8
4157,1075,Expansion Packs,4,0,0.0,4
4158,1075,Game Packs,2,0,0.0,2
4159,1075,Kits,1,0,0.0,1
4160,1075,Stuff Packs,2,1,0.5,1
4161,1076,Expansion Packs,16,0,0.0,16
4162,1076,Game Packs,12,0,0.0,12
4163,1076,Kits,33,0,0.0,33
4164,1076,Stuff Packs,20,0,0.0,20
4165,1077,Expansion Packs,5,0,0.0,5
4166,1077,Game Packs,4,0,0.0,4
4167,1077,Kits,4,1,0.25,3
4168,1077,Stuff Packs,4,2,0.5,2
4169,1078,Expansion Packs,10,0,0.0,10
4170,1078,Game Packs,3,0,0.0,3
4171,1078,Kits,1,0,0.0,1
4172,1078,Stuff Packs,6,0,0.0,6
4173,1079,Expansion Packs,12,2,0.16666666666666666,10
4174,1079,Game Packs,6,1,0.16666666666666666,5
4175,1079,Kits,12,2,0.16666666666666666,10
4176,1079,Stuff Packs,8,5,0.625,3
4177,1080,Expansion Packs,2,1,0.5,1
4178,1080,Stuff Packs,2,2,1.0,0
4179,1081,Expansion Packs,6,0,0.0,6
4180,1081,Game Packs,4,0,0.0,4
4181,1081,Kits,5,0,0.0,5
4182,1081,Stuff Packs,5,0,0.0,5
4183,1082,Expansion Packs,12,0,0.0,12
4184,1082,Game Packs,5,0,0.0,5
4185,1082,Kits,2,0,0.0,2
4186,1082,Stuff Packs,3,1,0.3333333333333333,2
4187,1083,Expansion Packs,16,0,0.0,16
4188,1083,Game Packs,12,0,0.0,12
4189,1083,Kits,13,1,0.07692307692307693,12
4190,1083,Stuff Packs,19,0,0.0,19
4191,1084,Expansion Packs,16,0,0.0,16
4192,1084,Game Packs,6,0,0.0,6
4193,1084,Kits,4,0,0.0,4
4194,1084,Stuff Packs,9,0,0.0,9
4195,1085,Expansion Packs,13,0,0.0,13
4196,1085,Game Packs,10,0,0.0,10
4197,1085,Kits,2,1,0.5,1
4198,1085,Stuff Packs,17,1,0.058823529411764705,16
4199,1086,Expansion Packs,16,0,0.0,16
4200,1086,Game Packs,12,0,0.0,12
4201,1086,Kits,33,0,0.0,33
4202,1086,Stuff Packs,20,0,0.0,20
4203,1087,Expansion Packs,6,0,0.0,6
4204,1087,Game Packs,3,0,0.0,3
4205,1087,Kits,1,1,1.0,0
4206,1087,Stuff Packs,4,1,0.25,3
4207,1088,Expansion Packs,10,0,0.0,10
4208,1088,Game Packs,4,0,0.0,4
4209,1088,Kits,2,1,0.5,1
4210,1088,Stuff Packs,6,2,0.3333333333333333,4
4211,1089,Expansion Packs,15,1,0.06666666666666667,14
4212,1089,Game Packs,6,0,0.0,6
4213,1089,Kits,1,0,0.0,1
4214,1089,Stuff Packs,7,0,0.0,7
4215,1090,Expansion Packs,16,4,0.25,12
4216,1090,Game Packs,12,0,0.0,12
4217,1090,Kits,33,0,0.0,33
4218,1090,Stuff Packs,20,0,0.0,20
4219,1091,Expansion Packs,5,0,0.0,5
4220,1091,Game Packs,2,0,0.0,2
4221,1091,Kits,2,2,1.0,0
4222,1091,Stuff Packs,4,2,0.5,2
4223,1092,Expansion Packs,10,1,0.1,9
4224,1092,Game Packs,8,0,0.0,8
4225,1092,Kits,4,2,0.5,2
4226,1092,Stuff Packs,7,3,0.42857142857142855,4
4227,1093,Expansion Packs,8,0,0.0,8
4228,1093,Game Packs,3,1,0.3333333333333333,2
4229,1093,Kits,1,0,0.0,1
4230,1093,Stuff Packs,5,4,0.8,1
4231,1094,Expansion Packs,9,0,0.0,9
4232,1094,Game Packs,10,0,0.0,10
4233,1094,Kits,3,1,0.3333333333333333,2
4234,1094,Stuff Packs,13,0,0.0,13
4235,1095,Expansion Packs,15,0,0.0,15
4236,1095,Game Packs,9,0,0.0,9
4237,1095,Kits,7,1,0.14285714285714285,6
4238,1095,Stuff Packs,4,0,0.0,4
4239,1096,Expansion Packs,10,0,0.0,10
4240,1096,Game Packs,6,0,0.0,6
4241,1096,Stuff Packs,3,0,0.0,3
4242,1097,Expansion Packs,9,0,0.0,9
4243,1097,Game Packs,2,0,0.0,2
4244,1097,Stuff Packs,3,0,0.0,3
4245,1098,Expansion Packs,4,0,0.0,4
4246,1098,Game Packs,3,0,0.0,3
4247,1098,Stuff Packs,3,2,0.6666666666666666,1
4248,1099,Expansion Packs,16,0,0.0,16
4249,1099,Game Packs,6,0,0.0,6
4250,1099,Kits,4,2,0.5,2
4251,1099,Stuff Packs,5,3,0.6,2
4252,1100,Expansion Packs,3,0,0.0,3
4253,1100,Game Packs,3,0,0.0,3
4254,1100,Kits,1,1,1.0,0
4255,1100,Stuff Packs,5,3,0.6,2
4256,1101,Kits,2,1,0.5,1
4257,1101,Stuff Packs,2,2,1.0,0
4258,1102,Expansion Packs,4,0,0.0,4
4259,1102,Game Packs,1,0,0.0,1
4260,1102,Kits,1,1,1.0,0
4261,1102,Stuff Packs,5,3,0.6,2
4262,1103,Expansion Packs,16,0,0.0,16
4263,1103,Game Packs,12,0,0.0,12
4264,1103,Kits,5,1,0.2,4
4265,1103,Stuff Packs,20,0,0.0,20
4266,1104,Expansion Packs,16,0,0.0,16
4267,1104,Game Packs,12,0,0.0,12
4268,1104,Kits,33,0,0.0,33
4269,1104,Stuff Packs,20,0,0.0,20
4270,1105,Expansion Packs,16,0,0.0,16
4271,1105,Game Packs,12,0,0.0,12
4272,1105,Kits,23,2,0.08695652173913043,21
4273,1105,Stuff Packs,20,0,0.0,20
4274,1106,Expansion Packs,3,0,0.0,3
4275,1106,Game Packs,1,0,0.0,1
4276,1106,Kits,2,2,1.0,0
4277,1106,Stuff Packs,6,4,0.6666666666666666,2
4278,1107,Expansion Packs,6,0,0.0,6
4279,1107,Game Packs,2,1,0.5,1
4280,1107,Kits,4,3,0.75,1
4281,1107,Stuff Packs,8,4,0.5,4
4282,1108,Expansion Packs,14,0,0.0,14
4283,1108,Game Packs,8,1,0.125,7
4284,1108,Kits,16,2,0.125,14
4285,1108,Stuff Packs,14,2,0.14285714285714285,12
4286,1109,Expansion Packs,12,0,0.0,12
4287,1109,Game Packs,7,0,0.0,7
4288,1109,Kits,8,1,0.125,7
4289,1109,Stuff Packs,8,3,0.375,5
4290,1110,Expansion Packs,16,0,0.0,16
4291,1110,Game Packs,4,0,0.0,4
4292,1110,Kits,2,2,1.0,0
4293,1110,Stuff Packs,6,3,0.5,3
4294,1111,Expansion Packs,9,0,0.0,9
4295,1111,Game Packs,7,1,0.14285714285714285,6
4296,1111,Kits,4,3,0.75,1
4297,1111,Stuff Packs,9,3,0.3333333333333333,6
4298,1112,Expansion Packs,6,0,0.0,6
4299,1112,Game Packs,7,1,0.14285714285714285,6
4300,1112,Kits,1,1,1.0,0
4301,1112,Stuff Packs,8,3,0.375,5
4302,1113,Expansion Packs,11,0,0.0,11
4303,1113,Game Packs,7,0,0.0,7
4304,1113,Kits,1,1,1.0,0
4305,1113,Stuff Packs,8,0,0.0,8
4306,1114,Expansion Packs,13,0,0.0,13
4307,1114,Game Packs,10,0,0.0,10
4308,1114,Kits,5,1,0.2,4
4309,1114,Stuff Packs,13,0,0.0,13
4310,1115,Expansion Packs,16,0,0.0,16
4311,1115,Game Packs,12,0,0.0,12
4312,1115,Kits,33,0,0.0,33
4313,1115,Stuff Packs,20,0,0.0,20
4314,1116,Expansion Packs,16,0,0.0,16
4315,1116,Game Packs,12,0,0.0,12
4316,1116,Kits,32,1,0.03125,31
4317,1116,Stuff Packs,20,0,0.0,20
4318,1117,Expansion Packs,14,0,0.0,14
4319,1117,Game Packs,10,0,0.0,10
4320,1117,Kits,2,1,0.5,1
4321,1117,Stuff Packs,13,1,0.07692307692307693,12
4322,1118,Expansion Packs,16,0,0.0,16
4323,1118,Game Packs,11,0,0.0,11
4324,1118,Kits,1,1,1.0,0
4325,1118,Stuff Packs,19,1,0.05263157894736842,18
4326,1119,Expansion Packs,15,0,0.0,15
4327,1119,Game Packs,5,0,0.0,5
4328,1119,Kits,7,2,0.2857142857142857,5
4329,1119,Stuff Packs,8,3,0.375,5
4330,1120,Expansion Packs,8,0,0.0,8
4331,1120,Game Packs,1,0,0.0,1
4332,1120,Stuff Packs,2,2,1.0,0
4333,1121,Expansion Packs,16,0,0.0,16
4334,1121,Game Packs,12,0,0.0,12
4335,1121,Kits,33,2,0.06060606060606061,31
4336,1121,Stuff Packs,20,0,0.0,20
4337,1122,Expansion Packs,14,0,0.0,14
4338,1122,Game Packs,9,0,0.0,9
4339,1122,Kits,4,2,0.5,2
4340,1122,Stuff Packs,10,1,0.1,9
4341,1123,Expansion Packs,16,0,0.0,16
4342,1123,Game Packs,11,1,0.09090909090909091,10
4343,1123,Kits,16,3,0.1875,13
4344,1123,Stuff Packs,14,4,0.2857142857142857,10
4345,1124,Expansion Packs,14,0,0.0,14
4346,1124,Game Packs,8,0,0.0,8
4347,1124,Kits,14,1,0.07142857142857142,13
4348,1124,Stuff Packs,15,2,0.13333333333333333,13
4349,1125,Expansion Packs,8,0,0.0,8
4350,1125,Game Packs,2,0,0.0,2
4351,1125,Kits,3,1,0.3333333333333333,2
4352,1125,Stuff Packs,6,2,0.3333333333333333,4
4353,1126,Expansion Packs,11,0,0.0,11
4354,1126,Game Packs,8,0,0.0,8
4355,1126,Kits,5,1,0.2,4
4356,1126,Stuff Packs,7,0,0.0,7
4357,1127,Expansion Packs,14,0,0.0,14
4358,1127,Game Packs,8,0,0.0,8
4359,1127,Kits,4,2,0.5,2
4360,1127,Stuff Packs,13,0,0.0,13
4361,1128,Expansion Packs,16,0,0.0,16
4362,1128,Game Packs,12,0,0.0,12
4363,1128,Kits,20,2,0.1,18
4364,1128,Stuff Packs,20,1,0.05,19
4365,1129,Expansion Packs,4,0,0.0,4
4366,1129,Game Packs,2,0,0.0,2
4367,1129,Kits,1,1,1.0,0
4368,1129,Stuff Packs,4,1,0.25,3
4369,1130,Expansion Packs,10,0,0.0,10
4370,1130,Game Packs,9,0,0.0,9
4371,1130,Kits,1,1,1.0,0
4372,1130,Stuff Packs,12,0,0.0,12
4373,1131,Expansion Packs,15,0,0.0,15
4374,1131,Game Packs,11,0,0.0,11
4375,1131,Kits,5,1,0.2,4
4376,1131,Stuff Packs,15,0,0.0,15
4377,1132,Expansion Packs,12,0,0.0,12
4378,1132,Game Packs,9,0,0.0,9
4379,1132,Kits,3,2,0.6666666666666666,1
4380,1132,Stuff Packs,11,4,0.36363636363636365,7
4381,1133,Expansion Packs,16,0,0.0,16
4382,1133,Game Packs,11,0,0.0,11
4383,1133,Kits,16,1,0.0625,15
4384,1133,Stuff Packs,18,1,0.05555555555555555,17
4385,1134,Expansion Packs,3,0,0.0,3
4386,1134,Game Packs,5,0,0.0,5
4387,1134,Stuff Packs,5,2,0.4,3
4388,1135,Expansion Packs,13,0,0.0,13
4389,1135,Game Packs,4,0,0.0,4
4390,1135,Stuff Packs,10,0,0.0,10
4391,1136,Expansion Packs,15,1,0.06666666666666667,14
4392,1136,Game Packs,6,1,0.16666666666666666,5
4393,1136,Kits,5,4,0.8,1
4394,1136,Stuff Packs,11,4,0.36363636363636365,7
4395,1137,Expansion Packs,13,0,0.0,13
4396,1137,Game Packs,10,0,0.0,10
4397,1137,Kits,5,1,0.2,4
4398,1137,Stuff Packs,17,1,0.058823529411764705,16
4399,1138,Expansion Packs,16,0,0.0,16
4400,1138,Game Packs,10,0,0.0,10
4401,1138,Kits,16,1,0.0625,15
4402,1138,Stuff Packs,17,2,0.11764705882352941,15
4403,1139,Expansion Packs,16,0,0.0,16
4404,1139,Game Packs,12,0,0.0,12
4405,1139,Kits,33,0,0.0,33
4406,1139,Stuff Packs,20,0,0.0,20
4407,1140,Expansion Packs,8,0,0.0,8
4408,1140,Game Packs,3,0,0.0,3
4409,1140,Kits,1,1,1.0,0
4410,1140,Stuff Packs,1,0,0.0,1
4411,1141,Expansion Packs,12,0,0.0,12
4412,1141,Game Packs,7,0,0.0,7
4413,1141,Kits,7,0,0.0,7
4414,1141,Stuff Packs,10,3,0.3,7
4415,1142,Expansion Packs,16,0,0.0,16
4416,1142,Game Packs,12,1,0.08333333333333333,11
4417,1142,Kits,33,2,0.06060606060606061,31
4418,1142,Stuff Packs,20,4,0.2,16
4419,1143,Expansion Packs,12,0,0.0,12
4420,1143,Game Packs,4,1,0.25,3
4421,1143,Kits,5,2,0.4,3
4422,1143,Stuff Packs,12,4,0.3333333333333333,8
4423,1144,Expansion Packs,5,0,0.0,5
4424,1144,Game Packs,6,0,0.0,6
4425,1144,Kits,1,0,0.0,1
4426,1144,Stuff Packs,5,0,0.0,5
4427,1145,Expansion Packs,16,1,0.0625,15
4428,1145,Game Packs,8,0,0.0,8
4429,1145,Kits,9,4,0.4444444444444444,5
4430,1145,Stuff Packs,12,4,0.3333333333333333,8
4431,1146,Expansion Packs,14,0,0.0,14
4432,1146,Game Packs,5,0,0.0,5
4433,1146,Kits,1,1,1.0,0
4434,1146,Stuff Packs,5,2,0.4,3
4435,1147,Expansion Packs,6,0,0.0,6
4436,1147,Kits,1,1,1.0,0
4437,1147,Stuff Packs,2,1,0.5,1
4438,1148,Expansion Packs,5,0,0.0,5
4439,1148,Game Packs,3,0,0.0,3
4440,1148,Kits,2,2,1.0,0
4441,1148,Stuff Packs,3,0,0.0,3
4442,1149,Expansion Packs,16,0,0.0,16
4443,1149,Game Packs,12,0,0.0,12
4444,1149,Kits,33,1,0.030303030303030304,32
4445,1149,Stuff Packs,20,0,0.0,20
4446,1150,Expansion Packs,16,0,0.0,16
4447,1150,Game Packs,12,0,0.0,12
4448,1150,Kits,28,0,0.0,28
4449,1150,Stuff Packs,19,0,0.0,19
4450,1151,Expansion Packs,9,0,0.0,9
4451,1151,Game Packs,7,0,0.0,7
4452,1151,Kits,1,1,1.0,0
4453,1151,Stuff Packs,18,0,0.0,18
4454,1152,Expansion Packs,2,0,0.0,2
4455,1152,Kits,1,1,1.0,0
4456,1152,Stuff Packs,4,2,0.5,2
4457,1153,Expansion Packs,7,0,0.0,7
4458,1153,Game Packs,4,1,0.25,3
4459,1153,Kits,1,1,1.0,0
4460,1153,Stuff Packs,4,3,0.75,1
4461,1154,Expansion Packs,14,0,0.0,14
4462,1154,Game Packs,12,0,0.0,12
4463,1154,Kits,15,0,0.0,15
4464,1154,Stuff Packs,18,0,0.0,18
4465,1155,Expansion Packs,16,0,0.0,16
4466,1155,Game Packs,12,0,0.0,12
4467,1155,Kits,32,0,0.0,32
4468,1155,Stuff Packs,20,0,0.0,20
4469,1156,Expansion Packs,7,7,1.0,0
4470,1156,Game Packs,2,2,1.0,0
4471,1156,Kits,2,2,1.0,0
4472,1156,Stuff Packs,5,5,1.0,0
4473,1157,Expansion Packs,12,0,0.0,12
4474,1157,Game Packs,7,0,0.0,7
4475,1157,Kits,5,1,0.2,4
4476,1157,Stuff Packs,15,1,0.06666666666666667,14
4477,1158,Expansion Packs,13,0,0.0,13
4478,1158,Game Packs,12,0,0.0,12
4479,1158,Kits,18,0,0.0,18
4480,1158,Stuff Packs,19,0,0.0,19
4481,1159,Expansion Packs,15,14,0.9333333333333333,1
4482,1159,Game Packs,9,8,0.8888888888888888,1
4483,1159,Kits,4,4,1.0,0
4484,1159,Stuff Packs,9,9,1.0,0
4485,1160,Expansion Packs,6,0,0.0,6
4486,1160,Game Packs,3,0,0.0,3
4487,1160,Kits,2,2,1.0,0
4488,1160,Stuff Packs,8,2,0.25,6
4489,1161,Expansion Packs,16,0,0.0,16
4490,1161,Game Packs,10,0,0.0,10
4491,1161,Kits,14,1,0.07142857142857142,13
4492,1161,Stuff Packs,17,1,0.058823529411764705,16
4493,1162,Expansion Packs,5,1,0.2,4
4494,1162,Game Packs,6,0,0.0,6
4495,1162,Kits,4,0,0.0,4
4496,1162,Stuff Packs,7,0,0.0,7
4497,1163,Expansion Packs,16,0,0.0,16
4498,1163,Game Packs,11,0,0.0,11
4499,1163,Kits,31,0,0.0,31
4500,1163,Stuff Packs,20,0,0.0,20
4501,1164,Expansion Packs,11,0,0.0,11
4502,1164,Game Packs,8,0,0.0,8
4503,1164,Kits,1,1,1.0,0
4504,1164,Stuff Packs,2,0,0.0,2
4505,1165,Expansion Packs,1,1,1.0,0
4506,1165,Kits,1,1,1.0,0
4507,1165,Stuff Packs,3,3,1.0,0
4508,1166,Expansion Packs,16,0,0.0,16
4509,1166,Game Packs,11,0,0.0,11
4510,1166,Kits,24,2,0.08333333333333333,22
4511,1166,Stuff Packs,19,0,0.0,19
4512,1167,Expansion Packs,16,0,0.0,16
4513,1167,Game Packs,10,1,0.1,9
4514,1167,Kits,3,2,0.6666666666666666,1
4515,1167,Stuff Packs,6,1,0.16666666666666666,5
4516,1168,Expansion Packs,16,0,0.0,16
4517,1168,Game Packs,12,0,0.0,12
4518,1168,Kits,33,1,0.030303030303030304,32
4519,1168,Stuff Packs,20,0,0.0,20
4520,1169,Expansion Packs,5,0,0.0,5
4521,1169,Game Packs,1,0,0.0,1
4522,1169,Stuff Packs,3,1,0.3333333333333333,2
4523,1170,Expansion Packs,16,0,0.0,16
4524,1170,Game Packs,12,1,0.08333333333333333,11
4525,1170,Kits,33,1,0.030303030303030304,32
4526,1170,Stuff Packs,20,0,0.0,20
4527,1171,Expansion Packs,5,0,0.0,5
4528,1171,Stuff Packs,1,1,1.0,0
4529,1172,Expansion Packs,3,0,0.0,3
4530,1172,Game Packs,3,1,0.3333333333333333,2
4531,1172,Kits,3,3,1.0,0
4532,1172,Stuff Packs,5,4,0.8,1
4533,1173,Expansion Packs,13,3,0.23076923076923078,10
4534,1173,Game Packs,4,0,0.0,4
4535,1173,Kits,7,1,0.14285714285714285,6
4536,1173,Stuff Packs,7,2,0.2857142857142857,5
4537,1174,Expansion Packs,16,0,0.0,16
4538,1174,Game Packs,12,0,0.0,12
4539,1174,Kits,33,0,0.0,33
4540,1174,Stuff Packs,20,1,0.05,19
4541,1175,Expansion Packs,14,0,0.0,14
4542,1175,Game Packs,9,0,0.0,9
4543,1175,Kits,7,1,0.14285714285714285,6
4544,1175,Stuff Packs,13,0,0.0,13
4545,1176,Kits,1,1,1.0,0
4546,1176,Stuff Packs,3,3,1.0,0
4547,1177,Expansion Packs,6,0,0.0,6
4548,1177,Game Packs,3,1,0.3333333333333333,2
4549,1177,Kits,3,3,1.0,0
4550,1177,Stuff Packs,5,4,0.8,1
4551,1178,Expansion Packs,3,0,0.0,3
4552,1178,Game Packs,4,1,0.25,3
4553,1178,Kits,2,2,1.0,0
4554,1178,Stuff Packs,7,4,0.5714285714285714,3
4555,1179,Expansion Packs,14,0,0.0,14
4556,1179,Game Packs,10,1,0.1,9
4557,1179,Kits,10,0,0.0,10
4558,1179,Stuff Packs,18,0,0.0,18
4559,1180,Expansion Packs,15,0,0.0,15
4560,1180,Game Packs,9,0,0.0,9
4561,1180,Kits,3,3,1.0,0
4562,1180,Stuff Packs,13,4,0.3076923076923077,9
4563,1181,Expansion Packs,16,0,0.0,16
4564,1181,Game Packs,12,0,0.0,12
4565,1181,Kits,33,0,0.0,33
4566,1181,Stuff Packs,20,0,0.0,20
4567,1182,Expansion Packs,16,0,0.0,16
4568,1182,Game Packs,12,0,0.0,12
4569,1182,Kits,23,0,0.0,23
4570,1182,Stuff Packs,20,0,0.0,20
4571,1183,Expansion Packs,11,0,0.0,11
4572,1183,Game Packs,7,0,0.0,7
4573,1183,Stuff Packs,7,2,0.2857142857142857,5
4574,1184,Expansion Packs,16,0,0.0,16
4575,1184,Game Packs,12,0,0.0,12
4576,1184,Kits,33,0,0.0,33
4577,1184,Stuff Packs,20,0,0.0,20
4578,1185,Expansion Packs,16,0,0.0,16
4579,1185,Game Packs,12,0,0.0,12
4580,1185,Kits,33,0,0.0,33
4581,1185,Stuff Packs,20,0,0.0,20
4582,1186,Expansion Packs,5,0,0.0,5
4583,1186,Game Packs,4,0,0.0,4
4584,1186,Stuff Packs,1,0,0.0,1
4585,1187,Expansion Packs,16,0,0.0,16
4586,1187,Game Packs,12,0,0.0,12
4587,1187,Kits,33,0,0.0,33
4588,1187,Stuff Packs,20,0,0.0,20
4589,1188,Expansion Packs,6,0,0.0,6
4590,1188,Game Packs,3,0,0.0,3
4591,1188,Kits,5,0,0.0,5
4592,1188,Stuff Packs,6,0,0.0,6
4593,1189,Expansion Packs,15,0,0.0,15
4594,1189,Game Packs,12,0,0.0,12
4595,1189,Kits,12,0,0.0,12
4596,1189,Stuff Packs,12,0,0.0,12
4597,1190,Expansion Packs,16,0,0.0,16
4598,1190,Game Packs,11,0,0.0,11
4599,1190,Kits,5,3,0.6,2
4600,1190,Stuff Packs,15,2,0.13333333333333333,13
4601,1191,Expansion Packs,9,0,0.0,9
4602,1191,Game Packs,3,0,0.0,3
4603,1191,Kits,2,2,1.0,0
4604,1191,Stuff Packs,7,1,0.14285714285714285,6
4605,1192,Expansion Packs,7,0,0.0,7
4606,1192,Game Packs,2,0,0.0,2
4607,1193,Expansion Packs,16,0,0.0,16
4608,1193,Game Packs,7,0,0.0,7
4609,1193,Kits,21,1,0.047619047619047616,20
4610,1193,Stuff Packs,17,2,0.11764705882352941,15
4611,1194,Expansion Packs,16,0,0.0,16
4612,1194,Game Packs,12,0,0.0,12
4613,1194,Kits,17,0,0.0,17
4614,1194,Stuff Packs,20,0,0.0,20
4615,1195,Expansion Packs,11,0,0.0,11
4616,1195,Game Packs,6,0,0.0,6
4617,1195,Kits,4,1,0.25,3
4618,1195,Stuff Packs,13,2,0.15384615384615385,11
4619,1196,Expansion Packs,9,0,0.0,9
4620,1196,Game Packs,5,0,0.0,5
4621,1196,Kits,2,2,1.0,0
4622,1196,Stuff Packs,9,2,0.2222222222222222,7
4623,1197,Expansion Packs,7,0,0.0,7
4624,1197,Game Packs,5,1,0.2,4
4625,1197,Kits,1,1,1.0,0
4626,1197,Stuff Packs,9,4,0.4444444444444444,5
4627,1198,Expansion Packs,10,0,0.0,10
4628,1198,Game Packs,5,0,0.0,5
4629,1198,Kits,9,1,0.1111111111111111,8
4630,1198,Stuff Packs,7,0,0.0,7
4631,1199,Expansion Packs,16,0,0.0,16
4632,1199,Game Packs,6,0,0.0,6
4633,1199,Kits,7,1,0.14285714285714285,6
4634,1199,Stuff Packs,7,1,0.14285714285714285,6
4635,1200,Expansion Packs,7,0,0.0,7
4636,1200,Game Packs,2,0,0.0,2
4637,1200,Kits,2,1,0.5,1
4638,1200,Stuff Packs,5,3,0.6,2
4639,1201,Expansion Packs,14,0,0.0,14
4640,1201,Game Packs,10,0,0.0,10
4641,1201,Kits,2,1,0.5,1
4642,1201,Stuff Packs,6,2,0.3333333333333333,4
4643,1202,Expansion Packs,10,0,0.0,10
4644,1202,Game Packs,3,1,0.3333333333333333,2
4645,1202,Kits,6,3,0.5,3
4646,1202,Stuff Packs,6,3,0.5,3
4647,1203,Expansion Packs,12,3,0.25,9
4648,1203,Game Packs,6,4,0.6666666666666666,2
4649,1203,Stuff Packs,7,6,0.8571428571428571,1
4650,1204,Expansion Packs,7,0,0.0,7
4651,1204,Game Packs,5,1,0.2,4
4652,1204,Kits,2,2,1.0,0
4653,1204,Stuff Packs,7,4,0.5714285714285714,3
4654,1205,Expansion Packs,9,1,0.1111111111111111,8
4655,1205,Game Packs,5,0,0.0,5
4656,1205,Kits,2,0,0.0,2
4657,1205,Stuff Packs,7,0,0.0,7
4658,1206,Expansion Packs,15,0,0.0,15
4659,1206,Game Packs,9,0,0.0,9
4660,1206,Kits,11,2,0.18181818181818182,9
4661,1206,Stuff Packs,10,1,0.1,9
4662,1207,Expansion Packs,13,0,0.0,13
4663,1207,Game Packs,5,0,0.0,5
4664,1207,Kits,1,1,1.0,0
4665,1207,Stuff Packs,11,2,0.18181818181818182,9
4666,1208,Expansion Packs,16,0,0.0,16
4667,1208,Game Packs,8,0,0.0,8
4668,1208,Kits,5,0,0.0,5
4669,1208,Stuff Packs,16,0,0.0,16
4670,1209,Expansion Packs,15,7,0.4666666666666667,8
4671,1209,Game Packs,12,1,0.08333333333333333,11
4672,1209,Kits,21,1,0.047619047619047616,20
4673,1209,Stuff Packs,20,0,0.0,20
4674,1210,Expansion Packs,1,0,0.0,1
4675,1210,Game Packs,1,1,1.0,0
4676,1210,Kits,2,2,1.0,0
4677,1210,Stuff Packs,4,4,1.0,0
4678,1211,Expansion Packs,16,0,0.0,16
4679,1211,Game Packs,7,0,0.0,7
4680,1211,Kits,16,0,0.0,16
4681,1211,Stuff Packs,6,3,0.5,3
4682,1212,Expansion Packs,15,0,0.0,15
4683,1212,Game Packs,10,0,0.0,10
4684,1212,Kits,4,0,0.0,4
4685,1212,Stuff Packs,19,0,0.0,19
4686,1213,Expansion Packs,5,0,0.0,5
4687,1213,Kits,1,1,1.0,0
4688,1213,Stuff Packs,3,2,0.6666666666666666,1
4689,1214,Expansion Packs,11,0,0.0,11
4690,1214,Game Packs,3,0,0.0,3
4691,1214,Kits,2,2,1.0,0
4692,1214,Stuff Packs,9,3,0.3333333333333333,6
4693,1215,Expansion Packs,10,0,0.0,10
4694,1215,Game Packs,6,0,0.0,6
4695,1215,Kits,3,1,0.3333333333333333,2
4696,1215,Stuff Packs,9,2,0.2222222222222222,7
4697,1216,Expansion Packs,16,0,0.0,16
4698,1216,Game Packs,12,0,0.0,12
4699,1216,Kits,26,1,0.038461538461538464,25
4700,1216,Stuff Packs,20,0,0.0,20
4701,1217,Expansion Packs,11,0,0.0,11
4702,1217,Game Packs,4,0,0.0,4
4703,1217,Kits,2,0,0.0,2
4704,1217,Stuff Packs,6,3,0.5,3
4705,1218,Expansion Packs,5,0,0.0,5
4706,1218,Game Packs,1,0,0.0,1
4707,1218,Kits,1,1,1.0,0
4708,1218,Stuff Packs,7,0,0.0,7
4709,1219,Expansion Packs,15,0,0.0,15
4710,1219,Game Packs,11,0,0.0,11
4711,1219,Kits,7,1,0.14285714285714285,6
4712,1219,Stuff Packs,20,1,0.05,19
4713,1220,Expansion Packs,16,0,0.0,16
4714,1220,Game Packs,12,0,0.0,12
4715,1220,Kits,25,0,0.0,25
4716,1220,Stuff Packs,20,0,0.0,20
4717,1221,Expansion Packs,15,0,0.0,15
4718,1221,Game Packs,12,0,0.0,12
4719,1221,Kits,20,0,0.0,20
4720,1221,Stuff Packs,20,0,0.0,20
4721,1222,Expansion Packs,6,0,0.0,6
4722,1222,Game Packs,2,1,0.5,1
4723,1222,Kits,1,1,1.0,0
4724,1223,Expansion Packs,16,0,0.0,16
4725,1223,Game Packs,10,0,0.0,10
4726,1223,Stuff Packs,11,4,0.36363636363636365,7
4727,1224,Expansion Packs,13,0,0.0,13
4728,1224,Game Packs,8,0,0.0,8
4729,1224,Kits,3,3,1.0,0
4730,1224,Stuff Packs,10,4,0.4,6
4731,1225,Expansion Packs,16,0,0.0,16
4732,1225,Game Packs,12,0,0.0,12
4733,1225,Kits,33,0,0.0,33
4734,1225,Stuff Packs,20,0,0.0,20
4735,1226,Expansion Packs,16,0,0.0,16
4736,1226,Game Packs,12,0,0.0,12
4737,1226,Kits,31,0,0.0,31
4738,1226,Stuff Packs,20,0,0.0,20
4739,1227,Expansion Packs,9,0,0.0,9
4740,1227,Game Packs,5,0,0.0,5
4741,1227,Kits,1,0,0.0,1
4742,1227,Stuff Packs,7,2,0.2857142857142857,5
4743,1228,Expansion Packs,15,0,0.0,15
4744,1228,Game Packs,12,0,0.0,12
4745,1228,Kits,9,1,0.1111111111111111,8
4746,1228,Stuff Packs,15,1,0.06666666666666667,14
4747,1229,Expansion Packs,13,0,0.0,13
4748,1229,Game Packs,5,0,0.0,5
4749,1229,Kits,8,1,0.125,7
4750,1229,Stuff Packs,8,1,0.125,7
4751,1230,Expansion Packs,6,0,0.0,6
4752,1230,Game Packs,3,0,0.0,3
4753,1230,Kits,2,2,1.0,0
4754,1230,Stuff Packs,4,3,0.75,1
4755,1231,Expansion Packs,14,0,0.0,14
4756,1231,Game Packs,8,0,0.0,8
4757,1231,Kits,4,1,0.25,3
4758,1231,Stuff Packs,13,0,0.0,13
4759,1232,Expansion Packs,8,0,0.0,8
4760,1232,Game Packs,3,0,0.0,3
4761,1232,Stuff Packs,5,3,0.6,2
4762,1233,Expansion Packs,16,0,0.0,16
4763,1233,Game Packs,12,0,0.0,12
4764,1233,Kits,18,0,0.0,18
4765,1233,Stuff Packs,20,0,0.0,20
4766,1234,Expansion Packs,12,0,0.0,12
4767,1234,Game Packs,4,0,0.0,4
4768,1234,Kits,5,1,0.2,4
4769,1234,Stuff Packs,7,3,0.42857142857142855,4
4770,1235,Expansion Packs,16,0,0.0,16
4771,1235,Game Packs,11,0,0.0,11
4772,1235,Kits,12,0,0.0,12
4773,1235,Stuff Packs,20,0,0.0,20
4774,1236,Expansion Packs,7,0,0.0,7
4775,1236,Game Packs,4,0,0.0,4
4776,1236,Kits,2,2,1.0,0
4777,1236,Stuff Packs,8,1,0.125,7
4778,1237,Expansion Packs,8,4,0.5,4
4779,1237,Game Packs,4,0,0.0,4
4780,1237,Kits,11,11,1.0,0
4781,1237,Stuff Packs,10,7,0.7,3
4782,1238,Expansion Packs,9,0,0.0,9
4783,1238,Game Packs,5,0,0.0,5
4784,1238,Kits,2,2,1.0,0
4785,1238,Stuff Packs,8,0,0.0,8
4786,1239,Expansion Packs,16,0,0.0,16
4787,1239,Game Packs,12,0,0.0,12
4788,1239,Kits,33,1,0.030303030303030304,32
4789,1239,Stuff Packs,20,0,0.0,20
4790,1240,Expansion Packs,16,0,0.0,16
4791,1240,Game Packs,12,0,0.0,12
4792,1240,Kits,33,2,0.06060606060606061,31
4793,1240,Stuff Packs,20,4,0.2,16
4794,1241,Expansion Packs,16,0,0.0,16
4795,1241,Game Packs,12,0,0.0,12
4796,1241,Kits,33,0,0.0,33
4797,1241,Stuff Packs,20,0,0.0,20
4798,1242,Expansion Packs,9,0,0.0,9
4799,1242,Game Packs,4,1,0.25,3
4800,1242,Kits,1,1,1.0,0
4801,1242,Stuff Packs,4,2,0.5,2
4802,1243,Expansion Packs,14,0,0.0,14
4803,1243,Game Packs,6,0,0.0,6
4804,1243,Stuff Packs,7,1,0.14285714285714285,6
4805,1244,Expansion Packs,3,0,0.0,3
4806,1244,Game Packs,2,0,0.0,2
4807,1244,Stuff Packs,3,1,0.3333333333333333,2
4808,1245,Expansion Packs,16,0,0.0,16
4809,1245,Game Packs,12,0,0.0,12
4810,1245,Kits,33,1,0.030303030303030304,32
4811,1245,Stuff Packs,20,0,0.0,20
4812,1246,Expansion Packs,16,0,0.0,16
4813,1246,Game Packs,12,0,0.0,12
4814,1246,Kits,32,1,0.03125,31
4815,1246,Stuff Packs,20,0,0.0,20
4816,1247,Expansion Packs,2,0,0.0,2
4817,1247,Game Packs,2,0,0.0,2
4818,1247,Kits,1,1,1.0,0
4819,1247,Stuff Packs,2,2,1.0,0
4820,1248,Expansion Packs,16,0,0.0,16
4821,1248,Game Packs,12,0,0.0,12
4822,1248,Kits,33,0,0.0,33
4823,1248,Stuff Packs,20,0,0.0,20
4824,1249,Expansion Packs,1,0,0.0,1
4825,1249,Game Packs,1,0,0.0,1
4826,1249,Kits,4,1,0.25,3
4827,1249,Stuff Packs,2,1,0.5,1
4828,1250,Expansion Packs,14,0,0.0,14
4829,1250,Game Packs,10,0,0.0,10
4830,1250,Kits,14,1,0.07142857142857142,13
4831,1250,Stuff Packs,18,0,0.0,18
4832,1251,Expansion Packs,16,1,0.0625,15
4833,1251,Game Packs,11,0,0.0,11
4834,1251,Kits,7,1,0.14285714285714285,6
4835,1251,Stuff Packs,13,0,0.0,13
4836,1252,Expansion Packs,16,0,0.0,16
4837,1252,Game Packs,12,0,0.0,12
4838,1252,Kits,33,2,0.06060606060606061,31
4839,1252,Stuff Packs,20,0,0.0,20
4840,1253,Expansion Packs,15,0,0.0,15
4841,1253,Game Packs,2,0,0.0,2
4842,1253,Kits,4,1,0.25,3
4843,1253,Stuff Packs,2,0,0.0,2
4844,1254,Expansion Packs,5,0,0.0,5
4845,1254,Game Packs,1,1,1.0,0
4846,1254,Kits,2,0,0.0,2
4847,1254,Stuff Packs,7,4,0.5714285714285714,3
4848,1255,Kits,1,1,1.0,0
4849,1255,Stuff Packs,3,3,1.0,0
4850,1256,Expansion Packs,16,0,0.0,16
4851,1256,Game Packs,11,0,0.0,11
4852,1256,Kits,11,0,0.0,11
4853,1256,Stuff Packs,18,0,0.0,18
4854,1257,Expansion Packs,10,0,0.0,10
4855,1257,Game Packs,8,0,0.0,8
4856,1257,Kits,1,1,1.0,0
4857,1257,Stuff Packs,15,2,0.13333333333333333,13
4858,1258,Expansion Packs,6,0,0.0,6
4859,1258,Game Packs,6,0,0.0,6
4860,1258,Kits,5,0,0.0,5
4861,1258,Stuff Packs,11,0,0.0,11
4862,1259,Expansion Packs,13,0,0.0,13
4863,1259,Game Packs,8,4,0.5,4
4864,1259,Stuff Packs,9,8,0.8888888888888888,1
4865,1260,Expansion Packs,13,0,0.0,13
4866,1260,Game Packs,8,1,0.125,7
4867,1260,Kits,6,3,0.5,3
4868,1260,Stuff Packs,11,4,0.36363636363636365,7
4869,1261,Expansion Packs,15,0,0.0,15
4870,1261,Game Packs,10,0,0.0,10
4871,1261,Kits,5,2,0.4,3
4872,1261,Stuff Packs,18,0,0.0,18
4873,1262,Expansion Packs,11,0,0.0,11
4874,1262,Game Packs,6,0,0.0,6
4875,1262,Stuff Packs,2,0,0.0,2
4876,1263,Expansion Packs,16,0,0.0,16
4877,1263,Game Packs,9,0,0.0,9
4878,1263,Kits,5,0,0.0,5
4879,1263,Stuff Packs,19,0,0.0,19
4880,1264,Expansion Packs,16,0,0.0,16
4881,1264,Game Packs,12,0,0.0,12
4882,1264,Kits,7,0,0.0,7
4883,1264,Stuff Packs,15,0,0.0,15
4884,1265,Expansion Packs,16,0,0.0,16
4885,1265,Game Packs,9,0,0.0,9
4886,1265,Kits,11,0,0.0,11
4887,1265,Stuff Packs,11,0,0.0,11
4888,1266,Expansion Packs,14,0,0.0,14
4889,1266,Game Packs,11,0,0.0,11
4890,1266,Kits,6,1,0.16666666666666666,5
4891,1266,Stuff Packs,16,1,0.0625,15
4892,1267,Expansion Packs,4,0,0.0,4
4893,1267,Game Packs,1,0,0.0,1
4894,1267,Kits,15,0,0.0,15
4895,1267,Stuff Packs,7,3,0.42857142857142855,4
4896,1268,Expansion Packs,9,0,0.0,9
4897,1268,Game Packs,5,0,0.0,5
4898,1268,Kits,6,0,0.0,6
4899,1268,Stuff Packs,9,1,0.1111111111111111,8
4900,1269,Expansion Packs,4,0,0.0,4
4901,1269,Game Packs,1,0,0.0,1
4902,1269,Kits,4,0,0.0,4
4903,1269,Stuff Packs,5,0,0.0,5
4904,1270,Expansion Packs,16,0,0.0,16
4905,1270,Game Packs,12,0,0.0,12
4906,1270,Kits,33,1,0.030303030303030304,32
4907,1270,Stuff Packs,20,0,0.0,20
4908,1271,Expansion Packs,16,0,0.0,16
4909,1271,Game Packs,11,1,0.09090909090909091,10
4910,1271,Kits,4,0,0.0,4
4911,1271,Stuff Packs,13,0,0.0,13
4912,1272,Expansion Packs,15,0,0.0,15
4913,1272,Game Packs,11,0,0.0,11
4914,1272,Kits,10,1,0.1,9
4915,1272,Stuff Packs,8,2,0.25,6
4916,1273,Expansion Packs,16,0,0.0,16
4917,1273,Game Packs,10,0,0.0,10
4918,1273,Kits,13,0,0.0,13
4919,1273,Stuff Packs,11,0,0.0,11
4920,1274,Expansion Packs,16,0,0.0,16
4921,1274,Game Packs,11,0,0.0,11
4922,1274,Kits,16,1,0.0625,15
4923,1274,Stuff Packs,19,1,0.05263157894736842,18
4924,1275,Expansion Packs,9,0,0.0,9
4925,1275,Game Packs,6,0,0.0,6
4926,1275,Kits,1,0,0.0,1
4927,1275,Stuff Packs,6,1,0.16666666666666666,5
4928,1276,Expansion Packs,9,0,0.0,9
4929,1276,Game Packs,2,0,0.0,2
4930,1276,Kits,7,1,0.14285714285714285,6
4931,1276,Stuff Packs,3,3,1.0,0
4932,1277,Expansion Packs,16,2,0.125,14
4933,1277,Game Packs,12,0,0.0,12
4934,1277,Kits,33,2,0.06060606060606061,31
4935,1277,Stuff Packs,20,2,0.1,18
4936,1278,Expansion Packs,15,0,0.0,15
4937,1278,Game Packs,10,0,0.0,10
4938,1278,Kits,19,0,0.0,19
4939,1278,Stuff Packs,19,0,0.0,19
4940,1279,Expansion Packs,15,0,0.0,15
4941,1279,Game Packs,11,0,0.0,11
4942,1279,Kits,12,1,0.08333333333333333,11
4943,1279,Stuff Packs,20,0,0.0,20
4944,1280,Expansion Packs,10,0,0.0,10
4945,1280,Game Packs,1,0,0.0,1
4946,1280,Kits,6,1,0.16666666666666666,5
4947,1280,Stuff Packs,4,2,0.5,2
4948,1281,Expansion Packs,14,0,0.0,14
4949,1281,Game Packs,11,0,0.0,11
4950,1281,Kits,2,2,1.0,0
4951,1281,Stuff Packs,19,1,0.05263157894736842,18
4952,1282,Expansion Packs,16,0,0.0,16
4953,1282,Game Packs,12,0,0.0,12
4954,1282,Kits,33,1,0.030303030303030304,32
4955,1282,Stuff Packs,20,0,0.0,20
4956,1283,Expansion Packs,16,0,0.0,16
4957,1283,Game Packs,11,2,0.18181818181818182,9
4958,1283,Kits,24,0,0.0,24
4959,1283,Stuff Packs,17,0,0.0,17
4960,1284,Expansion Packs,10,0,0.0,10
4961,1284,Game Packs,6,0,0.0,6
4962,1284,Kits,5,2,0.4,3
4963,1284,Stuff Packs,13,3,0.23076923076923078,10
4964,1285,Expansion Packs,16,0,0.0,16
4965,1285,Game Packs,12,0,0.0,12
4966,1285,Kits,33,3,0.09090909090909091,30
4967,1285,Stuff Packs,20,2,0.1,18
4968,1286,Expansion Packs,11,0,0.0,11
4969,1286,Game Packs,6,0,0.0,6
4970,1286,Kits,4,1,0.25,3
4971,1286,Stuff Packs,14,1,0.07142857142857142,13
4972,1287,Expansion Packs,1,1,1.0,0
4973,1288,Expansion Packs,3,0,0.0,3
4974,1288,Game Packs,4,0,0.0,4
4975,1288,Kits,1,1,1.0,0
4976,1288,Stuff Packs,4,3,0.75,1
4977,1289,Expansion Packs,8,0,0.0,8
4978,1289,Game Packs,2,0,0.0,2
4979,1289,Kits,3,0,0.0,3
4980,1289,Stuff Packs,8,3,0.375,5
4981,1290,Expansion Packs,5,0,0.0,5
4982,1290,Game Packs,3,1,0.3333333333333333,2
4983,1290,Kits,3,3,1.0,0
4984,1290,Stuff Packs,5,4,0.8,1
4985,1291,Expansion Packs,11,0,0.0,11
4986,1291,Game Packs,5,0,0.0,5
4987,1291,Kits,6,0,0.0,6
4988,1291,Stuff Packs,10,1,0.1,9
4989,1292,Expansion Packs,4,0,0.0,4
4990,1292,Game Packs,4,1,0.25,3
4991,1292,Kits,3,3,1.0,0
4992,1292,Stuff Packs,7,4,0.5714285714285714,3
4993,1293,Expansion Packs,16,0,0.0,16
4994,1293,Game Packs,11,0,0.0,11
4995,1293,Kits,20,2,0.1,18
4996,1293,Stuff Packs,20,0,0.0,20
4997,1294,Expansion Packs,12,0,0.0,12
4998,1294,Game Packs,7,0,0.0,7
4999,1294,Kits,4,0,0.0,4
5000,1294,Stuff Packs,5,0,0.0,5
5001,1295,Expansion Packs,8,0,0.0,8
5002,1295,Game Packs,9,0,0.0,9
5003,1295,Kits,2,1,0.5,1
5004,1295,Stuff Packs,13,0,0.0,13
5005,1296,Expansion Packs,10,0,0.0,10
5006,1296,Game Packs,10,0,0.0,10
5007,1296,Stuff Packs,11,3,0.2727272727272727,8
5008,1297,Expansion Packs,16,0,0.0,16
5009,1297,Game Packs,12,0,0.0,12
5010,1297,Kits,33,2,0.06060606060606061,31
5011,1297,Stuff Packs,20,0,0.0,20
5012,1298,Expansion Packs,15,0,0.0,15
5013,1298,Game Packs,12,0,0.0,12
5014,1298,Kits,21,0,0.0,21
5015,1298,Stuff Packs,20,0,0.0,20
5016,1299,Expansion Packs,14,0,0.0,14
5017,1299,Game Packs,10,0,0.0,10
5018,1299,Kits,1,1,1.0,0
5019,1299,Stuff Packs,17,1,0.058823529411764705,16
5020,1300,Expansion Packs,16,0,0.0,16
5021,1300,Game Packs,12,0,0.0,12
5022,1300,Kits,33,0,0.0,33
5023,1300,Stuff Packs,20,0,0.0,20
5024,1301,Expansion Packs,16,0,0.0,16
5025,1301,Game Packs,12,0,0.0,12
5026,1301,Kits,33,0,0.0,33
5027,1301,Stuff Packs,20,0,0.0,20
5028,1302,Expansion Packs,14,0,0.0,14
5029,1302,Game Packs,8,0,0.0,8
5030,1302,Kits,7,1,0.14285714285714285,6
5031,1302,Stuff Packs,15,0,0.0,15
5032,1303,Expansion Packs,16,16,1.0,0
5033,1303,Game Packs,12,12,1.0,0
5034,1303,Kits,33,33,1.0,0
5035,1303,Stuff Packs,20,17,0.85,3
5036,1304,Expansion Packs,16,0,0.0,16
5037,1304,Game Packs,7,1,0.14285714285714285,6
5038,1304,Kits,4,3,0.75,1
5039,1304,Stuff Packs,12,4,0.3333333333333333,8
5040,1305,Expansion Packs,15,0,0.0,15
5041,1305,Game Packs,12,0,0.0,12
5042,1305,Kits,23,1,0.043478260869565216,22
5043,1305,Stuff Packs,20,0,0.0,20
5044,1306,Expansion Packs,16,0,0.0,16
5045,1306,Game Packs,12,0,0.0,12
5046,1306,Kits,33,0,0.0,33
5047,1306,Stuff Packs,20,0,0.0,20
5048,1307,Expansion Packs,16,0,0.0,16
5049,1307,Game Packs,12,0,0.0,12
5050,1307,Kits,33,1,0.030303030303030304,32
5051,1307,Stuff Packs,20,0,0.0,20
5052,1308,Expansion Packs,7,0,0.0,7
5053,1308,Game Packs,7,0,0.0,7
5054,1308,Stuff Packs,5,0,0.0,5
5055,1309,Expansion Packs,14,0,0.0,14
5056,1309,Game Packs,10,0,0.0,10
5057,1309,Kits,1,1,1.0,0
5058,1309,Stuff Packs,13,2,0.15384615384615385,11
5059,1310,Expansion Packs,13,0,0.0,13
5060,1310,Game Packs,10,0,0.0,10
5061,1310,Kits,4,1,0.25,3
5062,1310,Stuff Packs,19,0,0.0,19
5063,1311,Expansion Packs,7,0,0.0,7
5064,1311,Game Packs,2,0,0.0,2
5065,1311,Kits,1,1,1.0,0
5066,1311,Stuff Packs,7,3,0.42857142857142855,4
5067,1312,Expansion Packs,6,0,0.0,6
5068,1312,Game Packs,1,1,1.0,0
5069,1312,Kits,3,3,1.0,0
5070,1312,Stuff Packs,8,2,0.25,6
5071,1313,Expansion Packs,9,0,0.0,9
5072,1313,Game Packs,6,0,0.0,6
5073,1313,Kits,3,2,0.6666666666666666,1
5074,1313,Stuff Packs,10,1,0.1,9
5075,1314,Expansion Packs,11,0,0.0,11
5076,1314,Game Packs,10,0,0.0,10
5077,1314,Kits,2,0,0.0,2
5078,1314,Stuff Packs,16,0,0.0,16
5079,1315,Expansion Packs,5,0,0.0,5
5080,1315,Game Packs,2,0,0.0,2
5081,1315,Kits,2,2,1.0,0
5082,1315,Stuff Packs,4,3,0.75,1
5083,1316,Expansion Packs,14,0,0.0,14
5084,1316,Game Packs,5,0,0.0,5
5085,1316,Kits,4,1,0.25,3
5086,1316,Stuff Packs,7,1,0.14285714285714285,6
5087,1317,Expansion Packs,16,0,0.0,16
5088,1317,Game Packs,11,0,0.0,11
5089,1317,Kits,25,2,0.08,23
5090,1317,Stuff Packs,14,3,0.21428571428571427,11
5091,1318,Expansion Packs,16,0,0.0,16
5092,1318,Game Packs,11,0,0.0,11
5093,1318,Kits,26,0,0.0,26
5094,1318,Stuff Packs,20,0,0.0,20
5095,1319,Expansion Packs,16,0,0.0,16
5096,1319,Game Packs,12,0,0.0,12
5097,1319,Kits,26,1,0.038461538461538464,25
5098,1319,Stuff Packs,20,0,0.0,20
5099,1320,Expansion Packs,13,0,0.0,13
5100,1320,Game Packs,6,0,0.0,6
5101,1320,Kits,9,0,0.0,9
5102,1320,Stuff Packs,10,1,0.1,9
5103,1321,Expansion Packs,9,0,0.0,9
5104,1321,Game Packs,8,0,0.0,8
5105,1321,Kits,3,0,0.0,3
5106,1321,Stuff Packs,8,0,0.0,8
5107,1322,Expansion Packs,16,0,0.0,16
5108,1322,Game Packs,12,0,0.0,12
5109,1322,Kits,24,0,0.0,24
5110,1322,Stuff Packs,20,0,0.0,20
5111,1323,Expansion Packs,9,0,0.0,9
5112,1323,Game Packs,7,1,0.14285714285714285,6
5113,1323,Kits,5,3,0.6,2
5114,1323,Stuff Packs,9,3,0.3333333333333333,6
5115,1324,Expansion Packs,15,0,0.0,15
5116,1324,Game Packs,10,0,0.0,10
5117,1324,Kits,17,1,0.058823529411764705,16
5118,1324,Stuff Packs,17,0,0.0,17
5119,1325,Expansion Packs,14,0,0.0,14
5120,1325,Game Packs,11,1,0.09090909090909091,10
5121,1325,Kits,5,2,0.4,3
5122,1325,Stuff Packs,11,1,0.09090909090909091,10
5123,1326,Expansion Packs,15,0,0.0,15
5124,1326,Game Packs,12,0,0.0,12
5125,1326,Kits,24,1,0.041666666666666664,23
5126,1326,Stuff Packs,20,0,0.0,20
5127,1327,Expansion Packs,12,0,0.0,12
5128,1327,Game Packs,4,0,0.0,4
5129,1327,Kits,2,2,1.0,0
5130,1327,Stuff Packs,8,3,0.375,5
5131,1328,Expansion Packs,16,0,0.0,16
5132,1328,Game Packs,12,0,0.0,12
5133,1328,Kits,27,0,0.0,27
5134,1328,Stuff Packs,20,0,0.0,20
5135,1329,Expansion Packs,8,0,0.0,8
5136,1329,Game Packs,4,0,0.0,4
5137,1329,Kits,6,0,0.0,6
5138,1329,Stuff Packs,6,0,0.0,6
5139,1330,Expansion Packs,7,0,0.0,7
5140,1330,Game Packs,3,1,0.3333333333333333,2
5141,1330,Stuff Packs,10,0,0.0,10
5142,1331,Expansion Packs,16,0,0.0,16
5143,1331,Game Packs,12,0,0.0,12
5144,1331,Kits,26,0,0.0,26
5145,1331,Stuff Packs,20,0,0.0,20
5146,1332,Expansion Packs,16,0,0.0,16
5147,1332,Game Packs,12,0,0.0,12
5148,1332,Kits,33,0,0.0,33
5149,1332,Stuff Packs,20,0,0.0,20
5150,1333,Expansion Packs,9,0,0.0,9
5151,1333,Game Packs,4,0,0.0,4
5152,1333,Stuff Packs,9,2,0.2222222222222222,7
5153,1334,Expansion Packs,9,0,0.0,9
5154,1334,Game Packs,4,0,0.0,4
5155,1334,Kits,4,1,0.25,3
5156,1334,Stuff Packs,13,2,0.15384615384615385,11
5157,1335,Expansion Packs,16,0,0.0,16
5158,1335,Game Packs,11,0,0.0,11
5159,1335,Kits,3,2,0.6666666666666666,1
5160,1335,Stuff Packs,13,1,0.07692307692307693,12
5161,1336,Expansion Packs,15,0,0.0,15
5162,1336,Game Packs,12,0,0.0,12
5163,1336,Stuff Packs,19,0,0.0,19
5164,1337,Expansion Packs,16,0,0.0,16
5165,1337,Game Packs,11,0,0.0,11
5166,1337,Kits,30,1,0.03333333333333333,29
5167,1337,Stuff Packs,19,0,0.0,19
5168,1338,Expansion Packs,16,0,0.0,16
5169,1338,Game Packs,12,0,0.0,12
5170,1338,Kits,33,0,0.0,33
5171,1338,Stuff Packs,20,0,0.0,20
5172,1339,Expansion Packs,15,0,0.0,15
5173,1339,Game Packs,7,0,0.0,7
5174,1339,Kits,6,1,0.16666666666666666,5
5175,1339,Stuff Packs,15,0,0.0,15
5176,1340,Expansion Packs,12,0,0.0,12
5177,1340,Game Packs,11,0,0.0,11
5178,1340,Kits,2,2,1.0,0
5179,1340,Stuff Packs,14,2,0.14285714285714285,12
5180,1341,Expansion Packs,15,0,0.0,15
5181,1341,Game Packs,9,0,0.0,9
5182,1341,Kits,14,2,0.14285714285714285,12
5183,1341,Stuff Packs,17,0,0.0,17
5184,1342,Expansion Packs,16,0,0.0,16
5185,1342,Game Packs,10,0,0.0,10
5186,1342,Kits,4,0,0.0,4
5187,1342,Stuff Packs,9,0,0.0,9
5188,1343,Expansion Packs,16,0,0.0,16
5189,1343,Game Packs,12,0,0.0,12
5190,1343,Kits,33,0,0.0,33
5191,1343,Stuff Packs,20,0,0.0,20
5192,1344,Expansion Packs,11,0,0.0,11
5193,1344,Game Packs,3,1,0.3333333333333333,2
5194,1344,Kits,7,1,0.14285714285714285,6
5195,1344,Stuff Packs,8,1,0.125,7
5196,1345,Expansion Packs,12,0,0.0,12
5197,1345,Game Packs,8,0,0.0,8
5198,1345,Kits,12,2,0.16666666666666666,10
5199,1345,Stuff Packs,14,0,0.0,14
5200,1346,Expansion Packs,15,0,0.0,15
5201,1346,Game Packs,11,0,0.0,11
5202,1346,Kits,4,0,0.0,4
5203,1346,Stuff Packs,18,0,0.0,18
5204,1347,Expansion Packs,7,0,0.0,7
5205,1347,Game Packs,1,0,0.0,1
5206,1347,Kits,2,2,1.0,0
5207,1347,Stuff Packs,5,3,0.6,2
5208,1348,Expansion Packs,15,0,0.0,15
5209,1348,Game Packs,12,0,0.0,12
5210,1348,Kits,10,1,0.1,9
5211,1348,Stuff Packs,20,0,0.0,20
5212,1349,Expansion Packs,6,0,0.0,6
5213,1349,Game Packs,3,0,0.0,3
5214,1349,Kits,5,5,1.0,0
5215,1349,Stuff Packs,1,1,1.0,0
5216,1350,Expansion Packs,7,0,0.0,7
5217,1350,Game Packs,3,0,0.0,3
5218,1350,Kits,2,2,1.0,0
5219,1350,Stuff Packs,4,3,0.75,1
5220,1351,Expansion Packs,16,0,0.0,16
5221,1351,Game Packs,10,0,0.0,10
5222,1351,Kits,10,2,0.2,8
5223,1351,Stuff Packs,11,2,0.18181818181818182,9
5224,1352,Expansion Packs,9,0,0.0,9
5225,1352,Game Packs,4,0,0.0,4
5226,1352,Kits,1,1,1.0,0
5227,1352,Stuff Packs,5,2,0.4,3
5228,1353,Expansion Packs,16,0,0.0,16
5229,1353,Game Packs,11,0,0.0,11
5230,1353,Kits,29,1,0.034482758620689655,28
5231,1353,Stuff Packs,20,0,0.0,20
5232,1354,Expansion Packs,13,0,0.0,13
5233,1354,Game Packs,7,0,0.0,7
5234,1354,Kits,1,1,1.0,0
5235,1354,Stuff Packs,9,0,0.0,9
5236,1355,Expansion Packs,6,0,0.0,6
5237,1355,Game Packs,1,0,0.0,1
5238,1355,Kits,2,0,0.0,2
5239,1355,Stuff Packs,2,2,1.0,0
5240,1356,Expansion Packs,16,0,0.0,16
5241,1356,Game Packs,11,0,0.0,11
5242,1356,Kits,6,1,0.16666666666666666,5
5243,1356,Stuff Packs,15,0,0.0,15
5244,1357,Expansion Packs,16,0,0.0,16
5245,1357,Game Packs,11,0,0.0,11
5246,1357,Kits,33,0,0.0,33
5247,1357,Stuff Packs,20,0,0.0,20
5248,1358,Expansion Packs,16,0,0.0,16
5249,1358,Game Packs,12,0,0.0,12
5250,1358,Kits,33,0,0.0,33
5251,1358,Stuff Packs,20,1,0.05,19
5252,1359,Expansion Packs,16,0,0.0,16
5253,1359,Game Packs,11,0,0.0,11
5254,1359,Kits,15,3,0.2,12
5255,1359,Stuff Packs,20,2,0.1,18
5256,1360,Expansion Packs,14,0,0.0,14
5257,1360,Game Packs,8,1,0.125,7
5258,1360,Kits,3,0,0.0,3
5259,1360,Stuff Packs,12,5,0.4166666666666667,7
5260,1361,Expansion Packs,16,0,0.0,16
5261,1361,Game Packs,12,0,0.0,12
5262,1361,Kits,26,1,0.038461538461538464,25
5263,1361,Stuff Packs,20,0,0.0,20
5264,1362,Expansion Packs,16,0,0.0,16
5265,1362,Game Packs,11,0,0.0,11
5266,1362,Kits,25,0,0.0,25
5267,1362,Stuff Packs,19,1,0.05263157894736842,18
5268,1363,Expansion Packs,16,0,0.0,16
5269,1363,Game Packs,12,0,0.0,12
5270,1363,Kits,31,0,0.0,31
5271,1363,Stuff Packs,19,0,0.0,19
5272,1364,Expansion Packs,4,0,0.0,4
5273,1364,Game Packs,2,0,0.0,2
5274,1364,Kits,6,3,0.5,3
5275,1364,Stuff Packs,6,4,0.6666666666666666,2
5276,1365,Expansion Packs,16,0,0.0,16
5277,1365,Game Packs,11,0,0.0,11
5278,1365,Kits,27,0,0.0,27
5279,1365,Stuff Packs,14,0,0.0,14
5280,1366,Expansion Packs,14,0,0.0,14
5281,1366,Game Packs,10,1,0.1,9
5282,1366,Kits,13,3,0.23076923076923078,10
5283,1366,Stuff Packs,19,0,0.0,19
5284,1367,Expansion Packs,16,1,0.0625,15
5285,1367,Game Packs,12,0,0.0,12
5286,1367,Kits,33,0,0.0,33
5287,1367,Stuff Packs,20,1,0.05,19
5288,1368,Expansion Packs,15,1,0.06666666666666667,14
5289,1368,Game Packs,12,0,0.0,12
5290,1368,Kits,23,1,0.043478260869565216,22
5291,1368,Stuff Packs,20,1,0.05,19
5292,1369,Expansion Packs,12,0,0.0,12
5293,1369,Game Packs,5,2,0.4,3
5294,1369,Kits,5,2,0.4,3
5295,1369,Stuff Packs,10,4,0.4,6
5296,1370,Expansion Packs,11,0,0.0,11
5297,1370,Game Packs,6,1,0.16666666666666666,5
5298,1370,Kits,3,3,1.0,0
5299,1370,Stuff Packs,6,4,0.6666666666666666,2
5300,1371,Expansion Packs,5,1,0.2,4
5301,1371,Game Packs,1,0,0.0,1
5302,1371,Kits,6,0,0.0,6
5303,1371,Stuff Packs,4,1,0.25,3
5304,1372,Expansion Packs,16,15,0.9375,1
5305,1372,Game Packs,12,12,1.0,0
5306,1372,Kits,33,0,0.0,33
5307,1372,Stuff Packs,20,2,0.1,18
5308,1373,Expansion Packs,11,0,0.0,11
5309,1373,Game Packs,3,0,0.0,3
5310,1373,Kits,4,0,0.0,4
5311,1373,Stuff Packs,2,0,0.0,2
5312,1374,Expansion Packs,8,0,0.0,8
5313,1374,Game Packs,4,0,0.0,4
5314,1374,Kits,1,1,1.0,0
5315,1374,Stuff Packs,6,3,0.5,3
5316,1375,Expansion Packs,16,0,0.0,16
5317,1375,Game Packs,12,0,0.0,12
5318,1375,Kits,33,1,0.030303030303030304,32
5319,1375,Stuff Packs,20,0,0.0,20
5320,1376,Expansion Packs,16,0,0.0,16
5321,1376,Game Packs,11,0,0.0,11
5322,1376,Kits,20,2,0.1,18
5323,1376,Stuff Packs,19,0,0.0,19
5324,1377,Expansion Packs,16,0,0.0,16
5325,1377,Game Packs,12,0,0.0,12
5326,1377,Kits,33,0,0.0,33
5327,1377,Stuff Packs,20,1,0.05,19
5328,1378,Expansion Packs,15,0,0.0,15
5329,1378,Game Packs,11,0,0.0,11
5330,1378,Kits,4,1,0.25,3
5331,1378,Stuff Packs,19,1,0.05263157894736842,18
5332,1379,Expansion Packs,16,1,0.0625,15
5333,1379,Game Packs,12,1,0.08333333333333333,11
5334,1379,Kits,30,5,0.16666666666666666,25
5335,1379,Stuff Packs,20,3,0.15,17
5336,1380,Expansion Packs,16,0,0.0,16
5337,1380,Game Packs,11,0,0.0,11
5338,1380,Kits,33,0,0.0,33
5339,1380,Stuff Packs,20,0,0.0,20
5340,1381,Expansion Packs,14,0,0.0,14
5341,1381,Game Packs,11,0,0.0,11
5342,1381,Kits,31,1,0.03225806451612903,30
5343,1381,Stuff Packs,20,0,0.0,20
5344,1382,Expansion Packs,13,3,0.23076923076923078,10
5345,1382,Game Packs,10,0,0.0,10
5346,1382,Kits,14,12,0.8571428571428571,2
5347,1382,Stuff Packs,18,16,0.8888888888888888,2
5348,1383,Expansion Packs,13,0,0.0,13
5349,1383,Game Packs,9,0,0.0,9
5350,1383,Stuff Packs,5,0,0.0,5
5351,1384,Expansion Packs,12,0,0.0,12
5352,1384,Game Packs,7,0,0.0,7
5353,1384,Stuff Packs,8,0,0.0,8
5354,1385,Expansion Packs,11,0,0.0,11
5355,1385,Game Packs,6,1,0.16666666666666666,5
5356,1385,Kits,4,2,0.5,2
5357,1385,Stuff Packs,9,3,0.3333333333333333,6
5358,1386,Expansion Packs,12,0,0.0,12
5359,1386,Game Packs,11,0,0.0,11
5360,1386,Kits,6,0,0.0,6
5361,1386,Stuff Packs,14,0,0.0,14
5362,1387,Expansion Packs,14,0,0.0,14
5363,1387,Game Packs,9,1,0.1111111111111111,8
5364,1387,Kits,17,2,0.11764705882352941,15
5365,1387,Stuff Packs,20,1,0.05,19
5366,1388,Expansion Packs,10,0,0.0,10
5367,1388,Game Packs,3,0,0.0,3
5368,1388,Kits,2,2,1.0,0
5369,1388,Stuff Packs,5,2,0.4,3
5370,1389,Expansion Packs,15,0,0.0,15
5371,1389,Game Packs,9,0,0.0,9
5372,1389,Kits,5,0,0.0,5
5373,1389,Stuff Packs,17,2,0.11764705882352941,15
5374,1390,Expansion Packs,16,0,0.0,16
5375,1390,Game Packs,12,0,0.0,12
5376,1390,Kits,33,2,0.06060606060606061,31
5377,1390,Stuff Packs,20,1,0.05,19
5378,1391,Expansion Packs,16,0,0.0,16
5379,1391,Game Packs,12,0,0.0,12
5380,1391,Kits,33,1,0.030303030303030304,32
5381,1391,Stuff Packs,20,0,0.0,20
5382,1392,Expansion Packs,12,0,0.0,12
5383,1392,Game Packs,6,0,0.0,6
5384,1392,Kits,4,2,0.5,2
5385,1392,Stuff Packs,7,1,0.14285714285714285,6
5386,1393,Expansion Packs,7,0,0.0,7
5387,1393,Game Packs,3,1,0.3333333333333333,2
5388,1393,Kits,2,2,1.0,0
5389,1393,Stuff Packs,9,4,0.4444444444444444,5
5390,1394,Expansion Packs,12,0,0.0,12
5391,1394,Game Packs,8,1,0.125,7
5392,1394,Kits,10,3,0.3,7
5393,1394,Stuff Packs,8,3,0.375,5
5394,1395,Expansion Packs,12,0,0.0,12
5395,1395,Game Packs,7,0,0.0,7
5396,1395,Kits,10,1,0.1,9
5397,1395,Stuff Packs,14,0,0.0,14
5398,1396,Expansion Packs,4,0,0.0,4
5399,1396,Game Packs,4,1,0.25,3
5400,1396,Kits,8,1,0.125,7
5401,1396,Stuff Packs,5,3,0.6,2
5402,1397,Expansion Packs,1,0,0.0,1
5403,1397,Game Packs,1,0,0.0,1
5404,1398,Expansion Packs,11,0,0.0,11
5405,1398,Game Packs,4,0,0.0,4
5406,1398,Stuff Packs,9,0,0.0,9
5407,1399,Expansion Packs,7,0,0.0,7
5408,1399,Game Packs,5,1,0.2,4
5409,1399,Kits,1,1,1.0,0
5410,1399,Stuff Packs,6,1,0.16666666666666666,5
5411,1400,Expansion Packs,16,0,0.0,16
5412,1400,Game Packs,10,0,0.0,10
5413,1400,Kits,12,1,0.08333333333333333,11
5414,1400,Stuff Packs,13,2,0.15384615384615385,11
5415,1401,Expansion Packs,13,0,0.0,13
5416,1401,Game Packs,8,0,0.0,8
5417,1401,Kits,7,1,0.14285714285714285,6
5418,1401,Stuff Packs,12,0,0.0,12
5419,1402,Expansion Packs,10,0,0.0,10
5420,1402,Game Packs,3,0,0.0,3
5421,1402,Kits,2,2,1.0,0
5422,1402,Stuff Packs,5,2,0.4,3
5423,1403,Expansion Packs,16,0,0.0,16
5424,1403,Game Packs,12,0,0.0,12
5425,1403,Kits,33,0,0.0,33
5426,1403,Stuff Packs,20,0,0.0,20
5427,1404,Expansion Packs,14,0,0.0,14
5428,1404,Game Packs,9,0,0.0,9
5429,1404,Kits,10,1,0.1,9
5430,1404,Stuff Packs,14,2,0.14285714285714285,12
5431,1405,Expansion Packs,16,1,0.0625,15
5432,1405,Game Packs,12,0,0.0,12
5433,1405,Kits,33,4,0.12121212121212122,29
5434,1405,Stuff Packs,20,1,0.05,19
5435,1406,Expansion Packs,14,0,0.0,14
5436,1406,Game Packs,10,0,0.0,10
5437,1406,Kits,7,2,0.2857142857142857,5
5438,1406,Stuff Packs,11,3,0.2727272727272727,8
5439,1407,Expansion Packs,16,0,0.0,16
5440,1407,Game Packs,12,0,0.0,12
5441,1407,Kits,26,1,0.038461538461538464,25
5442,1407,Stuff Packs,20,1,0.05,19
5443,1408,Expansion Packs,13,0,0.0,13
5444,1408,Game Packs,7,0,0.0,7
5445,1408,Stuff Packs,8,0,0.0,8
5446,1409,Expansion Packs,10,0,0.0,10
5447,1409,Game Packs,6,0,0.0,6
5448,1409,Kits,2,0,0.0,2
5449,1409,Stuff Packs,15,1,0.06666666666666667,14
5450,1410,Expansion Packs,10,0,0.0,10
5451,1410,Game Packs,2,0,0.0,2
5452,1410,Kits,1,1,1.0,0
5453,1410,Stuff Packs,6,3,0.5,3
5454,1411,Expansion Packs,3,0,0.0,3
5455,1411,Game Packs,1,0,0.0,1
5456,1411,Kits,1,1,1.0,0
5457,1411,Stuff Packs,8,4,0.5,4
5458,1412,Expansion Packs,15,0,0.0,15
5459,1412,Game Packs,10,0,0.0,10
5460,1412,Kits,8,3,0.375,5
5461,1412,Stuff Packs,18,0,0.0,18
5462,1413,Expansion Packs,10,0,0.0,10
5463,1413,Game Packs,5,0,0.0,5
5464,1413,Kits,1,1,1.0,0
5465,1413,Stuff Packs,6,0,0.0,6
5466,1414,Expansion Packs,4,0,0.0,4
5467,1414,Game Packs,4,0,0.0,4
5468,1414,Kits,4,1,0.25,3
5469,1414,Stuff Packs,3,2,0.6666666666666666,1
5470,1415,Expansion Packs,16,0,0.0,16
5471,1415,Game Packs,10,0,0.0,10
5472,1415,Kits,30,1,0.03333333333333333,29
5473,1415,Stuff Packs,20,0,0.0,20
5474,1416,Expansion Packs,11,0,0.0,11
5475,1416,Game Packs,10,0,0.0,10
5476,1416,Kits,3,0,0.0,3
5477,1416,Stuff Packs,17,0,0.0,17
5478,1417,Expansion Packs,11,0,0.0,11
5479,1417,Game Packs,8,0,0.0,8
5480,1417,Kits,16,4,0.25,12
5481,1417,Stuff Packs,11,4,0.36363636363636365,7
5482,1418,Expansion Packs,10,0,0.0,10
5483,1418,Game Packs,6,0,0.0,6
5484,1418,Kits,3,2,0.6666666666666666,1
5485,1418,Stuff Packs,9,1,0.1111111111111111,8
5486,1419,Expansion Packs,8,0,0.0,8
5487,1419,Game Packs,4,0,0.0,4
5488,1419,Kits,2,0,0.0,2
5489,1419,Stuff Packs,6,3,0.5,3
5490,1420,Expansion Packs,12,0,0.0,12
5491,1420,Game Packs,6,0,0.0,6
5492,1420,Kits,8,0,0.0,8
5493,1420,Stuff Packs,15,3,0.2,12
5494,1421,Expansion Packs,14,0,0.0,14
5495,1421,Game Packs,11,1,0.09090909090909091,10
5496,1421,Kits,3,1,0.3333333333333333,2
5497,1421,Stuff Packs,18,0,0.0,18
5498,1422,Expansion Packs,16,0,0.0,16
5499,1422,Game Packs,11,1,0.09090909090909091,10
5500,1422,Kits,25,1,0.04,24
5501,1422,Stuff Packs,20,1,0.05,19
5502,1423,Expansion Packs,16,10,0.625,6
5503,1423,Game Packs,11,6,0.5454545454545454,5
5504,1423,Kits,33,24,0.7272727272727273,9
5505,1423,Stuff Packs,19,11,0.5789473684210527,8
5506,1424,Expansion Packs,11,0,0.0,11
5507,1424,Game Packs,9,0,0.0,9
5508,1424,Kits,2,0,0.0,2
5509,1424,Stuff Packs,10,0,0.0,10
5510,1425,Expansion Packs,15,1,0.06666666666666667,14
5511,1425,Game Packs,10,0,0.0,10
5512,1425,Kits,15,1,0.06666666666666667,14
5513,1425,Stuff Packs,18,1,0.05555555555555555,17
5514,1426,Expansion Packs,16,1,0.0625,15
5515,1426,Game Packs,12,0,0.0,12
5516,1426,Kits,33,1,0.030303030303030304,32
5517,1426,Stuff Packs,20,0,0.0,20
5518,1427,Expansion Packs,13,0,0.0,13
5519,1427,Game Packs,5,1,0.2,4
5520,1427,Kits,7,3,0.42857142857142855,4
5521,1427,Stuff Packs,10,3,0.3,7
5522,1428,Expansion Packs,15,0,0.0,15
5523,1428,Game Packs,11,0,0.0,11
5524,1428,Kits,3,2,0.6666666666666666,1
5525,1428,Stuff Packs,20,0,0.0,20
5526,1429,Expansion Packs,10,0,0.0,10
5527,1429,Game Packs,6,0,0.0,6
5528,1429,Kits,1,1,1.0,0
5529,1429,Stuff Packs,5,1,0.2,4
5530,1430,Expansion Packs,15,0,0.0,15
5531,1430,Game Packs,11,0,0.0,11
5532,1430,Kits,21,1,0.047619047619047616,20
5533,1430,Stuff Packs,19,0,0.0,19
5534,1431,Expansion Packs,16,0,0.0,16
5535,1431,Game Packs,11,0,0.0,11
5536,1431,Kits,14,1,0.07142857142857142,13
5537,1431,Stuff Packs,15,2,0.13333333333333333,13
5538,1432,Expansion Packs,7,0,0.0,7
5539,1432,Game Packs,4,1,0.25,3
5540,1432,Kits,3,3,1.0,0
5541,1432,Stuff Packs,6,3,0.5,3
5542,1433,Expansion Packs,15,0,0.0,15
5543,1433,Game Packs,8,1,0.125,7
5544,1433,Kits,3,3,1.0,0
5545,1433,Stuff Packs,12,3,0.25,9
5546,1434,Expansion Packs,4,2,0.5,2
5547,1434,Game Packs,1,0,0.0,1
5548,1434,Kits,4,2,0.5,2
5549,1434,Stuff Packs,5,3,0.6,2
5550,1435,Expansion Packs,16,0,0.0,16
5551,1435,Game Packs,12,0,0.0,12
5552,1435,Kits,33,0,0.0,33
5553,1435,Stuff Packs,20,0,0.0,20
5554,1436,Expansion Packs,15,0,0.0,15
5555,1436,Game Packs,10,0,0.0,10
5556,1436,Kits,16,2,0.125,14
5557,1436,Stuff Packs,17,0,0.0,17
5558,1437,Expansion Packs,2,0,0.0,2
5559,1437,Game Packs,1,0,0.0,1
5560,1437,Kits,3,1,0.3333333333333333,2
5561,1437,Stuff Packs,3,0,0.0,3
5562,1438,Expansion Packs,15,0,0.0,15
5563,1438,Game Packs,12,0,0.0,12
5564,1438,Kits,12,0,0.0,12
5565,1438,Stuff Packs,20,0,0.0,20
5566,1439,Expansion Packs,2,0,0.0,2
5567,1439,Kits,2,2,1.0,0
5568,1439,Stuff Packs,1,1,1.0,0
5569,1440,Expansion Packs,9,0,0.0,9
5570,1440,Game Packs,3,0,0.0,3
5571,1440,Kits,1,0,0.0,1
5572,1440,Stuff Packs,3,0,0.0,3
5573,1441,Expansion Packs,9,0,0.0,9
5574,1441,Game Packs,4,0,0.0,4
5575,1441,Kits,1,1,1.0,0
5576,1441,Stuff Packs,11,2,0.18181818181818182,9
5577,1442,Expansion Packs,15,0,0.0,15
5578,1442,Game Packs,10,0,0.0,10
5579,1442,Kits,19,2,0.10526315789473684,17
5580,1442,Stuff Packs,11,0,0.0,11
5581,1443,Expansion Packs,15,10,0.6666666666666666,5
5582,1443,Game Packs,9,4,0.4444444444444444,5
5583,1443,Kits,17,11,0.6470588235294118,6
5584,1443,Stuff Packs,14,8,0.5714285714285714,6
5585,1444,Expansion Packs,16,1,0.0625,15
5586,1444,Game Packs,12,0,0.0,12
5587,1444,Kits,32,0,0.0,32
5588,1444,Stuff Packs,20,0,0.0,20
5589,1445,Expansion Packs,6,0,0.0,6
5590,1445,Game Packs,4,0,0.0,4
5591,1445,Stuff Packs,5,3,0.6,2
5592,1446,Expansion Packs,16,0,0.0,16
5593,1446,Game Packs,12,0,0.0,12
5594,1446,Kits,21,2,0.09523809523809523,19
5595,1446,Stuff Packs,17,3,0.17647058823529413,14
5596,1447,Expansion Packs,11,0,0.0,11
5597,1447,Game Packs,2,0,0.0,2
5598,1447,Kits,2,2,1.0,0
5599,1447,Stuff Packs,7,2,0.2857142857142857,5
5600,1448,Expansion Packs,13,0,0.0,13
5601,1448,Game Packs,9,1,0.1111111111111111,8
5602,1448,Kits,3,1,0.3333333333333333,2
5603,1448,Stuff Packs,10,1,0.1,9
5604,1449,Expansion Packs,16,0,0.0,16
5605,1449,Game Packs,12,0,0.0,12
5606,1449,Kits,18,0,0.0,18
5607,1449,Stuff Packs,20,0,0.0,20
5608,1450,Expansion Packs,9,0,0.0,9
5609,1450,Game Packs,6,0,0.0,6
5610,1450,Kits,2,0,0.0,2
5611,1450,Stuff Packs,7,0,0.0,7
5612,1451,Expansion Packs,10,0,0.0,10
5613,1451,Game Packs,5,0,0.0,5
5614,1451,Kits,2,0,0.0,2
5615,1451,Stuff Packs,13,1,0.07692307692307693,12
5616,1452,Expansion Packs,7,0,0.0,7
5617,1452,Game Packs,5,0,0.0,5
5618,1452,Kits,2,2,1.0,0
5619,1452,Stuff Packs,8,0,0.0,8
5620,1453,Expansion Packs,9,0,0.0,9
5621,1453,Game Packs,9,0,0.0,9
5622,1453,Kits,2,0,0.0,2
5623,1453,Stuff Packs,10,5,0.5,5
5624,1454,Expansion Packs,10,0,0.0,10
5625,1454,Game Packs,7,0,0.0,7
5626,1454,Kits,4,3,0.75,1
5627,1454,Stuff Packs,14,1,0.07142857142857142,13
5628,1455,Expansion Packs,16,0,0.0,16
5629,1455,Game Packs,12,0,0.0,12
5630,1455,Kits,16,1,0.0625,15
5631,1455,Stuff Packs,20,1,0.05,19
5632,1456,Expansion Packs,14,0,0.0,14
5633,1456,Game Packs,12,0,0.0,12
5634,1456,Kits,2,2,1.0,0
5635,1456,Stuff Packs,17,0,0.0,17
5636,1457,Expansion Packs,13,0,0.0,13
5637,1457,Game Packs,10,0,0.0,10
5638,1457,Kits,4,1,0.25,3
5639,1457,Stuff Packs,13,2,0.15384615384615385,11
5640,1458,Expansion Packs,11,0,0.0,11
5641,1458,Game Packs,3,0,0.0,3
5642,1458,Kits,5,1,0.2,4
5643,1458,Stuff Packs,17,1,0.058823529411764705,16
5644,1459,Expansion Packs,16,0,0.0,16
5645,1459,Game Packs,8,0,0.0,8
5646,1459,Kits,10,1,0.1,9
5647,1459,Stuff Packs,14,0,0.0,14
5648,1460,Expansion Packs,2,0,0.0,2
5649,1460,Game Packs,5,0,0.0,5
5650,1460,Kits,1,1,1.0,0
5651,1460,Stuff Packs,6,3,0.5,3
5652,1461,Expansion Packs,2,0,0.0,2
5653,1461,Game Packs,2,0,0.0,2
5654,1461,Kits,4,0,0.0,4
5655,1461,Stuff Packs,2,0,0.0,2
5656,1462,Expansion Packs,16,0,0.0,16
5657,1462,Game Packs,12,0,0.0,12
5658,1462,Kits,33,0,0.0,33
5659,1462,Stuff Packs,20,0,0.0,20
5660,1463,Expansion Packs,8,0,0.0,8
5661,1463,Game Packs,2,0,0.0,2
5662,1463,Kits,2,1,0.5,1
5663,1463,Stuff Packs,4,1,0.25,3
5664,1464,Expansion Packs,16,0,0.0,16
5665,1464,Game Packs,7,0,0.0,7
5666,1464,Stuff Packs,7,3,0.42857142857142855,4
5667,1465,Expansion Packs,15,0,0.0,15
5668,1465,Game Packs,8,0,0.0,8
5669,1465,Kits,3,3,1.0,0
5670,1465,Stuff Packs,12,4,0.3333333333333333,8
5671,1466,Expansion Packs,2,0,0.0,2
5672,1466,Game Packs,1,0,0.0,1
5673,1466,Kits,1,1,1.0,0
5674,1466,Stuff Packs,1,0,0.0,1
5675,1467,Expansion Packs,15,0,0.0,15
5676,1467,Game Packs,10,0,0.0,10
5677,1467,Kits,5,2,0.4,3
5678,1467,Stuff Packs,9,2,0.2222222222222222,7
5679,1468,Expansion Packs,7,0,0.0,7
5680,1468,Game Packs,3,0,0.0,3
5681,1468,Kits,6,3,0.5,3
5682,1468,Stuff Packs,6,3,0.5,3
5683,1469,Expansion Packs,16,0,0.0,16
5684,1469,Game Packs,11,0,0.0,11
5685,1469,Kits,27,0,0.0,27
5686,1469,Stuff Packs,18,0,0.0,18
5687,1470,Expansion Packs,11,0,0.0,11
5688,1470,Game Packs,9,0,0.0,9
5689,1470,Kits,2,2,1.0,0
5690,1470,Stuff Packs,11,4,0.36363636363636365,7
5691,1471,Expansion Packs,16,0,0.0,16
5692,1471,Game Packs,12,0,0.0,12
5693,1471,Kits,28,0,0.0,28
5694,1471,Stuff Packs,20,0,0.0,20
5695,1472,Expansion Packs,15,0,0.0,15
5696,1472,Game Packs,8,0,0.0,8
5697,1472,Kits,4,1,0.25,3
5698,1472,Stuff Packs,6,0,0.0,6
5699,1473,Expansion Packs,16,0,0.0,16
5700,1473,Game Packs,12,0,0.0,12
5701,1473,Kits,21,1,0.047619047619047616,20
5702,1473,Stuff Packs,20,0,0.0,20
5703,1474,Expansion Packs,14,0,0.0,14
5704,1474,Game Packs,12,0,0.0,12
5705,1474,Kits,21,0,0.0,21
5706,1474,Stuff Packs,20,0,0.0,20
5707,1475,Expansion Packs,4,0,0.0,4
5708,1475,Game Packs,1,1,1.0,0
5709,1475,Kits,2,2,1.0,0
5710,1475,Stuff Packs,1,1,1.0,0
5711,1476,Expansion Packs,16,0,0.0,16
5712,1476,Game Packs,7,0,0.0,7
5713,1476,Kits,3,1,0.3333333333333333,2
5714,1476,Stuff Packs,9,0,0.0,9
5715,1477,Expansion Packs,8,0,0.0,8
5716,1477,Game Packs,2,0,0.0,2
5717,1477,Kits,1,0,0.0,1
5718,1477,Stuff Packs,1,0,0.0,1
5719,1478,Expansion Packs,16,0,0.0,16
5720,1478,Game Packs,11,0,0.0,11
5721,1478,Kits,32,1,0.03125,31
5722,1478,Stuff Packs,19,2,0.10526315789473684,17
5723,1479,Expansion Packs,1,0,0.0,1
5724,1479,Kits,1,1,1.0,0
5725,1479,Stuff Packs,3,3,1.0,0
5726,1480,Expansion Packs,16,0,0.0,16
5727,1480,Game Packs,11,0,0.0,11
5728,1480,Kits,10,1,0.1,9
5729,1480,Stuff Packs,20,0,0.0,20
5730,1481,Expansion Packs,16,0,0.0,16
5731,1481,Game Packs,10,0,0.0,10
5732,1481,Kits,17,0,0.0,17
5733,1481,Stuff Packs,17,0,0.0,17
5734,1482,Expansion Packs,7,0,0.0,7
5735,1482,Game Packs,3,0,0.0,3
5736,1482,Kits,2,0,0.0,2
5737,1482,Stuff Packs,6,3,0.5,3
5738,1483,Expansion Packs,15,0,0.0,15
5739,1483,Game Packs,11,0,0.0,11
5740,1483,Kits,21,0,0.0,21
5741,1483,Stuff Packs,20,0,0.0,20
5742,1484,Expansion Packs,14,0,0.0,14
5743,1484,Game Packs,11,0,0.0,11
5744,1484,Kits,8,0,0.0,8
5745,1484,Stuff Packs,17,1,0.058823529411764705,16
5746,1485,Expansion Packs,14,0,0.0,14
5747,1485,Game Packs,10,0,0.0,10
5748,1485,Kits,5,1,0.2,4
5749,1485,Stuff Packs,10,1,0.1,9
5750,1486,Expansion Packs,11,0,0.0,11
5751,1486,Game Packs,6,1,0.16666666666666666,5
5752,1486,Kits,4,2,0.5,2
5753,1486,Stuff Packs,7,4,0.5714285714285714,3
5754,1487,Expansion Packs,16,0,0.0,16
5755,1487,Game Packs,12,0,0.0,12
5756,1487,Kits,33,0,0.0,33
5757,1487,Stuff Packs,20,0,0.0,20
5758,1488,Expansion Packs,16,1,0.0625,15
5759,1488,Game Packs,7,0,0.0,7
5760,1488,Kits,19,1,0.05263157894736842,18
5761,1488,Stuff Packs,18,1,0.05555555555555555,17
5762,1489,Expansion Packs,1,0,0.0,1
5763,1489,Game Packs,1,1,1.0,0
5764,1489,Kits,2,2,1.0,0
5765,1489,Stuff Packs,4,4,1.0,0
5766,1490,Expansion Packs,16,0,0.0,16
5767,1490,Game Packs,12,2,0.16666666666666666,10
5768,1490,Kits,28,0,0.0,28
5769,1490,Stuff Packs,20,1,0.05,19
5770,1491,Expansion Packs,15,0,0.0,15
5771,1491,Game Packs,8,0,0.0,8
5772,1491,Kits,8,1,0.125,7
5773,1491,Stuff Packs,16,3,0.1875,13
5774,1492,Expansion Packs,12,0,0.0,12
5775,1492,Game Packs,9,0,0.0,9
5776,1492,Stuff Packs,16,0,0.0,16
5777,1493,Expansion Packs,7,0,0.0,7
5778,1493,Game Packs,6,1,0.16666666666666666,5
5779,1493,Kits,6,2,0.3333333333333333,4
5780,1493,Stuff Packs,6,3,0.5,3
5781,1494,Expansion Packs,16,0,0.0,16
5782,1494,Game Packs,12,0,0.0,12
5783,1494,Kits,33,0,0.0,33
5784,1494,Stuff Packs,20,0,0.0,20
5785,1495,Expansion Packs,7,0,0.0,7
5786,1495,Game Packs,6,0,0.0,6
5787,1495,Kits,1,1,1.0,0
5788,1495,Stuff Packs,9,1,0.1111111111111111,8
5789,1496,Expansion Packs,2,0,0.0,2
5790,1496,Game Packs,1,0,0.0,1
5791,1496,Kits,4,0,0.0,4
5792,1496,Stuff Packs,4,2,0.5,2
5793,1497,Expansion Packs,16,0,0.0,16
5794,1497,Game Packs,10,0,0.0,10
5795,1497,Kits,24,0,0.0,24
5796,1497,Stuff Packs,20,0,0.0,20
5797,1498,Expansion Packs,12,0,0.0,12
5798,1498,Game Packs,5,0,0.0,5
5799,1498,Kits,8,1,0.125,7
5800,1498,Stuff Packs,9,2,0.2222222222222222,7
5801,1499,Expansion Packs,10,0,0.0,10
5802,1499,Game Packs,7,0,0.0,7
5803,1499,Kits,15,0,0.0,15
5804,1499,Stuff Packs,11,1,0.09090909090909091,10
5805,1500,Expansion Packs,16,0,0.0,16
5806,1500,Game Packs,11,0,0.0,11
5807,1500,Kits,16,1,0.0625,15
5808,1500,Stuff Packs,17,1,0.058823529411764705,16
5809,1501,Expansion Packs,15,0,0.0,15
5810,1501,Game Packs,11,0,0.0,11
5811,1501,Kits,22,1,0.045454545454545456,21
5812,1501,Stuff Packs,19,2,0.10526315789473684,17
5813,1502,Expansion Packs,14,0,0.0,14
5814,1502,Game Packs,8,0,0.0,8
5815,1502,Kits,11,1,0.09090909090909091,10
5816,1502,Stuff Packs,11,1,0.09090909090909091,10
5817,1503,Expansion Packs,15,0,0.0,15
5818,1503,Game Packs,10,0,0.0,10
5819,1503,Kits,19,2,0.10526315789473684,17
5820,1503,Stuff Packs,14,0,0.0,14
5821,1504,Expansion Packs,13,0,0.0,13
5822,1504,Game Packs,5,0,0.0,5
5823,1504,Kits,1,1,1.0,0
5824,1504,Stuff Packs,4,2,0.5,2
5825,1505,Expansion Packs,16,0,0.0,16
5826,1505,Game Packs,12,0,0.0,12
5827,1505,Kits,29,3,0.10344827586206896,26
5828,1505,Stuff Packs,20,0,0.0,20
5829,1506,Expansion Packs,5,0,0.0,5
5830,1506,Game Packs,4,1,0.25,3
5831,1506,Kits,3,3,1.0,0
5832,1506,Stuff Packs,5,4,0.8,1
5833,1507,Expansion Packs,9,0,0.0,9
5834,1507,Game Packs,3,0,0.0,3
5835,1507,Kits,3,1,0.3333333333333333,2
5836,1507,Stuff Packs,4,0,0.0,4
5837,1508,Expansion Packs,3,0,0.0,3
5838,1508,Game Packs,1,1,1.0,0
5839,1508,Kits,2,2,1.0,0
5840,1508,Stuff Packs,4,4,1.0,0
5841,1509,Expansion Packs,16,0,0.0,16
5842,1509,Game Packs,12,0,0.0,12
5843,1509,Kits,20,0,0.0,20
5844,1509,Stuff Packs,20,3,0.15,17
5845,1510,Expansion Packs,11,0,0.0,11
5846,1510,Game Packs,6,0,0.0,6
5847,1510,Stuff Packs,8,1,0.125,7
5848,1511,Expansion Packs,11,0,0.0,11
5849,1511,Game Packs,8,0,0.0,8
5850,1511,Kits,4,0,0.0,4
5851,1511,Stuff Packs,19,0,0.0,19
5852,1512,Expansion Packs,15,0,0.0,15
5853,1512,Game Packs,12,0,0.0,12
5854,1512,Kits,11,0,0.0,11
5855,1512,Stuff Packs,19,1,0.05263157894736842,18
5856,1513,Expansion Packs,11,0,0.0,11
5857,1513,Game Packs,3,0,0.0,3
5858,1513,Kits,11,0,0.0,11
5859,1513,Stuff Packs,8,3,0.375,5
5860,1514,Expansion Packs,8,0,0.0,8
5861,1514,Game Packs,3,0,0.0,3
5862,1514,Kits,4,0,0.0,4
5863,1514,Stuff Packs,6,0,0.0,6
5864,1515,Expansion Packs,15,4,0.26666666666666666,11
5865,1515,Game Packs,12,4,0.3333333333333333,8
5866,1515,Kits,30,14,0.4666666666666667,16
5867,1515,Stuff Packs,20,15,0.75,5
5868,1516,Expansion Packs,1,0,0.0,1
5869,1516,Kits,1,1,1.0,0
5870,1516,Stuff Packs,3,3,1.0,0
5871,1517,Expansion Packs,16,0,0.0,16
5872,1517,Game Packs,12,0,0.0,12
5873,1517,Kits,33,0,0.0,33
5874,1517,Stuff Packs,20,0,0.0,20
5875,1518,Expansion Packs,11,0,0.0,11
5876,1518,Game Packs,6,1,0.16666666666666666,5
5877,1518,Kits,9,2,0.2222222222222222,7
5878,1518,Stuff Packs,11,4,0.36363636363636365,7
5879,1519,Expansion Packs,16,8,0.5,8
5880,1519,Game Packs,12,9,0.75,3
5881,1519,Kits,33,2,0.06060606060606061,31
5882,1519,Stuff Packs,20,10,0.5,10
5883,1520,Expansion Packs,11,0,0.0,11
5884,1520,Game Packs,7,0,0.0,7
5885,1520,Kits,7,2,0.2857142857142857,5
5886,1520,Stuff Packs,11,3,0.2727272727272727,8
5887,1521,Expansion Packs,11,0,0.0,11
5888,1521,Game Packs,3,0,0.0,3
5889,1521,Stuff Packs,4,1,0.25,3
5890,1522,Expansion Packs,13,5,0.38461538461538464,8
5891,1522,Game Packs,10,8,0.8,2
5892,1522,Kits,8,2,0.25,6
5893,1522,Stuff Packs,12,4,0.3333333333333333,8
5894,1523,Expansion Packs,14,0,0.0,14
5895,1523,Game Packs,9,0,0.0,9
5896,1523,Kits,3,1,0.3333333333333333,2
5897,1523,Stuff Packs,16,0,0.0,16
5898,1524,Expansion Packs,3,0,0.0,3
5899,1524,Game Packs,2,1,0.5,1
5900,1524,Kits,3,3,1.0,0
5901,1524,Stuff Packs,4,4,1.0,0
5902,1525,Expansion Packs,16,0,0.0,16
5903,1525,Game Packs,11,0,0.0,11
5904,1525,Kits,24,1,0.041666666666666664,23
5905,1525,Stuff Packs,18,0,0.0,18
5906,1526,Expansion Packs,16,0,0.0,16
5907,1526,Game Packs,11,0,0.0,11
5908,1526,Kits,31,2,0.06451612903225806,29
5909,1526,Stuff Packs,20,0,0.0,20
5910,1527,Expansion Packs,16,0,0.0,16
5911,1527,Game Packs,11,0,0.0,11
5912,1527,Kits,26,1,0.038461538461538464,25
5913,1527,Stuff Packs,19,0,0.0,19
5914,1528,Expansion Packs,16,0,0.0,16
5915,1528,Game Packs,11,0,0.0,11
5916,1528,Kits,21,0,0.0,21
5917,1528,Stuff Packs,20,0,0.0,20
5918,1529,Expansion Packs,9,1,0.1111111111111111,8
5919,1529,Game Packs,6,1,0.16666666666666666,5
5920,1529,Kits,12,0,0.0,12
5921,1529,Stuff Packs,7,1,0.14285714285714285,6
5922,1530,Expansion Packs,16,0,0.0,16
5923,1530,Game Packs,11,0,0.0,11
5924,1530,Kits,14,1,0.07142857142857142,13
5925,1530,Stuff Packs,11,0,0.0,11
5926,1531,Expansion Packs,12,0,0.0,12
5927,1531,Game Packs,2,0,0.0,2
5928,1531,Kits,2,2,1.0,0
5929,1531,Stuff Packs,5,0,0.0,5
5930,1532,Expansion Packs,5,0,0.0,5
5931,1532,Kits,4,0,0.0,4
5932,1532,Stuff Packs,6,0,0.0,6
5933,1533,Expansion Packs,10,0,0.0,10
5934,1533,Game Packs,6,0,0.0,6
5935,1533,Kits,5,1,0.2,4
5936,1533,Stuff Packs,8,2,0.25,6
5937,1534,Expansion Packs,16,0,0.0,16
5938,1534,Game Packs,11,0,0.0,11
5939,1534,Kits,31,1,0.03225806451612903,30
5940,1534,Stuff Packs,19,1,0.05263157894736842,18
5941,1535,Expansion Packs,13,0,0.0,13
5942,1535,Game Packs,10,0,0.0,10
5943,1535,Kits,2,1,0.5,1
5944,1535,Stuff Packs,13,2,0.15384615384615385,11
5945,1536,Expansion Packs,14,0,0.0,14
5946,1536,Game Packs,11,0,0.0,11
5947,1536,Kits,3,1,0.3333333333333333,2
5948,1536,Stuff Packs,12,0,0.0,12
5949,1537,Expansion Packs,13,5,0.38461538461538464,8
5950,1537,Game Packs,10,3,0.3,7
5951,1537,Kits,9,1,0.1111111111111111,8
5952,1537,Stuff Packs,14,4,0.2857142857142857,10
5953,1538,Expansion Packs,5,0,0.0,5
5954,1538,Game Packs,4,0,0.0,4
5955,1538,Kits,2,2,1.0,0
5956,1538,Stuff Packs,6,0,0.0,6
5957,1539,Expansion Packs,15,0,0.0,15
5958,1539,Game Packs,12,0,0.0,12
5959,1539,Kits,15,0,0.0,15
5960,1539,Stuff Packs,16,2,0.125,14
5961,1540,Expansion Packs,14,0,0.0,14
5962,1540,Game Packs,11,0,0.0,11
5963,1540,Kits,5,1,0.2,4
5964,1540,Stuff Packs,15,0,0.0,15
5965,1541,Expansion Packs,16,0,0.0,16
5966,1541,Game Packs,12,0,0.0,12
5967,1541,Kits,33,0,0.0,33
5968,1541,Stuff Packs,20,0,0.0,20
5969,1542,Expansion Packs,14,0,0.0,14
5970,1542,Game Packs,10,0,0.0,10
5971,1542,Kits,7,1,0.14285714285714285,6
5972,1542,Stuff Packs,17,1,0.058823529411764705,16
5973,1543,Expansion Packs,5,0,0.0,5
5974,1543,Kits,2,2,1.0,0
5975,1543,Stuff Packs,4,2,0.5,2
5976,1544,Expansion Packs,16,0,0.0,16
5977,1544,Game Packs,8,0,0.0,8
5978,1544,Kits,6,0,0.0,6
5979,1544,Stuff Packs,13,0,0.0,13
5980,1545,Expansion Packs,5,0,0.0,5
5981,1545,Game Packs,1,0,0.0,1
5982,1545,Kits,3,0,0.0,3
5983,1545,Stuff Packs,2,1,0.5,1
5984,1546,Expansion Packs,10,0,0.0,10
5985,1546,Game Packs,8,0,0.0,8
5986,1546,Stuff Packs,9,1,0.1111111111111111,8
5987,1547,Expansion Packs,14,0,0.0,14
5988,1547,Game Packs,9,1,0.1111111111111111,8
5989,1547,Stuff Packs,7,1,0.14285714285714285,6
5990,1548,Expansion Packs,16,0,0.0,16
5991,1548,Game Packs,12,0,0.0,12
5992,1548,Kits,32,1,0.03125,31
5993,1548,Stuff Packs,20,0,0.0,20
5994,1549,Expansion Packs,16,0,0.0,16
5995,1549,Game Packs,12,0,0.0,12
5996,1549,Kits,9,2,0.2222222222222222,7
5997,1549,Stuff Packs,19,0,0.0,19
5998,1550,Expansion Packs,16,0,0.0,16
5999,1550,Game Packs,12,0,0.0,12
6000,1550,Kits,33,2,0.06060606060606061,31
6001,1550,Stuff Packs,20,0,0.0,20
6002,1551,Expansion Packs,16,0,0.0,16
6003,1551,Game Packs,12,0,0.0,12
6004,1551,Kits,33,0,0.0,33
6005,1551,Stuff Packs,20,0,0.0,20
6006,1552,Expansion Packs,7,0,0.0,7
6007,1552,Game Packs,3,0,0.0,3
6008,1552,Stuff Packs,6,0,0.0,6
6009,1553,Expansion Packs,8,0,0.0,8
6010,1553,Game Packs,5,1,0.2,4
6011,1553,Kits,2,2,1.0,0
6012,1553,Stuff Packs,6,3,0.5,3
6013,1554,Expansion Packs,16,0,0.0,16
6014,1554,Game Packs,11,0,0.0,11
6015,1554,Kits,12,0,0.0,12
6016,1554,Stuff Packs,20,0,0.0,20
6017,1555,Expansion Packs,11,0,0.0,11
6018,1555,Game Packs,6,1,0.16666666666666666,5
6019,1555,Kits,3,2,0.6666666666666666,1
6020,1555,Stuff Packs,7,4,0.5714285714285714,3
6021,1556,Expansion Packs,3,0,0.0,3
6022,1556,Game Packs,2,1,0.5,1
6023,1556,Kits,2,2,1.0,0
6024,1556,Stuff Packs,3,1,0.3333333333333333,2
6025,1557,Expansion Packs,12,0,0.0,12
6026,1557,Game Packs,8,0,0.0,8
6027,1557,Kits,5,1,0.2,4
6028,1557,Stuff Packs,11,3,0.2727272727272727,8
6029,1558,Expansion Packs,11,0,0.0,11
6030,1558,Game Packs,7,0,0.0,7
6031,1558,Kits,5,0,0.0,5
6032,1558,Stuff Packs,14,0,0.0,14
6033,1559,Expansion Packs,3,0,0.0,3
6034,1559,Stuff Packs,1,1,1.0,0
6035,1560,Expansion Packs,9,0,0.0,9
6036,1560,Game Packs,6,2,0.3333333333333333,4
6037,1560,Kits,3,1,0.3333333333333333,2
6038,1560,Stuff Packs,8,2,0.25,6
6039,1561,Expansion Packs,11,1,0.09090909090909091,10
6040,1561,Game Packs,5,0,0.0,5
6041,1561,Kits,11,10,0.9090909090909091,1
6042,1561,Stuff Packs,11,4,0.36363636363636365,7
6043,1562,Expansion Packs,7,0,0.0,7
6044,1562,Game Packs,4,0,0.0,4
6045,1562,Kits,1,1,1.0,0
6046,1562,Stuff Packs,8,2,0.25,6
6047,1563,Expansion Packs,2,0,0.0,2
6048,1563,Game Packs,4,0,0.0,4
6049,1563,Kits,2,1,0.5,1
6050,1563,Stuff Packs,1,1,1.0,0
6051,1564,Expansion Packs,13,0,0.0,13
6052,1564,Game Packs,5,0,0.0,5
6053,1564,Kits,4,3,0.75,1
6054,1564,Stuff Packs,6,3,0.5,3
6055,1565,Expansion Packs,6,5,0.8333333333333334,1
6056,1565,Game Packs,4,2,0.5,2
6057,1565,Kits,9,0,0.0,9
6058,1565,Stuff Packs,5,3,0.6,2
6059,1566,Expansion Packs,16,0,0.0,16
6060,1566,Game Packs,12,1,0.08333333333333333,11
6061,1566,Kits,33,1,0.030303030303030304,32
6062,1566,Stuff Packs,20,0,0.0,20
6063,1567,Expansion Packs,7,0,0.0,7
6064,1567,Game Packs,3,1,0.3333333333333333,2
6065,1567,Kits,4,0,0.0,4
6066,1567,Stuff Packs,8,4,0.5,4
6067,1568,Expansion Packs,16,0,0.0,16
6068,1568,Game Packs,12,1,0.08333333333333333,11
6069,1568,Kits,33,1,0.030303030303030304,32
6070,1568,Stuff Packs,20,0,0.0,20
6071,1569,Expansion Packs,9,0,0.0,9
6072,1569,Game Packs,4,0,0.0,4
6073,1569,Kits,2,1,0.5,1
6074,1569,Stuff Packs,7,3,0.42857142857142855,4
6075,1570,Expansion Packs,16,1,0.0625,15
6076,1570,Game Packs,10,1,0.1,9
6077,1570,Kits,6,1,0.16666666666666666,5
6078,1570,Stuff Packs,16,1,0.0625,15
6079,1571,Expansion Packs,13,0,0.0,13
6080,1571,Game Packs,11,0,0.0,11
6081,1571,Kits,5,1,0.2,4
6082,1571,Stuff Packs,16,2,0.125,14
6083,1572,Expansion Packs,16,0,0.0,16
6084,1572,Game Packs,9,1,0.1111111111111111,8
6085,1572,Kits,15,2,0.13333333333333333,13
6086,1572,Stuff Packs,14,1,0.07142857142857142,13
6087,1573,Expansion Packs,15,0,0.0,15
6088,1573,Game Packs,10,0,0.0,10
6089,1573,Kits,14,2,0.14285714285714285,12
6090,1573,Stuff Packs,16,1,0.0625,15
6091,1574,Expansion Packs,12,0,0.0,12
6092,1574,Game Packs,8,0,0.0,8
6093,1574,Kits,4,2,0.5,2
6094,1574,Stuff Packs,10,2,0.2,8
6095,1575,Expansion Packs,4,0,0.0,4
6096,1575,Game Packs,2,0,0.0,2
6097,1575,Stuff Packs,3,0,0.0,3
6098,1576,Expansion Packs,4,0,0.0,4
6099,1576,Game Packs,3,0,0.0,3
6100,1576,Kits,2,1,0.5,1
6101,1576,Stuff Packs,5,3,0.6,2
6102,1577,Expansion Packs,12,0,0.0,12
6103,1577,Game Packs,4,0,0.0,4
6104,1577,Kits,2,2,1.0,0
6105,1577,Stuff Packs,8,3,0.375,5
6106,1578,Kits,1,1,1.0,0
6107,1579,Expansion Packs,5,0,0.0,5
6108,1579,Stuff Packs,2,1,0.5,1
6109,1580,Expansion Packs,16,0,0.0,16
6110,1580,Game Packs,11,0,0.0,11
6111,1580,Kits,8,2,0.25,6
6112,1580,Stuff Packs,20,1,0.05,19
6113,1581,Expansion Packs,11,0,0.0,11
6114,1581,Game Packs,5,0,0.0,5
6115,1581,Kits,2,0,0.0,2
6116,1581,Stuff Packs,7,1,0.14285714285714285,6
6117,1582,Expansion Packs,15,0,0.0,15
6118,1582,Game Packs,12,0,0.0,12
6119,1582,Kits,13,1,0.07692307692307693,12
6120,1582,Stuff Packs,20,0,0.0,20
6121,1583,Expansion Packs,14,0,0.0,14
6122,1583,Game Packs,8,0,0.0,8
6123,1583,Kits,6,0,0.0,6
6124,1583,Stuff Packs,9,0,0.0,9
6125,1584,Expansion Packs,16,0,0.0,16
6126,1584,Game Packs,12,0,0.0,12
6127,1584,Kits,33,1,0.030303030303030304,32
6128,1584,Stuff Packs,20,0,0.0,20
6129,1585,Expansion Packs,10,0,0.0,10
6130,1585,Game Packs,7,0,0.0,7
6131,1585,Kits,1,0,0.0,1
6132,1585,Stuff Packs,7,1,0.14285714285714285,6
6133,1586,Expansion Packs,12,0,0.0,12
6134,1586,Game Packs,7,0,0.0,7
6135,1586,Kits,1,1,1.0,0
6136,1586,Stuff Packs,9,1,0.1111111111111111,8
6137,1587,Expansion Packs,16,0,0.0,16
6138,1587,Game Packs,8,1,0.125,7
6139,1587,Kits,10,0,0.0,10
6140,1587,Stuff Packs,15,2,0.13333333333333333,13
6141,1588,Expansion Packs,4,1,0.25,3
6142,1588,Game Packs,3,1,0.3333333333333333,2
6143,1588,Kits,3,3,1.0,0
6144,1588,Stuff Packs,3,3,1.0,0
6145,1589,Expansion Packs,15,1,0.06666666666666667,14
6146,1589,Game Packs,12,2,0.16666666666666666,10
6147,1589,Kits,11,1,0.09090909090909091,10
6148,1589,Stuff Packs,19,2,0.10526315789473684,17
6149,1590,Expansion Packs,2,0,0.0,2
6150,1590,Game Packs,3,1,0.3333333333333333,2
6151,1590,Stuff Packs,4,2,0.5,2
6152,1591,Expansion Packs,14,0,0.0,14
6153,1591,Game Packs,12,1,0.08333333333333333,11
6154,1591,Kits,12,0,0.0,12
6155,1591,Stuff Packs,11,0,0.0,11
6156,1592,Expansion Packs,16,0,0.0,16
6157,1592,Game Packs,12,0,0.0,12
6158,1592,Kits,33,0,0.0,33
6159,1592,Stuff Packs,20,0,0.0,20
6160,1593,Expansion Packs,8,1,0.125,7
6161,1593,Game Packs,1,0,0.0,1
6162,1593,Kits,3,1,0.3333333333333333,2
6163,1593,Stuff Packs,4,1,0.25,3
6164,1594,Expansion Packs,15,0,0.0,15
6165,1594,Game Packs,12,0,0.0,12
6166,1594,Kits,13,0,0.0,13
6167,1594,Stuff Packs,20,0,0.0,20
6168,1595,Expansion Packs,16,0,0.0,16
6169,1595,Game Packs,11,0,0.0,11
6170,1595,Kits,2,2,1.0,0
6171,1595,Stuff Packs,15,2,0.13333333333333333,13
6172,1596,Expansion Packs,11,0,0.0,11
6173,1596,Game Packs,6,0,0.0,6
6174,1596,Kits,4,2,0.5,2
6175,1596,Stuff Packs,9,2,0.2222222222222222,7
6176,1597,Expansion Packs,16,0,0.0,16
6177,1597,Game Packs,12,0,0.0,12
6178,1597,Kits,33,0,0.0,33
6179,1597,Stuff Packs,20,0,0.0,20
6180,1598,Expansion Packs,13,0,0.0,13
6181,1598,Game Packs,12,0,0.0,12
6182,1598,Kits,19,0,0.0,19
6183,1598,Stuff Packs,18,0,0.0,18
6184,1599,Expansion Packs,10,0,0.0,10
6185,1599,Game Packs,3,1,0.3333333333333333,2
6186,1599,Kits,3,1,0.3333333333333333,2
6187,1599,Stuff Packs,7,2,0.2857142857142857,5
6188,1600,Expansion Packs,9,0,0.0,9
6189,1600,Game Packs,10,0,0.0,10
6190,1600,Stuff Packs,7,1,0.14285714285714285,6
6191,1601,Expansion Packs,11,0,0.0,11
6192,1601,Game Packs,8,2,0.25,6
6193,1601,Kits,9,3,0.3333333333333333,6
6194,1601,Stuff Packs,10,3,0.3,7
6195,1602,Expansion Packs,15,0,0.0,15
6196,1602,Game Packs,11,0,0.0,11
6197,1602,Kits,10,0,0.0,10
6198,1602,Stuff Packs,20,0,0.0,20
6199,1603,Expansion Packs,16,0,0.0,16
6200,1603,Game Packs,9,0,0.0,9
6201,1603,Kits,6,1,0.16666666666666666,5
6202,1603,Stuff Packs,13,4,0.3076923076923077,9
6203,1604,Expansion Packs,7,0,0.0,7
6204,1604,Kits,2,1,0.5,1
6205,1604,Stuff Packs,3,0,0.0,3
6206,1605,Expansion Packs,5,0,0.0,5
6207,1605,Game Packs,5,0,0.0,5
6208,1605,Stuff Packs,10,1,0.1,9
6209,1606,Expansion Packs,10,0,0.0,10
6210,1606,Game Packs,3,1,0.3333333333333333,2
6211,1606,Kits,2,2,1.0,0
6212,1606,Stuff Packs,8,4,0.5,4
6213,1607,Expansion Packs,16,0,0.0,16
6214,1607,Game Packs,12,0,0.0,12
6215,1607,Kits,22,0,0.0,22
6216,1607,Stuff Packs,17,0,0.0,17
6217,1608,Expansion Packs,5,0,0.0,5
6218,1608,Game Packs,3,0,0.0,3
6219,1608,Stuff Packs,5,0,0.0,5
6220,1609,Expansion Packs,13,0,0.0,13
6221,1609,Game Packs,7,0,0.0,7
6222,1609,Kits,2,2,1.0,0
6223,1609,Stuff Packs,13,1,0.07692307692307693,12
6224,1610,Expansion Packs,16,0,0.0,16
6225,1610,Game Packs,12,0,0.0,12
6226,1610,Kits,33,1,0.030303030303030304,32
6227,1610,Stuff Packs,20,0,0.0,20
6228,1611,Expansion Packs,16,0,0.0,16
6229,1611,Game Packs,12,0,0.0,12
6230,1611,Kits,14,1,0.07142857142857142,13
6231,1611,Stuff Packs,20,0,0.0,20
6232,1612,Expansion Packs,14,1,0.07142857142857142,13
6233,1612,Game Packs,10,0,0.0,10
6234,1612,Kits,9,4,0.4444444444444444,5
6235,1612,Stuff Packs,19,0,0.0,19
6236,1613,Expansion Packs,13,0,0.0,13
6237,1613,Game Packs,9,0,0.0,9
6238,1613,Kits,3,2,0.6666666666666666,1
6239,1613,Stuff Packs,6,2,0.3333333333333333,4
6240,1614,Expansion Packs,16,0,0.0,16
6241,1614,Game Packs,10,0,0.0,10
6242,1614,Kits,14,1,0.07142857142857142,13
6243,1614,Stuff Packs,17,0,0.0,17
6244,1615,Expansion Packs,16,0,0.0,16
6245,1615,Game Packs,11,0,0.0,11
6246,1615,Kits,10,2,0.2,8
6247,1615,Stuff Packs,19,0,0.0,19
6248,1616,Expansion Packs,6,0,0.0,6
6249,1616,Kits,1,1,1.0,0
6250,1616,Stuff Packs,3,2,0.6666666666666666,1
6251,1617,Expansion Packs,12,0,0.0,12
6252,1617,Game Packs,9,0,0.0,9
6253,1617,Kits,4,1,0.25,3
6254,1617,Stuff Packs,14,2,0.14285714285714285,12
6255,1618,Expansion Packs,14,0,0.0,14
6256,1618,Game Packs,10,0,0.0,10
6257,1618,Kits,5,2,0.4,3
6258,1618,Stuff Packs,18,0,0.0,18
6259,1619,Expansion Packs,8,0,0.0,8
6260,1619,Game Packs,3,0,0.0,3
6261,1619,Kits,2,1,0.5,1
6262,1619,Stuff Packs,5,1,0.2,4
6263,1620,Expansion Packs,15,0,0.0,15
6264,1620,Game Packs,7,0,0.0,7
6265,1620,Kits,2,0,0.0,2
6266,1620,Stuff Packs,16,0,0.0,16
6267,1621,Expansion Packs,16,0,0.0,16
6268,1621,Game Packs,12,0,0.0,12
6269,1621,Kits,33,1,0.030303030303030304,32
6270,1621,Stuff Packs,20,0,0.0,20
6271,1622,Expansion Packs,16,0,0.0,16
6272,1622,Game Packs,12,0,0.0,12
6273,1622,Kits,33,0,0.0,33
6274,1622,Stuff Packs,20,0,0.0,20
6275,1623,Expansion Packs,14,0,0.0,14
6276,1623,Game Packs,11,0,0.0,11
6277,1623,Kits,14,2,0.14285714285714285,12
6278,1623,Stuff Packs,20,0,0.0,20
6279,1624,Expansion Packs,16,0,0.0,16
6280,1624,Game Packs,12,0,0.0,12
6281,1624,Kits,33,0,0.0,33
6282,1624,Stuff Packs,20,0,0.0,20
6283,1625,Expansion Packs,15,0,0.0,15
6284,1625,Game Packs,10,0,0.0,10
6285,1625,Kits,9,2,0.2222222222222222,7
6286,1625,Stuff Packs,8,3,0.375,5
6287,1626,Expansion Packs,14,0,0.0,14
6288,1626,Game Packs,7,0,0.0,7
6289,1626,Kits,7,1,0.14285714285714285,6
6290,1626,Stuff Packs,12,0,0.0,12
6291,1627,Expansion Packs,16,0,0.0,16
6292,1627,Game Packs,12,0,0.0,12
6293,1627,Kits,33,0,0.0,33
6294,1627,Stuff Packs,20,0,0.0,20
6295,1628,Expansion Packs,14,0,0.0,14
6296,1628,Game Packs,6,0,0.0,6
6297,1628,Kits,2,2,1.0,0
6298,1628,Stuff Packs,15,1,0.06666666666666667,14
6299,1629,Expansion Packs,4,0,0.0,4
6300,1629,Game Packs,1,0,0.0,1
6301,1629,Kits,3,0,0.0,3
6302,1629,Stuff Packs,3,0,0.0,3
6303,1630,Expansion Packs,15,0,0.0,15
6304,1630,Game Packs,11,0,0.0,11
6305,1630,Kits,14,0,0.0,14
6306,1630,Stuff Packs,20,0,0.0,20
6307,1631,Expansion Packs,8,0,0.0,8
6308,1631,Game Packs,5,0,0.0,5
6309,1631,Kits,7,1,0.14285714285714285,6
6310,1631,Stuff Packs,12,1,0.08333333333333333,11
6311,1632,Expansion Packs,12,0,0.0,12
6312,1632,Game Packs,5,0,0.0,5
6313,1632,Kits,9,1,0.1111111111111111,8
6314,1632,Stuff Packs,14,3,0.21428571428571427,11
6315,1633,Expansion Packs,16,0,0.0,16
6316,1633,Game Packs,12,0,0.0,12
6317,1633,Kits,18,1,0.05555555555555555,17
6318,1633,Stuff Packs,20,0,0.0,20
6319,1634,Expansion Packs,16,0,0.0,16
6320,1634,Game Packs,12,0,0.0,12
6321,1634,Kits,17,0,0.0,17
6322,1634,Stuff Packs,20,0,0.0,20
6323,1635,Expansion Packs,16,0,0.0,16
6324,1635,Game Packs,12,0,0.0,12
6325,1635,Kits,33,0,0.0,33
6326,1635,Stuff Packs,20,3,0.15,17
6327,1636,Expansion Packs,9,0,0.0,9
6328,1636,Game Packs,4,1,0.25,3
6329,1636,Kits,3,3,1.0,0
6330,1636,Stuff Packs,6,5,0.8333333333333334,1
6331,1637,Expansion Packs,15,0,0.0,15
6332,1637,Game Packs,12,0,0.0,12
6333,1637,Kits,9,3,0.3333333333333333,6
6334,1637,Stuff Packs,18,0,0.0,18
6335,1638,Expansion Packs,15,0,0.0,15
6336,1638,Game Packs,11,0,0.0,11
6337,1638,Kits,17,1,0.058823529411764705,16
6338,1638,Stuff Packs,20,0,0.0,20
6339,1639,Expansion Packs,1,0,0.0,1
6340,1639,Game Packs,2,1,0.5,1
6341,1639,Kits,1,1,1.0,0
6342,1639,Stuff Packs,3,3,1.0,0
6343,1640,Expansion Packs,16,0,0.0,16
6344,1640,Game Packs,12,0,0.0,12
6345,1640,Kits,33,0,0.0,33
6346,1640,Stuff Packs,20,0,0.0,20
6347,1641,Expansion Packs,13,0,0.0,13
6348,1641,Game Packs,4,0,0.0,4
6349,1641,Kits,2,0,0.0,2
6350,1641,Stuff Packs,8,2,0.25,6
6351,1642,Expansion Packs,8,0,0.0,8
6352,1642,Game Packs,5,0,0.0,5
6353,1642,Stuff Packs,7,3,0.42857142857142855,4
6354,1643,Expansion Packs,16,0,0.0,16
6355,1643,Game Packs,11,0,0.0,11
6356,1643,Kits,28,0,0.0,28
6357,1643,Stuff Packs,20,0,0.0,20
6358,1644,Expansion Packs,9,0,0.0,9
6359,1644,Game Packs,6,0,0.0,6
6360,1644,Kits,1,1,1.0,0
6361,1644,Stuff Packs,9,1,0.1111111111111111,8
6362,1645,Expansion Packs,16,3,0.1875,13
6363,1645,Game Packs,12,0,0.0,12
6364,1645,Kits,17,2,0.11764705882352941,15
6365,1645,Stuff Packs,20,0,0.0,20
6366,1646,Expansion Packs,12,0,0.0,12
6367,1646,Game Packs,5,1,0.2,4
6368,1646,Kits,17,0,0.0,17
6369,1646,Stuff Packs,18,1,0.05555555555555555,17
6370,1647,Expansion Packs,6,0,0.0,6
6371,1647,Game Packs,4,1,0.25,3
6372,1647,Kits,3,3,1.0,0
6373,1647,Stuff Packs,5,3,0.6,2
6374,1648,Expansion Packs,12,1,0.08333333333333333,11
6375,1648,Stuff Packs,2,2,1.0,0
6376,1649,Expansion Packs,15,0,0.0,15
6377,1649,Game Packs,12,0,0.0,12
6378,1649,Kits,14,1,0.07142857142857142,13
6379,1649,Stuff Packs,12,1,0.08333333333333333,11
6380,1650,Expansion Packs,16,0,0.0,16
6381,1650,Game Packs,10,0,0.0,10
6382,1650,Kits,13,1,0.07692307692307693,12
6383,1650,Stuff Packs,15,2,0.13333333333333333,13
6384,1651,Expansion Packs,8,5,0.625,3
6385,1651,Game Packs,4,4,1.0,0
6386,1651,Kits,6,0,0.0,6
6387,1651,Stuff Packs,6,6,1.0,0
6388,1652,Expansion Packs,16,0,0.0,16
6389,1652,Game Packs,11,0,0.0,11
6390,1652,Kits,32,1,0.03125,31
6391,1652,Stuff Packs,20,1,0.05,19
6392,1653,Expansion Packs,6,0,0.0,6
6393,1653,Game Packs,3,1,0.3333333333333333,2
6394,1653,Kits,3,3,1.0,0
6395,1653,Stuff Packs,7,4,0.5714285714285714,3
6396,1654,Expansion Packs,16,0,0.0,16
6397,1654,Game Packs,12,0,0.0,12
6398,1654,Kits,33,1,0.030303030303030304,32
6399,1654,Stuff Packs,20,0,0.0,20
6400,1655,Expansion Packs,16,0,0.0,16
6401,1655,Game Packs,12,0,0.0,12
6402,1655,Kits,33,0,0.0,33
6403,1655,Stuff Packs,20,0,0.0,20
6404,1656,Expansion Packs,15,0,0.0,15
6405,1656,Game Packs,12,0,0.0,12
6406,1656,Kits,15,0,0.0,15
6407,1656,Stuff Packs,20,0,0.0,20
6408,1657,Expansion Packs,16,0,0.0,16
6409,1657,Game Packs,12,0,0.0,12
6410,1657,Kits,33,1,0.030303030303030304,32
6411,1657,Stuff Packs,20,0,0.0,20
6412,1658,Expansion Packs,10,1,0.1,9
6413,1658,Game Packs,9,1,0.1111111111111111,8
6414,1658,Kits,14,2,0.14285714285714285,12
6415,1658,Stuff Packs,20,5,0.25,15
6416,1659,Expansion Packs,16,0,0.0,16
6417,1659,Game Packs,12,1,0.08333333333333333,11
6418,1659,Kits,23,1,0.043478260869565216,22
6419,1659,Stuff Packs,20,3,0.15,17
6420,1660,Expansion Packs,10,0,0.0,10
6421,1660,Game Packs,7,0,0.0,7
6422,1660,Kits,2,0,0.0,2
6423,1660,Stuff Packs,6,0,0.0,6
6424,1661,Expansion Packs,16,0,0.0,16
6425,1661,Game Packs,11,0,0.0,11
6426,1661,Kits,13,1,0.07692307692307693,12
6427,1661,Stuff Packs,17,3,0.17647058823529413,14
6428,1662,Expansion Packs,16,0,0.0,16
6429,1662,Game Packs,12,2,0.16666666666666666,10
6430,1662,Kits,33,2,0.06060606060606061,31
6431,1662,Stuff Packs,20,2,0.1,18
6432,1663,Expansion Packs,4,0,0.0,4
6433,1663,Game Packs,1,0,0.0,1
6434,1663,Kits,3,1,0.3333333333333333,2
6435,1663,Stuff Packs,3,2,0.6666666666666666,1
6436,1664,Expansion Packs,7,1,0.14285714285714285,6
6437,1664,Game Packs,2,1,0.5,1
6438,1664,Kits,4,1,0.25,3
6439,1664,Stuff Packs,7,2,0.2857142857142857,5
6440,1665,Expansion Packs,2,0,0.0,2
6441,1665,Game Packs,1,1,1.0,0
6442,1665,Kits,2,2,1.0,0
6443,1665,Stuff Packs,3,3,1.0,0
6444,1666,Expansion Packs,10,0,0.0,10
6445,1666,Game Packs,7,0,0.0,7
6446,1666,Kits,2,2,1.0,0
6447,1666,Stuff Packs,11,3,0.2727272727272727,8
6448,1667,Expansion Packs,7,0,0.0,7
6449,1667,Game Packs,4,1,0.25,3
6450,1667,Kits,1,1,1.0,0
6451,1667,Stuff Packs,5,2,0.4,3
6452,1668,Expansion Packs,15,0,0.0,15
6453,1668,Game Packs,11,0,0.0,11
6454,1668,Kits,14,3,0.21428571428571427,11
6455,1668,Stuff Packs,13,4,0.3076923076923077,9
6456,1669,Expansion Packs,11,0,0.0,11
6457,1669,Game Packs,3,1,0.3333333333333333,2
6458,1669,Kits,2,2,1.0,0
6459,1669,Stuff Packs,3,2,0.6666666666666666,1
6460,1670,Expansion Packs,7,0,0.0,7
6461,1670,Game Packs,5,0,0.0,5
6462,1670,Kits,3,0,0.0,3
6463,1670,Stuff Packs,5,1,0.2,4
6464,1671,Expansion Packs,16,0,0.0,16
6465,1671,Game Packs,12,0,0.0,12
6466,1671,Kits,22,2,0.09090909090909091,20
6467,1671,Stuff Packs,20,0,0.0,20
6468,1672,Expansion Packs,16,0,0.0,16
6469,1672,Game Packs,8,0,0.0,8
6470,1672,Kits,30,0,0.0,30
6471,1672,Stuff Packs,14,0,0.0,14
6472,1673,Expansion Packs,10,0,0.0,10
6473,1673,Game Packs,7,0,0.0,7
6474,1673,Stuff Packs,8,1,0.125,7
6475,1674,Expansion Packs,15,0,0.0,15
6476,1674,Game Packs,12,0,0.0,12
6477,1674,Kits,2,2,1.0,0
6478,1674,Stuff Packs,7,3,0.42857142857142855,4
6479,1675,Expansion Packs,16,0,0.0,16
6480,1675,Game Packs,12,0,0.0,12
6481,1675,Kits,11,0,0.0,11
6482,1675,Stuff Packs,14,0,0.0,14
6483,1676,Expansion Packs,16,0,0.0,16
6484,1676,Game Packs,6,0,0.0,6
6485,1676,Kits,6,2,0.3333333333333333,4
6486,1676,Stuff Packs,8,0,0.0,8
6487,1677,Expansion Packs,14,0,0.0,14
6488,1677,Game Packs,5,0,0.0,5
6489,1677,Kits,8,0,0.0,8
6490,1677,Stuff Packs,9,1,0.1111111111111111,8
6491,1678,Expansion Packs,13,0,0.0,13
6492,1678,Game Packs,8,0,0.0,8
6493,1678,Kits,4,2,0.5,2
6494,1678,Stuff Packs,9,3,0.3333333333333333,6
6495,1679,Expansion Packs,15,0,0.0,15
6496,1679,Game Packs,11,0,0.0,11
6497,1679,Kits,23,1,0.043478260869565216,22
6498,1679,Stuff Packs,20,1,0.05,19
6499,1680,Expansion Packs,5,0,0.0,5
6500,1680,Game Packs,3,0,0.0,3
6501,1680,Kits,2,1,0.5,1
6502,1680,Stuff Packs,3,1,0.3333333333333333,2
6503,1681,Expansion Packs,7,1,0.14285714285714285,6
6504,1681,Game Packs,4,1,0.25,3
6505,1681,Kits,3,3,1.0,0
6506,1681,Stuff Packs,8,4,0.5,4
6507,1682,Expansion Packs,3,0,0.0,3
6508,1682,Game Packs,3,0,0.0,3
6509,1682,Stuff Packs,2,0,0.0,2
6510,1683,Expansion Packs,12,1,0.08333333333333333,11
6511,1683,Game Packs,10,0,0.0,10
6512,1683,Kits,1,0,0.0,1
6513,1683,Stuff Packs,10,0,0.0,10
6514,1684,Expansion Packs,15,0,0.0,15
6515,1684,Game Packs,12,0,0.0,12
6516,1684,Kits,33,1,0.030303030303030304,32
6517,1684,Stuff Packs,20,1,0.05,19
6518,1685,Expansion Packs,12,0,0.0,12
6519,1685,Game Packs,7,0,0.0,7
6520,1685,Kits,3,0,0.0,3
6521,1685,Stuff Packs,16,0,0.0,16
6522,1686,Expansion Packs,16,0,0.0,16
6523,1686,Game Packs,11,0,0.0,11
6524,1686,Kits,14,2,0.14285714285714285,12
6525,1686,Stuff Packs,20,2,0.1,18
6526,1687,Expansion Packs,12,0,0.0,12
6527,1687,Game Packs,10,1,0.1,9
6528,1687,Kits,5,3,0.6,2
6529,1687,Stuff Packs,16,0,0.0,16
6530,1688,Kits,1,1,1.0,0
6531,1688,Stuff Packs,3,3,1.0,0
6532,1689,Expansion Packs,16,0,0.0,16
6533,1689,Game Packs,11,0,0.0,11
6534,1689,Kits,9,0,0.0,9
6535,1689,Stuff Packs,18,0,0.0,18
6536,1690,Expansion Packs,16,0,0.0,16
6537,1690,Game Packs,12,0,0.0,12
6538,1690,Kits,6,2,0.3333333333333333,4
6539,1690,Stuff Packs,20,0,0.0,20
6540,1691,Expansion Packs,15,0,0.0,15
6541,1691,Game Packs,12,0,0.0,12
6542,1691,Kits,23,1,0.043478260869565216,22
6543,1691,Stuff Packs,20,0,0.0,20
6544,1692,Expansion Packs,16,0,0.0,16
6545,1692,Game Packs,7,0,0.0,7
6546,1692,Kits,12,0,0.0,12
6547,1692,Stuff Packs,10,1,0.1,9
6548,1693,Expansion Packs,16,0,0.0,16
6549,1693,Game Packs,12,0,0.0,12
6550,1693,Kits,21,1,0.047619047619047616,20
6551,1693,Stuff Packs,20,6,0.3,14
6552,1694,Expansion Packs,16,0,0.0,16
6553,1694,Game Packs,12,0,0.0,12
6554,1694,Kits,33,0,0.0,33
6555,1694,Stuff Packs,20,0,0.0,20
6556,1695,Expansion Packs,4,0,0.0,4
6557,1695,Game Packs,3,0,0.0,3
6558,1695,Kits,1,1,1.0,0
6559,1695,Stuff Packs,3,0,0.0,3
6560,1696,Expansion Packs,16,0,0.0,16
6561,1696,Game Packs,12,0,0.0,12
6562,1696,Kits,4,2,0.5,2
6563,1696,Stuff Packs,14,0,0.0,14
6564,1697,Expansion Packs,16,0,0.0,16
6565,1697,Game Packs,12,0,0.0,12
6566,1697,Kits,32,0,0.0,32
6567,1697,Stuff Packs,20,0,0.0,20
6568,1698,Expansion Packs,11,0,0.0,11
6569,1698,Game Packs,8,0,0.0,8
6570,1698,Kits,2,1,0.5,1
6571,1698,Stuff Packs,17,1,0.058823529411764705,16
6572,1699,Expansion Packs,13,0,0.0,13
6573,1699,Game Packs,7,0,0.0,7
6574,1699,Kits,5,1,0.2,4
6575,1699,Stuff Packs,9,1,0.1111111111111111,8
6576,1700,Expansion Packs,10,0,0.0,10
6577,1700,Game Packs,9,1,0.1111111111111111,8
6578,1700,Kits,5,2,0.4,3
6579,1700,Stuff Packs,18,2,0.1111111111111111,16
6580,1701,Expansion Packs,16,0,0.0,16
6581,1701,Game Packs,12,0,0.0,12
6582,1701,Kits,24,1,0.041666666666666664,23
6583,1701,Stuff Packs,19,0,0.0,19
6584,1702,Expansion Packs,11,0,0.0,11
6585,1702,Game Packs,1,0,0.0,1
6586,1702,Kits,7,1,0.14285714285714285,6
6587,1702,Stuff Packs,5,2,0.4,3
6588,1703,Expansion Packs,16,0,0.0,16
6589,1703,Game Packs,10,0,0.0,10
6590,1703,Kits,12,0,0.0,12
6591,1703,Stuff Packs,18,0,0.0,18
6592,1704,Expansion Packs,12,0,0.0,12
6593,1704,Game Packs,8,0,0.0,8
6594,1704,Stuff Packs,18,0,0.0,18
6595,1705,Expansion Packs,16,0,0.0,16
6596,1705,Game Packs,12,0,0.0,12
6597,1705,Kits,33,1,0.030303030303030304,32
6598,1705,Stuff Packs,20,0,0.0,20
6599,1706,Expansion Packs,15,0,0.0,15
6600,1706,Game Packs,9,0,0.0,9
6601,1706,Kits,11,1,0.09090909090909091,10
6602,1706,Stuff Packs,20,0,0.0,20
6603,1707,Expansion Packs,12,0,0.0,12
6604,1707,Game Packs,7,0,0.0,7
6605,1707,Kits,3,2,0.6666666666666666,1
6606,1707,Stuff Packs,9,2,0.2222222222222222,7
6607,1708,Expansion Packs,6,0,0.0,6
6608,1708,Game Packs,2,0,0.0,2
6609,1708,Stuff Packs,2,0,0.0,2
6610,1709,Expansion Packs,16,0,0.0,16
6611,1709,Game Packs,12,0,0.0,12
6612,1709,Kits,33,1,0.030303030303030304,32
6613,1709,Stuff Packs,20,0,0.0,20
6614,1710,Expansion Packs,12,0,0.0,12
6615,1710,Game Packs,9,0,0.0,9
6616,1710,Kits,5,2,0.4,3
6617,1710,Stuff Packs,15,1,0.06666666666666667,14
6618,1711,Expansion Packs,5,0,0.0,5
6619,1711,Game Packs,1,0,0.0,1
6620,1711,Kits,3,0,0.0,3
6621,1711,Stuff Packs,4,0,0.0,4
6622,1712,Expansion Packs,15,0,0.0,15
6623,1712,Game Packs,6,1,0.16666666666666666,5
6624,1712,Kits,6,2,0.3333333333333333,4
6625,1712,Stuff Packs,7,4,0.5714285714285714,3
6626,1713,Expansion Packs,14,0,0.0,14
6627,1713,Game Packs,11,0,0.0,11
6628,1713,Kits,21,1,0.047619047619047616,20
6629,1713,Stuff Packs,19,2,0.10526315789473684,17
6630,1714,Expansion Packs,16,0,0.0,16
6631,1714,Game Packs,11,0,0.0,11
6632,1714,Kits,12,0,0.0,12
6633,1714,Stuff Packs,16,0,0.0,16
6634,1715,Expansion Packs,13,0,0.0,13
6635,1715,Game Packs,7,1,0.14285714285714285,6
6636,1715,Kits,8,1,0.125,7
6637,1715,Stuff Packs,12,3,0.25,9
6638,1716,Expansion Packs,16,0,0.0,16
6639,1716,Game Packs,12,0,0.0,12
6640,1716,Kits,32,1,0.03125,31
6641,1716,Stuff Packs,20,0,0.0,20
6642,1717,Expansion Packs,5,0,0.0,5
6643,1717,Game Packs,1,0,0.0,1
6644,1717,Stuff Packs,1,0,0.0,1
6645,1718,Expansion Packs,15,0,0.0,15
6646,1718,Game Packs,10,0,0.0,10
6647,1718,Kits,1,0,0.0,1
6648,1718,Stuff Packs,17,0,0.0,17
6649,1719,Expansion Packs,16,0,0.0,16
6650,1719,Game Packs,12,0,0.0,12
6651,1719,Kits,33,0,0.0,33
6652,1719,Stuff Packs,20,0,0.0,20
6653,1720,Expansion Packs,16,0,0.0,16
6654,1720,Game Packs,11,1,0.09090909090909091,10
6655,1720,Kits,14,0,0.0,14
6656,1720,Stuff Packs,18,1,0.05555555555555555,17
6657,1721,Expansion Packs,5,0,0.0,5
6658,1721,Game Packs,2,0,0.0,2
6659,1721,Stuff Packs,3,0,0.0,3
6660,1722,Expansion Packs,12,0,0.0,12
6661,1722,Game Packs,4,0,0.0,4
6662,1722,Kits,4,2,0.5,2
6663,1722,Stuff Packs,7,2,0.2857142857142857,5
6664,1723,Expansion Packs,16,0,0.0,16
6665,1723,Game Packs,11,0,0.0,11
6666,1723,Kits,25,1,0.04,24
6667,1723,Stuff Packs,20,0,0.0,20
6668,1724,Expansion Packs,4,0,0.0,4
6669,1724,Game Packs,3,1,0.3333333333333333,2
6670,1724,Kits,3,2,0.6666666666666666,1
6671,1724,Stuff Packs,3,2,0.6666666666666666,1
6672,1725,Expansion Packs,2,0,0.0,2
6673,1725,Game Packs,1,1,1.0,0
6674,1725,Kits,2,2,1.0,0
6675,1725,Stuff Packs,4,4,1.0,0
6676,1726,Expansion Packs,13,0,0.0,13
6677,1726,Game Packs,6,0,0.0,6
6678,1726,Stuff Packs,7,0,0.0,7
6679,1727,Expansion Packs,14,0,0.0,14
6680,1727,Game Packs,9,0,0.0,9
6681,1727,Kits,6,1,0.16666666666666666,5
6682,1727,Stuff Packs,16,1,0.0625,15
6683,1728,Expansion Packs,15,0,0.0,15
6684,1728,Game Packs,8,0,0.0,8
6685,1728,Kits,4,1,0.25,3
6686,1728,Stuff Packs,7,3,0.42857142857142855,4
6687,1729,Expansion Packs,16,0,0.0,16
6688,1729,Game Packs,7,0,0.0,7
6689,1729,Kits,17,1,0.058823529411764705,16
6690,1729,Stuff Packs,12,2,0.16666666666666666,10
6691,1730,Expansion Packs,6,0,0.0,6
6692,1730,Game Packs,3,0,0.0,3
6693,1730,Kits,1,1,1.0,0
6694,1730,Stuff Packs,2,2,1.0,0
6695,1731,Expansion Packs,5,0,0.0,5
6696,1731,Game Packs,5,0,0.0,5
6697,1731,Stuff Packs,12,0,0.0,12
6698,1732,Expansion Packs,13,0,0.0,13
6699,1732,Game Packs,5,0,0.0,5
6700,1732,Kits,1,1,1.0,0
6701,1732,Stuff Packs,9,2,0.2222222222222222,7
6702,1733,Stuff Packs,4,3,0.75,1
6703,1734,Expansion Packs,16,0,0.0,16
6704,1734,Game Packs,12,0,0.0,12
6705,1734,Kits,27,0,0.0,27
6706,1734,Stuff Packs,20,0,0.0,20
6707,1735,Expansion Packs,11,0,0.0,11
6708,1735,Game Packs,8,0,0.0,8
6709,1735,Kits,1,1,1.0,0
6710,1735,Stuff Packs,9,1,0.1111111111111111,8
6711,1736,Expansion Packs,4,0,0.0,4
6712,1736,Game Packs,2,0,0.0,2
6713,1736,Stuff Packs,4,1,0.25,3
6714,1737,Expansion Packs,15,0,0.0,15
6715,1737,Game Packs,12,0,0.0,12
6716,1737,Kits,11,0,0.0,11
6717,1737,Stuff Packs,19,1,0.05263157894736842,18
6718,1738,Expansion Packs,16,1,0.0625,15
6719,1738,Game Packs,11,0,0.0,11
6720,1738,Kits,12,3,0.25,9
6721,1738,Stuff Packs,12,4,0.3333333333333333,8
6722,1739,Expansion Packs,16,0,0.0,16
6723,1739,Game Packs,11,0,0.0,11
6724,1739,Kits,30,1,0.03333333333333333,29
6725,1739,Stuff Packs,20,0,0.0,20
6726,1740,Expansion Packs,12,0,0.0,12
6727,1740,Game Packs,10,0,0.0,10
6728,1740,Kits,1,0,0.0,1
6729,1740,Stuff Packs,14,0,0.0,14
6730,1741,Expansion Packs,7,0,0.0,7
6731,1741,Game Packs,4,0,0.0,4
6732,1741,Kits,22,2,0.09090909090909091,20
6733,1741,Stuff Packs,16,4,0.25,12
6734,1742,Expansion Packs,15,0,0.0,15
6735,1742,Game Packs,12,0,0.0,12
6736,1742,Kits,16,0,0.0,16
6737,1742,Stuff Packs,18,0,0.0,18
6738,1743,Expansion Packs,16,0,0.0,16
6739,1743,Game Packs,12,0,0.0,12
6740,1743,Kits,33,1,0.030303030303030304,32
6741,1743,Stuff Packs,20,0,0.0,20
6742,1744,Expansion Packs,14,2,0.14285714285714285,12
6743,1744,Game Packs,12,1,0.08333333333333333,11
6744,1744,Kits,21,1,0.047619047619047616,20
6745,1744,Stuff Packs,19,3,0.15789473684210525,16
6746,1745,Expansion Packs,15,0,0.0,15
6747,1745,Game Packs,11,0,0.0,11
6748,1745,Kits,12,0,0.0,12
6749,1745,Stuff Packs,12,0,0.0,12
6750,1746,Expansion Packs,16,0,0.0,16
6751,1746,Game Packs,11,1,0.09090909090909091,10
6752,1746,Kits,25,1,0.04,24
6753,1746,Stuff Packs,19,1,0.05263157894736842,18
6754,1747,Expansion Packs,7,0,0.0,7
6755,1747,Game Packs,6,1,0.16666666666666666,5
6756,1747,Kits,6,3,0.5,3
6757,1747,Stuff Packs,9,3,0.3333333333333333,6
6758,1748,Expansion Packs,15,1,0.06666666666666667,14
6759,1748,Game Packs,10,0,0.0,10
6760,1748,Kits,5,2,0.4,3
6761,1748,Stuff Packs,20,0,0.0,20
6762,1749,Expansion Packs,1,0,0.0,1
6763,1749,Game Packs,2,0,0.0,2
6764,1749,Kits,2,0,0.0,2
6765,1749,Stuff Packs,3,2,0.6666666666666666,1
6766,1750,Expansion Packs,16,0,0.0,16
6767,1750,Game Packs,12,0,0.0,12
6768,1750,Kits,26,2,0.07692307692307693,24
6769,1750,Stuff Packs,20,1,0.05,19
6770,1751,Expansion Packs,7,0,0.0,7
6771,1751,Game Packs,7,0,0.0,7
6772,1751,Kits,7,2,0.2857142857142857,5
6773,1751,Stuff Packs,7,1,0.14285714285714285,6
6774,1752,Expansion Packs,4,0,0.0,4
6775,1752,Game Packs,2,0,0.0,2
6776,1752,Kits,2,1,0.5,1
6777,1752,Stuff Packs,4,3,0.75,1
6778,1753,Expansion Packs,15,0,0.0,15
6779,1753,Game Packs,7,0,0.0,7
6780,1753,Kits,10,1,0.1,9
6781,1753,Stuff Packs,15,1,0.06666666666666667,14
6782,1754,Expansion Packs,3,0,0.0,3
6783,1754,Game Packs,2,0,0.0,2
6784,1754,Kits,2,1,0.5,1
6785,1755,Expansion Packs,15,0,0.0,15
6786,1755,Game Packs,9,0,0.0,9
6787,1755,Kits,7,1,0.14285714285714285,6
6788,1755,Stuff Packs,13,1,0.07692307692307693,12
6789,1756,Expansion Packs,14,0,0.0,14
6790,1756,Game Packs,12,0,0.0,12
6791,1756,Kits,4,0,0.0,4
6792,1756,Stuff Packs,18,1,0.05555555555555555,17
6793,1757,Expansion Packs,16,0,0.0,16
6794,1757,Game Packs,12,0,0.0,12
6795,1757,Kits,33,0,0.0,33
6796,1757,Stuff Packs,20,0,0.0,20
6797,1758,Expansion Packs,13,0,0.0,13
6798,1758,Game Packs,4,0,0.0,4
6799,1758,Kits,3,0,0.0,3
6800,1758,Stuff Packs,5,3,0.6,2
6801,1759,Expansion Packs,14,0,0.0,14
6802,1759,Game Packs,10,0,0.0,10
6803,1759,Kits,3,2,0.6666666666666666,1
6804,1759,Stuff Packs,14,3,0.21428571428571427,11
6805,1760,Expansion Packs,10,0,0.0,10
6806,1760,Game Packs,5,1,0.2,4
6807,1760,Kits,5,1,0.2,4
6808,1760,Stuff Packs,9,3,0.3333333333333333,6
6809,1761,Expansion Packs,16,0,0.0,16
6810,1761,Game Packs,12,0,0.0,12
6811,1761,Kits,33,1,0.030303030303030304,32
6812,1761,Stuff Packs,20,0,0.0,20
6813,1762,Expansion Packs,12,1,0.08333333333333333,11
6814,1762,Game Packs,7,0,0.0,7
6815,1762,Kits,2,1,0.5,1
6816,1762,Stuff Packs,6,4,0.6666666666666666,2
6817,1763,Expansion Packs,11,0,0.0,11
6818,1763,Game Packs,6,1,0.16666666666666666,5
6819,1763,Kits,3,3,1.0,0
6820,1763,Stuff Packs,11,4,0.36363636363636365,7
6821,1764,Expansion Packs,15,0,0.0,15
6822,1764,Game Packs,9,1,0.1111111111111111,8
6823,1764,Kits,18,3,0.16666666666666666,15
6824,1764,Stuff Packs,16,4,0.25,12
6825,1765,Expansion Packs,16,0,0.0,16
6826,1765,Game Packs,12,0,0.0,12
6827,1765,Kits,29,1,0.034482758620689655,28
6828,1765,Stuff Packs,10,1,0.1,9
6829,1766,Expansion Packs,7,0,0.0,7
6830,1766,Game Packs,4,1,0.25,3
6831,1766,Kits,3,3,1.0,0
6832,1766,Stuff Packs,10,4,0.4,6
6833,1767,Expansion Packs,14,0,0.0,14
6834,1767,Game Packs,8,0,0.0,8
6835,1767,Kits,1,0,0.0,1
6836,1767,Stuff Packs,13,0,0.0,13
6837,1768,Expansion Packs,16,0,0.0,16
6838,1768,Game Packs,12,0,0.0,12
6839,1768,Kits,24,1,0.041666666666666664,23
6840,1768,Stuff Packs,19,0,0.0,19
6841,1769,Expansion Packs,15,0,0.0,15
6842,1769,Game Packs,10,0,0.0,10
6843,1769,Kits,7,0,0.0,7
6844,1769,Stuff Packs,19,0,0.0,19
6845,1770,Expansion Packs,8,0,0.0,8
6846,1770,Game Packs,5,0,0.0,5
6847,1770,Kits,3,0,0.0,3
6848,1770,Stuff Packs,10,3,0.3,7
6849,1771,Expansion Packs,1,0,0.0,1
6850,1771,Kits,2,2,1.0,0
6851,1771,Stuff Packs,4,4,1.0,0
6852,1772,Expansion Packs,16,0,0.0,16
6853,1772,Game Packs,12,0,0.0,12
6854,1772,Kits,16,0,0.0,16
6855,1772,Stuff Packs,19,1,0.05263157894736842,18
6856,1773,Expansion Packs,6,0,0.0,6
6857,1773,Kits,2,0,0.0,2
6858,1773,Stuff Packs,2,0,0.0,2
6859,1774,Expansion Packs,16,0,0.0,16
6860,1774,Game Packs,10,0,0.0,10
6861,1774,Kits,17,1,0.058823529411764705,16
6862,1774,Stuff Packs,15,3,0.2,12
6863,1775,Kits,1,1,1.0,0
6864,1776,Expansion Packs,3,0,0.0,3
6865,1776,Game Packs,3,0,0.0,3
6866,1776,Kits,4,1,0.25,3
6867,1776,Stuff Packs,5,2,0.4,3
6868,1777,Expansion Packs,5,0,0.0,5
6869,1777,Game Packs,2,0,0.0,2
6870,1777,Kits,2,2,1.0,0
6871,1777,Stuff Packs,2,0,0.0,2
6872,1778,Expansion Packs,5,0,0.0,5
6873,1778,Game Packs,3,0,0.0,3
6874,1778,Kits,3,0,0.0,3
6875,1778,Stuff Packs,8,0,0.0,8
6876,1779,Expansion Packs,16,0,0.0,16
6877,1779,Game Packs,11,0,0.0,11
6878,1779,Kits,29,0,0.0,29
6879,1779,Stuff Packs,20,1,0.05,19
6880,1780,Expansion Packs,16,0,0.0,16
6881,1780,Game Packs,12,0,0.0,12
6882,1780,Kits,31,0,0.0,31
6883,1780,Stuff Packs,20,0,0.0,20
6884,1781,Expansion Packs,15,0,0.0,15
6885,1781,Game Packs,10,0,0.0,10
6886,1781,Kits,4,1,0.25,3
6887,1781,Stuff Packs,15,0,0.0,15
6888,1782,Expansion Packs,11,0,0.0,11
6889,1782,Game Packs,10,0,0.0,10
6890,1782,Kits,5,1,0.2,4
6891,1782,Stuff Packs,13,2,0.15384615384615385,11
6892,1783,Expansion Packs,4,0,0.0,4
6893,1783,Game Packs,1,1,1.0,0
6894,1783,Kits,2,2,1.0,0
6895,1783,Stuff Packs,5,4,0.8,1
6896,1784,Expansion Packs,9,0,0.0,9
6897,1784,Game Packs,6,0,0.0,6
6898,1784,Kits,2,0,0.0,2
6899,1784,Stuff Packs,7,1,0.14285714285714285,6
6900,1785,Expansion Packs,12,0,0.0,12
6901,1785,Game Packs,9,0,0.0,9
6902,1785,Stuff Packs,12,1,0.08333333333333333,11
6903,1786,Expansion Packs,11,0,0.0,11
6904,1786,Game Packs,9,0,0.0,9
6905,1786,Stuff Packs,7,0,0.0,7
6906,1787,Expansion Packs,15,0,0.0,15
6907,1787,Game Packs,9,0,0.0,9
6908,1787,Kits,2,1,0.5,1
6909,1787,Stuff Packs,14,0,0.0,14
6910,1788,Expansion Packs,16,0,0.0,16
6911,1788,Game Packs,12,0,0.0,12
6912,1788,Kits,31,1,0.03225806451612903,30
6913,1788,Stuff Packs,20,0,0.0,20
6914,1789,Expansion Packs,12,0,0.0,12
6915,1789,Game Packs,6,0,0.0,6
6916,1789,Stuff Packs,3,0,0.0,3
6917,1790,Expansion Packs,7,0,0.0,7
6918,1790,Game Packs,2,0,0.0,2
6919,1790,Stuff Packs,3,0,0.0,3
6920,1791,Expansion Packs,11,0,0.0,11
6921,1791,Game Packs,7,0,0.0,7
6922,1791,Kits,3,2,0.6666666666666666,1
6923,1791,Stuff Packs,11,2,0.18181818181818182,9
6924,1792,Expansion Packs,13,0,0.0,13
6925,1792,Game Packs,9,0,0.0,9
6926,1792,Kits,9,1,0.1111111111111111,8
6927,1792,Stuff Packs,15,1,0.06666666666666667,14
6928,1793,Expansion Packs,16,0,0.0,16
6929,1793,Game Packs,12,0,0.0,12
6930,1793,Kits,33,1,0.030303030303030304,32
6931,1793,Stuff Packs,20,0,0.0,20
6932,1794,Expansion Packs,16,0,0.0,16
6933,1794,Game Packs,12,1,0.08333333333333333,11
6934,1794,Kits,33,1,0.030303030303030304,32
6935,1794,Stuff Packs,20,0,0.0,20
6936,1795,Expansion Packs,14,1,0.07142857142857142,13
6937,1795,Game Packs,3,0,0.0,3
6938,1795,Kits,2,2,1.0,0
6939,1795,Stuff Packs,8,2,0.25,6
6940,1796,Expansion Packs,16,0,0.0,16
6941,1796,Game Packs,12,0,0.0,12
6942,1796,Kits,33,0,0.0,33
6943,1796,Stuff Packs,20,0,0.0,20
6944,1797,Expansion Packs,14,0,0.0,14
6945,1797,Game Packs,6,0,0.0,6
6946,1797,Kits,4,1,0.25,3
6947,1797,Stuff Packs,11,1,0.09090909090909091,10
6948,1798,Expansion Packs,2,0,0.0,2
6949,1798,Game Packs,2,0,0.0,2
6950,1798,Kits,1,1,1.0,0
6951,1798,Stuff Packs,2,1,0.5,1
6952,1799,Expansion Packs,13,0,0.0,13
6953,1799,Game Packs,6,0,0.0,6
6954,1799,Kits,1,1,1.0,0
6955,1799,Stuff Packs,7,3,0.42857142857142855,4
6956,1800,Expansion Packs,9,0,0.0,9
6957,1800,Game Packs,10,0,0.0,10
6958,1800,Kits,6,0,0.0,6
6959,1800,Stuff Packs,9,1,0.1111111111111111,8
6960,1801,Expansion Packs,3,0,0.0,3
6961,1801,Game Packs,1,1,1.0,0
6962,1801,Kits,4,3,0.75,1
6963,1801,Stuff Packs,4,4,1.0,0
6964,1802,Expansion Packs,14,0,0.0,14
6965,1802,Game Packs,9,0,0.0,9
6966,1802,Kits,13,1,0.07692307692307693,12
6967,1802,Stuff Packs,14,3,0.21428571428571427,11
6968,1803,Expansion Packs,15,1,0.06666666666666667,14
6969,1803,Game Packs,11,0,0.0,11
6970,1803,Kits,4,1,0.25,3
6971,1803,Stuff Packs,19,0,0.0,19
6972,1804,Expansion Packs,11,0,0.0,11
6973,1804,Game Packs,10,0,0.0,10
6974,1804,Kits,2,2,1.0,0
6975,1804,Stuff Packs,12,1,0.08333333333333333,11
6976,1805,Expansion Packs,15,0,0.0,15
6977,1805,Game Packs,5,0,0.0,5
6978,1805,Kits,1,1,1.0,0
6979,1805,Stuff Packs,8,3,0.375,5
6980,1806,Expansion Packs,5,0,0.0,5
6981,1806,Game Packs,3,0,0.0,3
6982,1806,Kits,9,0,0.0,9
6983,1806,Stuff Packs,8,2,0.25,6
6984,1807,Expansion Packs,15,0,0.0,15
6985,1807,Game Packs,11,0,0.0,11
6986,1807,Kits,11,1,0.09090909090909091,10
6987,1807,Stuff Packs,14,3,0.21428571428571427,11
6988,1808,Expansion Packs,5,0,0.0,5
6989,1808,Game Packs,4,0,0.0,4
6990,1808,Kits,2,2,1.0,0
6991,1808,Stuff Packs,4,0,0.0,4
6992,1809,Expansion Packs,16,0,0.0,16
6993,1809,Game Packs,12,0,0.0,12
6994,1809,Kits,10,3,0.3,7
6995,1809,Stuff Packs,17,2,0.11764705882352941,15
6996,1810,Expansion Packs,16,0,0.0,16
6997,1810,Game Packs,12,0,0.0,12
6998,1810,Kits,31,1,0.03225806451612903,30
6999,1810,Stuff Packs,20,0,0.0,20
7000,1811,Expansion Packs,6,0,0.0,6
7001,1811,Game Packs,2,0,0.0,2
7002,1811,Kits,2,2,1.0,0
7003,1811,Stuff Packs,6,3,0.5,3
7004,1812,Expansion Packs,16,0,0.0,16
7005,1812,Game Packs,4,1,0.25,3
7006,1812,Kits,11,2,0.18181818181818182,9
7007,1812,Stuff Packs,11,4,0.36363636363636365,7
7008,1813,Expansion Packs,15,0,0.0,15
7009,1813,Game Packs,9,0,0.0,9
7010,1813,Kits,10,1,0.1,9
7011,1813,Stuff Packs,19,2,0.10526315789473684,17
7012,1814,Expansion Packs,16,0,0.0,16
7013,1814,Game Packs,10,1,0.1,9
7014,1814,Kits,5,1,0.2,4
7015,1814,Stuff Packs,14,3,0.21428571428571427,11
7016,1815,Expansion Packs,16,0,0.0,16
7017,1815,Game Packs,12,0,0.0,12
7018,1815,Kits,33,1,0.030303030303030304,32
7019,1815,Stuff Packs,20,0,0.0,20
7020,1816,Expansion Packs,16,0,0.0,16
7021,1816,Game Packs,9,0,0.0,9
7022,1816,Kits,13,1,0.07692307692307693,12
7023,1816,Stuff Packs,9,1,0.1111111111111111,8
7024,1817,Expansion Packs,9,0,0.0,9
7025,1817,Game Packs,8,0,0.0,8
7026,1817,Kits,2,2,1.0,0
7027,1817,Stuff Packs,11,1,0.09090909090909091,10
7028,1818,Expansion Packs,16,0,0.0,16
7029,1818,Game Packs,11,0,0.0,11
7030,1818,Kits,12,1,0.08333333333333333,11
7031,1818,Stuff Packs,17,1,0.058823529411764705,16
7032,1819,Expansion Packs,12,0,0.0,12
7033,1819,Game Packs,9,0,0.0,9
7034,1819,Stuff Packs,4,0,0.0,4
7035,1820,Expansion Packs,14,0,0.0,14
7036,1820,Game Packs,10,0,0.0,10
7037,1820,Kits,2,0,0.0,2
7038,1820,Stuff Packs,12,0,0.0,12
7039,1821,Expansion Packs,14,0,0.0,14
7040,1821,Game Packs,7,1,0.14285714285714285,6
7041,1821,Kits,11,1,0.09090909090909091,10
7042,1821,Stuff Packs,13,3,0.23076923076923078,10
7043,1822,Expansion Packs,10,0,0.0,10
7044,1822,Game Packs,7,0,0.0,7
7045,1822,Kits,2,0,0.0,2
7046,1822,Stuff Packs,7,0,0.0,7
7047,1823,Expansion Packs,13,0,0.0,13
7048,1823,Game Packs,9,1,0.1111111111111111,8
7049,1823,Kits,12,1,0.08333333333333333,11
7050,1823,Stuff Packs,11,0,0.0,11
7051,1824,Expansion Packs,16,0,0.0,16
7052,1824,Game Packs,11,1,0.09090909090909091,10
7053,1824,Kits,32,1,0.03125,31
7054,1824,Stuff Packs,20,0,0.0,20
7055,1825,Expansion Packs,10,0,0.0,10
7056,1825,Game Packs,3,0,0.0,3
7057,1825,Kits,3,2,0.6666666666666666,1
7058,1825,Stuff Packs,5,1,0.2,4
7059,1826,Expansion Packs,9,1,0.1111111111111111,8
7060,1826,Game Packs,6,0,0.0,6
7061,1826,Kits,1,0,0.0,1
7062,1826,Stuff Packs,5,0,0.0,5
7063,1827,Expansion Packs,13,0,0.0,13
7064,1827,Game Packs,10,0,0.0,10
7065,1827,Kits,4,0,0.0,4
7066,1827,Stuff Packs,12,0,0.0,12
7067,1828,Expansion Packs,14,0,0.0,14
7068,1828,Game Packs,3,0,0.0,3
7069,1828,Kits,2,0,0.0,2
7070,1828,Stuff Packs,7,0,0.0,7
7071,1829,Expansion Packs,14,0,0.0,14
7072,1829,Game Packs,4,0,0.0,4
7073,1829,Kits,3,2,0.6666666666666666,1
7074,1829,Stuff Packs,7,2,0.2857142857142857,5
7075,1830,Expansion Packs,4,0,0.0,4
7076,1830,Stuff Packs,1,0,0.0,1
7077,1831,Expansion Packs,14,0,0.0,14
7078,1831,Game Packs,7,0,0.0,7
7079,1831,Kits,3,1,0.3333333333333333,2
7080,1831,Stuff Packs,14,1,0.07142857142857142,13
7081,1832,Expansion Packs,16,0,0.0,16
7082,1832,Game Packs,11,0,0.0,11
7083,1832,Kits,13,2,0.15384615384615385,11
7084,1832,Stuff Packs,18,1,0.05555555555555555,17
7085,1833,Expansion Packs,16,1,0.0625,15
7086,1833,Game Packs,8,0,0.0,8
7087,1833,Kits,27,1,0.037037037037037035,26
7088,1833,Stuff Packs,16,3,0.1875,13
7089,1834,Expansion Packs,14,0,0.0,14
7090,1834,Game Packs,12,0,0.0,12
7091,1834,Kits,11,1,0.09090909090909091,10
7092,1834,Stuff Packs,18,1,0.05555555555555555,17
7093,1835,Expansion Packs,16,0,0.0,16
7094,1835,Game Packs,12,0,0.0,12
7095,1835,Kits,33,0,0.0,33
7096,1835,Stuff Packs,20,0,0.0,20
7097,1836,Expansion Packs,16,0,0.0,16
7098,1836,Game Packs,12,0,0.0,12
7099,1836,Kits,33,0,0.0,33
7100,1836,Stuff Packs,20,0,0.0,20
7101,1837,Expansion Packs,11,0,0.0,11
7102,1837,Game Packs,9,0,0.0,9
7103,1837,Kits,2,2,1.0,0
7104,1837,Stuff Packs,11,1,0.09090909090909091,10
7105,1838,Expansion Packs,16,0,0.0,16
7106,1838,Game Packs,12,0,0.0,12
7107,1838,Kits,33,1,0.030303030303030304,32
7108,1838,Stuff Packs,20,0,0.0,20
7109,1839,Expansion Packs,16,0,0.0,16
7110,1839,Game Packs,12,0,0.0,12
7111,1839,Kits,33,0,0.0,33
7112,1839,Stuff Packs,20,0,0.0,20
7113,1840,Expansion Packs,10,0,0.0,10
7114,1840,Game Packs,3,0,0.0,3
7115,1840,Kits,2,1,0.5,1
7116,1840,Stuff Packs,6,0,0.0,6
7117,1841,Expansion Packs,7,0,0.0,7
7118,1841,Game Packs,4,1,0.25,3
7119,1841,Kits,3,3,1.0,0
7120,1841,Stuff Packs,11,4,0.36363636363636365,7
7121,1842,Expansion Packs,6,0,0.0,6
7122,1842,Game Packs,3,0,0.0,3
7123,1842,Stuff Packs,3,0,0.0,3
7124,1843,Expansion Packs,13,0,0.0,13
7125,1843,Game Packs,3,0,0.0,3
7126,1843,Kits,2,0,0.0,2
7127,1843,Stuff Packs,5,0,0.0,5
7128,1844,Expansion Packs,10,0,0.0,10
7129,1844,Game Packs,8,0,0.0,8
7130,1844,Kits,1,1,1.0,0
7131,1844,Stuff Packs,16,0,0.0,16
7132,1845,Expansion Packs,14,0,0.0,14
7133,1845,Game Packs,5,1,0.2,4
7134,1845,Kits,2,2,1.0,0
7135,1845,Stuff Packs,5,2,0.4,3
7136,1846,Expansion Packs,6,0,0.0,6
7137,1846,Game Packs,6,1,0.16666666666666666,5
7138,1846,Kits,6,2,0.3333333333333333,4
7139,1846,Stuff Packs,11,3,0.2727272727272727,8
7140,1847,Expansion Packs,14,0,0.0,14
7141,1847,Game Packs,11,0,0.0,11
7142,1847,Kits,6,1,0.16666666666666666,5
7143,1847,Stuff Packs,13,0,0.0,13
7144,1848,Expansion Packs,16,0,0.0,16
7145,1848,Game Packs,12,0,0.0,12
7146,1848,Kits,33,1,0.030303030303030304,32
7147,1848,Stuff Packs,20,0,0.0,20
7148,1849,Expansion Packs,16,0,0.0,16
7149,1849,Game Packs,12,0,0.0,12
7150,1849,Kits,25,2,0.08,23
7151,1849,Stuff Packs,20,0,0.0,20
7152,1850,Expansion Packs,4,0,0.0,4
7153,1851,Expansion Packs,2,0,0.0,2
7154,1851,Kits,1,0,0.0,1
7155,1852,Expansion Packs,11,0,0.0,11
7156,1852,Game Packs,7,2,0.2857142857142857,5
7157,1852,Kits,4,2,0.5,2
7158,1852,Stuff Packs,12,2,0.16666666666666666,10
7159,1853,Expansion Packs,16,0,0.0,16
7160,1853,Game Packs,11,0,0.0,11
7161,1853,Kits,8,2,0.25,6
7162,1853,Stuff Packs,13,3,0.23076923076923078,10
7163,1854,Expansion Packs,8,0,0.0,8
7164,1854,Game Packs,5,0,0.0,5
7165,1854,Kits,3,3,1.0,0
7166,1854,Stuff Packs,9,4,0.4444444444444444,5
7167,1855,Expansion Packs,15,0,0.0,15
7168,1855,Game Packs,9,0,0.0,9
7169,1855,Kits,6,2,0.3333333333333333,4
7170,1855,Stuff Packs,19,1,0.05263157894736842,18
7171,1856,Expansion Packs,16,0,0.0,16
7172,1856,Game Packs,9,1,0.1111111111111111,8
7173,1856,Kits,25,1,0.04,24
7174,1856,Stuff Packs,14,1,0.07142857142857142,13
7175,1857,Expansion Packs,11,0,0.0,11
7176,1857,Game Packs,6,1,0.16666666666666666,5
7177,1857,Kits,3,3,1.0,0
7178,1857,Stuff Packs,8,4,0.5,4
7179,1858,Expansion Packs,14,0,0.0,14
7180,1858,Game Packs,7,0,0.0,7
7181,1858,Kits,10,0,0.0,10
7182,1858,Stuff Packs,10,0,0.0,10
7183,1859,Expansion Packs,16,0,0.0,16
7184,1859,Game Packs,12,0,0.0,12
7185,1859,Kits,33,0,0.0,33
7186,1859,Stuff Packs,20,0,0.0,20
7187,1860,Expansion Packs,16,1,0.0625,15
7188,1860,Game Packs,8,0,0.0,8
7189,1860,Kits,2,1,0.5,1
7190,1860,Stuff Packs,17,0,0.0,17
7191,1861,Stuff Packs,2,2,1.0,0
7192,1862,Expansion Packs,16,0,0.0,16
7193,1862,Game Packs,9,0,0.0,9
7194,1862,Kits,20,1,0.05,19
7195,1862,Stuff Packs,15,3,0.2,12
7196,1863,Expansion Packs,14,0,0.0,14
7197,1863,Game Packs,5,0,0.0,5
7198,1863,Kits,2,1,0.5,1
7199,1863,Stuff Packs,9,2,0.2222222222222222,7
7200,1864,Expansion Packs,14,0,0.0,14
7201,1864,Game Packs,12,0,0.0,12
7202,1864,Kits,15,0,0.0,15
7203,1864,Stuff Packs,18,0,0.0,18
7204,1865,Expansion Packs,15,0,0.0,15
7205,1865,Game Packs,9,0,0.0,9
7206,1865,Kits,16,2,0.125,14
7207,1865,Stuff Packs,16,1,0.0625,15
7208,1866,Expansion Packs,16,0,0.0,16
7209,1866,Game Packs,12,0,0.0,12
7210,1866,Kits,16,2,0.125,14
7211,1866,Stuff Packs,14,2,0.14285714285714285,12
7212,1867,Expansion Packs,7,0,0.0,7
7213,1867,Game Packs,3,0,0.0,3
7214,1867,Kits,1,1,1.0,0
7215,1867,Stuff Packs,3,1,0.3333333333333333,2
7216,1868,Expansion Packs,16,0,0.0,16
7217,1868,Game Packs,12,0,0.0,12
7218,1868,Kits,26,0,0.0,26
7219,1868,Stuff Packs,20,0,0.0,20
7220,1869,Expansion Packs,16,0,0.0,16
7221,1869,Game Packs,11,0,0.0,11
7222,1869,Kits,3,1,0.3333333333333333,2
7223,1869,Stuff Packs,20,0,0.0,20
7224,1870,Expansion Packs,13,0,0.0,13
7225,1870,Game Packs,10,0,0.0,10
7226,1870,Stuff Packs,17,0,0.0,17
7227,1871,Expansion Packs,13,0,0.0,13
7228,1871,Game Packs,5,0,0.0,5
7229,1871,Kits,2,2,1.0,0
7230,1871,Stuff Packs,8,0,0.0,8
7231,1872,Expansion Packs,13,0,0.0,13
7232,1872,Game Packs,8,0,0.0,8
7233,1872,Kits,13,1,0.07692307692307693,12
7234,1872,Stuff Packs,16,0,0.0,16
7235,1873,Expansion Packs,15,0,0.0,15
7236,1873,Game Packs,11,0,0.0,11
7237,1873,Kits,15,1,0.06666666666666667,14
7238,1873,Stuff Packs,18,1,0.05555555555555555,17
7239,1874,Expansion Packs,4,0,0.0,4
7240,1874,Game Packs,3,0,0.0,3
7241,1874,Kits,1,0,0.0,1
7242,1874,Stuff Packs,2,0,0.0,2
7243,1875,Expansion Packs,8,0,0.0,8
7244,1875,Game Packs,3,0,0.0,3
7245,1875,Kits,3,1,0.3333333333333333,2
7246,1875,Stuff Packs,3,0,0.0,3
7247,1876,Expansion Packs,16,0,0.0,16
7248,1876,Game Packs,12,0,0.0,12
7249,1876,Kits,31,0,0.0,31
7250,1876,Stuff Packs,20,0,0.0,20
7251,1877,Expansion Packs,5,0,0.0,5
7252,1877,Game Packs,5,1,0.2,4
7253,1877,Kits,2,2,1.0,0
7254,1877,Stuff Packs,6,4,0.6666666666666666,2
7255,1878,Expansion Packs,13,0,0.0,13
7256,1878,Game Packs,6,0,0.0,6
7257,1878,Kits,1,1,1.0,0
7258,1878,Stuff Packs,7,4,0.5714285714285714,3
7259,1879,Expansion Packs,15,0,0.0,15
7260,1879,Game Packs,10,0,0.0,10
7261,1879,Kits,1,1,1.0,0
7262,1879,Stuff Packs,11,3,0.2727272727272727,8
7263,1880,Expansion Packs,16,0,0.0,16
7264,1880,Game Packs,6,1,0.16666666666666666,5
7265,1880,Kits,17,1,0.058823529411764705,16
7266,1880,Stuff Packs,7,3,0.42857142857142855,4
7267,1881,Expansion Packs,11,0,0.0,11
7268,1881,Game Packs,6,0,0.0,6
7269,1881,Kits,5,2,0.4,3
7270,1881,Stuff Packs,18,2,0.1111111111111111,16
7271,1882,Expansion Packs,16,0,0.0,16
7272,1882,Game Packs,12,0,0.0,12
7273,1882,Kits,33,0,0.0,33
7274,1882,Stuff Packs,20,0,0.0,20
7275,1883,Expansion Packs,15,0,0.0,15
7276,1883,Game Packs,8,0,0.0,8
7277,1883,Kits,5,0,0.0,5
7278,1883,Stuff Packs,14,1,0.07142857142857142,13
7279,1884,Expansion Packs,7,0,0.0,7
7280,1884,Game Packs,4,1,0.25,3
7281,1884,Kits,2,2,1.0,0
7282,1884,Stuff Packs,5,1,0.2,4
7283,1885,Expansion Packs,7,0,0.0,7
7284,1885,Game Packs,3,0,0.0,3
7285,1885,Kits,4,1,0.25,3
7286,1885,Stuff Packs,5,3,0.6,2
7287,1886,Expansion Packs,16,0,0.0,16
7288,1886,Game Packs,11,0,0.0,11
7289,1886,Kits,6,1,0.16666666666666666,5
7290,1886,Stuff Packs,17,1,0.058823529411764705,16
7291,1887,Expansion Packs,16,0,0.0,16
7292,1887,Game Packs,11,0,0.0,11
7293,1887,Kits,33,1,0.030303030303030304,32
7294,1887,Stuff Packs,20,0,0.0,20
7295,1888,Expansion Packs,9,0,0.0,9
7296,1888,Game Packs,7,0,0.0,7
7297,1888,Kits,2,2,1.0,0
7298,1888,Stuff Packs,4,0,0.0,4
7299,1889,Expansion Packs,8,0,0.0,8
7300,1889,Game Packs,2,0,0.0,2
7301,1889,Stuff Packs,2,0,0.0,2
7302,1890,Expansion Packs,10,0,0.0,10
7303,1890,Game Packs,6,0,0.0,6
7304,1890,Kits,3,3,1.0,0
7305,1890,Stuff Packs,9,2,0.2222222222222222,7
7306,1891,Expansion Packs,14,0,0.0,14
7307,1891,Game Packs,9,0,0.0,9
7308,1891,Kits,3,2,0.6666666666666666,1
7309,1891,Stuff Packs,13,1,0.07692307692307693,12
7310,1892,Expansion Packs,15,0,0.0,15
7311,1892,Game Packs,12,0,0.0,12
7312,1892,Kits,13,1,0.07692307692307693,12
7313,1892,Stuff Packs,20,1,0.05,19
7314,1893,Expansion Packs,15,0,0.0,15
7315,1893,Game Packs,9,0,0.0,9
7316,1893,Kits,12,1,0.08333333333333333,11
7317,1893,Stuff Packs,11,1,0.09090909090909091,10
7318,1894,Expansion Packs,16,0,0.0,16
7319,1894,Game Packs,10,0,0.0,10
7320,1894,Kits,18,0,0.0,18
7321,1894,Stuff Packs,19,0,0.0,19
7322,1895,Expansion Packs,7,0,0.0,7
7323,1895,Game Packs,6,1,0.16666666666666666,5
7324,1895,Kits,3,2,0.6666666666666666,1
7325,1895,Stuff Packs,4,4,1.0,0
7326,1896,Expansion Packs,16,0,0.0,16
7327,1896,Game Packs,12,0,0.0,12
7328,1896,Kits,31,0,0.0,31
7329,1896,Stuff Packs,20,0,0.0,20
7330,1897,Expansion Packs,9,0,0.0,9
7331,1897,Game Packs,4,0,0.0,4
7332,1897,Stuff Packs,2,0,0.0,2
7333,1898,Expansion Packs,16,0,0.0,16
7334,1898,Game Packs,12,0,0.0,12
7335,1898,Kits,33,0,0.0,33
7336,1898,Stuff Packs,20,0,0.0,20
7337,1899,Expansion Packs,7,0,0.0,7
7338,1899,Game Packs,2,0,0.0,2
7339,1899,Kits,1,0,0.0,1
7340,1899,Stuff Packs,5,2,0.4,3
7341,1900,Expansion Packs,11,0,0.0,11
7342,1900,Game Packs,7,1,0.14285714285714285,6
7343,1900,Kits,10,1,0.1,9
7344,1900,Stuff Packs,11,2,0.18181818181818182,9
7345,1901,Expansion Packs,15,0,0.0,15
7346,1901,Game Packs,10,0,0.0,10
7347,1901,Kits,18,2,0.1111111111111111,16
7348,1901,Stuff Packs,19,0,0.0,19
7349,1902,Expansion Packs,16,0,0.0,16
7350,1902,Game Packs,12,0,0.0,12
7351,1902,Kits,33,1,0.030303030303030304,32
7352,1902,Stuff Packs,20,1,0.05,19
7353,1903,Expansion Packs,15,0,0.0,15
7354,1903,Game Packs,8,0,0.0,8
7355,1903,Kits,1,1,1.0,0
7356,1903,Stuff Packs,14,1,0.07142857142857142,13
7357,1904,Expansion Packs,10,0,0.0,10
7358,1904,Game Packs,4,1,0.25,3
7359,1904,Kits,3,3,1.0,0
7360,1904,Stuff Packs,9,4,0.4444444444444444,5
7361,1905,Expansion Packs,16,0,0.0,16
7362,1905,Game Packs,12,0,0.0,12
7363,1905,Kits,33,1,0.030303030303030304,32
7364,1905,Stuff Packs,20,0,0.0,20
7365,1906,Expansion Packs,9,0,0.0,9
7366,1906,Game Packs,4,0,0.0,4
7367,1906,Kits,5,0,0.0,5
7368,1906,Stuff Packs,5,0,0.0,5
7369,1907,Expansion Packs,15,0,0.0,15
7370,1907,Game Packs,12,0,0.0,12
7371,1907,Kits,27,0,0.0,27
7372,1907,Stuff Packs,19,0,0.0,19
7373,1908,Expansion Packs,10,0,0.0,10
7374,1908,Game Packs,6,0,0.0,6
7375,1908,Kits,2,2,1.0,0
7376,1908,Stuff Packs,9,3,0.3333333333333333,6
7377,1909,Expansion Packs,16,0,0.0,16
7378,1909,Game Packs,12,0,0.0,12
7379,1909,Kits,5,0,0.0,5
7380,1909,Stuff Packs,12,0,0.0,12
7381,1910,Expansion Packs,16,0,0.0,16
7382,1910,Game Packs,6,0,0.0,6
7383,1910,Kits,12,0,0.0,12
7384,1910,Stuff Packs,10,0,0.0,10
7385,1911,Expansion Packs,5,0,0.0,5
7386,1911,Game Packs,2,1,0.5,1
7387,1911,Kits,4,1,0.25,3
7388,1911,Stuff Packs,9,3,0.3333333333333333,6
7389,1912,Expansion Packs,10,0,0.0,10
7390,1912,Game Packs,8,0,0.0,8
7391,1912,Stuff Packs,5,1,0.2,4
7392,1913,Expansion Packs,9,0,0.0,9
7393,1913,Game Packs,4,1,0.25,3
7394,1913,Kits,2,1,0.5,1
7395,1913,Stuff Packs,6,0,0.0,6
7396,1914,Expansion Packs,16,0,0.0,16
7397,1914,Game Packs,11,0,0.0,11
7398,1914,Kits,21,0,0.0,21
7399,1914,Stuff Packs,20,0,0.0,20
7400,1915,Expansion Packs,11,0,0.0,11
7401,1915,Game Packs,7,3,0.42857142857142855,4
7402,1915,Kits,3,2,0.6666666666666666,1
7403,1915,Stuff Packs,10,4,0.4,6
7404,1916,Expansion Packs,2,0,0.0,2
7405,1916,Game Packs,1,0,0.0,1
7406,1916,Stuff Packs,1,0,0.0,1
7407,1917,Expansion Packs,16,0,0.0,16
7408,1917,Game Packs,9,0,0.0,9
7409,1917,Kits,10,0,0.0,10
7410,1917,Stuff Packs,17,1,0.058823529411764705,16
7411,1918,Expansion Packs,6,0,0.0,6
7412,1918,Game Packs,5,0,0.0,5
7413,1918,Stuff Packs,8,2,0.25,6
7414,1919,Expansion Packs,16,1,0.0625,15
7415,1919,Game Packs,11,1,0.09090909090909091,10
7416,1919,Kits,6,2,0.3333333333333333,4
7417,1919,Stuff Packs,17,4,0.23529411764705882,13
7418,1920,Expansion Packs,16,0,0.0,16
7419,1920,Game Packs,12,0,0.0,12
7420,1920,Kits,31,1,0.03225806451612903,30
7421,1920,Stuff Packs,20,0,0.0,20
7422,1921,Expansion Packs,16,0,0.0,16
7423,1921,Game Packs,12,0,0.0,12
7424,1921,Kits,33,0,0.0,33
7425,1921,Stuff Packs,20,0,0.0,20
7426,1922,Expansion Packs,9,0,0.0,9
7427,1922,Game Packs,7,0,0.0,7
7428,1922,Kits,4,4,1.0,0
7429,1922,Stuff Packs,8,1,0.125,7
7430,1923,Expansion Packs,6,0,0.0,6
7431,1923,Game Packs,1,0,0.0,1
7432,1923,Stuff Packs,4,3,0.75,1
7433,1924,Expansion Packs,10,0,0.0,10
7434,1924,Game Packs,9,0,0.0,9
7435,1924,Kits,1,1,1.0,0
7436,1924,Stuff Packs,14,0,0.0,14
7437,1925,Expansion Packs,8,1,0.125,7
7438,1925,Game Packs,8,0,0.0,8
7439,1925,Kits,1,0,0.0,1
7440,1925,Stuff Packs,15,0,0.0,15
7441,1926,Expansion Packs,5,0,0.0,5
7442,1926,Game Packs,3,0,0.0,3
7443,1926,Kits,1,1,1.0,0
7444,1926,Stuff Packs,5,3,0.6,2
7445,1927,Expansion Packs,16,1,0.0625,15
7446,1927,Game Packs,7,1,0.14285714285714285,6
7447,1927,Kits,9,3,0.3333333333333333,6
7448,1927,Stuff Packs,17,3,0.17647058823529413,14
7449,1928,Expansion Packs,15,0,0.0,15
7450,1928,Game Packs,11,0,0.0,11
7451,1928,Kits,16,1,0.0625,15
7452,1928,Stuff Packs,19,0,0.0,19
7453,1929,Expansion Packs,10,0,0.0,10
7454,1929,Game Packs,7,0,0.0,7
7455,1929,Kits,5,1,0.2,4
7456,1929,Stuff Packs,13,0,0.0,13
7457,1930,Expansion Packs,1,0,0.0,1
7458,1930,Game Packs,4,1,0.25,3
7459,1930,Kits,2,2,1.0,0
7460,1930,Stuff Packs,6,4,0.6666666666666666,2
7461,1931,Expansion Packs,10,0,0.0,10
7462,1931,Game Packs,4,0,0.0,4
7463,1931,Kits,2,2,1.0,0
7464,1931,Stuff Packs,4,2,0.5,2
7465,1932,Expansion Packs,1,0,0.0,1
7466,1932,Game Packs,4,0,0.0,4
7467,1932,Kits,2,0,0.0,2
7468,1932,Stuff Packs,1,0,0.0,1
7469,1933,Expansion Packs,14,0,0.0,14
7470,1933,Game Packs,11,0,0.0,11
7471,1933,Kits,17,2,0.11764705882352941,15
7472,1933,Stuff Packs,18,1,0.05555555555555555,17
7473,1934,Expansion Packs,13,0,0.0,13
7474,1934,Game Packs,11,0,0.0,11
7475,1934,Kits,10,1,0.1,9
7476,1934,Stuff Packs,17,1,0.058823529411764705,16
7477,1935,Expansion Packs,11,0,0.0,11
7478,1935,Game Packs,4,0,0.0,4
7479,1935,Stuff Packs,2,2,1.0,0
7480,1936,Expansion Packs,16,0,0.0,16
7481,1936,Game Packs,12,0,0.0,12
7482,1936,Kits,22,0,0.0,22
7483,1936,Stuff Packs,20,0,0.0,20
7484,1937,Expansion Packs,14,0,0.0,14
7485,1937,Game Packs,11,0,0.0,11
7486,1937,Kits,6,3,0.5,3
7487,1937,Stuff Packs,17,0,0.0,17
7488,1938,Expansion Packs,16,0,0.0,16
7489,1938,Game Packs,12,0,0.0,12
7490,1938,Kits,19,1,0.05263157894736842,18
7491,1938,Stuff Packs,20,0,0.0,20
7492,1939,Expansion Packs,14,0,0.0,14
7493,1939,Game Packs,6,0,0.0,6
7494,1939,Kits,3,1,0.3333333333333333,2
7495,1939,Stuff Packs,8,3,0.375,5
7496,1940,Expansion Packs,10,0,0.0,10
7497,1940,Game Packs,7,0,0.0,7
7498,1940,Kits,1,1,1.0,0
7499,1940,Stuff Packs,12,1,0.08333333333333333,11
7500,1941,Expansion Packs,16,0,0.0,16
7501,1941,Game Packs,11,0,0.0,11
7502,1941,Kits,31,0,0.0,31
7503,1941,Stuff Packs,20,0,0.0,20
7504,1942,Expansion Packs,5,0,0.0,5
7505,1942,Game Packs,6,1,0.16666666666666666,5
7506,1942,Kits,3,3,1.0,0
7507,1942,Stuff Packs,12,4,0.3333333333333333,8
7508,1943,Expansion Packs,16,0,0.0,16
7509,1943,Game Packs,8,0,0.0,8
7510,1943,Kits,20,1,0.05,19
7511,1943,Stuff Packs,13,1,0.07692307692307693,12
7512,1944,Expansion Packs,10,0,0.0,10
7513,1944,Game Packs,7,1,0.14285714285714285,6
7514,1944,Kits,8,1,0.125,7
7515,1944,Stuff Packs,7,1,0.14285714285714285,6
7516,1945,Expansion Packs,12,1,0.08333333333333333,11
7517,1945,Game Packs,8,0,0.0,8
7518,1945,Kits,3,2,0.6666666666666666,1
7519,1945,Stuff Packs,17,1,0.058823529411764705,16
7520,1946,Expansion Packs,14,0,0.0,14
7521,1946,Game Packs,10,0,0.0,10
7522,1946,Kits,7,1,0.14285714285714285,6
7523,1946,Stuff Packs,13,0,0.0,13
7524,1947,Expansion Packs,16,0,0.0,16
7525,1947,Game Packs,12,0,0.0,12
7526,1947,Kits,33,0,0.0,33
7527,1947,Stuff Packs,20,0,0.0,20
7528,1948,Expansion Packs,12,0,0.0,12
7529,1948,Game Packs,5,1,0.2,4
7530,1948,Kits,6,3,0.5,3
7531,1948,Stuff Packs,9,4,0.4444444444444444,5
7532,1949,Expansion Packs,3,0,0.0,3
7533,1949,Game Packs,3,0,0.0,3
7534,1949,Kits,1,0,0.0,1
7535,1949,Stuff Packs,1,0,0.0,1
7536,1950,Expansion Packs,16,0,0.0,16
7537,1950,Game Packs,11,0,0.0,11
7538,1950,Kits,8,0,0.0,8
7539,1950,Stuff Packs,18,1,0.05555555555555555,17
7540,1951,Expansion Packs,10,0,0.0,10
7541,1951,Game Packs,6,2,0.3333333333333333,4
7542,1951,Kits,7,2,0.2857142857142857,5
7543,1951,Stuff Packs,10,4,0.4,6
7544,1952,Expansion Packs,13,0,0.0,13
7545,1952,Game Packs,11,0,0.0,11
7546,1952,Kits,5,1,0.2,4
7547,1952,Stuff Packs,19,0,0.0,19
7548,1953,Expansion Packs,13,0,0.0,13
7549,1953,Game Packs,7,0,0.0,7
7550,1953,Kits,7,2,0.2857142857142857,5
7551,1953,Stuff Packs,11,4,0.36363636363636365,7
7552,1954,Expansion Packs,14,0,0.0,14
7553,1954,Game Packs,7,0,0.0,7
7554,1954,Kits,5,0,0.0,5
7555,1954,Stuff Packs,11,0,0.0,11
7556,1955,Expansion Packs,13,6,0.46153846153846156,7
7557,1955,Game Packs,9,7,0.7777777777777778,2
7558,1955,Kits,2,2,1.0,0
7559,1955,Stuff Packs,15,6,0.4,9
7560,1956,Expansion Packs,15,0,0.0,15
7561,1956,Game Packs,3,0,0.0,3
7562,1956,Kits,15,1,0.06666666666666667,14
7563,1956,Stuff Packs,12,1,0.08333333333333333,11
7564,1957,Expansion Packs,3,0,0.0,3
7565,1957,Game Packs,2,0,0.0,2
7566,1957,Kits,1,1,1.0,0
7567,1957,Stuff Packs,5,3,0.6,2
7568,1958,Expansion Packs,16,0,0.0,16
7569,1958,Game Packs,12,0,0.0,12
7570,1958,Kits,18,1,0.05555555555555555,17
7571,1958,Stuff Packs,20,0,0.0,20
7572,1959,Expansion Packs,16,0,0.0,16
7573,1959,Game Packs,12,0,0.0,12
7574,1959,Kits,13,1,0.07692307692307693,12
7575,1959,Stuff Packs,20,0,0.0,20
7576,1960,Expansion Packs,14,0,0.0,14
7577,1960,Game Packs,11,0,0.0,11
7578,1960,Kits,5,2,0.4,3
7579,1960,Stuff Packs,11,2,0.18181818181818182,9
7580,1961,Expansion Packs,15,0,0.0,15
7581,1961,Game Packs,8,0,0.0,8
7582,1961,Kits,15,1,0.06666666666666667,14
7583,1961,Stuff Packs,12,3,0.25,9
7584,1962,Expansion Packs,11,0,0.0,11
7585,1962,Game Packs,7,0,0.0,7
7586,1962,Kits,2,0,0.0,2
7587,1962,Stuff Packs,12,0,0.0,12
7588,1963,Expansion Packs,16,0,0.0,16
7589,1963,Game Packs,12,0,0.0,12
7590,1963,Kits,33,0,0.0,33
7591,1963,Stuff Packs,20,0,0.0,20
7592,1964,Expansion Packs,16,0,0.0,16
7593,1964,Game Packs,12,0,0.0,12
7594,1964,Kits,33,0,0.0,33
7595,1964,Stuff Packs,20,0,0.0,20
7596,1965,Expansion Packs,14,0,0.0,14
7597,1965,Game Packs,9,0,0.0,9
7598,1965,Kits,6,3,0.5,3
7599,1965,Stuff Packs,9,3,0.3333333333333333,6
7600,1966,Expansion Packs,9,0,0.0,9
7601,1966,Game Packs,6,0,0.0,6
7602,1966,Stuff Packs,6,0,0.0,6
7603,1967,Expansion Packs,16,0,0.0,16
7604,1967,Game Packs,12,0,0.0,12
7605,1967,Kits,31,0,0.0,31
7606,1967,Stuff Packs,20,1,0.05,19
7607,1968,Expansion Packs,8,0,0.0,8
7608,1968,Game Packs,3,0,0.0,3
7609,1968,Kits,4,1,0.25,3
7610,1968,Stuff Packs,8,3,0.375,5
7611,1969,Expansion Packs,9,0,0.0,9
7612,1969,Game Packs,4,0,0.0,4
7613,1969,Kits,1,1,1.0,0
7614,1969,Stuff Packs,9,2,0.2222222222222222,7
7615,1970,Expansion Packs,3,0,0.0,3
7616,1970,Game Packs,1,0,0.0,1
7617,1970,Kits,1,1,1.0,0
7618,1970,Stuff Packs,4,2,0.5,2
7619,1971,Expansion Packs,13,0,0.0,13
7620,1971,Game Packs,7,0,0.0,7
7621,1971,Kits,12,0,0.0,12
7622,1971,Stuff Packs,12,2,0.16666666666666666,10
7623,1972,Expansion Packs,16,0,0.0,16
7624,1972,Game Packs,11,0,0.0,11
7625,1972,Kits,9,1,0.1111111111111111,8
7626,1972,Stuff Packs,14,1,0.07142857142857142,13
7627,1973,Expansion Packs,16,0,0.0,16
7628,1973,Game Packs,11,0,0.0,11
7629,1973,Kits,32,0,0.0,32
7630,1973,Stuff Packs,20,0,0.0,20
7631,1974,Expansion Packs,16,0,0.0,16
7632,1974,Game Packs,12,1,0.08333333333333333,11
7633,1974,Kits,33,1,0.030303030303030304,32
7634,1974,Stuff Packs,20,2,0.1,18
7635,1975,Expansion Packs,14,0,0.0,14
7636,1975,Game Packs,9,0,0.0,9
7637,1975,Kits,9,1,0.1111111111111111,8
7638,1975,Stuff Packs,15,1,0.06666666666666667,14
7639,1976,Expansion Packs,1,0,0.0,1
7640,1976,Game Packs,3,0,0.0,3
7641,1976,Stuff Packs,1,0,0.0,1
7642,1977,Expansion Packs,2,0,0.0,2
7643,1977,Game Packs,3,0,0.0,3
7644,1977,Kits,2,0,0.0,2
7645,1977,Stuff Packs,3,0,0.0,3
7646,1978,Expansion Packs,5,0,0.0,5
7647,1978,Game Packs,1,0,0.0,1
7648,1978,Kits,1,0,0.0,1
7649,1978,Stuff Packs,2,0,0.0,2
7650,1979,Expansion Packs,4,0,0.0,4
7651,1979,Game Packs,2,1,0.5,1
7652,1979,Kits,2,2,1.0,0
7653,1979,Stuff Packs,4,3,0.75,1
7654,1980,Expansion Packs,11,0,0.0,11
7655,1980,Game Packs,5,0,0.0,5
7656,1980,Kits,2,1,0.5,1
7657,1980,Stuff Packs,11,3,0.2727272727272727,8
7658,1981,Expansion Packs,3,0,0.0,3
7659,1981,Game Packs,3,1,0.3333333333333333,2
7660,1981,Stuff Packs,3,2,0.6666666666666666,1
7661,1982,Expansion Packs,12,0,0.0,12
7662,1982,Game Packs,10,0,0.0,10
7663,1982,Kits,11,1,0.09090909090909091,10
7664,1982,Stuff Packs,15,3,0.2,12
7665,1983,Expansion Packs,2,0,0.0,2
7666,1983,Game Packs,5,0,0.0,5
7667,1983,Stuff Packs,1,0,0.0,1
7668,1984,Expansion Packs,3,0,0.0,3
7669,1984,Game Packs,3,0,0.0,3
7670,1984,Stuff Packs,2,0,0.0,2
7671,1985,Expansion Packs,1,0,0.0,1
7672,1985,Kits,1,1,1.0,0
7673,1985,Stuff Packs,3,3,1.0,0
7674,1986,Expansion Packs,9,0,0.0,9
7675,1986,Game Packs,6,0,0.0,6
7676,1986,Kits,8,3,0.375,5
7677,1986,Stuff Packs,10,4,0.4,6
7678,1987,Expansion Packs,15,0,0.0,15
7679,1987,Game Packs,12,0,0.0,12
7680,1987,Kits,20,1,0.05,19
7681,1987,Stuff Packs,20,1,0.05,19
7682,1988,Expansion Packs,16,0,0.0,16
7683,1988,Game Packs,10,0,0.0,10
7684,1988,Kits,16,1,0.0625,15
7685,1988,Stuff Packs,14,1,0.07142857142857142,13
7686,1989,Expansion Packs,10,0,0.0,10
7687,1989,Game Packs,10,0,0.0,10
7688,1989,Stuff Packs,17,1,0.058823529411764705,16
7689,1990,Expansion Packs,16,0,0.0,16
7690,1990,Game Packs,7,0,0.0,7
7691,1990,Kits,14,0,0.0,14
7692,1990,Stuff Packs,13,1,0.07692307692307693,12
7693,1991,Expansion Packs,10,0,0.0,10
7694,1991,Game Packs,5,0,0.0,5
7695,1991,Kits,3,1,0.3333333333333333,2
7696,1991,Stuff Packs,7,2,0.2857142857142857,5
7697,1992,Expansion Packs,15,0,0.0,15
7698,1992,Game Packs,10,0,0.0,10
7699,1992,Kits,4,2,0.5,2
7700,1992,Stuff Packs,6,2,0.3333333333333333,4
7701,1993,Expansion Packs,7,0,0.0,7
7702,1993,Game Packs,2,0,0.0,2
7703,1993,Kits,2,2,1.0,0
7704,1993,Stuff Packs,5,3,0.6,2
7705,1994,Expansion Packs,16,1,0.0625,15
7706,1994,Game Packs,12,0,0.0,12
7707,1994,Kits,33,0,0.0,33
7708,1994,Stuff Packs,20,0,0.0,20
7709,1995,Expansion Packs,11,0,0.0,11
7710,1995,Game Packs,4,0,0.0,4
7711,1995,Kits,3,1,0.3333333333333333,2
7712,1995,Stuff Packs,7,4,0.5714285714285714,3
7713,1996,Expansion Packs,13,0,0.0,13
7714,1996,Game Packs,11,0,0.0,11
7715,1996,Kits,8,1,0.125,7
7716,1996,Stuff Packs,14,0,0.0,14
7717,1997,Expansion Packs,3,0,0.0,3
7718,1997,Game Packs,2,0,0.0,2
7719,1997,Stuff Packs,2,0,0.0,2
7720,1998,Expansion Packs,11,0,0.0,11
7721,1998,Game Packs,4,1,0.25,3
7722,1998,Kits,2,1,0.5,1
7723,1998,Stuff Packs,8,2,0.25,6
7724,1999,Expansion Packs,16,0,0.0,16
7725,1999,Game Packs,12,0,0.0,12
7726,1999,Kits,33,1,0.030303030303030304,32
7727,1999,Stuff Packs,20,0,0.0,20
7728,2000,Expansion Packs,10,0,0.0,10
7729,2000,Game Packs,9,0,0.0,9
7730,2000,Kits,5,1,0.2,4
7731,2000,Stuff Packs,11,3,0.2727272727272727,8
7732,2001,Expansion Packs,16,0,0.0,16
7733,2001,Game Packs,11,0,0.0,11
7734,2001,Kits,21,0,0.0,21
7735,2001,Stuff Packs,20,0,0.0,20
7736,2002,Expansion Packs,10,0,0.0,10
7737,2002,Game Packs,4,2,0.5,2
7738,2002,Stuff Packs,3,1,0.3333333333333333,2
7739,2003,Expansion Packs,16,0,0.0,16
7740,2003,Game Packs,9,0,0.0,9
7741,2003,Kits,4,0,0.0,4
7742,2003,Stuff Packs,18,1,0.05555555555555555,17
7743,2004,Expansion Packs,11,0,0.0,11
7744,2004,Game Packs,3,0,0.0,3
7745,2004,Kits,2,1,0.5,1
7746,2004,Stuff Packs,6,3,0.5,3
7747,2005,Expansion Packs,10,0,0.0,10
7748,2005,Game Packs,4,0,0.0,4
7749,2005,Kits,3,1,0.3333333333333333,2
7750,2005,Stuff Packs,5,2,0.4,3
7751,2006,Expansion Packs,16,0,0.0,16
7752,2006,Game Packs,12,0,0.0,12
7753,2006,Kits,32,0,0.0,32
7754,2006,Stuff Packs,20,0,0.0,20
7755,2007,Expansion Packs,16,0,0.0,16
7756,2007,Game Packs,12,0,0.0,12
7757,2007,Kits,33,0,0.0,33
7758,2007,Stuff Packs,20,0,0.0,20
7759,2008,Expansion Packs,9,0,0.0,9
7760,2008,Game Packs,3,0,0.0,3
7761,2008,Kits,8,0,0.0,8
7762,2008,Stuff Packs,4,0,0.0,4
7763,2009,Expansion Packs,3,0,0.0,3
7764,2009,Game Packs,1,0,0.0,1
7765,2009,Stuff Packs,2,2,1.0,0
7766,2010,Expansion Packs,3,0,0.0,3
7767,2010,Game Packs,2,1,0.5,1
7768,2010,Stuff Packs,6,4,0.6666666666666666,2
7769,2011,Expansion Packs,11,0,0.0,11
7770,2011,Game Packs,8,0,0.0,8
7771,2011,Stuff Packs,7,3,0.42857142857142855,4
7772,2012,Expansion Packs,14,0,0.0,14
7773,2012,Game Packs,8,0,0.0,8
7774,2012,Kits,15,0,0.0,15
7775,2012,Stuff Packs,13,2,0.15384615384615385,11
7776,2013,Expansion Packs,16,0,0.0,16
7777,2013,Game Packs,12,2,0.16666666666666666,10
7778,2013,Kits,26,1,0.038461538461538464,25
7779,2013,Stuff Packs,20,3,0.15,17
7780,2014,Expansion Packs,12,0,0.0,12
7781,2014,Game Packs,9,0,0.0,9
7782,2014,Kits,4,1,0.25,3
7783,2014,Stuff Packs,7,1,0.14285714285714285,6
7784,2015,Expansion Packs,16,0,0.0,16
7785,2015,Game Packs,7,0,0.0,7
7786,2015,Kits,1,1,1.0,0
7787,2015,Stuff Packs,8,0,0.0,8
7788,2016,Expansion Packs,7,5,0.7142857142857143,2
7789,2016,Game Packs,3,3,1.0,0
7790,2016,Kits,4,1,0.25,3
7791,2016,Stuff Packs,1,0,0.0,1
7792,2017,Expansion Packs,16,0,0.0,16
7793,2017,Game Packs,11,0,0.0,11
7794,2017,Kits,20,2,0.1,18
7795,2017,Stuff Packs,19,0,0.0,19
7796,2018,Expansion Packs,16,0,0.0,16
7797,2018,Game Packs,12,0,0.0,12
7798,2018,Kits,33,0,0.0,33
7799,2018,Stuff Packs,20,0,0.0,20
7800,2019,Expansion Packs,4,0,0.0,4
7801,2019,Game Packs,3,0,0.0,3
7802,2019,Kits,2,2,1.0,0
7803,2019,Stuff Packs,6,3,0.5,3
7804,2020,Expansion Packs,15,0,0.0,15
7805,2020,Game Packs,11,0,0.0,11
7806,2020,Kits,4,1,0.25,3
7807,2020,Stuff Packs,20,0,0.0,20
7808,2021,Game Packs,1,1,1.0,0
7809,2021,Kits,1,1,1.0,0
7810,2022,Expansion Packs,6,0,0.0,6
7811,2022,Game Packs,5,0,0.0,5
7812,2022,Kits,4,2,0.5,2
7813,2022,Stuff Packs,4,0,0.0,4
7814,2023,Expansion Packs,15,0,0.0,15
7815,2023,Game Packs,12,0,0.0,12
7816,2023,Kits,3,0,0.0,3
7817,2023,Stuff Packs,19,1,0.05263157894736842,18
7818,2024,Expansion Packs,6,0,0.0,6
7819,2024,Game Packs,2,0,0.0,2
7820,2024,Stuff Packs,6,1,0.16666666666666666,5
7821,2025,Expansion Packs,15,0,0.0,15
7822,2025,Game Packs,11,0,0.0,11
7823,2025,Kits,8,2,0.25,6
7824,2025,Stuff Packs,17,2,0.11764705882352941,15
7825,2026,Expansion Packs,13,0,0.0,13
7826,2026,Game Packs,3,0,0.0,3
7827,2026,Kits,4,0,0.0,4
7828,2026,Stuff Packs,8,0,0.0,8
7829,2027,Expansion Packs,5,3,0.6,2
7830,2027,Game Packs,3,0,0.0,3
7831,2027,Kits,1,0,0.0,1
7832,2027,Stuff Packs,4,0,0.0,4
7833,2028,Expansion Packs,11,0,0.0,11
7834,2028,Game Packs,5,1,0.2,4
7835,2028,Kits,9,2,0.2222222222222222,7
7836,2028,Stuff Packs,15,2,0.13333333333333333,13
7837,2029,Expansion Packs,14,0,0.0,14
7838,2029,Game Packs,12,2,0.16666666666666666,10
7839,2029,Kits,24,1,0.041666666666666664,23
7840,2029,Stuff Packs,18,0,0.0,18
7841,2030,Expansion Packs,16,0,0.0,16
7842,2030,Game Packs,12,0,0.0,12
7843,2030,Kits,14,1,0.07142857142857142,13
7844,2030,Stuff Packs,18,1,0.05555555555555555,17
7845,2031,Expansion Packs,16,1,0.0625,15
7846,2031,Game Packs,12,0,0.0,12
7847,2031,Kits,33,4,0.12121212121212122,29
7848,2031,Stuff Packs,20,0,0.0,20
7849,2032,Expansion Packs,9,0,0.0,9
7850,2032,Game Packs,6,0,0.0,6
7851,2032,Kits,2,1,0.5,1
7852,2032,Stuff Packs,8,2,0.25,6
7853,2033,Expansion Packs,6,0,0.0,6
7854,2033,Game Packs,4,1,0.25,3
7855,2033,Kits,3,2,0.6666666666666666,1
7856,2033,Stuff Packs,7,4,0.5714285714285714,3
7857,2034,Expansion Packs,8,0,0.0,8
7858,2034,Game Packs,4,0,0.0,4
7859,2034,Kits,2,2,1.0,0
7860,2034,Stuff Packs,5,0,0.0,5
7861,2035,Expansion Packs,16,0,0.0,16
7862,2035,Game Packs,12,0,0.0,12
7863,2035,Kits,33,1,0.030303030303030304,32
7864,2035,Stuff Packs,20,0,0.0,20
7865,2036,Expansion Packs,3,0,0.0,3
7866,2036,Game Packs,4,0,0.0,4
7867,2036,Kits,10,1,0.1,9
7868,2036,Stuff Packs,8,0,0.0,8
7869,2037,Expansion Packs,6,0,0.0,6
7870,2037,Game Packs,2,0,0.0,2
7871,2037,Stuff Packs,2,0,0.0,2
7872,2038,Expansion Packs,16,0,0.0,16
7873,2038,Game Packs,8,0,0.0,8
7874,2038,Kits,12,1,0.08333333333333333,11
7875,2038,Stuff Packs,12,0,0.0,12
7876,2039,Expansion Packs,16,0,0.0,16
7877,2039,Game Packs,12,0,0.0,12
7878,2039,Kits,13,1,0.07692307692307693,12
7879,2039,Stuff Packs,20,0,0.0,20
7880,2040,Expansion Packs,12,0,0.0,12
7881,2040,Game Packs,9,0,0.0,9
7882,2040,Stuff Packs,7,0,0.0,7
7883,2041,Expansion Packs,2,0,0.0,2
7884,2041,Game Packs,1,0,0.0,1
7885,2041,Stuff Packs,2,1,0.5,1
7886,2042,Expansion Packs,12,1,0.08333333333333333,11
7887,2042,Game Packs,3,1,0.3333333333333333,2
7888,2042,Kits,6,0,0.0,6
7889,2042,Stuff Packs,7,2,0.2857142857142857,5
7890,2043,Expansion Packs,16,0,0.0,16
7891,2043,Game Packs,10,1,0.1,9
7892,2043,Kits,31,2,0.06451612903225806,29
7893,2043,Stuff Packs,18,2,0.1111111111111111,16
7894,2044,Expansion Packs,6,0,0.0,6
7895,2044,Game Packs,3,0,0.0,3
7896,2044,Kits,6,2,0.3333333333333333,4
7897,2044,Stuff Packs,4,1,0.25,3
7898,2045,Expansion Packs,15,0,0.0,15
7899,2045,Game Packs,9,0,0.0,9
7900,2045,Kits,17,0,0.0,17
7901,2045,Stuff Packs,16,0,0.0,16
7902,2046,Expansion Packs,13,4,0.3076923076923077,9
7903,2046,Game Packs,8,4,0.5,4
7904,2046,Kits,26,26,1.0,0
7905,2046,Stuff Packs,15,10,0.6666666666666666,5
7906,2047,Expansion Packs,13,0,0.0,13
7907,2047,Game Packs,7,0,0.0,7
7908,2047,Kits,2,2,1.0,0
7909,2047,Stuff Packs,8,3,0.375,5
7910,2048,Expansion Packs,16,0,0.0,16
7911,2048,Game Packs,12,0,0.0,12
7912,2048,Kits,32,0,0.0,32
7913,2048,Stuff Packs,20,0,0.0,20
7914,2049,Expansion Packs,4,0,0.0,4
7915,2049,Game Packs,4,1,0.25,3
7916,2049,Kits,3,1,0.3333333333333333,2
7917,2049,Stuff Packs,8,3,0.375,5
7918,2050,Expansion Packs,15,0,0.0,15
7919,2050,Game Packs,11,0,0.0,11
7920,2050,Kits,14,1,0.07142857142857142,13
7921,2050,Stuff Packs,19,0,0.0,19
7922,2051,Expansion Packs,15,0,0.0,15
7923,2051,Game Packs,11,0,0.0,11
7924,2051,Kits,15,1,0.06666666666666667,14
7925,2051,Stuff Packs,20,0,0.0,20
7926,2052,Expansion Packs,15,0,0.0,15
7927,2052,Game Packs,11,0,0.0,11
7928,2052,Kits,11,1,0.09090909090909091,10
7929,2052,Stuff Packs,19,0,0.0,19
7930,2053,Expansion Packs,14,0,0.0,14
7931,2053,Game Packs,3,0,0.0,3
7932,2053,Stuff Packs,6,2,0.3333333333333333,4
7933,2054,Expansion Packs,16,0,0.0,16
7934,2054,Game Packs,8,0,0.0,8
7935,2054,Kits,17,1,0.058823529411764705,16
7936,2054,Stuff Packs,12,2,0.16666666666666666,10
7937,2055,Expansion Packs,13,0,0.0,13
7938,2055,Game Packs,4,0,0.0,4
7939,2055,Kits,2,2,1.0,0
7940,2055,Stuff Packs,4,3,0.75,1
7941,2056,Expansion Packs,16,0,0.0,16
7942,2056,Game Packs,10,0,0.0,10
7943,2056,Kits,20,0,0.0,20
7944,2056,Stuff Packs,19,0,0.0,19
7945,2057,Expansion Packs,13,0,0.0,13
7946,2057,Game Packs,10,0,0.0,10
7947,2057,Kits,3,2,0.6666666666666666,1
7948,2057,Stuff Packs,16,1,0.0625,15
7949,2058,Expansion Packs,16,0,0.0,16
7950,2058,Game Packs,11,0,0.0,11
7951,2058,Kits,33,0,0.0,33
7952,2058,Stuff Packs,20,0,0.0,20
7953,2059,Expansion Packs,8,0,0.0,8
7954,2059,Game Packs,7,0,0.0,7
7955,2059,Stuff Packs,6,2,0.3333333333333333,4
7956,2060,Expansion Packs,15,0,0.0,15
7957,2060,Game Packs,12,0,0.0,12
7958,2060,Kits,25,0,0.0,25
7959,2060,Stuff Packs,19,1,0.05263157894736842,18
7960,2061,Expansion Packs,13,0,0.0,13
7961,2061,Game Packs,8,0,0.0,8
7962,2061,Kits,4,1,0.25,3
7963,2061,Stuff Packs,17,0,0.0,17
7964,2062,Expansion Packs,14,0,0.0,14
7965,2062,Game Packs,6,0,0.0,6
7966,2062,Kits,16,0,0.0,16
7967,2062,Stuff Packs,16,0,0.0,16
7968,2063,Expansion Packs,15,0,0.0,15
7969,2063,Game Packs,10,0,0.0,10
7970,2063,Kits,8,0,0.0,8
7971,2063,Stuff Packs,15,0,0.0,15
7972,2064,Expansion Packs,6,0,0.0,6
7973,2064,Game Packs,7,1,0.14285714285714285,6
7974,2064,Kits,1,1,1.0,0
7975,2064,Stuff Packs,5,3,0.6,2
7976,2065,Expansion Packs,13,0,0.0,13
7977,2065,Game Packs,2,0,0.0,2
7978,2065,Kits,4,1,0.25,3
7979,2065,Stuff Packs,4,0,0.0,4
7980,2066,Expansion Packs,14,0,0.0,14
7981,2066,Game Packs,10,0,0.0,10
7982,2066,Kits,11,3,0.2727272727272727,8
7983,2066,Stuff Packs,19,1,0.05263157894736842,18
7984,2067,Expansion Packs,10,0,0.0,10
7985,2067,Game Packs,4,0,0.0,4
7986,2067,Kits,9,0,0.0,9
7987,2067,Stuff Packs,10,0,0.0,10
7988,2068,Expansion Packs,12,0,0.0,12
7989,2068,Game Packs,9,0,0.0,9
7990,2068,Kits,2,2,1.0,0
7991,2068,Stuff Packs,15,0,0.0,15
7992,2069,Expansion Packs,9,0,0.0,9
7993,2069,Game Packs,4,0,0.0,4
7994,2069,Kits,2,2,1.0,0
7995,2069,Stuff Packs,6,1,0.16666666666666666,5
7996,2070,Expansion Packs,16,0,0.0,16
7997,2070,Game Packs,12,0,0.0,12
7998,2070,Kits,33,1,0.030303030303030304,32
7999,2070,Stuff Packs,20,0,0.0,20
8000,2071,Expansion Packs,14,0,0.0,14
8001,2071,Game Packs,8,0,0.0,8
8002,2071,Kits,4,1,0.25,3
8003,2071,Stuff Packs,8,2,0.25,6
8004,2072,Expansion Packs,8,0,0.0,8
8005,2072,Game Packs,3,1,0.3333333333333333,2
8006,2072,Kits,1,0,0.0,1
8007,2072,Stuff Packs,7,3,0.42857142857142855,4
8008,2073,Expansion Packs,6,0,0.0,6
8009,2073,Game Packs,2,0,0.0,2
8010,2073,Kits,2,2,1.0,0
8011,2073,Stuff Packs,9,2,0.2222222222222222,7
8012,2074,Expansion Packs,11,0,0.0,11
8013,2074,Game Packs,10,0,0.0,10
8014,2074,Kits,2,0,0.0,2
8015,2074,Stuff Packs,11,0,0.0,11
8016,2075,Expansion Packs,15,3,0.2,12
8017,2075,Game Packs,5,0,0.0,5
8018,2075,Kits,2,0,0.0,2
8019,2075,Stuff Packs,6,0,0.0,6
8020,2076,Expansion Packs,13,0,0.0,13
8021,2076,Game Packs,11,1,0.09090909090909091,10
8022,2076,Kits,4,1,0.25,3
8023,2076,Stuff Packs,17,0,0.0,17
8024,2077,Expansion Packs,15,0,0.0,15
8025,2077,Game Packs,12,0,0.0,12
8026,2077,Kits,27,0,0.0,27
8027,2077,Stuff Packs,19,0,0.0,19
8028,2078,Expansion Packs,10,0,0.0,10
8029,2078,Game Packs,3,1,0.3333333333333333,2
8030,2078,Kits,2,2,1.0,0
8031,2078,Stuff Packs,6,4,0.6666666666666666,2
8032,2079,Expansion Packs,16,2,0.125,14
8033,2079,Game Packs,12,0,0.0,12
8034,2079,Kits,33,7,0.21212121212121213,26
8035,2079,Stuff Packs,20,2,0.1,18
8036,2080,Expansion Packs,15,0,0.0,15
8037,2080,Game Packs,11,1,0.09090909090909091,10
8038,2080,Kits,11,0,0.0,11
8039,2080,Stuff Packs,19,0,0.0,19
8040,2081,Expansion Packs,16,0,0.0,16
8041,2081,Game Packs,8,0,0.0,8
8042,2081,Kits,7,1,0.14285714285714285,6
8043,2081,Stuff Packs,11,3,0.2727272727272727,8
8044,2082,Expansion Packs,11,0,0.0,11
8045,2082,Game Packs,12,0,0.0,12
8046,2082,Kits,21,5,0.23809523809523808,16
8047,2082,Stuff Packs,18,13,0.7222222222222222,5
8048,2083,Expansion Packs,8,0,0.0,8
8049,2083,Game Packs,6,1,0.16666666666666666,5
8050,2083,Kits,3,3,1.0,0
8051,2083,Stuff Packs,7,2,0.2857142857142857,5
8052,2084,Expansion Packs,10,0,0.0,10
8053,2084,Game Packs,4,0,0.0,4
8054,2084,Kits,5,0,0.0,5
8055,2084,Stuff Packs,4,3,0.75,1
8056,2085,Expansion Packs,16,0,0.0,16
8057,2085,Game Packs,12,0,0.0,12
8058,2085,Kits,12,0,0.0,12
8059,2085,Stuff Packs,19,0,0.0,19
8060,2086,Expansion Packs,16,0,0.0,16
8061,2086,Game Packs,12,0,0.0,12
8062,2086,Kits,31,1,0.03225806451612903,30
8063,2086,Stuff Packs,20,0,0.0,20
8064,2087,Expansion Packs,3,0,0.0,3
8065,2087,Game Packs,6,0,0.0,6
8066,2087,Kits,8,1,0.125,7
8067,2087,Stuff Packs,9,3,0.3333333333333333,6
8068,2088,Expansion Packs,13,0,0.0,13
8069,2088,Game Packs,10,0,0.0,10
8070,2088,Kits,5,0,0.0,5
8071,2088,Stuff Packs,8,2,0.25,6
8072,2089,Expansion Packs,16,0,0.0,16
8073,2089,Game Packs,11,0,0.0,11
8074,2089,Kits,20,2,0.1,18
8075,2089,Stuff Packs,18,0,0.0,18
8076,2090,Expansion Packs,15,0,0.0,15
8077,2090,Game Packs,9,0,0.0,9
8078,2090,Kits,17,1,0.058823529411764705,16
8079,2090,Stuff Packs,18,0,0.0,18
8080,2091,Expansion Packs,14,0,0.0,14
8081,2091,Game Packs,11,0,0.0,11
8082,2091,Kits,18,1,0.05555555555555555,17
8083,2091,Stuff Packs,13,1,0.07692307692307693,12
8084,2092,Expansion Packs,16,1,0.0625,15
8085,2092,Game Packs,11,0,0.0,11
8086,2092,Kits,21,1,0.047619047619047616,20
8087,2092,Stuff Packs,18,2,0.1111111111111111,16
8088,2093,Expansion Packs,12,0,0.0,12
8089,2093,Game Packs,8,0,0.0,8
8090,2093,Kits,1,1,1.0,0
8091,2093,Stuff Packs,14,0,0.0,14
8092,2094,Expansion Packs,15,0,0.0,15
8093,2094,Game Packs,12,0,0.0,12
8094,2094,Kits,24,1,0.041666666666666664,23
8095,2094,Stuff Packs,20,0,0.0,20
8096,2095,Expansion Packs,16,0,0.0,16
8097,2095,Game Packs,12,0,0.0,12
8098,2095,Kits,33,0,0.0,33
8099,2095,Stuff Packs,20,0,0.0,20
8100,2096,Expansion Packs,14,0,0.0,14
8101,2096,Game Packs,11,0,0.0,11
8102,2096,Kits,15,0,0.0,15
8103,2096,Stuff Packs,20,0,0.0,20
8104,2097,Expansion Packs,9,0,0.0,9
8105,2097,Game Packs,4,0,0.0,4
8106,2097,Kits,2,2,1.0,0
8107,2097,Stuff Packs,7,3,0.42857142857142855,4
8108,2098,Expansion Packs,1,0,0.0,1
8109,2098,Stuff Packs,1,0,0.0,1
8110,2099,Expansion Packs,9,1,0.1111111111111111,8
8111,2099,Game Packs,3,0,0.0,3
8112,2099,Kits,3,3,1.0,0
8113,2099,Stuff Packs,6,2,0.3333333333333333,4
8114,2100,Expansion Packs,16,0,0.0,16
8115,2100,Game Packs,12,0,0.0,12
8116,2100,Kits,31,0,0.0,31
8117,2100,Stuff Packs,20,1,0.05,19
8118,2101,Expansion Packs,10,0,0.0,10
8119,2101,Game Packs,5,1,0.2,4
8120,2101,Kits,3,3,1.0,0
8121,2101,Stuff Packs,6,4,0.6666666666666666,2
8122,2102,Expansion Packs,16,0,0.0,16
8123,2102,Game Packs,12,0,0.0,12
8124,2102,Kits,33,0,0.0,33
8125,2102,Stuff Packs,20,2,0.1,18
8126,2103,Expansion Packs,15,0,0.0,15
8127,2103,Game Packs,5,1,0.2,4
8128,2103,Kits,5,2,0.4,3
8129,2103,Stuff Packs,9,2,0.2222222222222222,7
8130,2104,Expansion Packs,16,0,0.0,16
8131,2104,Game Packs,11,0,0.0,11
8132,2104,Kits,20,1,0.05,19
8133,2104,Stuff Packs,20,0,0.0,20
8134,2105,Expansion Packs,12,1,0.08333333333333333,11
8135,2105,Game Packs,4,0,0.0,4
8136,2105,Kits,3,1,0.3333333333333333,2
8137,2105,Stuff Packs,3,2,0.6666666666666666,1
8138,2106,Expansion Packs,16,0,0.0,16
8139,2106,Game Packs,12,0,0.0,12
8140,2106,Kits,33,0,0.0,33
8141,2106,Stuff Packs,20,2,0.1,18
8142,2107,Expansion Packs,7,0,0.0,7
8143,2107,Game Packs,3,1,0.3333333333333333,2
8144,2107,Kits,4,3,0.75,1
8145,2107,Stuff Packs,5,2,0.4,3
8146,2108,Expansion Packs,16,16,1.0,0
8147,2108,Game Packs,12,12,1.0,0
8148,2108,Kits,33,33,1.0,0
8149,2108,Stuff Packs,20,20,1.0,0
8150,2109,Expansion Packs,14,0,0.0,14
8151,2109,Game Packs,7,0,0.0,7
8152,2109,Kits,2,1,0.5,1
8153,2109,Stuff Packs,18,1,0.05555555555555555,17
8154,2110,Expansion Packs,15,0,0.0,15
8155,2110,Game Packs,10,1,0.1,9
8156,2110,Stuff Packs,17,1,0.058823529411764705,16
8157,2111,Expansion Packs,16,0,0.0,16
8158,2111,Game Packs,12,0,0.0,12
8159,2111,Kits,7,3,0.42857142857142855,4
8160,2111,Stuff Packs,19,2,0.10526315789473684,17
8161,2112,Expansion Packs,7,0,0.0,7
8162,2112,Game Packs,6,0,0.0,6
8163,2112,Kits,2,2,1.0,0
8164,2112,Stuff Packs,7,2,0.2857142857142857,5
8165,2113,Expansion Packs,3,0,0.0,3
8166,2113,Game Packs,2,0,0.0,2
8167,2113,Kits,1,1,1.0,0
8168,2113,Stuff Packs,2,0,0.0,2
8169,2114,Expansion Packs,10,0,0.0,10
8170,2114,Game Packs,3,0,0.0,3
8171,2114,Kits,2,0,0.0,2
8172,2114,Stuff Packs,9,5,0.5555555555555556,4
8173,2115,Expansion Packs,4,0,0.0,4
8174,2115,Game Packs,2,0,0.0,2
8175,2115,Kits,4,0,0.0,4
8176,2115,Stuff Packs,2,0,0.0,2
8177,2116,Expansion Packs,5,0,0.0,5
8178,2116,Game Packs,1,0,0.0,1
8179,2116,Kits,1,0,0.0,1
8180,2116,Stuff Packs,8,1,0.125,7
8181,2117,Expansion Packs,16,0,0.0,16
8182,2117,Game Packs,10,0,0.0,10
8183,2117,Kits,19,0,0.0,19
8184,2117,Stuff Packs,14,0,0.0,14
8185,2118,Expansion Packs,5,0,0.0,5
8186,2118,Game Packs,3,0,0.0,3
8187,2118,Kits,4,2,0.5,2
8188,2118,Stuff Packs,5,2,0.4,3
8189,2119,Expansion Packs,15,0,0.0,15
8190,2119,Game Packs,10,0,0.0,10
8191,2119,Kits,15,2,0.13333333333333333,13
8192,2119,Stuff Packs,19,0,0.0,19
8193,2120,Expansion Packs,7,0,0.0,7
8194,2120,Game Packs,8,1,0.125,7
8195,2120,Kits,5,3,0.6,2
8196,2120,Stuff Packs,7,3,0.42857142857142855,4
8197,2121,Expansion Packs,15,0,0.0,15
8198,2121,Game Packs,6,0,0.0,6
8199,2121,Kits,14,2,0.14285714285714285,12
8200,2121,Stuff Packs,15,4,0.26666666666666666,11
8201,2122,Expansion Packs,15,0,0.0,15
8202,2122,Game Packs,5,1,0.2,4
8203,2122,Kits,2,2,1.0,0
8204,2122,Stuff Packs,10,2,0.2,8
8205,2123,Expansion Packs,16,0,0.0,16
8206,2123,Game Packs,12,0,0.0,12
8207,2123,Kits,33,0,0.0,33
8208,2123,Stuff Packs,20,0,0.0,20
8209,2124,Expansion Packs,9,1,0.1111111111111111,8
8210,2124,Game Packs,3,0,0.0,3
8211,2124,Kits,7,3,0.42857142857142855,4
8212,2124,Stuff Packs,8,3,0.375,5
8213,2125,Expansion Packs,9,0,0.0,9
8214,2125,Game Packs,1,0,0.0,1
8215,2125,Kits,2,0,0.0,2
8216,2125,Stuff Packs,5,0,0.0,5
8217,2126,Expansion Packs,10,0,0.0,10
8218,2126,Game Packs,5,0,0.0,5
8219,2126,Kits,2,1,0.5,1
8220,2126,Stuff Packs,6,1,0.16666666666666666,5
8221,2127,Expansion Packs,12,0,0.0,12
8222,2127,Game Packs,8,0,0.0,8
8223,2127,Stuff Packs,14,0,0.0,14
8224,2128,Expansion Packs,12,0,0.0,12
8225,2128,Game Packs,8,1,0.125,7
8226,2128,Kits,4,4,1.0,0
8227,2128,Stuff Packs,8,1,0.125,7
8228,2129,Expansion Packs,16,0,0.0,16
8229,2129,Game Packs,12,0,0.0,12
8230,2129,Kits,32,4,0.125,28
8231,2129,Stuff Packs,20,0,0.0,20
8232,2130,Expansion Packs,8,0,0.0,8
8233,2130,Game Packs,6,0,0.0,6
8234,2130,Kits,3,3,1.0,0
8235,2130,Stuff Packs,7,4,0.5714285714285714,3
8236,2131,Expansion Packs,16,0,0.0,16
8237,2131,Game Packs,12,0,0.0,12
8238,2131,Kits,20,0,0.0,20
8239,2131,Stuff Packs,20,0,0.0,20
8240,2132,Expansion Packs,16,1,0.0625,15
8241,2132,Game Packs,11,0,0.0,11
8242,2132,Kits,2,0,0.0,2
8243,2132,Stuff Packs,11,1,0.09090909090909091,10
8244,2133,Expansion Packs,14,0,0.0,14
8245,2133,Game Packs,11,0,0.0,11
8246,2133,Kits,22,1,0.045454545454545456,21
8247,2133,Stuff Packs,19,0,0.0,19
8248,2134,Expansion Packs,4,0,0.0,4
8249,2134,Game Packs,4,0,0.0,4
8250,2134,Kits,3,3,1.0,0
8251,2134,Stuff Packs,2,2,1.0,0
8252,2135,Expansion Packs,16,0,0.0,16
8253,2135,Game Packs,12,0,0.0,12
8254,2135,Kits,33,0,0.0,33
8255,2135,Stuff Packs,20,0,0.0,20
8256,2136,Expansion Packs,16,1,0.0625,15
8257,2136,Game Packs,12,1,0.08333333333333333,11
8258,2136,Kits,12,1,0.08333333333333333,11
8259,2136,Stuff Packs,20,1,0.05,19
8260,2137,Expansion Packs,16,0,0.0,16
8261,2137,Game Packs,9,1,0.1111111111111111,8
8262,2137,Kits,5,2,0.4,3
8263,2137,Stuff Packs,19,0,0.0,19
8264,2138,Expansion Packs,11,0,0.0,11
8265,2138,Game Packs,3,1,0.3333333333333333,2
8266,2138,Kits,2,2,1.0,0
8267,2138,Stuff Packs,5,3,0.6,2
8268,2139,Expansion Packs,15,0,0.0,15
8269,2139,Game Packs,11,0,0.0,11
8270,2139,Kits,10,1,0.1,9
8271,2139,Stuff Packs,18,0,0.0,18
8272,2140,Expansion Packs,16,0,0.0,16
8273,2140,Game Packs,11,1,0.09090909090909091,10
8274,2140,Kits,4,2,0.5,2
8275,2140,Stuff Packs,13,3,0.23076923076923078,10
8276,2141,Expansion Packs,6,1,0.16666666666666666,5
8277,2141,Game Packs,3,0,0.0,3
8278,2141,Kits,6,0,0.0,6
8279,2141,Stuff Packs,8,3,0.375,5
8280,2142,Expansion Packs,16,0,0.0,16
8281,2142,Game Packs,12,0,0.0,12
8282,2142,Kits,33,0,0.0,33
8283,2142,Stuff Packs,20,0,0.0,20
8284,2143,Expansion Packs,16,0,0.0,16
8285,2143,Game Packs,12,0,0.0,12
8286,2143,Kits,7,1,0.14285714285714285,6
8287,2143,Stuff Packs,20,0,0.0,20
8288,2144,Expansion Packs,8,0,0.0,8
8289,2144,Game Packs,3,0,0.0,3
8290,2144,Stuff Packs,5,3,0.6,2
8291,2145,Expansion Packs,13,0,0.0,13
8292,2145,Game Packs,6,0,0.0,6
8293,2145,Kits,10,2,0.2,8
8294,2145,Stuff Packs,12,3,0.25,9
8295,2146,Expansion Packs,10,1,0.1,9
8296,2146,Game Packs,5,1,0.2,4
8297,2146,Kits,2,1,0.5,1
8298,2146,Stuff Packs,2,2,1.0,0
8299,2147,Expansion Packs,9,0,0.0,9
8300,2147,Game Packs,4,0,0.0,4
8301,2147,Kits,4,1,0.25,3
8302,2147,Stuff Packs,8,2,0.25,6
8303,2148,Expansion Packs,16,0,0.0,16
8304,2148,Game Packs,11,0,0.0,11
8305,2148,Kits,5,0,0.0,5
8306,2148,Stuff Packs,8,0,0.0,8
8307,2149,Expansion Packs,16,0,0.0,16
8308,2149,Game Packs,11,0,0.0,11
8309,2149,Kits,28,0,0.0,28
8310,2149,Stuff Packs,20,0,0.0,20
8311,2150,Expansion Packs,16,0,0.0,16
8312,2150,Game Packs,11,0,0.0,11
8313,2150,Kits,27,0,0.0,27
8314,2150,Stuff Packs,19,0,0.0,19
8315,2151,Expansion Packs,11,0,0.0,11
8316,2151,Game Packs,6,0,0.0,6
8317,2151,Kits,1,0,0.0,1
8318,2151,Stuff Packs,2,0,0.0,2
8319,2152,Expansion Packs,11,0,0.0,11
8320,2152,Game Packs,6,0,0.0,6
8321,2152,Stuff Packs,8,1,0.125,7
8322,2153,Expansion Packs,15,0,0.0,15
8323,2153,Game Packs,5,0,0.0,5
8324,2153,Kits,2,0,0.0,2
8325,2153,Stuff Packs,6,3,0.5,3
8326,2154,Expansion Packs,16,0,0.0,16
8327,2154,Game Packs,12,0,0.0,12
8328,2154,Kits,29,0,0.0,29
8329,2154,Stuff Packs,20,0,0.0,20
8330,2155,Expansion Packs,16,0,0.0,16
8331,2155,Game Packs,12,0,0.0,12
8332,2155,Kits,33,0,0.0,33
8333,2155,Stuff Packs,20,0,0.0,20
8334,2156,Expansion Packs,2,0,0.0,2
8335,2156,Game Packs,2,1,0.5,1
8336,2156,Kits,2,0,0.0,2
8337,2156,Stuff Packs,2,0,0.0,2
8338,2157,Expansion Packs,13,0,0.0,13
8339,2157,Game Packs,10,0,0.0,10
8340,2157,Stuff Packs,7,2,0.2857142857142857,5
8341,2158,Expansion Packs,16,0,0.0,16
8342,2158,Game Packs,11,0,0.0,11
8343,2158,Kits,32,2,0.0625,30
8344,2158,Stuff Packs,20,0,0.0,20
8345,2159,Expansion Packs,15,0,0.0,15
8346,2159,Game Packs,12,0,0.0,12
8347,2159,Kits,16,1,0.0625,15
8348,2159,Stuff Packs,20,0,0.0,20
8349,2160,Expansion Packs,16,0,0.0,16
8350,2160,Game Packs,11,0,0.0,11
8351,2160,Kits,31,0,0.0,31
8352,2160,Stuff Packs,20,0,0.0,20
8353,2161,Expansion Packs,16,0,0.0,16
8354,2161,Game Packs,8,0,0.0,8
8355,2161,Kits,11,2,0.18181818181818182,9
8356,2161,Stuff Packs,13,3,0.23076923076923078,10
8357,2162,Expansion Packs,9,0,0.0,9
8358,2162,Game Packs,6,1,0.16666666666666666,5
8359,2162,Kits,3,3,1.0,0
8360,2162,Stuff Packs,11,4,0.36363636363636365,7
8361,2163,Expansion Packs,13,0,0.0,13
8362,2163,Game Packs,10,0,0.0,10
8363,2163,Kits,4,0,0.0,4
8364,2163,Stuff Packs,16,0,0.0,16
8365,2164,Expansion Packs,14,0,0.0,14
8366,2164,Game Packs,12,0,0.0,12
8367,2164,Kits,6,1,0.16666666666666666,5
8368,2164,Stuff Packs,17,0,0.0,17
8369,2165,Expansion Packs,16,0,0.0,16
8370,2165,Game Packs,12,0,0.0,12
8371,2165,Kits,24,0,0.0,24
8372,2165,Stuff Packs,20,0,0.0,20
8373,2166,Expansion Packs,7,0,0.0,7
8374,2166,Game Packs,4,0,0.0,4
8375,2166,Kits,1,1,1.0,0
8376,2166,Stuff Packs,8,2,0.25,6
8377,2167,Expansion Packs,14,0,0.0,14
8378,2167,Game Packs,9,0,0.0,9
8379,2167,Kits,8,0,0.0,8
8380,2167,Stuff Packs,9,0,0.0,9
8381,2168,Expansion Packs,16,0,0.0,16
8382,2168,Game Packs,10,0,0.0,10
8383,2168,Kits,13,3,0.23076923076923078,10
8384,2168,Stuff Packs,16,2,0.125,14
8385,2169,Expansion Packs,16,0,0.0,16
8386,2169,Game Packs,12,0,0.0,12
8387,2169,Kits,22,1,0.045454545454545456,21
8388,2169,Stuff Packs,20,2,0.1,18
8389,2170,Expansion Packs,13,0,0.0,13
8390,2170,Game Packs,9,0,0.0,9
8391,2170,Kits,3,2,0.6666666666666666,1
8392,2170,Stuff Packs,12,2,0.16666666666666666,10
8393,2171,Expansion Packs,16,0,0.0,16
8394,2171,Game Packs,12,0,0.0,12
8395,2171,Kits,33,0,0.0,33
8396,2171,Stuff Packs,20,0,0.0,20
8397,2172,Expansion Packs,14,0,0.0,14
8398,2172,Game Packs,10,0,0.0,10
8399,2172,Kits,5,0,0.0,5
8400,2172,Stuff Packs,10,0,0.0,10
8401,2173,Expansion Packs,14,0,0.0,14
8402,2173,Game Packs,12,0,0.0,12
8403,2173,Kits,3,1,0.3333333333333333,2
8404,2173,Stuff Packs,16,0,0.0,16
8405,2174,Expansion Packs,16,0,0.0,16
8406,2174,Game Packs,12,1,0.08333333333333333,11
8407,2174,Kits,33,0,0.0,33
8408,2174,Stuff Packs,20,0,0.0,20
8409,2175,Expansion Packs,10,0,0.0,10
8410,2175,Game Packs,3,0,0.0,3
8411,2175,Kits,3,2,0.6666666666666666,1
8412,2175,Stuff Packs,6,3,0.5,3
8413,2176,Expansion Packs,14,0,0.0,14
8414,2176,Game Packs,11,0,0.0,11
8415,2176,Kits,11,1,0.09090909090909091,10
8416,2176,Stuff Packs,12,2,0.16666666666666666,10
8417,2177,Expansion Packs,16,0,0.0,16
8418,2177,Game Packs,12,0,0.0,12
8419,2177,Kits,27,1,0.037037037037037035,26
8420,2177,Stuff Packs,20,0,0.0,20
8421,2178,Expansion Packs,11,0,0.0,11
8422,2178,Game Packs,9,1,0.1111111111111111,8
8423,2178,Kits,4,1,0.25,3
8424,2178,Stuff Packs,15,6,0.4,9
8425,2179,Expansion Packs,12,0,0.0,12
8426,2179,Game Packs,6,1,0.16666666666666666,5
8427,2179,Kits,2,1,0.5,1
8428,2179,Stuff Packs,11,1,0.09090909090909091,10
8429,2180,Expansion Packs,12,0,0.0,12
8430,2180,Game Packs,9,0,0.0,9
8431,2180,Kits,2,1,0.5,1
8432,2180,Stuff Packs,10,2,0.2,8
8433,2181,Expansion Packs,5,0,0.0,5
8434,2181,Game Packs,2,0,0.0,2
8435,2181,Kits,3,0,0.0,3
8436,2181,Stuff Packs,3,1,0.3333333333333333,2
8437,2182,Expansion Packs,16,0,0.0,16
8438,2182,Game Packs,7,0,0.0,7
8439,2182,Kits,13,0,0.0,13
8440,2182,Stuff Packs,13,0,0.0,13
8441,2183,Expansion Packs,16,0,0.0,16
8442,2183,Game Packs,11,0,0.0,11
8443,2183,Kits,23,1,0.043478260869565216,22
8444,2183,Stuff Packs,16,1,0.0625,15
8445,2184,Expansion Packs,14,10,0.7142857142857143,4
8446,2184,Game Packs,11,6,0.5454545454545454,5
8447,2184,Kits,4,0,0.0,4
8448,2184,Stuff Packs,9,1,0.1111111111111111,8
8449,2185,Expansion Packs,16,0,0.0,16
8450,2185,Game Packs,11,0,0.0,11
8451,2185,Kits,20,0,0.0,20
8452,2185,Stuff Packs,20,0,0.0,20
8453,2186,Expansion Packs,15,0,0.0,15
8454,2186,Game Packs,11,0,0.0,11
8455,2186,Kits,14,1,0.07142857142857142,13
8456,2186,Stuff Packs,17,0,0.0,17
8457,2187,Expansion Packs,13,0,0.0,13
8458,2187,Game Packs,8,0,0.0,8
8459,2187,Stuff Packs,4,0,0.0,4
8460,2188,Expansion Packs,15,0,0.0,15
8461,2188,Game Packs,9,0,0.0,9
8462,2188,Kits,18,1,0.05555555555555555,17
8463,2188,Stuff Packs,14,2,0.14285714285714285,12
8464,2189,Expansion Packs,11,0,0.0,11
8465,2189,Game Packs,2,0,0.0,2
8466,2189,Stuff Packs,3,0,0.0,3
8467,2190,Expansion Packs,14,0,0.0,14
8468,2190,Game Packs,9,0,0.0,9
8469,2190,Kits,3,0,0.0,3
8470,2190,Stuff Packs,12,2,0.16666666666666666,10
8471,2191,Expansion Packs,6,0,0.0,6
8472,2191,Game Packs,5,1,0.2,4
8473,2191,Kits,4,3,0.75,1
8474,2191,Stuff Packs,10,4,0.4,6
8475,2192,Expansion Packs,16,0,0.0,16
8476,2192,Game Packs,12,0,0.0,12
8477,2192,Kits,33,0,0.0,33
8478,2192,Stuff Packs,20,0,0.0,20
8479,2193,Expansion Packs,16,0,0.0,16
8480,2193,Game Packs,12,0,0.0,12
8481,2193,Kits,33,2,0.06060606060606061,31
8482,2193,Stuff Packs,20,0,0.0,20
8483,2194,Expansion Packs,14,0,0.0,14
8484,2194,Game Packs,9,0,0.0,9
8485,2194,Kits,6,3,0.5,3
8486,2194,Stuff Packs,9,3,0.3333333333333333,6
8487,2195,Expansion Packs,16,0,0.0,16
8488,2195,Game Packs,12,0,0.0,12
8489,2195,Kits,33,0,0.0,33
8490,2195,Stuff Packs,20,0,0.0,20
8491,2196,Expansion Packs,5,0,0.0,5
8492,2196,Game Packs,2,1,0.5,1
8493,2196,Kits,1,1,1.0,0
8494,2196,Stuff Packs,3,2,0.6666666666666666,1
8495,2197,Expansion Packs,15,3,0.2,12
8496,2197,Game Packs,11,2,0.18181818181818182,9
8497,2197,Stuff Packs,10,0,0.0,10
8498,2198,Expansion Packs,14,0,0.0,14
8499,2198,Game Packs,7,0,0.0,7
8500,2198,Kits,11,1,0.09090909090909091,10
8501,2198,Stuff Packs,6,0,0.0,6
8502,2199,Expansion Packs,10,0,0.0,10
8503,2199,Game Packs,8,0,0.0,8
8504,2199,Kits,1,0,0.0,1
8505,2199,Stuff Packs,13,0,0.0,13
8506,2200,Expansion Packs,11,0,0.0,11
8507,2200,Game Packs,5,0,0.0,5
8508,2200,Kits,3,0,0.0,3
8509,2200,Stuff Packs,3,0,0.0,3
8510,2201,Expansion Packs,10,0,0.0,10
8511,2201,Game Packs,5,0,0.0,5
8512,2201,Kits,5,2,0.4,3
8513,2201,Stuff Packs,5,0,0.0,5
8514,2202,Expansion Packs,7,0,0.0,7
8515,2202,Game Packs,6,1,0.16666666666666666,5
8516,2202,Kits,6,3,0.5,3
8517,2202,Stuff Packs,8,4,0.5,4
8518,2203,Expansion Packs,16,0,0.0,16
8519,2203,Game Packs,12,0,0.0,12
8520,2203,Kits,33,0,0.0,33
8521,2203,Stuff Packs,20,0,0.0,20
8522,2204,Expansion Packs,5,0,0.0,5
8523,2204,Game Packs,1,1,1.0,0
8524,2204,Kits,3,0,0.0,3
8525,2204,Stuff Packs,4,1,0.25,3
8526,2205,Expansion Packs,6,0,0.0,6
8527,2205,Game Packs,1,0,0.0,1
8528,2205,Kits,3,0,0.0,3
8529,2205,Stuff Packs,4,0,0.0,4
8530,2206,Expansion Packs,9,0,0.0,9
8531,2206,Stuff Packs,2,0,0.0,2
8532,2207,Expansion Packs,5,0,0.0,5
8533,2207,Game Packs,2,0,0.0,2
8534,2207,Kits,1,1,1.0,0
8535,2207,Stuff Packs,4,2,0.5,2
8536,2208,Expansion Packs,8,0,0.0,8
8537,2208,Game Packs,4,0,0.0,4
8538,2208,Kits,2,1,0.5,1
8539,2208,Stuff Packs,7,3,0.42857142857142855,4
8540,2209,Expansion Packs,16,0,0.0,16
8541,2209,Game Packs,12,0,0.0,12
8542,2209,Kits,31,1,0.03225806451612903,30
8543,2209,Stuff Packs,20,0,0.0,20
8544,2210,Expansion Packs,14,0,0.0,14
8545,2210,Game Packs,10,0,0.0,10
8546,2210,Kits,17,3,0.17647058823529413,14
8547,2210,Stuff Packs,19,1,0.05263157894736842,18
8548,2211,Expansion Packs,1,0,0.0,1
8549,2211,Game Packs,1,0,0.0,1
8550,2211,Stuff Packs,1,0,0.0,1
8551,2212,Expansion Packs,16,0,0.0,16
8552,2212,Game Packs,9,1,0.1111111111111111,8
8553,2212,Kits,16,1,0.0625,15
8554,2212,Stuff Packs,14,3,0.21428571428571427,11
8555,2213,Expansion Packs,15,0,0.0,15
8556,2213,Game Packs,5,0,0.0,5
8557,2213,Kits,10,2,0.2,8
8558,2213,Stuff Packs,10,3,0.3,7
8559,2214,Expansion Packs,11,0,0.0,11
8560,2214,Game Packs,6,0,0.0,6
8561,2214,Stuff Packs,6,1,0.16666666666666666,5
8562,2215,Expansion Packs,16,0,0.0,16
8563,2215,Game Packs,12,0,0.0,12
8564,2215,Kits,33,1,0.030303030303030304,32
8565,2215,Stuff Packs,20,0,0.0,20
8566,2216,Expansion Packs,5,0,0.0,5
8567,2216,Game Packs,3,0,0.0,3
8568,2216,Kits,11,0,0.0,11
8569,2216,Stuff Packs,5,1,0.2,4
8570,2217,Expansion Packs,6,0,0.0,6
8571,2217,Game Packs,4,1,0.25,3
8572,2217,Kits,3,2,0.6666666666666666,1
8573,2217,Stuff Packs,5,3,0.6,2
8574,2218,Expansion Packs,16,1,0.0625,15
8575,2218,Game Packs,12,0,0.0,12
8576,2218,Kits,28,1,0.03571428571428571,27
8577,2218,Stuff Packs,20,0,0.0,20
8578,2219,Expansion Packs,8,0,0.0,8
8579,2219,Game Packs,3,0,0.0,3
8580,2219,Kits,1,1,1.0,0
8581,2219,Stuff Packs,4,2,0.5,2
8582,2220,Expansion Packs,16,0,0.0,16
8583,2220,Game Packs,12,0,0.0,12
8584,2220,Kits,7,1,0.14285714285714285,6
8585,2220,Stuff Packs,19,0,0.0,19
8586,2221,Expansion Packs,16,0,0.0,16
8587,2221,Game Packs,5,0,0.0,5
8588,2221,Kits,5,1,0.2,4
8589,2221,Stuff Packs,13,2,0.15384615384615385,11
8590,2222,Expansion Packs,15,0,0.0,15
8591,2222,Game Packs,10,0,0.0,10
8592,2222,Kits,3,0,0.0,3
8593,2222,Stuff Packs,20,0,0.0,20
8594,2223,Expansion Packs,16,0,0.0,16
8595,2223,Game Packs,12,0,0.0,12
8596,2223,Kits,33,1,0.030303030303030304,32
8597,2223,Stuff Packs,20,0,0.0,20
8598,2224,Expansion Packs,5,0,0.0,5
8599,2224,Game Packs,4,0,0.0,4
8600,2224,Stuff Packs,10,0,0.0,10
8601,2225,Expansion Packs,3,0,0.0,3
8602,2225,Game Packs,3,0,0.0,3
8603,2225,Kits,3,0,0.0,3
8604,2225,Stuff Packs,4,0,0.0,4
8605,2226,Expansion Packs,12,0,0.0,12
8606,2226,Game Packs,3,0,0.0,3
8607,2226,Kits,4,1,0.25,3
8608,2226,Stuff Packs,10,1,0.1,9
8609,2227,Expansion Packs,7,0,0.0,7
8610,2227,Game Packs,6,0,0.0,6
8611,2227,Kits,10,2,0.2,8
8612,2227,Stuff Packs,7,0,0.0,7
8613,2228,Expansion Packs,6,0,0.0,6
8614,2228,Game Packs,4,0,0.0,4
8615,2228,Kits,4,2,0.5,2
8616,2228,Stuff Packs,6,3,0.5,3
8617,2229,Expansion Packs,16,0,0.0,16
8618,2229,Game Packs,12,0,0.0,12
8619,2229,Kits,19,1,0.05263157894736842,18
8620,2229,Stuff Packs,20,0,0.0,20
8621,2230,Expansion Packs,9,0,0.0,9
8622,2230,Game Packs,4,0,0.0,4
8623,2230,Kits,4,0,0.0,4
8624,2230,Stuff Packs,5,0,0.0,5
8625,2231,Expansion Packs,3,0,0.0,3
8626,2231,Game Packs,1,0,0.0,1
8627,2231,Kits,2,0,0.0,2
8628,2231,Stuff Packs,1,0,0.0,1
8629,2232,Expansion Packs,16,10,0.625,6
8630,2232,Game Packs,11,9,0.8181818181818182,2
8631,2232,Kits,18,1,0.05555555555555555,17
8632,2232,Stuff Packs,15,1,0.06666666666666667,14
8633,2233,Expansion Packs,1,0,0.0,1
8634,2233,Game Packs,1,0,0.0,1
8635,2233,Stuff Packs,4,1,0.25,3
8636,2234,Expansion Packs,6,0,0.0,6
8637,2234,Game Packs,3,1,0.3333333333333333,2
8638,2234,Kits,3,0,0.0,3
8639,2234,Stuff Packs,5,3,0.6,2
8640,2235,Expansion Packs,13,0,0.0,13
8641,2235,Game Packs,10,0,0.0,10
8642,2235,Stuff Packs,15,1,0.06666666666666667,14
8643,2236,Expansion Packs,16,0,0.0,16
8644,2236,Game Packs,11,0,0.0,11
8645,2236,Kits,14,1,0.07142857142857142,13
8646,2236,Stuff Packs,20,1,0.05,19
8647,2237,Expansion Packs,16,0,0.0,16
8648,2237,Game Packs,12,0,0.0,12
8649,2237,Kits,33,0,0.0,33
8650,2237,Stuff Packs,20,0,0.0,20
8651,2238,Expansion Packs,15,0,0.0,15
8652,2238,Game Packs,8,0,0.0,8
8653,2238,Kits,6,0,0.0,6
8654,2238,Stuff Packs,10,1,0.1,9
8655,2239,Expansion Packs,16,0,0.0,16
8656,2239,Game Packs,12,0,0.0,12
8657,2239,Kits,15,0,0.0,15
8658,2239,Stuff Packs,18,0,0.0,18
8659,2240,Expansion Packs,3,0,0.0,3
8660,2240,Game Packs,3,0,0.0,3
8661,2240,Kits,3,3,1.0,0
8662,2240,Stuff Packs,6,4,0.6666666666666666,2
8663,2241,Expansion Packs,14,0,0.0,14
8664,2241,Game Packs,11,0,0.0,11
8665,2241,Kits,16,1,0.0625,15
8666,2241,Stuff Packs,17,2,0.11764705882352941,15
8667,2242,Expansion Packs,14,0,0.0,14
8668,2242,Game Packs,4,0,0.0,4
8669,2242,Kits,1,0,0.0,1
8670,2242,Stuff Packs,9,2,0.2222222222222222,7
8671,2243,Expansion Packs,14,0,0.0,14
8672,2243,Game Packs,8,0,0.0,8
8673,2243,Kits,2,2,1.0,0
8674,2243,Stuff Packs,8,1,0.125,7
8675,2244,Expansion Packs,14,0,0.0,14
8676,2244,Game Packs,10,0,0.0,10
8677,2244,Kits,9,2,0.2222222222222222,7
8678,2244,Stuff Packs,13,1,0.07692307692307693,12
8679,2245,Expansion Packs,8,1,0.125,7
8680,2245,Game Packs,2,0,0.0,2
8681,2245,Kits,3,1,0.3333333333333333,2
8682,2245,Stuff Packs,5,2,0.4,3
8683,2246,Expansion Packs,4,2,0.5,2
8684,2246,Game Packs,2,1,0.5,1
8685,2246,Stuff Packs,4,2,0.5,2
8686,2247,Expansion Packs,10,0,0.0,10
8687,2247,Game Packs,3,1,0.3333333333333333,2
8688,2247,Kits,1,1,1.0,0
8689,2247,Stuff Packs,3,1,0.3333333333333333,2
8690,2248,Expansion Packs,16,0,0.0,16
8691,2248,Game Packs,12,0,0.0,12
8692,2248,Kits,18,0,0.0,18
8693,2248,Stuff Packs,20,0,0.0,20
8694,2249,Expansion Packs,16,0,0.0,16
8695,2249,Game Packs,12,0,0.0,12
8696,2249,Kits,33,0,0.0,33
8697,2249,Stuff Packs,20,0,0.0,20
8698,2250,Expansion Packs,15,0,0.0,15
8699,2250,Game Packs,9,0,0.0,9
8700,2250,Kits,13,0,0.0,13
8701,2250,Stuff Packs,14,3,0.21428571428571427,11
8702,2251,Expansion Packs,2,0,0.0,2
8703,2251,Game Packs,2,1,0.5,1
8704,2251,Kits,2,2,1.0,0
8705,2251,Stuff Packs,3,2,0.6666666666666666,1
8706,2252,Expansion Packs,16,0,0.0,16
8707,2252,Game Packs,12,0,0.0,12
8708,2252,Kits,33,0,0.0,33
8709,2252,Stuff Packs,20,1,0.05,19
8710,2253,Expansion Packs,13,0,0.0,13
8711,2253,Game Packs,7,1,0.14285714285714285,6
8712,2253,Kits,5,1,0.2,4
8713,2253,Stuff Packs,8,3,0.375,5
8714,2254,Expansion Packs,10,0,0.0,10
8715,2254,Game Packs,7,0,0.0,7
8716,2254,Stuff Packs,10,2,0.2,8
8717,2255,Expansion Packs,16,0,0.0,16
8718,2255,Game Packs,12,0,0.0,12
8719,2255,Kits,33,0,0.0,33
8720,2255,Stuff Packs,20,0,0.0,20
8721,2256,Expansion Packs,16,0,0.0,16
8722,2256,Game Packs,11,0,0.0,11
8723,2256,Kits,6,0,0.0,6
8724,2256,Stuff Packs,19,1,0.05263157894736842,18
8725,2257,Expansion Packs,16,0,0.0,16
8726,2257,Game Packs,12,0,0.0,12
8727,2257,Kits,15,1,0.06666666666666667,14
8728,2257,Stuff Packs,20,0,0.0,20
8729,2258,Expansion Packs,5,0,0.0,5
8730,2258,Game Packs,2,0,0.0,2
8731,2258,Kits,3,0,0.0,3
8732,2258,Stuff Packs,6,3,0.5,3
8733,2259,Expansion Packs,6,0,0.0,6
8734,2259,Game Packs,5,1,0.2,4
8735,2259,Kits,3,3,1.0,0
8736,2259,Stuff Packs,5,4,0.8,1
8737,2260,Expansion Packs,10,0,0.0,10
8738,2260,Game Packs,6,0,0.0,6
8739,2260,Kits,2,2,1.0,0
8740,2260,Stuff Packs,10,2,0.2,8
8741,2261,Expansion Packs,14,2,0.14285714285714285,12
8742,2261,Game Packs,6,0,0.0,6
8743,2261,Kits,1,0,0.0,1
8744,2261,Stuff Packs,9,2,0.2222222222222222,7
8745,2262,Expansion Packs,14,0,0.0,14
8746,2262,Game Packs,11,0,0.0,11
8747,2262,Kits,15,0,0.0,15
8748,2262,Stuff Packs,17,2,0.11764705882352941,15
8749,2263,Expansion Packs,11,0,0.0,11
8750,2263,Game Packs,2,0,0.0,2
8751,2263,Kits,3,1,0.3333333333333333,2
8752,2263,Stuff Packs,6,0,0.0,6
8753,2264,Expansion Packs,12,1,0.08333333333333333,11
8754,2264,Game Packs,4,0,0.0,4
8755,2264,Kits,2,0,0.0,2
8756,2264,Stuff Packs,6,1,0.16666666666666666,5
8757,2265,Expansion Packs,16,0,0.0,16
8758,2265,Game Packs,12,0,0.0,12
8759,2265,Kits,33,1,0.030303030303030304,32
8760,2265,Stuff Packs,20,0,0.0,20
8761,2266,Expansion Packs,16,0,0.0,16
8762,2266,Game Packs,11,0,0.0,11
8763,2266,Kits,27,1,0.037037037037037035,26
8764,2266,Stuff Packs,20,2,0.1,18
8765,2267,Expansion Packs,16,0,0.0,16
8766,2267,Game Packs,12,0,0.0,12
8767,2267,Kits,22,0,0.0,22
8768,2267,Stuff Packs,20,0,0.0,20
8769,2268,Expansion Packs,16,0,0.0,16
8770,2268,Game Packs,12,0,0.0,12
8771,2268,Kits,27,0,0.0,27
8772,2268,Stuff Packs,20,0,0.0,20
8773,2269,Kits,2,2,1.0,0
8774,2269,Stuff Packs,3,3,1.0,0
8775,2270,Expansion Packs,11,0,0.0,11
8776,2270,Game Packs,8,0,0.0,8
8777,2270,Kits,1,1,1.0,0
8778,2270,Stuff Packs,10,0,0.0,10
8779,2271,Expansion Packs,16,0,0.0,16
8780,2271,Game Packs,12,0,0.0,12
8781,2271,Kits,33,0,0.0,33
8782,2271,Stuff Packs,20,0,0.0,20
8783,2272,Expansion Packs,8,0,0.0,8
8784,2272,Stuff Packs,6,1,0.16666666666666666,5
8785,2273,Expansion Packs,12,0,0.0,12
8786,2273,Game Packs,9,0,0.0,9
8787,2273,Kits,8,1,0.125,7
8788,2273,Stuff Packs,14,0,0.0,14
8789,2274,Expansion Packs,15,0,0.0,15
8790,2274,Game Packs,10,0,0.0,10
8791,2274,Kits,5,1,0.2,4
8792,2274,Stuff Packs,13,0,0.0,13
8793,2275,Expansion Packs,10,0,0.0,10
8794,2275,Game Packs,8,0,0.0,8
8795,2275,Kits,3,3,1.0,0
8796,2275,Stuff Packs,11,1,0.09090909090909091,10
8797,2276,Expansion Packs,5,0,0.0,5
8798,2276,Game Packs,3,0,0.0,3
8799,2276,Kits,1,1,1.0,0
8800,2276,Stuff Packs,4,2,0.5,2
8801,2277,Game Packs,1,0,0.0,1
8802,2277,Stuff Packs,2,1,0.5,1
8803,2278,Expansion Packs,15,11,0.7333333333333333,4
8804,2278,Game Packs,8,6,0.75,2
8805,2278,Kits,17,1,0.058823529411764705,16
8806,2278,Stuff Packs,19,17,0.8947368421052632,2
8807,2279,Expansion Packs,5,0,0.0,5
8808,2279,Game Packs,1,0,0.0,1
8809,2279,Kits,3,3,1.0,0
8810,2279,Stuff Packs,6,3,0.5,3
8811,2280,Expansion Packs,16,0,0.0,16
8812,2280,Game Packs,11,0,0.0,11
8813,2280,Kits,9,0,0.0,9
8814,2280,Stuff Packs,15,0,0.0,15
8815,2281,Expansion Packs,13,0,0.0,13
8816,2281,Game Packs,6,0,0.0,6
8817,2281,Kits,4,1,0.25,3
8818,2281,Stuff Packs,15,0,0.0,15
8819,2282,Expansion Packs,15,0,0.0,15
8820,2282,Game Packs,9,0,0.0,9
8821,2282,Kits,8,3,0.375,5
8822,2282,Stuff Packs,17,0,0.0,17
8823,2283,Expansion Packs,16,0,0.0,16
8824,2283,Game Packs,11,0,0.0,11
8825,2283,Kits,11,3,0.2727272727272727,8
8826,2283,Stuff Packs,20,0,0.0,20
8827,2284,Expansion Packs,11,0,0.0,11
8828,2284,Game Packs,4,0,0.0,4
8829,2284,Kits,4,2,0.5,2
8830,2284,Stuff Packs,7,1,0.14285714285714285,6
8831,2285,Expansion Packs,16,0,0.0,16
8832,2285,Game Packs,5,0,0.0,5
8833,2285,Kits,9,1,0.1111111111111111,8
8834,2285,Stuff Packs,6,3,0.5,3
8835,2286,Expansion Packs,16,0,0.0,16
8836,2286,Game Packs,10,0,0.0,10
8837,2286,Kits,4,3,0.75,1
8838,2286,Stuff Packs,18,1,0.05555555555555555,17
8839,2287,Expansion Packs,5,0,0.0,5
8840,2287,Game Packs,2,0,0.0,2
8841,2287,Kits,2,2,1.0,0
8842,2287,Stuff Packs,4,3,0.75,1
8843,2288,Expansion Packs,6,0,0.0,6
8844,2288,Game Packs,3,0,0.0,3
8845,2288,Kits,2,0,0.0,2
8846,2288,Stuff Packs,10,1,0.1,9
8847,2289,Expansion Packs,8,0,0.0,8
8848,2289,Game Packs,1,0,0.0,1
8849,2289,Kits,1,1,1.0,0
8850,2289,Stuff Packs,4,3,0.75,1
8851,2290,Expansion Packs,6,0,0.0,6
8852,2290,Game Packs,1,0,0.0,1
8853,2290,Kits,1,1,1.0,0
8854,2291,Expansion Packs,16,0,0.0,16
8855,2291,Game Packs,10,0,0.0,10
8856,2291,Kits,7,2,0.2857142857142857,5
8857,2291,Stuff Packs,18,1,0.05555555555555555,17
8858,2292,Expansion Packs,12,0,0.0,12
8859,2292,Game Packs,7,0,0.0,7
8860,2292,Stuff Packs,7,0,0.0,7
8861,2293,Expansion Packs,8,0,0.0,8
8862,2293,Game Packs,2,0,0.0,2
8863,2294,Expansion Packs,16,0,0.0,16
8864,2294,Game Packs,9,0,0.0,9
8865,2294,Kits,25,0,0.0,25
8866,2294,Stuff Packs,16,2,0.125,14
8867,2295,Expansion Packs,15,0,0.0,15
8868,2295,Game Packs,12,0,0.0,12
8869,2295,Kits,19,1,0.05263157894736842,18
8870,2295,Stuff Packs,20,0,0.0,20
8871,2296,Expansion Packs,9,0,0.0,9
8872,2296,Game Packs,8,0,0.0,8
8873,2296,Kits,1,1,1.0,0
8874,2296,Stuff Packs,14,0,0.0,14
8875,2297,Expansion Packs,14,0,0.0,14
8876,2297,Game Packs,10,0,0.0,10
8877,2297,Kits,6,1,0.16666666666666666,5
8878,2297,Stuff Packs,12,2,0.16666666666666666,10
8879,2298,Expansion Packs,16,0,0.0,16
8880,2298,Game Packs,12,0,0.0,12
8881,2298,Kits,27,2,0.07407407407407407,25
8882,2298,Stuff Packs,20,1,0.05,19
8883,2299,Expansion Packs,11,0,0.0,11
8884,2299,Game Packs,9,1,0.1111111111111111,8
8885,2299,Kits,2,2,1.0,0
8886,2299,Stuff Packs,11,3,0.2727272727272727,8
8887,2300,Expansion Packs,13,0,0.0,13
8888,2300,Game Packs,10,0,0.0,10
8889,2300,Kits,2,0,0.0,2
8890,2300,Stuff Packs,18,0,0.0,18
8891,2301,Expansion Packs,16,1,0.0625,15
8892,2301,Game Packs,11,0,0.0,11
8893,2301,Kits,23,1,0.043478260869565216,22
8894,2301,Stuff Packs,20,0,0.0,20
8895,2302,Expansion Packs,16,0,0.0,16
8896,2302,Game Packs,11,0,0.0,11
8897,2302,Kits,31,0,0.0,31
8898,2302,Stuff Packs,16,0,0.0,16
8899,2303,Expansion Packs,16,0,0.0,16
8900,2303,Game Packs,12,0,0.0,12
8901,2303,Kits,33,0,0.0,33
8902,2303,Stuff Packs,20,0,0.0,20
8903,2304,Expansion Packs,16,0,0.0,16
8904,2304,Game Packs,12,0,0.0,12
8905,2304,Kits,15,0,0.0,15
8906,2304,Stuff Packs,20,0,0.0,20
8907,2305,Expansion Packs,8,0,0.0,8
8908,2305,Game Packs,6,0,0.0,6
8909,2305,Kits,1,0,0.0,1
8910,2305,Stuff Packs,5,2,0.4,3
8911,2306,Expansion Packs,12,0,0.0,12
8912,2306,Game Packs,6,0,0.0,6
8913,2306,Kits,1,1,1.0,0
8914,2306,Stuff Packs,8,1,0.125,7
8915,2307,Expansion Packs,16,0,0.0,16
8916,2307,Game Packs,11,0,0.0,11
8917,2307,Kits,33,0,0.0,33
8918,2307,Stuff Packs,20,0,0.0,20
8919,2308,Expansion Packs,15,0,0.0,15
8920,2308,Game Packs,7,0,0.0,7
8921,2308,Kits,1,1,1.0,0
8922,2308,Stuff Packs,5,1,0.2,4
8923,2309,Expansion Packs,16,0,0.0,16
8924,2309,Game Packs,12,0,0.0,12
8925,2309,Kits,33,0,0.0,33
8926,2309,Stuff Packs,20,0,0.0,20
8927,2310,Expansion Packs,16,0,0.0,16
8928,2310,Game Packs,12,0,0.0,12
8929,2310,Kits,19,2,0.10526315789473684,17
8930,2310,Stuff Packs,20,2,0.1,18
8931,2311,Expansion Packs,2,0,0.0,2
8932,2311,Game Packs,3,1,0.3333333333333333,2
8933,2311,Kits,3,3,1.0,0
8934,2311,Stuff Packs,6,4,0.6666666666666666,2
8935,2312,Expansion Packs,16,0,0.0,16
8936,2312,Game Packs,12,0,0.0,12
8937,2312,Kits,33,1,0.030303030303030304,32
8938,2312,Stuff Packs,20,0,0.0,20
8939,2313,Expansion Packs,15,0,0.0,15
8940,2313,Game Packs,11,0,0.0,11
8941,2313,Kits,5,2,0.4,3
8942,2313,Stuff Packs,19,0,0.0,19
8943,2314,Expansion Packs,9,0,0.0,9
8944,2314,Game Packs,6,0,0.0,6
8945,2314,Kits,5,2,0.4,3
8946,2314,Stuff Packs,14,2,0.14285714285714285,12
8947,2315,Expansion Packs,12,0,0.0,12
8948,2315,Game Packs,5,0,0.0,5
8949,2315,Kits,8,0,0.0,8
8950,2315,Stuff Packs,12,3,0.25,9
8951,2316,Expansion Packs,13,0,0.0,13
8952,2316,Game Packs,10,0,0.0,10
8953,2316,Kits,4,1,0.25,3
8954,2316,Stuff Packs,18,4,0.2222222222222222,14
8955,2317,Expansion Packs,16,0,0.0,16
8956,2317,Game Packs,9,1,0.1111111111111111,8
8957,2317,Kits,8,2,0.25,6
8958,2317,Stuff Packs,11,2,0.18181818181818182,9
8959,2318,Expansion Packs,13,0,0.0,13
8960,2318,Game Packs,9,0,0.0,9
8961,2318,Kits,17,3,0.17647058823529413,14
8962,2318,Stuff Packs,12,2,0.16666666666666666,10
8963,2319,Expansion Packs,8,0,0.0,8
8964,2319,Game Packs,2,0,0.0,2
8965,2319,Kits,2,1,0.5,1
8966,2319,Stuff Packs,1,0,0.0,1
8967,2320,Expansion Packs,16,0,0.0,16
8968,2320,Game Packs,10,0,0.0,10
8969,2320,Kits,30,0,0.0,30
8970,2320,Stuff Packs,19,0,0.0,19
8971,2321,Expansion Packs,13,0,0.0,13
8972,2321,Game Packs,8,0,0.0,8
8973,2321,Kits,6,3,0.5,3
8974,2321,Stuff Packs,8,3,0.375,5
8975,2322,Expansion Packs,11,0,0.0,11
8976,2322,Game Packs,10,0,0.0,10
8977,2322,Kits,9,1,0.1111111111111111,8
8978,2322,Stuff Packs,14,1,0.07142857142857142,13
8979,2323,Expansion Packs,9,0,0.0,9
8980,2323,Game Packs,3,0,0.0,3
8981,2323,Kits,1,0,0.0,1
8982,2323,Stuff Packs,8,3,0.375,5
8983,2324,Expansion Packs,12,0,0.0,12
8984,2324,Game Packs,10,0,0.0,10
8985,2324,Kits,2,0,0.0,2
8986,2324,Stuff Packs,16,0,0.0,16
8987,2325,Expansion Packs,16,0,0.0,16
8988,2325,Game Packs,12,0,0.0,12
8989,2325,Kits,33,1,0.030303030303030304,32
8990,2325,Stuff Packs,20,0,0.0,20
8991,2326,Expansion Packs,16,8,0.5,8
8992,2326,Game Packs,12,12,1.0,0
8993,2326,Kits,33,33,1.0,0
8994,2326,Stuff Packs,20,20,1.0,0
8995,2327,Expansion Packs,12,0,0.0,12
8996,2327,Game Packs,6,0,0.0,6
8997,2327,Kits,7,1,0.14285714285714285,6
8998,2327,Stuff Packs,9,2,0.2222222222222222,7
8999,2328,Expansion Packs,15,0,0.0,15
9000,2328,Game Packs,6,0,0.0,6
9001,2328,Kits,14,1,0.07142857142857142,13
9002,2328,Stuff Packs,9,2,0.2222222222222222,7
9003,2329,Expansion Packs,16,0,0.0,16
9004,2329,Game Packs,12,0,0.0,12
9005,2329,Kits,28,1,0.03571428571428571,27
9006,2329,Stuff Packs,20,0,0.0,20
9007,2330,Expansion Packs,5,0,0.0,5
9008,2330,Game Packs,3,0,0.0,3
9009,2330,Stuff Packs,5,0,0.0,5
9010,2331,Expansion Packs,14,0,0.0,14
9011,2331,Game Packs,8,0,0.0,8
9012,2331,Kits,19,0,0.0,19
9013,2331,Stuff Packs,18,0,0.0,18
9014,2332,Expansion Packs,11,0,0.0,11
9015,2332,Game Packs,2,0,0.0,2
9016,2332,Kits,2,0,0.0,2
9017,2332,Stuff Packs,7,0,0.0,7
9018,2333,Expansion Packs,15,1,0.06666666666666667,14
9019,2333,Game Packs,11,1,0.09090909090909091,10
9020,2333,Kits,6,2,0.3333333333333333,4
9021,2333,Stuff Packs,11,4,0.36363636363636365,7
9022,2334,Expansion Packs,15,0,0.0,15
9023,2334,Game Packs,12,0,0.0,12
9024,2334,Kits,31,0,0.0,31
9025,2334,Stuff Packs,20,0,0.0,20
9026,2335,Expansion Packs,14,0,0.0,14
9027,2335,Game Packs,11,0,0.0,11
9028,2335,Kits,7,1,0.14285714285714285,6
9029,2335,Stuff Packs,20,0,0.0,20
9030,2336,Expansion Packs,16,0,0.0,16
9031,2336,Game Packs,12,0,0.0,12
9032,2336,Kits,33,0,0.0,33
9033,2336,Stuff Packs,20,0,0.0,20
9034,2337,Expansion Packs,16,0,0.0,16
9035,2337,Game Packs,8,0,0.0,8
9036,2337,Stuff Packs,18,1,0.05555555555555555,17
9037,2338,Expansion Packs,16,0,0.0,16
9038,2338,Game Packs,8,0,0.0,8
9039,2338,Kits,5,2,0.4,3
9040,2338,Stuff Packs,7,3,0.42857142857142855,4
9041,2339,Expansion Packs,16,0,0.0,16
9042,2339,Game Packs,12,0,0.0,12
9043,2339,Kits,22,1,0.045454545454545456,21
9044,2339,Stuff Packs,20,0,0.0,20
9045,2340,Expansion Packs,1,0,0.0,1
9046,2340,Game Packs,2,1,0.5,1
9047,2340,Kits,3,3,1.0,0
9048,2340,Stuff Packs,5,4,0.8,1
9049,2341,Expansion Packs,16,0,0.0,16
9050,2341,Game Packs,12,0,0.0,12
9051,2341,Kits,33,0,0.0,33
9052,2341,Stuff Packs,20,0,0.0,20
9053,2342,Expansion Packs,4,0,0.0,4
9054,2342,Game Packs,1,0,0.0,1
9055,2342,Stuff Packs,5,1,0.2,4
9056,2343,Expansion Packs,16,0,0.0,16
9057,2343,Game Packs,12,0,0.0,12
9058,2343,Kits,30,1,0.03333333333333333,29
9059,2343,Stuff Packs,20,0,0.0,20
9060,2344,Expansion Packs,13,0,0.0,13
9061,2344,Game Packs,8,1,0.125,7
9062,2344,Kits,3,2,0.6666666666666666,1
9063,2344,Stuff Packs,10,4,0.4,6
9064,2345,Expansion Packs,11,0,0.0,11
9065,2345,Game Packs,5,0,0.0,5
9066,2345,Kits,3,1,0.3333333333333333,2
9067,2345,Stuff Packs,8,4,0.5,4
9068,2346,Expansion Packs,9,0,0.0,9
9069,2346,Game Packs,8,0,0.0,8
9070,2346,Kits,5,1,0.2,4
9071,2346,Stuff Packs,9,2,0.2222222222222222,7
9072,2347,Expansion Packs,5,0,0.0,5
9073,2347,Kits,1,1,1.0,0
9074,2347,Stuff Packs,2,1,0.5,1
9075,2348,Kits,1,0,0.0,1
9076,2348,Stuff Packs,2,1,0.5,1
9077,2349,Expansion Packs,16,0,0.0,16
9078,2349,Game Packs,12,0,0.0,12
9079,2349,Kits,26,1,0.038461538461538464,25
9080,2349,Stuff Packs,20,0,0.0,20
9081,2350,Expansion Packs,16,0,0.0,16
9082,2350,Game Packs,12,0,0.0,12
9083,2350,Kits,24,0,0.0,24
9084,2350,Stuff Packs,20,1,0.05,19
9085,2351,Kits,1,1,1.0,0
9086,2351,Stuff Packs,1,1,1.0,0
9087,2352,Expansion Packs,7,0,0.0,7
9088,2352,Game Packs,2,0,0.0,2
9089,2352,Stuff Packs,2,0,0.0,2
9090,2353,Expansion Packs,5,0,0.0,5
9091,2353,Kits,1,1,1.0,0
9092,2353,Stuff Packs,3,1,0.3333333333333333,2
9093,2354,Expansion Packs,14,0,0.0,14
9094,2354,Game Packs,9,0,0.0,9
9095,2354,Kits,8,0,0.0,8
9096,2354,Stuff Packs,13,0,0.0,13
9097,2355,Expansion Packs,16,0,0.0,16
9098,2355,Game Packs,11,0,0.0,11
9099,2355,Kits,16,1,0.0625,15
9100,2355,Stuff Packs,17,1,0.058823529411764705,16
9101,2356,Expansion Packs,10,0,0.0,10
9102,2356,Game Packs,5,0,0.0,5
9103,2356,Kits,1,1,1.0,0
9104,2356,Stuff Packs,11,1,0.09090909090909091,10
9105,2357,Expansion Packs,15,0,0.0,15
9106,2357,Game Packs,11,0,0.0,11
9107,2357,Kits,6,0,0.0,6
9108,2357,Stuff Packs,18,0,0.0,18
9109,2358,Expansion Packs,10,0,0.0,10
9110,2358,Game Packs,5,0,0.0,5
9111,2358,Stuff Packs,10,0,0.0,10
9112,2359,Expansion Packs,16,0,0.0,16
9113,2359,Game Packs,12,0,0.0,12
9114,2359,Kits,33,1,0.030303030303030304,32
9115,2359,Stuff Packs,20,0,0.0,20
9116,2360,Expansion Packs,15,0,0.0,15
9117,2360,Game Packs,10,0,0.0,10
9118,2360,Kits,5,3,0.6,2
9119,2360,Stuff Packs,15,1,0.06666666666666667,14
9120,2361,Expansion Packs,15,0,0.0,15
9121,2361,Game Packs,12,0,0.0,12
9122,2361,Kits,24,0,0.0,24
9123,2361,Stuff Packs,20,0,0.0,20
9124,2362,Expansion Packs,8,0,0.0,8
9125,2362,Game Packs,2,0,0.0,2
9126,2362,Kits,4,1,0.25,3
9127,2362,Stuff Packs,4,3,0.75,1
9128,2363,Expansion Packs,8,0,0.0,8
9129,2363,Game Packs,5,0,0.0,5
9130,2363,Kits,2,2,1.0,0
9131,2363,Stuff Packs,7,4,0.5714285714285714,3
9132,2364,Expansion Packs,14,0,0.0,14
9133,2364,Game Packs,10,0,0.0,10
9134,2364,Kits,12,0,0.0,12
9135,2364,Stuff Packs,14,0,0.0,14
9136,2365,Expansion Packs,16,0,0.0,16
9137,2365,Game Packs,11,1,0.09090909090909091,10
9138,2365,Kits,28,3,0.10714285714285714,25
9139,2365,Stuff Packs,20,1,0.05,19
9140,2366,Expansion Packs,16,0,0.0,16
9141,2366,Game Packs,12,0,0.0,12
9142,2366,Kits,26,0,0.0,26
9143,2366,Stuff Packs,18,0,0.0,18
9144,2367,Expansion Packs,7,0,0.0,7
9145,2367,Game Packs,1,0,0.0,1
9146,2367,Kits,3,0,0.0,3
9147,2367,Stuff Packs,1,0,0.0,1
9148,2368,Expansion Packs,6,0,0.0,6
9149,2368,Game Packs,6,0,0.0,6
9150,2368,Stuff Packs,2,0,0.0,2
9151,2369,Expansion Packs,4,0,0.0,4
9152,2369,Game Packs,3,1,0.3333333333333333,2
9153,2369,Kits,1,1,1.0,0
9154,2369,Stuff Packs,6,4,0.6666666666666666,2
9155,2370,Expansion Packs,16,0,0.0,16
9156,2370,Game Packs,8,0,0.0,8
9157,2370,Kits,9,1,0.1111111111111111,8
9158,2370,Stuff Packs,13,2,0.15384615384615385,11
9159,2371,Expansion Packs,12,0,0.0,12
9160,2371,Game Packs,4,0,0.0,4
9161,2371,Kits,14,1,0.07142857142857142,13
9162,2371,Stuff Packs,11,3,0.2727272727272727,8
9163,2372,Expansion Packs,4,0,0.0,4
9164,2372,Game Packs,1,0,0.0,1
9165,2372,Kits,4,0,0.0,4
9166,2372,Stuff Packs,2,0,0.0,2
9167,2373,Expansion Packs,16,0,0.0,16
9168,2373,Game Packs,7,0,0.0,7
9169,2373,Kits,11,1,0.09090909090909091,10
9170,2373,Stuff Packs,11,0,0.0,11
9171,2374,Expansion Packs,14,0,0.0,14
9172,2374,Game Packs,9,0,0.0,9
9173,2374,Kits,10,0,0.0,10
9174,2374,Stuff Packs,17,2,0.11764705882352941,15
9175,2375,Expansion Packs,4,0,0.0,4
9176,2375,Game Packs,3,0,0.0,3
9177,2375,Kits,2,0,0.0,2
9178,2375,Stuff Packs,8,3,0.375,5
9179,2376,Expansion Packs,13,0,0.0,13
9180,2376,Game Packs,11,0,0.0,11
9181,2376,Kits,11,3,0.2727272727272727,8
9182,2376,Stuff Packs,18,0,0.0,18
9183,2377,Expansion Packs,16,0,0.0,16
9184,2377,Game Packs,11,0,0.0,11
9185,2377,Kits,14,0,0.0,14
9186,2377,Stuff Packs,20,1,0.05,19
9187,2378,Expansion Packs,12,0,0.0,12
9188,2378,Game Packs,9,0,0.0,9
9189,2378,Kits,7,2,0.2857142857142857,5
9190,2378,Stuff Packs,17,1,0.058823529411764705,16
9191,2379,Expansion Packs,15,0,0.0,15
9192,2379,Game Packs,10,0,0.0,10
9193,2379,Kits,23,1,0.043478260869565216,22
9194,2379,Stuff Packs,18,0,0.0,18
9195,2380,Expansion Packs,16,0,0.0,16
9196,2380,Game Packs,5,0,0.0,5
9197,2380,Kits,4,2,0.5,2
9198,2380,Stuff Packs,7,3,0.42857142857142855,4
9199,2381,Expansion Packs,16,0,0.0,16
9200,2381,Game Packs,12,0,0.0,12
9201,2381,Kits,9,1,0.1111111111111111,8
9202,2381,Stuff Packs,20,0,0.0,20
9203,2382,Expansion Packs,16,0,0.0,16
9204,2382,Game Packs,6,1,0.16666666666666666,5
9205,2382,Kits,4,3,0.75,1
9206,2382,Stuff Packs,9,3,0.3333333333333333,6
9207,2383,Expansion Packs,16,0,0.0,16
9208,2383,Game Packs,11,0,0.0,11
9209,2383,Kits,17,0,0.0,17
9210,2383,Stuff Packs,18,0,0.0,18
9211,2384,Expansion Packs,13,0,0.0,13
9212,2384,Game Packs,3,0,0.0,3
9213,2384,Kits,1,0,0.0,1
9214,2384,Stuff Packs,3,0,0.0,3
9215,2385,Expansion Packs,16,0,0.0,16
9216,2385,Game Packs,11,0,0.0,11
9217,2385,Kits,33,1,0.030303030303030304,32
9218,2385,Stuff Packs,20,0,0.0,20
9219,2386,Expansion Packs,2,1,0.5,1
9220,2386,Stuff Packs,3,3,1.0,0
9221,2387,Expansion Packs,15,0,0.0,15
9222,2387,Game Packs,12,0,0.0,12
9223,2387,Kits,1,1,1.0,0
9224,2387,Stuff Packs,7,3,0.42857142857142855,4
9225,2388,Expansion Packs,16,0,0.0,16
9226,2388,Game Packs,11,0,0.0,11
9227,2388,Kits,20,1,0.05,19
9228,2388,Stuff Packs,19,2,0.10526315789473684,17
9229,2389,Expansion Packs,13,0,0.0,13
9230,2389,Game Packs,6,0,0.0,6
9231,2389,Kits,3,1,0.3333333333333333,2
9232,2389,Stuff Packs,14,1,0.07142857142857142,13
9233,2390,Expansion Packs,6,0,0.0,6
9234,2390,Game Packs,3,0,0.0,3
9235,2390,Kits,1,0,0.0,1
9236,2390,Stuff Packs,4,0,0.0,4
9237,2391,Expansion Packs,16,0,0.0,16
9238,2391,Game Packs,11,0,0.0,11
9239,2391,Kits,30,2,0.06666666666666667,28
9240,2391,Stuff Packs,20,0,0.0,20
9241,2392,Expansion Packs,16,0,0.0,16
9242,2392,Game Packs,12,0,0.0,12
9243,2392,Kits,33,0,0.0,33
9244,2392,Stuff Packs,20,0,0.0,20
9245,2393,Expansion Packs,16,0,0.0,16
9246,2393,Game Packs,12,0,0.0,12
9247,2393,Kits,33,0,0.0,33
9248,2393,Stuff Packs,20,0,0.0,20
9249,2394,Expansion Packs,2,0,0.0,2
9250,2394,Kits,1,1,1.0,0
9251,2394,Stuff Packs,3,3,1.0,0
9252,2395,Expansion Packs,16,0,0.0,16
9253,2395,Game Packs,12,0,0.0,12
9254,2395,Kits,33,1,0.030303030303030304,32
9255,2395,Stuff Packs,20,0,0.0,20
9256,2396,Expansion Packs,11,0,0.0,11
9257,2396,Game Packs,7,0,0.0,7
9258,2396,Kits,10,1,0.1,9
9259,2396,Stuff Packs,11,4,0.36363636363636365,7
9260,2397,Expansion Packs,15,0,0.0,15
9261,2397,Game Packs,11,0,0.0,11
9262,2397,Kits,7,2,0.2857142857142857,5
9263,2397,Stuff Packs,20,0,0.0,20
9264,2398,Expansion Packs,8,0,0.0,8
9265,2398,Game Packs,5,1,0.2,4
9266,2398,Kits,1,1,1.0,0
9267,2398,Stuff Packs,9,3,0.3333333333333333,6
9268,2399,Expansion Packs,13,0,0.0,13
9269,2399,Game Packs,11,0,0.0,11
9270,2399,Kits,3,0,0.0,3
9271,2399,Stuff Packs,10,0,0.0,10
9272,2400,Expansion Packs,6,0,0.0,6
9273,2400,Game Packs,5,1,0.2,4
9274,2400,Kits,3,3,1.0,0
9275,2400,Stuff Packs,8,2,0.25,6
9276,2401,Expansion Packs,16,0,0.0,16
9277,2401,Game Packs,11,0,0.0,11
9278,2401,Kits,33,1,0.030303030303030304,32
9279,2401,Stuff Packs,20,0,0.0,20
9280,2402,Expansion Packs,6,0,0.0,6
9281,2402,Game Packs,1,0,0.0,1
9282,2402,Kits,1,1,1.0,0
9283,2403,Expansion Packs,6,0,0.0,6
9284,2403,Game Packs,4,0,0.0,4
9285,2403,Stuff Packs,1,0,0.0,1
9286,2404,Expansion Packs,13,0,0.0,13
9287,2404,Game Packs,9,0,0.0,9
9288,2404,Stuff Packs,10,0,0.0,10
9289,2405,Expansion Packs,2,0,0.0,2
9290,2405,Game Packs,1,0,0.0,1
9291,2405,Stuff Packs,4,2,0.5,2
9292,2406,Expansion Packs,8,0,0.0,8
9293,2406,Game Packs,1,0,0.0,1
9294,2407,Expansion Packs,16,1,0.0625,15
9295,2407,Game Packs,12,0,0.0,12
9296,2407,Kits,29,1,0.034482758620689655,28
9297,2407,Stuff Packs,19,0,0.0,19
9298,2408,Expansion Packs,7,0,0.0,7
9299,2408,Game Packs,3,0,0.0,3
9300,2408,Kits,4,1,0.25,3
9301,2408,Stuff Packs,5,1,0.2,4
9302,2409,Expansion Packs,15,0,0.0,15
9303,2409,Game Packs,8,0,0.0,8
9304,2409,Kits,1,1,1.0,0
9305,2409,Stuff Packs,13,0,0.0,13
9306,2410,Expansion Packs,15,0,0.0,15
9307,2410,Game Packs,11,0,0.0,11
9308,2410,Kits,5,1,0.2,4
9309,2410,Stuff Packs,19,0,0.0,19
9310,2411,Expansion Packs,9,0,0.0,9
9311,2411,Game Packs,2,0,0.0,2
9312,2411,Kits,8,0,0.0,8
9313,2411,Stuff Packs,7,3,0.42857142857142855,4
9314,2412,Expansion Packs,5,0,0.0,5
9315,2412,Game Packs,3,0,0.0,3
9316,2412,Kits,3,2,0.6666666666666666,1
9317,2412,Stuff Packs,5,3,0.6,2
9318,2413,Expansion Packs,15,0,0.0,15
9319,2413,Game Packs,11,0,0.0,11
9320,2413,Kits,15,0,0.0,15
9321,2413,Stuff Packs,19,0,0.0,19
9322,2414,Expansion Packs,16,0,0.0,16
9323,2414,Game Packs,11,0,0.0,11
9324,2414,Kits,31,1,0.03225806451612903,30
9325,2414,Stuff Packs,20,0,0.0,20
9326,2415,Expansion Packs,16,0,0.0,16
9327,2415,Game Packs,12,0,0.0,12
9328,2415,Kits,33,0,0.0,33
9329,2415,Stuff Packs,20,0,0.0,20
9330,2416,Expansion Packs,15,1,0.06666666666666667,14
9331,2416,Game Packs,10,0,0.0,10
9332,2416,Kits,3,0,0.0,3
9333,2416,Stuff Packs,11,1,0.09090909090909091,10
9334,2417,Expansion Packs,8,0,0.0,8
9335,2417,Game Packs,6,0,0.0,6
9336,2417,Kits,16,1,0.0625,15
9337,2417,Stuff Packs,12,2,0.16666666666666666,10
9338,2418,Expansion Packs,11,0,0.0,11
9339,2418,Game Packs,7,0,0.0,7
9340,2418,Kits,2,2,1.0,0
9341,2418,Stuff Packs,14,3,0.21428571428571427,11
9342,2419,Expansion Packs,16,0,0.0,16
9343,2419,Game Packs,12,0,0.0,12
9344,2419,Kits,33,0,0.0,33
9345,2419,Stuff Packs,20,0,0.0,20
9346,2420,Expansion Packs,13,0,0.0,13
9347,2420,Game Packs,6,0,0.0,6
9348,2420,Kits,5,2,0.4,3
9349,2420,Stuff Packs,12,1,0.08333333333333333,11
9350,2421,Expansion Packs,15,0,0.0,15
9351,2421,Game Packs,12,0,0.0,12
9352,2421,Kits,15,0,0.0,15
9353,2421,Stuff Packs,14,0,0.0,14
9354,2422,Expansion Packs,15,0,0.0,15
9355,2422,Game Packs,11,0,0.0,11
9356,2422,Kits,12,2,0.16666666666666666,10
9357,2422,Stuff Packs,19,3,0.15789473684210525,16
9358,2423,Expansion Packs,13,0,0.0,13
9359,2423,Game Packs,10,0,0.0,10
9360,2423,Kits,4,2,0.5,2
9361,2423,Stuff Packs,9,1,0.1111111111111111,8
9362,2424,Expansion Packs,14,0,0.0,14
9363,2424,Game Packs,9,0,0.0,9
9364,2424,Kits,5,2,0.4,3
9365,2424,Stuff Packs,17,1,0.058823529411764705,16
9366,2425,Expansion Packs,6,6,1.0,0
9367,2425,Game Packs,5,4,0.8,1
9368,2425,Kits,1,1,1.0,0
9369,2425,Stuff Packs,5,5,1.0,0
9370,2426,Expansion Packs,16,0,0.0,16
9371,2426,Game Packs,12,0,0.0,12
9372,2426,Kits,33,0,0.0,33
9373,2426,Stuff Packs,20,0,0.0,20
9374,2427,Expansion Packs,15,0,0.0,15
9375,2427,Game Packs,10,0,0.0,10
9376,2427,Kits,3,3,1.0,0
9377,2427,Stuff Packs,18,1,0.05555555555555555,17
9378,2428,Expansion Packs,15,0,0.0,15
9379,2428,Game Packs,10,0,0.0,10
9380,2428,Kits,3,2,0.6666666666666666,1
9381,2428,Stuff Packs,19,0,0.0,19
9382,2429,Expansion Packs,16,0,0.0,16
9383,2429,Game Packs,12,0,0.0,12
9384,2429,Kits,33,1,0.030303030303030304,32
9385,2429,Stuff Packs,20,0,0.0,20
9386,2430,Expansion Packs,11,0,0.0,11
9387,2430,Game Packs,4,0,0.0,4
9388,2430,Kits,2,1,0.5,1
9389,2430,Stuff Packs,6,3,0.5,3
9390,2431,Expansion Packs,14,0,0.0,14
9391,2431,Game Packs,7,0,0.0,7
9392,2431,Kits,6,1,0.16666666666666666,5
9393,2431,Stuff Packs,10,1,0.1,9
9394,2432,Expansion Packs,15,0,0.0,15
9395,2432,Game Packs,12,0,0.0,12
9396,2432,Kits,30,1,0.03333333333333333,29
9397,2432,Stuff Packs,20,0,0.0,20
9398,2433,Expansion Packs,16,0,0.0,16
9399,2433,Game Packs,12,0,0.0,12
9400,2433,Kits,33,0,0.0,33
9401,2433,Stuff Packs,20,0,0.0,20
9402,2434,Expansion Packs,12,0,0.0,12
9403,2434,Game Packs,4,0,0.0,4
9404,2434,Kits,2,2,1.0,0
9405,2434,Stuff Packs,8,3,0.375,5
9406,2435,Expansion Packs,10,0,0.0,10
9407,2435,Game Packs,8,0,0.0,8
9408,2435,Kits,1,1,1.0,0
9409,2435,Stuff Packs,13,1,0.07692307692307693,12
9410,2436,Expansion Packs,8,0,0.0,8
9411,2436,Game Packs,2,0,0.0,2
9412,2436,Kits,1,1,1.0,0
9413,2436,Stuff Packs,5,3,0.6,2
9414,2437,Expansion Packs,15,0,0.0,15
9415,2437,Game Packs,9,0,0.0,9
9416,2437,Kits,7,0,0.0,7
9417,2437,Stuff Packs,8,0,0.0,8
9418,2438,Expansion Packs,16,0,0.0,16
9419,2438,Game Packs,12,0,0.0,12
9420,2438,Kits,32,0,0.0,32
9421,2438,Stuff Packs,20,0,0.0,20
9422,2439,Expansion Packs,6,0,0.0,6
9423,2439,Game Packs,3,0,0.0,3
9424,2439,Kits,1,0,0.0,1
9425,2439,Stuff Packs,4,0,0.0,4
9426,2440,Expansion Packs,15,0,0.0,15
9427,2440,Game Packs,6,0,0.0,6
9428,2440,Kits,26,0,0.0,26
9429,2440,Stuff Packs,19,0,0.0,19
9430,2441,Expansion Packs,16,0,0.0,16
9431,2441,Game Packs,11,0,0.0,11
9432,2441,Kits,33,0,0.0,33
9433,2441,Stuff Packs,20,1,0.05,19
9434,2442,Expansion Packs,8,0,0.0,8
9435,2442,Game Packs,4,0,0.0,4
9436,2442,Kits,1,0,0.0,1
9437,2442,Stuff Packs,5,2,0.4,3
9438,2443,Expansion Packs,8,0,0.0,8
9439,2443,Game Packs,3,0,0.0,3
9440,2443,Stuff Packs,5,0,0.0,5
9441,2444,Expansion Packs,11,0,0.0,11
9442,2444,Game Packs,9,0,0.0,9
9443,2444,Kits,7,2,0.2857142857142857,5
9444,2444,Stuff Packs,13,1,0.07692307692307693,12
9445,2445,Expansion Packs,3,0,0.0,3
9446,2445,Game Packs,3,0,0.0,3
9447,2445,Stuff Packs,3,0,0.0,3
9448,2446,Expansion Packs,12,0,0.0,12
9449,2446,Game Packs,5,0,0.0,5
9450,2446,Kits,11,1,0.09090909090909091,10
9451,2446,Stuff Packs,8,0,0.0,8
9452,2447,Expansion Packs,8,0,0.0,8
9453,2447,Game Packs,2,0,0.0,2
9454,2447,Kits,23,0,0.0,23
9455,2447,Stuff Packs,20,0,0.0,20
9456,2448,Expansion Packs,4,0,0.0,4
9457,2448,Kits,1,1,1.0,0
9458,2448,Stuff Packs,3,3,1.0,0
9459,2449,Expansion Packs,8,0,0.0,8
9460,2449,Game Packs,5,0,0.0,5
9461,2449,Kits,7,1,0.14285714285714285,6
9462,2449,Stuff Packs,7,3,0.42857142857142855,4
9463,2450,Expansion Packs,14,0,0.0,14
9464,2450,Game Packs,5,0,0.0,5
9465,2450,Kits,13,0,0.0,13
9466,2450,Stuff Packs,10,1,0.1,9
9467,2451,Expansion Packs,5,0,0.0,5
9468,2451,Game Packs,5,0,0.0,5
9469,2451,Kits,2,2,1.0,0
9470,2451,Stuff Packs,7,0,0.0,7
9471,2452,Expansion Packs,5,0,0.0,5
9472,2452,Stuff Packs,4,0,0.0,4
9473,2453,Expansion Packs,16,0,0.0,16
9474,2453,Game Packs,12,0,0.0,12
9475,2453,Kits,30,2,0.06666666666666667,28
9476,2453,Stuff Packs,17,1,0.058823529411764705,16
9477,2454,Expansion Packs,13,0,0.0,13
9478,2454,Game Packs,5,0,0.0,5
9479,2454,Kits,2,2,1.0,0
9480,2454,Stuff Packs,5,2,0.4,3
9481,2455,Expansion Packs,7,0,0.0,7
9482,2455,Game Packs,2,0,0.0,2
9483,2455,Kits,1,1,1.0,0
9484,2455,Stuff Packs,2,0,0.0,2
9485,2456,Expansion Packs,16,0,0.0,16
9486,2456,Game Packs,11,0,0.0,11
9487,2456,Kits,1,1,1.0,0
9488,2456,Stuff Packs,20,0,0.0,20
9489,2457,Expansion Packs,14,0,0.0,14
9490,2457,Game Packs,7,1,0.14285714285714285,6
9491,2457,Kits,9,3,0.3333333333333333,6
9492,2457,Stuff Packs,12,3,0.25,9
9493,2458,Expansion Packs,11,0,0.0,11
9494,2458,Game Packs,4,0,0.0,4
9495,2458,Kits,5,1,0.2,4
9496,2458,Stuff Packs,8,0,0.0,8
9497,2459,Expansion Packs,16,0,0.0,16
9498,2459,Game Packs,12,0,0.0,12
9499,2459,Kits,33,0,0.0,33
9500,2459,Stuff Packs,20,0,0.0,20
9501,2460,Expansion Packs,13,1,0.07692307692307693,12
9502,2460,Game Packs,6,0,0.0,6
9503,2460,Kits,6,0,0.0,6
9504,2460,Stuff Packs,8,1,0.125,7
9505,2461,Expansion Packs,16,0,0.0,16
9506,2461,Game Packs,11,0,0.0,11
9507,2461,Kits,20,0,0.0,20
9508,2461,Stuff Packs,20,0,0.0,20
9509,2462,Expansion Packs,6,0,0.0,6
9510,2462,Game Packs,2,0,0.0,2
9511,2462,Kits,2,2,1.0,0
9512,2462,Stuff Packs,4,1,0.25,3
9513,2463,Expansion Packs,16,0,0.0,16
9514,2463,Game Packs,9,0,0.0,9
9515,2463,Kits,13,1,0.07692307692307693,12
9516,2463,Stuff Packs,17,0,0.0,17
9517,2464,Expansion Packs,16,0,0.0,16
9518,2464,Game Packs,10,0,0.0,10
9519,2464,Kits,23,1,0.043478260869565216,22
9520,2464,Stuff Packs,20,1,0.05,19
9521,2465,Expansion Packs,16,0,0.0,16
9522,2465,Game Packs,12,0,0.0,12
9523,2465,Kits,18,0,0.0,18
9524,2465,Stuff Packs,20,0,0.0,20
9525,2466,Expansion Packs,15,0,0.0,15
9526,2466,Game Packs,11,0,0.0,11
9527,2466,Kits,3,2,0.6666666666666666,1
9528,2466,Stuff Packs,7,4,0.5714285714285714,3
9529,2467,Expansion Packs,13,0,0.0,13
9530,2467,Game Packs,7,0,0.0,7
9531,2467,Kits,22,0,0.0,22
9532,2467,Stuff Packs,13,0,0.0,13
9533,2468,Expansion Packs,15,0,0.0,15
9534,2468,Game Packs,6,0,0.0,6
9535,2468,Kits,8,1,0.125,7
9536,2468,Stuff Packs,8,0,0.0,8
9537,2469,Expansion Packs,10,0,0.0,10
9538,2469,Game Packs,5,0,0.0,5
9539,2469,Kits,7,1,0.14285714285714285,6
9540,2469,Stuff Packs,9,2,0.2222222222222222,7
9541,2470,Expansion Packs,16,0,0.0,16
9542,2470,Game Packs,12,0,0.0,12
9543,2470,Kits,23,0,0.0,23
9544,2470,Stuff Packs,20,0,0.0,20
9545,2471,Expansion Packs,15,0,0.0,15
9546,2471,Game Packs,9,0,0.0,9
9547,2471,Kits,2,0,0.0,2
9548,2471,Stuff Packs,10,0,0.0,10
9549,2472,Expansion Packs,7,0,0.0,7
9550,2472,Game Packs,4,0,0.0,4
9551,2472,Kits,4,4,1.0,0
9552,2472,Stuff Packs,11,4,0.36363636363636365,7
9553,2473,Expansion Packs,12,0,0.0,12
9554,2473,Game Packs,8,0,0.0,8
9555,2473,Kits,2,2,1.0,0
9556,2473,Stuff Packs,5,1,0.2,4
9557,2474,Expansion Packs,16,0,0.0,16
9558,2474,Game Packs,10,0,0.0,10
9559,2474,Kits,4,0,0.0,4
9560,2474,Stuff Packs,12,0,0.0,12
9561,2475,Expansion Packs,14,0,0.0,14
9562,2475,Game Packs,4,0,0.0,4
9563,2475,Kits,15,1,0.06666666666666667,14
9564,2475,Stuff Packs,15,0,0.0,15
9565,2476,Game Packs,2,2,1.0,0
9566,2476,Kits,2,2,1.0,0
9567,2476,Stuff Packs,2,2,1.0,0
9568,2477,Expansion Packs,13,0,0.0,13
9569,2477,Game Packs,4,0,0.0,4
9570,2477,Stuff Packs,1,0,0.0,1
9571,2478,Expansion Packs,7,0,0.0,7
9572,2478,Game Packs,7,1,0.14285714285714285,6
9573,2478,Kits,1,1,1.0,0
9574,2478,Stuff Packs,8,3,0.375,5
9575,2479,Expansion Packs,16,0,0.0,16
9576,2479,Game Packs,12,0,0.0,12
9577,2479,Kits,11,1,0.09090909090909091,10
9578,2479,Stuff Packs,20,0,0.0,20
9579,2480,Expansion Packs,9,0,0.0,9
9580,2480,Game Packs,3,0,0.0,3
9581,2480,Kits,4,0,0.0,4
9582,2480,Stuff Packs,6,1,0.16666666666666666,5
9583,2481,Expansion Packs,4,1,0.25,3
9584,2481,Game Packs,6,0,0.0,6
9585,2481,Kits,5,0,0.0,5
9586,2481,Stuff Packs,15,4,0.26666666666666666,11
9587,2482,Expansion Packs,10,0,0.0,10
9588,2482,Game Packs,7,0,0.0,7
9589,2482,Stuff Packs,5,1,0.2,4
9590,2483,Expansion Packs,2,0,0.0,2
9591,2483,Stuff Packs,2,1,0.5,1
9592,2484,Expansion Packs,9,0,0.0,9
9593,2484,Game Packs,5,0,0.0,5
9594,2484,Kits,6,1,0.16666666666666666,5
9595,2484,Stuff Packs,13,0,0.0,13
9596,2485,Expansion Packs,16,0,0.0,16
9597,2485,Game Packs,12,0,0.0,12
9598,2485,Kits,31,0,0.0,31
9599,2485,Stuff Packs,20,0,0.0,20
9600,2486,Expansion Packs,8,0,0.0,8
9601,2486,Game Packs,5,0,0.0,5
9602,2486,Kits,1,1,1.0,0
9603,2486,Stuff Packs,13,4,0.3076923076923077,9
9604,2487,Expansion Packs,6,0,0.0,6
9605,2487,Game Packs,3,0,0.0,3
9606,2487,Kits,1,1,1.0,0
9607,2487,Stuff Packs,3,2,0.6666666666666666,1
9608,2488,Expansion Packs,11,0,0.0,11
9609,2488,Game Packs,6,0,0.0,6
9610,2488,Kits,2,0,0.0,2
9611,2488,Stuff Packs,8,2,0.25,6
9612,2489,Expansion Packs,16,0,0.0,16
9613,2489,Game Packs,12,0,0.0,12
9614,2489,Kits,33,0,0.0,33
9615,2489,Stuff Packs,20,1,0.05,19
9616,2490,Expansion Packs,7,0,0.0,7
9617,2490,Game Packs,3,0,0.0,3
9618,2490,Kits,1,0,0.0,1
9619,2490,Stuff Packs,2,0,0.0,2
9620,2491,Expansion Packs,14,0,0.0,14
9621,2491,Game Packs,6,1,0.16666666666666666,5
9622,2491,Kits,7,1,0.14285714285714285,6
9623,2491,Stuff Packs,9,3,0.3333333333333333,6
9624,2492,Expansion Packs,3,0,0.0,3
9625,2492,Game Packs,1,1,1.0,0
9626,2492,Kits,2,2,1.0,0
9627,2492,Stuff Packs,4,4,1.0,0
9628,2493,Expansion Packs,9,0,0.0,9
9629,2493,Game Packs,3,0,0.0,3
9630,2493,Kits,5,0,0.0,5
9631,2493,Stuff Packs,4,0,0.0,4
9632,2494,Expansion Packs,10,0,0.0,10
9633,2494,Game Packs,5,0,0.0,5
9634,2494,Kits,16,0,0.0,16
9635,2494,Stuff Packs,11,0,0.0,11
9636,2495,Expansion Packs,16,0,0.0,16
9637,2495,Game Packs,12,0,0.0,12
9638,2495,Kits,33,0,0.0,33
9639,2495,Stuff Packs,20,0,0.0,20
9640,2496,Expansion Packs,8,0,0.0,8
9641,2496,Game Packs,1,0,0.0,1
9642,2496,Kits,1,0,0.0,1
9643,2496,Stuff Packs,6,2,0.3333333333333333,4
9644,2497,Expansion Packs,15,0,0.0,15
9645,2497,Game Packs,12,0,0.0,12
9646,2497,Kits,10,1,0.1,9
9647,2497,Stuff Packs,20,0,0.0,20
9648,2498,Expansion Packs,15,0,0.0,15
9649,2498,Game Packs,12,0,0.0,12
9650,2498,Kits,2,2,1.0,0
9651,2498,Stuff Packs,20,0,0.0,20
9652,2499,Expansion Packs,16,0,0.0,16
9653,2499,Game Packs,12,0,0.0,12
9654,2499,Kits,33,2,0.06060606060606061,31
9655,2499,Stuff Packs,20,0,0.0,20
9656,2500,Expansion Packs,6,0,0.0,6
9657,2500,Game Packs,2,0,0.0,2
9658,2500,Kits,4,0,0.0,4
9659,2500,Stuff Packs,5,2,0.4,3
9660,2501,Expansion Packs,11,0,0.0,11
9661,2501,Game Packs,8,0,0.0,8
9662,2501,Kits,6,1,0.16666666666666666,5
9663,2501,Stuff Packs,12,2,0.16666666666666666,10
9664,2502,Expansion Packs,6,0,0.0,6
9665,2502,Game Packs,2,0,0.0,2
9666,2502,Stuff Packs,2,0,0.0,2
9667,2503,Expansion Packs,5,1,0.2,4
9668,2503,Kits,1,1,1.0,0
9669,2503,Stuff Packs,6,4,0.6666666666666666,2
9670,2504,Expansion Packs,15,0,0.0,15
9671,2504,Game Packs,10,0,0.0,10
9672,2504,Kits,24,1,0.041666666666666664,23
9673,2504,Stuff Packs,17,2,0.11764705882352941,15
9674,2505,Expansion Packs,11,0,0.0,11
9675,2505,Game Packs,8,0,0.0,8
9676,2505,Kits,2,0,0.0,2
9677,2505,Stuff Packs,7,0,0.0,7
9678,2506,Expansion Packs,11,0,0.0,11
9679,2506,Game Packs,8,0,0.0,8
9680,2506,Kits,4,2,0.5,2
9681,2506,Stuff Packs,14,1,0.07142857142857142,13
9682,2507,Expansion Packs,9,0,0.0,9
9683,2507,Game Packs,1,0,0.0,1
9684,2507,Kits,8,1,0.125,7
9685,2507,Stuff Packs,6,3,0.5,3
9686,2508,Expansion Packs,14,0,0.0,14
9687,2508,Game Packs,7,0,0.0,7
9688,2508,Kits,18,0,0.0,18
9689,2508,Stuff Packs,15,0,0.0,15
9690,2509,Expansion Packs,15,0,0.0,15
9691,2509,Game Packs,10,0,0.0,10
9692,2509,Kits,6,1,0.16666666666666666,5
9693,2509,Stuff Packs,17,1,0.058823529411764705,16
9694,2510,Expansion Packs,15,0,0.0,15
9695,2510,Game Packs,10,0,0.0,10
9696,2510,Kits,7,1,0.14285714285714285,6
9697,2510,Stuff Packs,13,1,0.07692307692307693,12
9698,2511,Expansion Packs,12,0,0.0,12
9699,2511,Game Packs,8,0,0.0,8
9700,2511,Kits,4,1,0.25,3
9701,2511,Stuff Packs,11,2,0.18181818181818182,9
9702,2512,Expansion Packs,3,0,0.0,3
9703,2512,Stuff Packs,1,0,0.0,1
9704,2513,Expansion Packs,15,0,0.0,15
9705,2513,Game Packs,12,0,0.0,12
9706,2513,Kits,12,1,0.08333333333333333,11
9707,2513,Stuff Packs,20,0,0.0,20
9708,2514,Expansion Packs,12,0,0.0,12
9709,2514,Game Packs,4,0,0.0,4
9710,2514,Kits,11,0,0.0,11
9711,2514,Stuff Packs,11,2,0.18181818181818182,9
9712,2515,Expansion Packs,16,0,0.0,16
9713,2515,Game Packs,12,0,0.0,12
9714,2515,Kits,33,0,0.0,33
9715,2515,Stuff Packs,20,0,0.0,20
9716,2516,Expansion Packs,15,0,0.0,15
9717,2516,Game Packs,9,0,0.0,9
9718,2516,Kits,15,0,0.0,15
9719,2516,Stuff Packs,15,1,0.06666666666666667,14
9720,2517,Expansion Packs,14,0,0.0,14
9721,2517,Game Packs,1,0,0.0,1
9722,2517,Kits,1,1,1.0,0
9723,2517,Stuff Packs,7,3,0.42857142857142855,4
9724,2518,Expansion Packs,16,0,0.0,16
9725,2518,Game Packs,6,0,0.0,6
9726,2518,Kits,10,0,0.0,10
9727,2518,Stuff Packs,6,1,0.16666666666666666,5
9728,2519,Expansion Packs,16,0,0.0,16
9729,2519,Game Packs,10,0,0.0,10
9730,2519,Kits,2,0,0.0,2
9731,2519,Stuff Packs,18,0,0.0,18
9732,2520,Expansion Packs,8,0,0.0,8
9733,2520,Game Packs,4,0,0.0,4
9734,2520,Kits,3,0,0.0,3
9735,2520,Stuff Packs,6,0,0.0,6
9736,2521,Expansion Packs,15,0,0.0,15
9737,2521,Game Packs,11,0,0.0,11
9738,2521,Kits,12,0,0.0,12
9739,2521,Stuff Packs,16,0,0.0,16
9740,2522,Expansion Packs,16,0,0.0,16
9741,2522,Game Packs,12,0,0.0,12
9742,2522,Kits,29,0,0.0,29
9743,2522,Stuff Packs,20,0,0.0,20
9744,2523,Expansion Packs,12,0,0.0,12
9745,2523,Game Packs,5,0,0.0,5
9746,2523,Kits,2,2,1.0,0
9747,2523,Stuff Packs,9,0,0.0,9
9748,2524,Expansion Packs,14,0,0.0,14
9749,2524,Game Packs,10,0,0.0,10
9750,2524,Stuff Packs,10,1,0.1,9
9751,2525,Expansion Packs,16,0,0.0,16
9752,2525,Game Packs,11,0,0.0,11
9753,2525,Kits,24,0,0.0,24
9754,2525,Stuff Packs,16,1,0.0625,15
9755,2526,Expansion Packs,9,0,0.0,9
9756,2526,Game Packs,5,0,0.0,5
9757,2526,Kits,14,0,0.0,14
9758,2526,Stuff Packs,10,1,0.1,9
9759,2527,Expansion Packs,16,0,0.0,16
9760,2527,Game Packs,8,0,0.0,8
9761,2527,Kits,4,1,0.25,3
9762,2527,Stuff Packs,10,3,0.3,7
9763,2528,Expansion Packs,7,0,0.0,7
9764,2528,Game Packs,5,0,0.0,5
9765,2528,Kits,1,0,0.0,1
9766,2528,Stuff Packs,2,0,0.0,2
9767,2529,Expansion Packs,7,0,0.0,7
9768,2529,Game Packs,6,0,0.0,6
9769,2529,Kits,3,3,1.0,0
9770,2529,Stuff Packs,12,1,0.08333333333333333,11
9771,2530,Expansion Packs,7,0,0.0,7
9772,2530,Game Packs,3,0,0.0,3
9773,2530,Kits,1,1,1.0,0
9774,2530,Stuff Packs,5,2,0.4,3
9775,2531,Expansion Packs,7,0,0.0,7
9776,2531,Game Packs,4,0,0.0,4
9777,2531,Stuff Packs,7,0,0.0,7
9778,2532,Expansion Packs,15,0,0.0,15
9779,2532,Game Packs,6,0,0.0,6
9780,2532,Kits,6,1,0.16666666666666666,5
9781,2532,Stuff Packs,9,1,0.1111111111111111,8
9782,2533,Expansion Packs,11,0,0.0,11
9783,2533,Game Packs,4,0,0.0,4
9784,2533,Kits,7,1,0.14285714285714285,6
9785,2533,Stuff Packs,7,3,0.42857142857142855,4
9786,2534,Expansion Packs,16,0,0.0,16
9787,2534,Game Packs,12,0,0.0,12
9788,2534,Kits,24,0,0.0,24
9789,2534,Stuff Packs,20,1,0.05,19
9790,2535,Expansion Packs,14,0,0.0,14
9791,2535,Game Packs,5,0,0.0,5
9792,2535,Kits,5,1,0.2,4
9793,2535,Stuff Packs,11,3,0.2727272727272727,8
9794,2536,Expansion Packs,11,0,0.0,11
9795,2536,Game Packs,7,0,0.0,7
9796,2536,Kits,9,4,0.4444444444444444,5
9797,2536,Stuff Packs,11,0,0.0,11
9798,2537,Expansion Packs,11,0,0.0,11
9799,2537,Game Packs,1,0,0.0,1
9800,2537,Kits,1,1,1.0,0
9801,2537,Stuff Packs,6,3,0.5,3
9802,2538,Expansion Packs,13,0,0.0,13
9803,2538,Game Packs,9,0,0.0,9
9804,2538,Kits,8,2,0.25,6
9805,2538,Stuff Packs,15,1,0.06666666666666667,14
9806,2539,Expansion Packs,12,0,0.0,12
9807,2539,Game Packs,8,0,0.0,8
9808,2539,Kits,10,1,0.1,9
9809,2539,Stuff Packs,11,2,0.18181818181818182,9
9810,2540,Expansion Packs,6,0,0.0,6
9811,2540,Game Packs,2,0,0.0,2
9812,2540,Kits,1,1,1.0,0
9813,2540,Stuff Packs,9,3,0.3333333333333333,6
9814,2541,Expansion Packs,16,0,0.0,16
9815,2541,Game Packs,10,0,0.0,10
9816,2541,Kits,8,1,0.125,7
9817,2541,Stuff Packs,14,4,0.2857142857142857,10
9818,2542,Expansion Packs,6,0,0.0,6
9819,2542,Game Packs,3,0,0.0,3
9820,2542,Stuff Packs,4,1,0.25,3
9821,2543,Expansion Packs,16,0,0.0,16
9822,2543,Game Packs,12,0,0.0,12
9823,2543,Kits,33,1,0.030303030303030304,32
9824,2543,Stuff Packs,20,0,0.0,20
9825,2544,Expansion Packs,4,0,0.0,4
9826,2544,Kits,2,2,1.0,0
9827,2544,Stuff Packs,4,3,0.75,1
9828,2545,Expansion Packs,16,0,0.0,16
9829,2545,Game Packs,12,0,0.0,12
9830,2545,Kits,33,0,0.0,33
9831,2545,Stuff Packs,20,0,0.0,20
9832,2546,Expansion Packs,16,0,0.0,16
9833,2546,Game Packs,12,0,0.0,12
9834,2546,Kits,33,0,0.0,33
9835,2546,Stuff Packs,20,0,0.0,20
9836,2547,Expansion Packs,2,0,0.0,2
9837,2547,Game Packs,1,0,0.0,1
9838,2547,Kits,1,1,1.0,0
9839,2547,Stuff Packs,4,3,0.75,1
9840,2548,Expansion Packs,12,0,0.0,12
9841,2548,Game Packs,7,1,0.14285714285714285,6
9842,2548,Kits,3,3,1.0,0
9843,2548,Stuff Packs,9,5,0.5555555555555556,4
9844,2549,Expansion Packs,8,0,0.0,8
9845,2549,Game Packs,2,0,0.0,2
9846,2549,Kits,1,1,1.0,0
9847,2549,Stuff Packs,2,2,1.0,0
9848,2550,Expansion Packs,2,0,0.0,2
9849,2550,Game Packs,4,1,0.25,3
9850,2550,Kits,3,1,0.3333333333333333,2
9851,2550,Stuff Packs,7,3,0.42857142857142855,4
9852,2551,Expansion Packs,14,0,0.0,14
9853,2551,Game Packs,10,0,0.0,10
9854,2551,Kits,5,1,0.2,4
9855,2551,Stuff Packs,17,2,0.11764705882352941,15
9856,2552,Expansion Packs,2,0,0.0,2
9857,2552,Game Packs,3,0,0.0,3
9858,2552,Stuff Packs,1,0,0.0,1
9859,2553,Expansion Packs,16,0,0.0,16
9860,2553,Game Packs,11,0,0.0,11
9861,2553,Kits,26,1,0.038461538461538464,25
9862,2553,Stuff Packs,17,0,0.0,17
9863,2554,Expansion Packs,7,3,0.42857142857142855,4
9864,2554,Game Packs,1,1,1.0,0
9865,2554,Kits,5,5,1.0,0
9866,2554,Stuff Packs,4,4,1.0,0
9867,2555,Expansion Packs,11,0,0.0,11
9868,2555,Game Packs,9,0,0.0,9
9869,2555,Kits,18,0,0.0,18
9870,2555,Stuff Packs,8,2,0.25,6
9871,2556,Expansion Packs,16,0,0.0,16
9872,2556,Game Packs,12,0,0.0,12
9873,2556,Kits,33,1,0.030303030303030304,32
9874,2556,Stuff Packs,20,0,0.0,20
9875,2557,Expansion Packs,4,0,0.0,4
9876,2557,Game Packs,1,0,0.0,1
9877,2557,Kits,2,0,0.0,2
9878,2557,Stuff Packs,4,0,0.0,4
9879,2558,Expansion Packs,13,0,0.0,13
9880,2558,Game Packs,8,0,0.0,8
9881,2558,Kits,13,0,0.0,13
9882,2558,Stuff Packs,13,0,0.0,13
9883,2559,Expansion Packs,14,0,0.0,14
9884,2559,Game Packs,10,0,0.0,10
9885,2559,Kits,7,2,0.2857142857142857,5
9886,2559,Stuff Packs,12,2,0.16666666666666666,10
9887,2560,Expansion Packs,16,0,0.0,16
9888,2560,Game Packs,10,0,0.0,10
9889,2560,Kits,10,0,0.0,10
9890,2560,Stuff Packs,15,0,0.0,15
9891,2561,Expansion Packs,5,0,0.0,5
9892,2561,Game Packs,4,0,0.0,4
9893,2561,Stuff Packs,4,2,0.5,2
9894,2562,Expansion Packs,4,0,0.0,4
9895,2562,Game Packs,3,0,0.0,3
9896,2562,Kits,1,0,0.0,1
9897,2562,Stuff Packs,7,5,0.7142857142857143,2
9898,2563,Expansion Packs,7,0,0.0,7
9899,2563,Game Packs,3,0,0.0,3
9900,2563,Kits,2,2,1.0,0
9901,2563,Stuff Packs,6,2,0.3333333333333333,4
9902,2564,Expansion Packs,14,0,0.0,14
9903,2564,Game Packs,7,0,0.0,7
9904,2564,Kits,3,2,0.6666666666666666,1
9905,2564,Stuff Packs,10,3,0.3,7
9906,2565,Expansion Packs,16,0,0.0,16
9907,2565,Game Packs,12,0,0.0,12
9908,2565,Kits,33,1,0.030303030303030304,32
9909,2565,Stuff Packs,20,0,0.0,20
9910,2566,Expansion Packs,2,0,0.0,2
9911,2566,Game Packs,1,0,0.0,1
9912,2567,Expansion Packs,16,0,0.0,16
9913,2567,Game Packs,11,0,0.0,11
9914,2567,Kits,24,0,0.0,24
9915,2567,Stuff Packs,20,0,0.0,20
9916,2568,Expansion Packs,12,0,0.0,12
9917,2568,Game Packs,1,0,0.0,1
9918,2569,Expansion Packs,16,0,0.0,16
9919,2569,Game Packs,11,0,0.0,11
9920,2569,Kits,18,0,0.0,18
9921,2569,Stuff Packs,17,3,0.17647058823529413,14
9922,2570,Expansion Packs,16,0,0.0,16
9923,2570,Game Packs,12,0,0.0,12
9924,2570,Kits,3,2,0.6666666666666666,1
9925,2570,Stuff Packs,15,2,0.13333333333333333,13
9926,2571,Expansion Packs,16,0,0.0,16
9927,2571,Game Packs,11,0,0.0,11
9928,2571,Kits,27,1,0.037037037037037035,26
9929,2571,Stuff Packs,20,1,0.05,19
9930,2572,Expansion Packs,12,0,0.0,12
9931,2572,Game Packs,10,0,0.0,10
9932,2572,Kits,4,0,0.0,4
9933,2572,Stuff Packs,16,1,0.0625,15
9934,2573,Expansion Packs,16,0,0.0,16
9935,2573,Game Packs,12,0,0.0,12
9936,2573,Kits,31,1,0.03225806451612903,30
9937,2573,Stuff Packs,20,0,0.0,20
9938,2574,Expansion Packs,13,0,0.0,13
9939,2574,Game Packs,6,0,0.0,6
9940,2574,Kits,22,1,0.045454545454545456,21
9941,2574,Stuff Packs,4,0,0.0,4
9942,2575,Expansion Packs,4,0,0.0,4
9943,2575,Game Packs,3,1,0.3333333333333333,2
9944,2575,Kits,2,2,1.0,0
9945,2575,Stuff Packs,5,4,0.8,1
9946,2576,Expansion Packs,4,0,0.0,4
9947,2576,Kits,2,2,1.0,0
9948,2577,Expansion Packs,16,1,0.0625,15
9949,2577,Game Packs,12,0,0.0,12
9950,2577,Kits,18,1,0.05555555555555555,17
9951,2577,Stuff Packs,20,2,0.1,18
9952,2578,Expansion Packs,16,0,0.0,16
9953,2578,Game Packs,12,0,0.0,12
9954,2578,Kits,33,1,0.030303030303030304,32
9955,2578,Stuff Packs,20,0,0.0,20
9956,2579,Expansion Packs,4,0,0.0,4
9957,2579,Game Packs,1,0,0.0,1
9958,2579,Kits,1,1,1.0,0
9959,2579,Stuff Packs,3,3,1.0,0
9960,2580,Expansion Packs,16,0,0.0,16
9961,2580,Game Packs,12,0,0.0,12
9962,2580,Kits,23,1,0.043478260869565216,22
9963,2580,Stuff Packs,20,0,0.0,20
9964,2581,Expansion Packs,14,0,0.0,14
9965,2581,Game Packs,12,0,0.0,12
9966,2581,Kits,25,1,0.04,24
9967,2581,Stuff Packs,19,0,0.0,19
9968,2582,Expansion Packs,16,1,0.0625,15
9969,2582,Game Packs,12,0,0.0,12
9970,2582,Kits,33,2,0.06060606060606061,31
9971,2582,Stuff Packs,20,0,0.0,20
9972,2583,Expansion Packs,11,0,0.0,11
9973,2583,Game Packs,4,1,0.25,3
9974,2583,Kits,10,3,0.3,7
9975,2583,Stuff Packs,13,4,0.3076923076923077,9
9976,2584,Expansion Packs,9,1,0.1111111111111111,8
9977,2584,Game Packs,6,1,0.16666666666666666,5
9978,2584,Kits,7,2,0.2857142857142857,5
9979,2584,Stuff Packs,13,3,0.23076923076923078,10
9980,2585,Expansion Packs,12,0,0.0,12
9981,2585,Game Packs,10,0,0.0,10
9982,2585,Kits,1,1,1.0,0
9983,2585,Stuff Packs,16,3,0.1875,13
9984,2586,Expansion Packs,4,0,0.0,4
9985,2586,Game Packs,4,0,0.0,4
9986,2586,Kits,2,0,0.0,2
9987,2586,Stuff Packs,8,1,0.125,7
9988,2587,Expansion Packs,12,0,0.0,12
9989,2587,Game Packs,7,0,0.0,7
9990,2587,Kits,16,0,0.0,16
9991,2587,Stuff Packs,13,0,0.0,13
9992,2588,Expansion Packs,10,0,0.0,10
9993,2588,Kits,3,0,0.0,3
9994,2588,Stuff Packs,4,0,0.0,4
9995,2589,Expansion Packs,13,0,0.0,13
9996,2589,Game Packs,11,0,0.0,11
9997,2589,Stuff Packs,11,2,0.18181818181818182,9
9998,2590,Expansion Packs,7,0,0.0,7
9999,2590,Game Packs,4,0,0.0,4
10000,2590,Kits,2,2,1.0,0
10001,2590,Stuff Packs,7,3,0.42857142857142855,4
10002,2591,Expansion Packs,15,0,0.0,15
10003,2591,Game Packs,12,0,0.0,12
10004,2591,Kits,14,1,0.07142857142857142,13
10005,2591,Stuff Packs,18,0,0.0,18
10006,2592,Expansion Packs,16,0,0.0,16
10007,2592,Game Packs,12,0,0.0,12
10008,2592,Kits,33,0,0.0,33
10009,2592,Stuff Packs,20,0,0.0,20
10010,2593,Expansion Packs,11,0,0.0,11
10011,2593,Game Packs,9,1,0.1111111111111111,8
10012,2593,Kits,1,1,1.0,0
10013,2593,Stuff Packs,7,2,0.2857142857142857,5
10014,2594,Expansion Packs,8,0,0.0,8
10015,2594,Game Packs,4,0,0.0,4
10016,2594,Kits,5,0,0.0,5
10017,2594,Stuff Packs,4,0,0.0,4
10018,2595,Expansion Packs,16,0,0.0,16
10019,2595,Game Packs,12,0,0.0,12
10020,2595,Kits,22,1,0.045454545454545456,21
10021,2595,Stuff Packs,16,2,0.125,14
10022,2596,Expansion Packs,16,0,0.0,16
10023,2596,Game Packs,11,0,0.0,11
10024,2596,Kits,20,0,0.0,20
10025,2596,Stuff Packs,16,0,0.0,16
10026,2597,Expansion Packs,16,0,0.0,16
10027,2597,Game Packs,11,1,0.09090909090909091,10
10028,2597,Kits,13,1,0.07692307692307693,12
10029,2597,Stuff Packs,19,0,0.0,19
10030,2598,Expansion Packs,16,0,0.0,16
10031,2598,Game Packs,12,0,0.0,12
10032,2598,Kits,31,5,0.16129032258064516,26
10033,2598,Stuff Packs,20,0,0.0,20
10034,2599,Expansion Packs,11,0,0.0,11
10035,2599,Game Packs,10,0,0.0,10
10036,2599,Kits,3,3,1.0,0
10037,2599,Stuff Packs,9,3,0.3333333333333333,6
10038,2600,Expansion Packs,15,0,0.0,15
10039,2600,Game Packs,9,0,0.0,9
10040,2600,Stuff Packs,12,0,0.0,12
10041,2601,Expansion Packs,11,0,0.0,11
10042,2601,Game Packs,8,0,0.0,8
10043,2601,Stuff Packs,5,0,0.0,5
10044,2602,Expansion Packs,16,0,0.0,16
10045,2602,Game Packs,12,0,0.0,12
10046,2602,Kits,33,0,0.0,33
10047,2602,Stuff Packs,20,0,0.0,20
10048,2603,Expansion Packs,6,0,0.0,6
10049,2603,Game Packs,3,0,0.0,3
10050,2603,Kits,2,2,1.0,0
10051,2603,Stuff Packs,6,3,0.5,3
10052,2604,Expansion Packs,11,0,0.0,11
10053,2604,Game Packs,2,1,0.5,1
10054,2604,Kits,3,3,1.0,0
10055,2604,Stuff Packs,8,3,0.375,5
10056,2605,Expansion Packs,16,0,0.0,16
10057,2605,Game Packs,11,0,0.0,11
10058,2605,Kits,15,2,0.13333333333333333,13
10059,2605,Stuff Packs,20,0,0.0,20
10060,2606,Expansion Packs,16,0,0.0,16
10061,2606,Game Packs,12,0,0.0,12
10062,2606,Kits,33,1,0.030303030303030304,32
10063,2606,Stuff Packs,20,0,0.0,20
10064,2607,Expansion Packs,16,0,0.0,16
10065,2607,Game Packs,9,1,0.1111111111111111,8
10066,2607,Kits,2,2,1.0,0
10067,2607,Stuff Packs,8,2,0.25,6
10068,2608,Expansion Packs,7,0,0.0,7
10069,2608,Game Packs,2,0,0.0,2
10070,2608,Kits,2,2,1.0,0
10071,2608,Stuff Packs,4,2,0.5,2
10072,2609,Expansion Packs,9,0,0.0,9
10073,2609,Game Packs,8,1,0.125,7
10074,2609,Kits,3,3,1.0,0
10075,2609,Stuff Packs,8,1,0.125,7
10076,2610,Expansion Packs,16,0,0.0,16
10077,2610,Game Packs,9,2,0.2222222222222222,7
10078,2610,Kits,8,2,0.25,6
10079,2610,Stuff Packs,15,3,0.2,12
10080,2611,Expansion Packs,16,0,0.0,16
10081,2611,Game Packs,12,1,0.08333333333333333,11
10082,2611,Kits,27,2,0.07407407407407407,25
10083,2611,Stuff Packs,20,1,0.05,19
10084,2612,Expansion Packs,15,0,0.0,15
10085,2612,Game Packs,7,0,0.0,7
10086,2612,Kits,5,0,0.0,5
10087,2612,Stuff Packs,6,1,0.16666666666666666,5
10088,2613,Kits,1,1,1.0,0
10089,2613,Stuff Packs,3,2,0.6666666666666666,1
10090,2614,Expansion Packs,16,0,0.0,16
10091,2614,Game Packs,12,0,0.0,12
10092,2614,Kits,33,1,0.030303030303030304,32
10093,2614,Stuff Packs,20,1,0.05,19
10094,2615,Expansion Packs,15,0,0.0,15
10095,2615,Game Packs,11,0,0.0,11
10096,2615,Kits,5,0,0.0,5
10097,2615,Stuff Packs,18,0,0.0,18
10098,2616,Expansion Packs,16,0,0.0,16
10099,2616,Game Packs,12,0,0.0,12
10100,2616,Kits,33,1,0.030303030303030304,32
10101,2616,Stuff Packs,20,0,0.0,20
10102,2617,Expansion Packs,10,0,0.0,10
10103,2617,Game Packs,8,0,0.0,8
10104,2617,Kits,1,0,0.0,1
10105,2617,Stuff Packs,10,0,0.0,10
10106,2618,Expansion Packs,12,0,0.0,12
10107,2618,Game Packs,9,0,0.0,9
10108,2618,Stuff Packs,8,0,0.0,8
10109,2619,Expansion Packs,16,0,0.0,16
10110,2619,Game Packs,11,1,0.09090909090909091,10
10111,2619,Kits,15,1,0.06666666666666667,14
10112,2619,Stuff Packs,12,3,0.25,9
10113,2620,Expansion Packs,11,0,0.0,11
10114,2620,Game Packs,8,0,0.0,8
10115,2620,Kits,4,2,0.5,2
10116,2620,Stuff Packs,11,0,0.0,11
10117,2621,Expansion Packs,16,1,0.0625,15
10118,2621,Game Packs,11,1,0.09090909090909091,10
10119,2621,Kits,22,3,0.13636363636363635,19
10120,2621,Stuff Packs,20,2,0.1,18
10121,2622,Expansion Packs,16,0,0.0,16
10122,2622,Game Packs,11,0,0.0,11
10123,2622,Kits,11,1,0.09090909090909091,10
10124,2622,Stuff Packs,20,0,0.0,20
10125,2623,Expansion Packs,9,0,0.0,9
10126,2623,Game Packs,4,0,0.0,4
10127,2623,Kits,6,1,0.16666666666666666,5
10128,2623,Stuff Packs,6,1,0.16666666666666666,5
10129,2624,Expansion Packs,13,0,0.0,13
10130,2624,Game Packs,5,0,0.0,5
10131,2624,Kits,4,3,0.75,1
10132,2624,Stuff Packs,10,4,0.4,6
10133,2625,Expansion Packs,16,0,0.0,16
10134,2625,Game Packs,12,0,0.0,12
10135,2625,Kits,31,0,0.0,31
10136,2625,Stuff Packs,20,0,0.0,20
10137,2626,Expansion Packs,14,0,0.0,14
10138,2626,Game Packs,7,0,0.0,7
10139,2626,Stuff Packs,10,2,0.2,8
10140,2627,Expansion Packs,7,0,0.0,7
10141,2627,Game Packs,4,0,0.0,4
10142,2627,Kits,1,1,1.0,0
10143,2627,Stuff Packs,3,3,1.0,0
10144,2628,Expansion Packs,16,0,0.0,16
10145,2628,Game Packs,12,0,0.0,12
10146,2628,Kits,27,2,0.07407407407407407,25
10147,2628,Stuff Packs,20,2,0.1,18
10148,2629,Expansion Packs,16,0,0.0,16
10149,2629,Game Packs,12,1,0.08333333333333333,11
10150,2629,Kits,33,1,0.030303030303030304,32
10151,2629,Stuff Packs,20,0,0.0,20
10152,2630,Expansion Packs,6,0,0.0,6
10153,2630,Game Packs,4,1,0.25,3
10154,2630,Kits,4,2,0.5,2
10155,2630,Stuff Packs,7,4,0.5714285714285714,3
10156,2631,Expansion Packs,16,0,0.0,16
10157,2631,Game Packs,11,0,0.0,11
10158,2631,Kits,22,3,0.13636363636363635,19
10159,2631,Stuff Packs,19,1,0.05263157894736842,18
10160,2632,Expansion Packs,16,0,0.0,16
10161,2632,Game Packs,9,1,0.1111111111111111,8
10162,2632,Kits,18,0,0.0,18
10163,2632,Stuff Packs,14,1,0.07142857142857142,13
10164,2633,Expansion Packs,16,0,0.0,16
10165,2633,Game Packs,12,0,0.0,12
10166,2633,Kits,33,0,0.0,33
10167,2633,Stuff Packs,20,0,0.0,20
10168,2634,Expansion Packs,16,0,0.0,16
10169,2634,Game Packs,12,0,0.0,12
10170,2634,Kits,20,2,0.1,18
10171,2634,Stuff Packs,20,0,0.0,20
10172,2635,Expansion Packs,15,15,1.0,0
10173,2635,Game Packs,5,5,1.0,0
10174,2635,Kits,17,17,1.0,0
10175,2635,Stuff Packs,12,12,1.0,0
10176,2636,Expansion Packs,11,0,0.0,11
10177,2636,Game Packs,9,0,0.0,9
10178,2636,Kits,2,2,1.0,0
10179,2636,Stuff Packs,7,2,0.2857142857142857,5
10180,2637,Expansion Packs,10,0,0.0,10
10181,2637,Game Packs,7,0,0.0,7
10182,2637,Kits,1,0,0.0,1
10183,2637,Stuff Packs,12,0,0.0,12
10184,2638,Expansion Packs,15,0,0.0,15
10185,2638,Game Packs,10,0,0.0,10
10186,2638,Kits,11,1,0.09090909090909091,10
10187,2638,Stuff Packs,17,1,0.058823529411764705,16
10188,2639,Expansion Packs,11,0,0.0,11
10189,2639,Game Packs,4,0,0.0,4
10190,2639,Kits,1,1,1.0,0
10191,2639,Stuff Packs,4,1,0.25,3
10192,2640,Expansion Packs,15,0,0.0,15
10193,2640,Game Packs,10,0,0.0,10
10194,2640,Kits,12,1,0.08333333333333333,11
10195,2640,Stuff Packs,18,1,0.05555555555555555,17
10196,2641,Expansion Packs,16,0,0.0,16
10197,2641,Game Packs,9,0,0.0,9
10198,2641,Kits,12,1,0.08333333333333333,11
10199,2641,Stuff Packs,12,0,0.0,12
10200,2642,Expansion Packs,16,0,0.0,16
10201,2642,Game Packs,12,0,0.0,12
10202,2642,Kits,33,1,0.030303030303030304,32
10203,2642,Stuff Packs,20,0,0.0,20
10204,2643,Expansion Packs,16,0,0.0,16
10205,2643,Game Packs,12,0,0.0,12
10206,2643,Kits,33,1,0.030303030303030304,32
10207,2643,Stuff Packs,20,0,0.0,20
10208,2644,Expansion Packs,13,0,0.0,13
10209,2644,Game Packs,11,0,0.0,11
10210,2644,Kits,20,0,0.0,20
10211,2644,Stuff Packs,18,0,0.0,18
10212,2645,Expansion Packs,16,0,0.0,16
10213,2645,Game Packs,11,0,0.0,11
10214,2645,Kits,27,0,0.0,27
10215,2645,Stuff Packs,19,0,0.0,19
10216,2646,Expansion Packs,11,0,0.0,11
10217,2646,Game Packs,5,0,0.0,5
10218,2646,Kits,10,1,0.1,9
10219,2646,Stuff Packs,14,0,0.0,14
10220,2647,Expansion Packs,12,0,0.0,12
10221,2647,Game Packs,10,0,0.0,10
10222,2647,Kits,9,1,0.1111111111111111,8
10223,2647,Stuff Packs,18,0,0.0,18
10224,2648,Expansion Packs,16,0,0.0,16
10225,2648,Game Packs,12,0,0.0,12
10226,2648,Kits,12,1,0.08333333333333333,11
10227,2648,Stuff Packs,17,0,0.0,17
10228,2649,Expansion Packs,14,0,0.0,14
10229,2649,Game Packs,11,0,0.0,11
10230,2649,Kits,8,2,0.25,6
10231,2649,Stuff Packs,13,3,0.23076923076923078,10
10232,2650,Expansion Packs,7,0,0.0,7
10233,2650,Game Packs,6,0,0.0,6
10234,2650,Stuff Packs,4,0,0.0,4
10235,2651,Expansion Packs,8,0,0.0,8
10236,2651,Game Packs,2,0,0.0,2
10237,2652,Expansion Packs,15,0,0.0,15
10238,2652,Game Packs,12,0,0.0,12
10239,2652,Kits,14,1,0.07142857142857142,13
10240,2652,Stuff Packs,20,0,0.0,20
10241,2653,Expansion Packs,4,0,0.0,4
10242,2653,Game Packs,3,0,0.0,3
10243,2653,Kits,1,1,1.0,0
10244,2653,Stuff Packs,6,3,0.5,3
10245,2654,Expansion Packs,13,0,0.0,13
10246,2654,Game Packs,11,0,0.0,11
10247,2654,Kits,15,0,0.0,15
10248,2654,Stuff Packs,18,1,0.05555555555555555,17
10249,2655,Expansion Packs,15,0,0.0,15
10250,2655,Game Packs,11,0,0.0,11
10251,2655,Kits,6,1,0.16666666666666666,5
10252,2655,Stuff Packs,18,1,0.05555555555555555,17
10253,2656,Expansion Packs,14,0,0.0,14
10254,2656,Game Packs,10,0,0.0,10
10255,2656,Kits,9,1,0.1111111111111111,8
10256,2656,Stuff Packs,17,1,0.058823529411764705,16
10257,2657,Expansion Packs,16,0,0.0,16
10258,2657,Game Packs,10,0,0.0,10
10259,2657,Kits,2,1,0.5,1
10260,2657,Stuff Packs,20,0,0.0,20
10261,2658,Expansion Packs,4,0,0.0,4
10262,2658,Game Packs,4,1,0.25,3
10263,2658,Kits,3,2,0.6666666666666666,1
10264,2658,Stuff Packs,8,4,0.5,4
10265,2659,Expansion Packs,16,0,0.0,16
10266,2659,Game Packs,11,0,0.0,11
10267,2659,Kits,25,1,0.04,24
10268,2659,Stuff Packs,19,0,0.0,19
10269,2660,Expansion Packs,16,0,0.0,16
10270,2660,Game Packs,12,0,0.0,12
10271,2660,Kits,33,1,0.030303030303030304,32
10272,2660,Stuff Packs,20,0,0.0,20
10273,2661,Expansion Packs,16,0,0.0,16
10274,2661,Game Packs,12,0,0.0,12
10275,2661,Kits,33,0,0.0,33
10276,2661,Stuff Packs,20,0,0.0,20
10277,2662,Expansion Packs,15,0,0.0,15
10278,2662,Game Packs,7,0,0.0,7
10279,2662,Kits,1,1,1.0,0
10280,2662,Stuff Packs,8,1,0.125,7
10281,2663,Expansion Packs,7,0,0.0,7
10282,2663,Game Packs,2,0,0.0,2
10283,2663,Kits,2,2,1.0,0
10284,2663,Stuff Packs,4,3,0.75,1
10285,2664,Expansion Packs,15,0,0.0,15
10286,2664,Game Packs,10,0,0.0,10
10287,2664,Kits,4,1,0.25,3
10288,2664,Stuff Packs,18,1,0.05555555555555555,17
10289,2665,Expansion Packs,5,0,0.0,5
10290,2665,Game Packs,4,0,0.0,4
10291,2665,Kits,2,1,0.5,1
10292,2665,Stuff Packs,2,1,0.5,1
10293,2666,Expansion Packs,16,0,0.0,16
10294,2666,Game Packs,12,0,0.0,12
10295,2666,Kits,32,1,0.03125,31
10296,2666,Stuff Packs,20,0,0.0,20
10297,2667,Expansion Packs,16,0,0.0,16
10298,2667,Game Packs,11,0,0.0,11
10299,2667,Kits,28,0,0.0,28
10300,2667,Stuff Packs,20,0,0.0,20
10301,2668,Expansion Packs,12,0,0.0,12
10302,2668,Game Packs,7,0,0.0,7
10303,2668,Kits,7,0,0.0,7
10304,2668,Stuff Packs,17,0,0.0,17
10305,2669,Expansion Packs,12,0,0.0,12
10306,2669,Game Packs,9,0,0.0,9
10307,2669,Kits,9,0,0.0,9
10308,2669,Stuff Packs,12,0,0.0,12
10309,2670,Expansion Packs,13,0,0.0,13
10310,2670,Game Packs,9,0,0.0,9
10311,2670,Kits,2,2,1.0,0
10312,2670,Stuff Packs,12,3,0.25,9
10313,2671,Expansion Packs,5,0,0.0,5
10314,2671,Game Packs,1,0,0.0,1
10315,2671,Kits,1,1,1.0,0
10316,2671,Stuff Packs,2,2,1.0,0
10317,2672,Expansion Packs,16,0,0.0,16
10318,2672,Game Packs,12,0,0.0,12
10319,2672,Kits,33,0,0.0,33
10320,2672,Stuff Packs,20,0,0.0,20
10321,2673,Expansion Packs,5,0,0.0,5
10322,2673,Game Packs,3,0,0.0,3
10323,2673,Kits,3,0,0.0,3
10324,2673,Stuff Packs,8,3,0.375,5
10325,2674,Expansion Packs,9,0,0.0,9
10326,2674,Game Packs,4,0,0.0,4
10327,2674,Stuff Packs,5,1,0.2,4
10328,2675,Expansion Packs,6,0,0.0,6
10329,2675,Game Packs,2,0,0.0,2
10330,2675,Kits,3,0,0.0,3
10331,2675,Stuff Packs,5,0,0.0,5
10332,2676,Expansion Packs,16,0,0.0,16
10333,2676,Game Packs,9,0,0.0,9
10334,2676,Kits,7,2,0.2857142857142857,5
10335,2676,Stuff Packs,15,0,0.0,15
10336,2677,Expansion Packs,15,7,0.4666666666666667,8
10337,2677,Game Packs,12,5,0.4166666666666667,7
10338,2677,Kits,33,33,1.0,0
10339,2677,Stuff Packs,20,1,0.05,19
10340,2678,Expansion Packs,16,0,0.0,16
10341,2678,Game Packs,12,0,0.0,12
10342,2678,Kits,33,0,0.0,33
10343,2678,Stuff Packs,20,0,0.0,20
10344,2679,Expansion Packs,10,0,0.0,10
10345,2679,Game Packs,4,0,0.0,4
10346,2679,Kits,2,1,0.5,1
10347,2679,Stuff Packs,10,2,0.2,8
10348,2680,Expansion Packs,9,0,0.0,9
10349,2680,Game Packs,6,1,0.16666666666666666,5
10350,2680,Kits,4,0,0.0,4
10351,2680,Stuff Packs,4,2,0.5,2
10352,2681,Expansion Packs,11,0,0.0,11
10353,2681,Game Packs,3,0,0.0,3
10354,2681,Kits,7,2,0.2857142857142857,5
10355,2681,Stuff Packs,8,3,0.375,5
10356,2682,Expansion Packs,14,0,0.0,14
10357,2682,Game Packs,9,0,0.0,9
10358,2682,Kits,8,2,0.25,6
10359,2682,Stuff Packs,12,3,0.25,9
10360,2683,Expansion Packs,14,0,0.0,14
10361,2683,Game Packs,11,0,0.0,11
10362,2683,Kits,4,2,0.5,2
10363,2683,Stuff Packs,20,0,0.0,20
10364,2684,Expansion Packs,13,0,0.0,13
10365,2684,Game Packs,3,0,0.0,3
10366,2684,Kits,8,0,0.0,8
10367,2684,Stuff Packs,10,0,0.0,10
10368,2685,Expansion Packs,9,0,0.0,9
10369,2685,Game Packs,4,0,0.0,4
10370,2685,Kits,1,1,1.0,0
10371,2685,Stuff Packs,7,3,0.42857142857142855,4
10372,2686,Expansion Packs,13,0,0.0,13
10373,2686,Game Packs,6,0,0.0,6
10374,2686,Kits,1,1,1.0,0
10375,2686,Stuff Packs,17,1,0.058823529411764705,16
10376,2687,Expansion Packs,6,0,0.0,6
10377,2687,Game Packs,3,0,0.0,3
10378,2687,Kits,2,0,0.0,2
10379,2687,Stuff Packs,8,3,0.375,5
10380,2688,Expansion Packs,16,0,0.0,16
10381,2688,Game Packs,12,0,0.0,12
10382,2688,Kits,23,0,0.0,23
10383,2688,Stuff Packs,18,0,0.0,18
10384,2689,Expansion Packs,16,0,0.0,16
10385,2689,Game Packs,12,0,0.0,12
10386,2689,Kits,19,4,0.21052631578947367,15
10387,2689,Stuff Packs,20,0,0.0,20
10388,2690,Expansion Packs,16,0,0.0,16
10389,2690,Game Packs,9,0,0.0,9
10390,2690,Kits,16,0,0.0,16
10391,2690,Stuff Packs,16,2,0.125,14
10392,2691,Expansion Packs,9,0,0.0,9
10393,2691,Game Packs,7,0,0.0,7
10394,2691,Kits,3,1,0.3333333333333333,2
10395,2691,Stuff Packs,11,4,0.36363636363636365,7
10396,2692,Expansion Packs,4,0,0.0,4
10397,2692,Game Packs,2,0,0.0,2
10398,2692,Kits,2,1,0.5,1
10399,2692,Stuff Packs,7,2,0.2857142857142857,5
10400,2693,Expansion Packs,14,0,0.0,14
10401,2693,Game Packs,10,0,0.0,10
10402,2693,Kits,3,2,0.6666666666666666,1
10403,2693,Stuff Packs,20,0,0.0,20
10404,2694,Expansion Packs,6,0,0.0,6
10405,2694,Game Packs,3,2,0.6666666666666666,1
10406,2694,Kits,5,1,0.2,4
10407,2694,Stuff Packs,9,6,0.6666666666666666,3
10408,2695,Expansion Packs,6,0,0.0,6
10409,2695,Game Packs,2,0,0.0,2
10410,2695,Kits,4,0,0.0,4
10411,2695,Stuff Packs,3,1,0.3333333333333333,2
10412,2696,Expansion Packs,14,0,0.0,14
10413,2696,Game Packs,7,0,0.0,7
10414,2696,Kits,1,1,1.0,0
10415,2696,Stuff Packs,12,0,0.0,12
10416,2697,Expansion Packs,11,0,0.0,11
10417,2697,Game Packs,7,0,0.0,7
10418,2697,Kits,1,1,1.0,0
10419,2697,Stuff Packs,10,3,0.3,7
10420,2698,Expansion Packs,3,0,0.0,3
10421,2698,Game Packs,2,1,0.5,1
10422,2698,Kits,4,2,0.5,2
10423,2698,Stuff Packs,6,4,0.6666666666666666,2
10424,2699,Expansion Packs,16,0,0.0,16
10425,2699,Game Packs,11,0,0.0,11
10426,2699,Kits,32,0,0.0,32
10427,2699,Stuff Packs,20,0,0.0,20
10428,2700,Expansion Packs,5,0,0.0,5
10429,2700,Game Packs,2,0,0.0,2
10430,2700,Kits,7,0,0.0,7
10431,2700,Stuff Packs,9,0,0.0,9
10432,2701,Expansion Packs,5,0,0.0,5
10433,2701,Game Packs,4,0,0.0,4
10434,2701,Kits,2,2,1.0,0
10435,2701,Stuff Packs,6,1,0.16666666666666666,5
10436,2702,Expansion Packs,16,0,0.0,16
10437,2702,Game Packs,12,0,0.0,12
10438,2702,Kits,33,0,0.0,33
10439,2702,Stuff Packs,20,0,0.0,20
10440,2703,Expansion Packs,16,0,0.0,16
10441,2703,Game Packs,9,0,0.0,9
10442,2703,Kits,11,0,0.0,11
10443,2703,Stuff Packs,17,0,0.0,17
10444,2704,Expansion Packs,15,0,0.0,15
10445,2704,Game Packs,9,0,0.0,9
10446,2704,Kits,3,1,0.3333333333333333,2
10447,2704,Stuff Packs,12,2,0.16666666666666666,10
10448,2705,Expansion Packs,16,0,0.0,16
10449,2705,Game Packs,11,0,0.0,11
10450,2705,Kits,25,0,0.0,25
10451,2705,Stuff Packs,19,0,0.0,19
10452,2706,Expansion Packs,9,0,0.0,9
10453,2706,Game Packs,1,0,0.0,1
10454,2706,Kits,6,0,0.0,6
10455,2706,Stuff Packs,7,0,0.0,7
10456,2707,Expansion Packs,15,0,0.0,15
10457,2707,Game Packs,12,0,0.0,12
10458,2707,Kits,33,1,0.030303030303030304,32
10459,2707,Stuff Packs,20,0,0.0,20
10460,2708,Stuff Packs,2,2,1.0,0
10461,2709,Expansion Packs,12,0,0.0,12
10462,2709,Game Packs,6,0,0.0,6
10463,2709,Kits,2,1,0.5,1
10464,2709,Stuff Packs,17,0,0.0,17
10465,2710,Expansion Packs,16,0,0.0,16
10466,2710,Game Packs,9,0,0.0,9
10467,2710,Kits,16,2,0.125,14
10468,2710,Stuff Packs,14,0,0.0,14
10469,2711,Expansion Packs,16,0,0.0,16
10470,2711,Game Packs,12,0,0.0,12
10471,2711,Kits,31,0,0.0,31
10472,2711,Stuff Packs,20,0,0.0,20
10473,2712,Expansion Packs,12,0,0.0,12
10474,2712,Game Packs,7,1,0.14285714285714285,6
10475,2712,Kits,1,0,0.0,1
10476,2712,Stuff Packs,14,1,0.07142857142857142,13
10477,2713,Expansion Packs,3,0,0.0,3
10478,2713,Game Packs,1,0,0.0,1
10479,2713,Kits,1,0,0.0,1
10480,2713,Stuff Packs,1,1,1.0,0
10481,2714,Expansion Packs,16,0,0.0,16
10482,2714,Game Packs,12,0,0.0,12
10483,2714,Kits,28,0,0.0,28
10484,2714,Stuff Packs,20,0,0.0,20
10485,2715,Expansion Packs,16,0,0.0,16
10486,2715,Game Packs,11,0,0.0,11
10487,2715,Kits,19,1,0.05263157894736842,18
10488,2715,Stuff Packs,20,2,0.1,18
10489,2716,Expansion Packs,11,0,0.0,11
10490,2716,Game Packs,4,0,0.0,4
10491,2716,Kits,7,1,0.14285714285714285,6
10492,2716,Stuff Packs,12,1,0.08333333333333333,11
10493,2717,Expansion Packs,12,0,0.0,12
10494,2717,Game Packs,8,0,0.0,8
10495,2717,Kits,1,1,1.0,0
10496,2717,Stuff Packs,9,1,0.1111111111111111,8
10497,2718,Expansion Packs,14,0,0.0,14
10498,2718,Game Packs,9,0,0.0,9
10499,2718,Kits,11,1,0.09090909090909091,10
10500,2718,Stuff Packs,16,2,0.125,14
10501,2719,Expansion Packs,15,0,0.0,15
10502,2719,Game Packs,7,2,0.2857142857142857,5
10503,2719,Kits,5,1,0.2,4
10504,2719,Stuff Packs,10,3,0.3,7
10505,2720,Expansion Packs,16,14,0.875,2
10506,2720,Game Packs,12,10,0.8333333333333334,2
10507,2720,Kits,33,16,0.48484848484848486,17
10508,2720,Stuff Packs,20,7,0.35,13
10509,2721,Expansion Packs,16,0,0.0,16
10510,2721,Game Packs,11,0,0.0,11
10511,2721,Kits,21,1,0.047619047619047616,20
10512,2721,Stuff Packs,18,0,0.0,18
10513,2722,Expansion Packs,16,15,0.9375,1
10514,2722,Game Packs,12,12,1.0,0
10515,2722,Kits,33,27,0.8181818181818182,6
10516,2722,Stuff Packs,20,15,0.75,5
10517,2723,Expansion Packs,16,0,0.0,16
10518,2723,Game Packs,9,0,0.0,9
10519,2723,Kits,2,1,0.5,1
10520,2723,Stuff Packs,8,1,0.125,7
10521,2724,Expansion Packs,11,0,0.0,11
10522,2724,Game Packs,4,0,0.0,4
10523,2724,Stuff Packs,3,2,0.6666666666666666,1
10524,2725,Expansion Packs,2,0,0.0,2
10525,2725,Game Packs,1,1,1.0,0
10526,2725,Kits,3,3,1.0,0
10527,2725,Stuff Packs,2,2,1.0,0
10528,2726,Expansion Packs,8,0,0.0,8
10529,2726,Game Packs,1,0,0.0,1
10530,2726,Kits,1,1,1.0,0
10531,2726,Stuff Packs,6,3,0.5,3
10532,2727,Expansion Packs,16,0,0.0,16
10533,2727,Game Packs,12,0,0.0,12
10534,2727,Kits,32,3,0.09375,29
10535,2727,Stuff Packs,20,0,0.0,20
10536,2728,Expansion Packs,14,0,0.0,14
10537,2728,Game Packs,12,0,0.0,12
10538,2728,Kits,12,1,0.08333333333333333,11
10539,2728,Stuff Packs,20,0,0.0,20
10540,2729,Expansion Packs,15,0,0.0,15
10541,2729,Game Packs,11,0,0.0,11
10542,2729,Kits,25,1,0.04,24
10543,2729,Stuff Packs,18,0,0.0,18
10544,2730,Expansion Packs,16,0,0.0,16
10545,2730,Game Packs,12,0,0.0,12
10546,2730,Kits,22,1,0.045454545454545456,21
10547,2730,Stuff Packs,18,0,0.0,18
10548,2731,Kits,1,1,1.0,0
10549,2732,Expansion Packs,16,0,0.0,16
10550,2732,Game Packs,12,1,0.08333333333333333,11
10551,2732,Kits,33,1,0.030303030303030304,32
10552,2732,Stuff Packs,20,0,0.0,20
10553,2733,Expansion Packs,11,0,0.0,11
10554,2733,Game Packs,6,0,0.0,6
10555,2733,Kits,1,1,1.0,0
10556,2733,Stuff Packs,14,0,0.0,14
10557,2734,Expansion Packs,16,0,0.0,16
10558,2734,Game Packs,9,0,0.0,9
10559,2734,Kits,29,1,0.034482758620689655,28
10560,2734,Stuff Packs,18,0,0.0,18
10561,2735,Expansion Packs,14,0,0.0,14
10562,2735,Game Packs,9,0,0.0,9
10563,2735,Kits,9,1,0.1111111111111111,8
10564,2735,Stuff Packs,9,0,0.0,9
10565,2736,Expansion Packs,3,0,0.0,3
10566,2736,Game Packs,4,3,0.75,1
10567,2736,Kits,2,1,0.5,1
10568,2736,Stuff Packs,3,1,0.3333333333333333,2
10569,2737,Expansion Packs,14,0,0.0,14
10570,2737,Game Packs,10,0,0.0,10
10571,2737,Kits,7,2,0.2857142857142857,5
10572,2737,Stuff Packs,17,1,0.058823529411764705,16
10573,2738,Expansion Packs,5,0,0.0,5
10574,2738,Game Packs,7,0,0.0,7
10575,2738,Kits,1,1,1.0,0
10576,2738,Stuff Packs,10,2,0.2,8
10577,2739,Expansion Packs,15,0,0.0,15
10578,2739,Game Packs,12,0,0.0,12
10579,2739,Kits,25,0,0.0,25
10580,2739,Stuff Packs,20,1,0.05,19
10581,2740,Expansion Packs,16,0,0.0,16
10582,2740,Game Packs,10,0,0.0,10
10583,2740,Kits,20,1,0.05,19
10584,2740,Stuff Packs,20,0,0.0,20
10585,2741,Expansion Packs,16,0,0.0,16
10586,2741,Game Packs,9,0,0.0,9
10587,2741,Kits,4,1,0.25,3
10588,2741,Stuff Packs,10,3,0.3,7
10589,2742,Expansion Packs,3,0,0.0,3
10590,2742,Game Packs,1,0,0.0,1
10591,2742,Kits,2,2,1.0,0
10592,2742,Stuff Packs,3,3,1.0,0
10593,2743,Expansion Packs,11,0,0.0,11
10594,2743,Game Packs,9,0,0.0,9
10595,2743,Kits,3,2,0.6666666666666666,1
10596,2743,Stuff Packs,10,0,0.0,10
10597,2744,Expansion Packs,14,0,0.0,14
10598,2744,Game Packs,9,0,0.0,9
10599,2744,Stuff Packs,9,3,0.3333333333333333,6
10600,2745,Expansion Packs,16,0,0.0,16
10601,2745,Game Packs,10,0,0.0,10
10602,2745,Kits,14,0,0.0,14
10603,2745,Stuff Packs,20,1,0.05,19
10604,2746,Expansion Packs,16,0,0.0,16
10605,2746,Game Packs,12,0,0.0,12
10606,2746,Kits,31,0,0.0,31
10607,2746,Stuff Packs,19,0,0.0,19
10608,2747,Expansion Packs,14,0,0.0,14
10609,2747,Game Packs,12,2,0.16666666666666666,10
10610,2747,Kits,22,3,0.13636363636363635,19
10611,2747,Stuff Packs,17,0,0.0,17
10612,2748,Expansion Packs,8,0,0.0,8
10613,2748,Game Packs,2,0,0.0,2
10614,2748,Kits,1,1,1.0,0
10615,2748,Stuff Packs,3,1,0.3333333333333333,2
10616,2749,Expansion Packs,14,0,0.0,14
10617,2749,Game Packs,12,0,0.0,12
10618,2749,Kits,11,2,0.18181818181818182,9
10619,2749,Stuff Packs,20,0,0.0,20
10620,2750,Expansion Packs,9,0,0.0,9
10621,2750,Game Packs,5,0,0.0,5
10622,2750,Kits,1,0,0.0,1
10623,2750,Stuff Packs,5,0,0.0,5
10624,2751,Expansion Packs,16,0,0.0,16
10625,2751,Game Packs,12,0,0.0,12
10626,2751,Kits,19,2,0.10526315789473684,17
10627,2751,Stuff Packs,20,3,0.15,17
10628,2752,Expansion Packs,16,0,0.0,16
10629,2752,Game Packs,11,0,0.0,11
10630,2752,Kits,18,2,0.1111111111111111,16
10631,2752,Stuff Packs,19,0,0.0,19
10632,2753,Expansion Packs,5,0,0.0,5
10633,2753,Game Packs,5,0,0.0,5
10634,2753,Stuff Packs,6,2,0.3333333333333333,4
10635,2754,Expansion Packs,16,0,0.0,16
10636,2754,Game Packs,8,1,0.125,7
10637,2754,Kits,9,2,0.2222222222222222,7
10638,2754,Stuff Packs,13,3,0.23076923076923078,10
10639,2755,Expansion Packs,15,0,0.0,15
10640,2755,Game Packs,12,0,0.0,12
10641,2755,Kits,27,0,0.0,27
10642,2755,Stuff Packs,19,0,0.0,19
10643,2756,Expansion Packs,16,2,0.125,14
10644,2756,Game Packs,12,6,0.5,6
10645,2756,Kits,33,5,0.15151515151515152,28
10646,2756,Stuff Packs,20,6,0.3,14
10647,2757,Expansion Packs,10,0,0.0,10
10648,2757,Game Packs,4,0,0.0,4
10649,2757,Kits,1,1,1.0,0
10650,2757,Stuff Packs,7,1,0.14285714285714285,6
10651,2758,Expansion Packs,5,0,0.0,5
10652,2758,Game Packs,3,0,0.0,3
10653,2758,Kits,4,1,0.25,3
10654,2758,Stuff Packs,7,3,0.42857142857142855,4
10655,2759,Expansion Packs,7,0,0.0,7
10656,2759,Game Packs,4,0,0.0,4
10657,2759,Kits,12,0,0.0,12
10658,2759,Stuff Packs,5,0,0.0,5
10659,2760,Expansion Packs,5,0,0.0,5
10660,2760,Game Packs,2,0,0.0,2
10661,2760,Kits,1,0,0.0,1
10662,2760,Stuff Packs,1,0,0.0,1
10663,2761,Expansion Packs,13,0,0.0,13
10664,2761,Game Packs,6,0,0.0,6
10665,2761,Kits,17,0,0.0,17
10666,2761,Stuff Packs,18,0,0.0,18
10667,2762,Expansion Packs,16,0,0.0,16
10668,2762,Game Packs,10,0,0.0,10
10669,2762,Kits,33,2,0.06060606060606061,31
10670,2762,Stuff Packs,19,0,0.0,19
10671,2763,Expansion Packs,16,0,0.0,16
10672,2763,Game Packs,12,0,0.0,12
10673,2763,Kits,30,0,0.0,30
10674,2763,Stuff Packs,18,0,0.0,18
10675,2764,Expansion Packs,10,0,0.0,10
10676,2764,Game Packs,4,0,0.0,4
10677,2764,Kits,2,2,1.0,0
10678,2764,Stuff Packs,7,2,0.2857142857142857,5
10679,2765,Expansion Packs,16,0,0.0,16
10680,2765,Game Packs,8,0,0.0,8
10681,2765,Kits,21,0,0.0,21
10682,2765,Stuff Packs,18,0,0.0,18
10683,2766,Expansion Packs,15,0,0.0,15
10684,2766,Game Packs,6,0,0.0,6
10685,2766,Kits,9,1,0.1111111111111111,8
10686,2766,Stuff Packs,9,0,0.0,9
10687,2767,Expansion Packs,8,0,0.0,8
10688,2767,Game Packs,1,0,0.0,1
10689,2767,Kits,2,0,0.0,2
10690,2767,Stuff Packs,2,0,0.0,2
10691,2768,Expansion Packs,7,0,0.0,7
10692,2768,Game Packs,3,0,0.0,3
10693,2768,Stuff Packs,6,3,0.5,3
10694,2769,Expansion Packs,16,0,0.0,16
10695,2769,Game Packs,11,0,0.0,11
10696,2769,Kits,33,1,0.030303030303030304,32
10697,2769,Stuff Packs,20,0,0.0,20
10698,2770,Expansion Packs,16,0,0.0,16
10699,2770,Game Packs,12,0,0.0,12
10700,2770,Kits,32,1,0.03125,31
10701,2770,Stuff Packs,20,0,0.0,20
10702,2771,Expansion Packs,10,0,0.0,10
10703,2771,Game Packs,7,1,0.14285714285714285,6
10704,2771,Kits,2,2,1.0,0
10705,2771,Stuff Packs,10,3,0.3,7
10706,2772,Expansion Packs,1,0,0.0,1
10707,2772,Game Packs,2,0,0.0,2
10708,2772,Stuff Packs,2,0,0.0,2
10709,2773,Expansion Packs,13,0,0.0,13
10710,2773,Game Packs,7,0,0.0,7
10711,2773,Kits,2,0,0.0,2
10712,2773,Stuff Packs,9,0,0.0,9
10713,2774,Expansion Packs,8,0,0.0,8
10714,2774,Game Packs,3,1,0.3333333333333333,2
10715,2774,Kits,2,2,1.0,0
10716,2774,Stuff Packs,2,1,0.5,1
10717,2775,Expansion Packs,15,0,0.0,15
10718,2775,Game Packs,11,0,0.0,11
10719,2775,Kits,32,1,0.03125,31
10720,2775,Stuff Packs,20,1,0.05,19
10721,2776,Expansion Packs,16,0,0.0,16
10722,2776,Game Packs,11,0,0.0,11
10723,2776,Kits,2,2,1.0,0
10724,2776,Stuff Packs,17,1,0.058823529411764705,16
10725,2777,Expansion Packs,16,0,0.0,16
10726,2777,Game Packs,12,0,0.0,12
10727,2777,Kits,28,2,0.07142857142857142,26
10728,2777,Stuff Packs,20,2,0.1,18
10729,2778,Expansion Packs,13,0,0.0,13
10730,2778,Game Packs,7,0,0.0,7
10731,2778,Kits,4,0,0.0,4
10732,2778,Stuff Packs,10,2,0.2,8
10733,2779,Expansion Packs,8,0,0.0,8
10734,2779,Game Packs,2,0,0.0,2
10735,2779,Kits,2,0,0.0,2
10736,2779,Stuff Packs,5,0,0.0,5
10737,2780,Expansion Packs,10,0,0.0,10
10738,2780,Game Packs,7,1,0.14285714285714285,6
10739,2780,Kits,3,3,1.0,0
10740,2780,Stuff Packs,7,4,0.5714285714285714,3
10741,2781,Expansion Packs,12,0,0.0,12
10742,2781,Game Packs,8,0,0.0,8
10743,2781,Stuff Packs,9,1,0.1111111111111111,8
10744,2782,Expansion Packs,16,0,0.0,16
10745,2782,Game Packs,11,0,0.0,11
10746,2782,Kits,21,2,0.09523809523809523,19
10747,2782,Stuff Packs,19,0,0.0,19
10748,2783,Expansion Packs,7,0,0.0,7
10749,2783,Game Packs,6,0,0.0,6
10750,2783,Kits,10,0,0.0,10
10751,2783,Stuff Packs,5,1,0.2,4
10752,2784,Expansion Packs,16,0,0.0,16
10753,2784,Game Packs,11,0,0.0,11
10754,2784,Kits,5,3,0.6,2
10755,2784,Stuff Packs,19,0,0.0,19
10756,2785,Expansion Packs,16,0,0.0,16
10757,2785,Game Packs,11,0,0.0,11
10758,2785,Kits,26,1,0.038461538461538464,25
10759,2785,Stuff Packs,17,0,0.0,17
10760,2786,Expansion Packs,16,0,0.0,16
10761,2786,Game Packs,12,0,0.0,12
10762,2786,Kits,33,0,0.0,33
10763,2786,Stuff Packs,20,0,0.0,20
10764,2787,Expansion Packs,16,0,0.0,16
10765,2787,Game Packs,11,0,0.0,11
10766,2787,Kits,18,0,0.0,18
10767,2787,Stuff Packs,15,0,0.0,15
10768,2788,Expansion Packs,14,0,0.0,14
10769,2788,Game Packs,12,0,0.0,12
10770,2788,Kits,13,1,0.07692307692307693,12
10771,2788,Stuff Packs,19,1,0.05263157894736842,18
10772,2789,Expansion Packs,13,0,0.0,13
10773,2789,Game Packs,6,0,0.0,6
10774,2789,Kits,1,1,1.0,0
10775,2789,Stuff Packs,10,3,0.3,7
10776,2790,Expansion Packs,16,0,0.0,16
10777,2790,Game Packs,12,0,0.0,12
10778,2790,Kits,18,1,0.05555555555555555,17
10779,2790,Stuff Packs,20,1,0.05,19
10780,2791,Expansion Packs,14,0,0.0,14
10781,2791,Game Packs,10,0,0.0,10
10782,2791,Kits,6,3,0.5,3
10783,2791,Stuff Packs,19,1,0.05263157894736842,18
10784,2792,Expansion Packs,11,0,0.0,11
10785,2792,Game Packs,4,0,0.0,4
10786,2792,Stuff Packs,2,1,0.5,1
10787,2793,Expansion Packs,14,0,0.0,14
10788,2793,Game Packs,10,0,0.0,10
10789,2793,Kits,4,1,0.25,3
10790,2793,Stuff Packs,16,0,0.0,16
10791,2794,Expansion Packs,10,0,0.0,10
10792,2794,Game Packs,7,0,0.0,7
10793,2794,Stuff Packs,7,0,0.0,7
10794,2795,Expansion Packs,14,0,0.0,14
10795,2795,Game Packs,12,0,0.0,12
10796,2795,Kits,22,1,0.045454545454545456,21
10797,2795,Stuff Packs,20,1,0.05,19
10798,2796,Expansion Packs,16,0,0.0,16
10799,2796,Game Packs,12,0,0.0,12
10800,2796,Kits,22,0,0.0,22
10801,2796,Stuff Packs,20,0,0.0,20
10802,2797,Expansion Packs,9,0,0.0,9
10803,2797,Game Packs,3,0,0.0,3
10804,2797,Kits,1,1,1.0,0
10805,2797,Stuff Packs,5,2,0.4,3
10806,2798,Expansion Packs,12,0,0.0,12
10807,2798,Game Packs,3,0,0.0,3
10808,2798,Kits,5,1,0.2,4
10809,2798,Stuff Packs,14,3,0.21428571428571427,11
10810,2799,Expansion Packs,8,0,0.0,8
10811,2799,Game Packs,5,0,0.0,5
10812,2799,Kits,1,1,1.0,0
10813,2799,Stuff Packs,6,2,0.3333333333333333,4
10814,2800,Expansion Packs,15,0,0.0,15
10815,2800,Game Packs,12,0,0.0,12
10816,2800,Kits,29,1,0.034482758620689655,28
10817,2800,Stuff Packs,20,1,0.05,19
10818,2801,Expansion Packs,15,0,0.0,15
10819,2801,Game Packs,11,0,0.0,11
10820,2801,Kits,25,2,0.08,23
10821,2801,Stuff Packs,16,3,0.1875,13
10822,2802,Expansion Packs,9,0,0.0,9
10823,2802,Game Packs,9,0,0.0,9
10824,2802,Kits,25,2,0.08,23
10825,2802,Stuff Packs,15,3,0.2,12
10826,2803,Expansion Packs,11,0,0.0,11
10827,2803,Game Packs,5,0,0.0,5
10828,2803,Kits,4,2,0.5,2
10829,2803,Stuff Packs,7,4,0.5714285714285714,3
10830,2804,Expansion Packs,16,1,0.0625,15
10831,2804,Game Packs,8,0,0.0,8
10832,2804,Kits,25,1,0.04,24
10833,2804,Stuff Packs,18,2,0.1111111111111111,16
10834,2805,Expansion Packs,16,0,0.0,16
10835,2805,Game Packs,12,0,0.0,12
10836,2805,Kits,23,2,0.08695652173913043,21
10837,2805,Stuff Packs,20,0,0.0,20
10838,2806,Expansion Packs,11,0,0.0,11
10839,2806,Game Packs,7,0,0.0,7
10840,2806,Kits,7,2,0.2857142857142857,5
10841,2806,Stuff Packs,7,0,0.0,7
10842,2807,Expansion Packs,12,0,0.0,12
10843,2807,Game Packs,6,0,0.0,6
10844,2807,Kits,1,1,1.0,0
10845,2807,Stuff Packs,4,0,0.0,4
10846,2808,Expansion Packs,14,0,0.0,14
10847,2808,Game Packs,9,0,0.0,9
10848,2808,Kits,12,1,0.08333333333333333,11
10849,2808,Stuff Packs,11,0,0.0,11
10850,2809,Expansion Packs,16,0,0.0,16
10851,2809,Game Packs,7,0,0.0,7
10852,2809,Kits,4,1,0.25,3
10853,2809,Stuff Packs,7,2,0.2857142857142857,5
10854,2810,Expansion Packs,12,0,0.0,12
10855,2810,Game Packs,7,0,0.0,7
10856,2810,Kits,5,1,0.2,4
10857,2810,Stuff Packs,16,0,0.0,16
10858,2811,Expansion Packs,15,0,0.0,15
10859,2811,Game Packs,10,0,0.0,10
10860,2811,Kits,2,2,1.0,0
10861,2811,Stuff Packs,17,1,0.058823529411764705,16
10862,2812,Expansion Packs,16,0,0.0,16
10863,2812,Game Packs,9,0,0.0,9
10864,2812,Kits,3,1,0.3333333333333333,2
10865,2812,Stuff Packs,9,2,0.2222222222222222,7
10866,2813,Expansion Packs,10,0,0.0,10
10867,2813,Game Packs,5,0,0.0,5
10868,2813,Stuff Packs,7,1,0.14285714285714285,6
10869,2814,Expansion Packs,13,0,0.0,13
10870,2814,Game Packs,9,0,0.0,9
10871,2814,Kits,7,1,0.14285714285714285,6
10872,2814,Stuff Packs,13,2,0.15384615384615385,11
10873,2815,Expansion Packs,10,1,0.1,9
10874,2815,Game Packs,5,1,0.2,4
10875,2815,Kits,4,2,0.5,2
10876,2815,Stuff Packs,5,2,0.4,3
10877,2816,Expansion Packs,15,0,0.0,15
10878,2816,Game Packs,6,0,0.0,6
10879,2816,Kits,7,1,0.14285714285714285,6
10880,2816,Stuff Packs,14,1,0.07142857142857142,13
10881,2817,Expansion Packs,16,0,0.0,16
10882,2817,Game Packs,11,0,0.0,11
10883,2817,Kits,26,1,0.038461538461538464,25
10884,2817,Stuff Packs,18,0,0.0,18
10885,2818,Expansion Packs,15,0,0.0,15
10886,2818,Game Packs,12,0,0.0,12
10887,2818,Kits,23,1,0.043478260869565216,22
10888,2818,Stuff Packs,20,1,0.05,19
10889,2819,Expansion Packs,2,0,0.0,2
10890,2819,Game Packs,2,0,0.0,2
10891,2819,Kits,4,0,0.0,4
10892,2819,Stuff Packs,2,0,0.0,2
10893,2820,Expansion Packs,16,1,0.0625,15
10894,2820,Game Packs,8,0,0.0,8
10895,2820,Kits,17,5,0.29411764705882354,12
10896,2820,Stuff Packs,17,6,0.35294117647058826,11
10897,2821,Expansion Packs,16,0,0.0,16
10898,2821,Game Packs,12,0,0.0,12
10899,2821,Kits,21,0,0.0,21
10900,2821,Stuff Packs,20,0,0.0,20
10901,2822,Expansion Packs,16,0,0.0,16
10902,2822,Game Packs,12,0,0.0,12
10903,2822,Kits,33,1,0.030303030303030304,32
10904,2822,Stuff Packs,20,0,0.0,20
10905,2823,Expansion Packs,15,0,0.0,15
10906,2823,Game Packs,11,0,0.0,11
10907,2823,Stuff Packs,16,0,0.0,16
10908,2824,Expansion Packs,16,0,0.0,16
10909,2824,Game Packs,11,0,0.0,11
10910,2824,Kits,12,0,0.0,12
10911,2824,Stuff Packs,18,0,0.0,18
10912,2825,Expansion Packs,7,0,0.0,7
10913,2825,Game Packs,3,0,0.0,3
10914,2825,Stuff Packs,5,3,0.6,2
10915,2826,Expansion Packs,16,1,0.0625,15
10916,2826,Game Packs,10,0,0.0,10
10917,2826,Kits,3,0,0.0,3
10918,2826,Stuff Packs,10,0,0.0,10
10919,2827,Expansion Packs,8,0,0.0,8
10920,2827,Game Packs,2,0,0.0,2
10921,2827,Kits,5,1,0.2,4
10922,2827,Stuff Packs,10,3,0.3,7
10923,2828,Expansion Packs,7,0,0.0,7
10924,2828,Game Packs,5,0,0.0,5
10925,2828,Stuff Packs,5,4,0.8,1
10926,2829,Expansion Packs,1,0,0.0,1
10927,2829,Game Packs,1,0,0.0,1
10928,2829,Kits,7,0,0.0,7
10929,2829,Stuff Packs,3,2,0.6666666666666666,1
10930,2830,Expansion Packs,14,0,0.0,14
10931,2830,Game Packs,11,0,0.0,11
10932,2830,Kits,2,0,0.0,2
10933,2830,Stuff Packs,12,0,0.0,12
10934,2831,Stuff Packs,1,1,1.0,0
10935,2832,Expansion Packs,12,0,0.0,12
10936,2832,Game Packs,8,0,0.0,8
10937,2832,Kits,4,1,0.25,3
10938,2832,Stuff Packs,6,2,0.3333333333333333,4
10939,2833,Expansion Packs,15,0,0.0,15
10940,2833,Game Packs,8,0,0.0,8
10941,2833,Kits,3,1,0.3333333333333333,2
10942,2833,Stuff Packs,14,0,0.0,14
10943,2834,Expansion Packs,16,0,0.0,16
10944,2834,Game Packs,12,0,0.0,12
10945,2834,Kits,33,1,0.030303030303030304,32
10946,2834,Stuff Packs,20,1,0.05,19
10947,2835,Expansion Packs,15,0,0.0,15
10948,2835,Game Packs,7,0,0.0,7
10949,2835,Kits,6,1,0.16666666666666666,5
10950,2835,Stuff Packs,11,3,0.2727272727272727,8
10951,2836,Expansion Packs,16,0,0.0,16
10952,2836,Game Packs,12,0,0.0,12
10953,2836,Kits,19,1,0.05263157894736842,18
10954,2836,Stuff Packs,20,0,0.0,20
10955,2837,Expansion Packs,6,0,0.0,6
10956,2837,Game Packs,2,0,0.0,2
10957,2837,Kits,1,0,0.0,1
10958,2837,Stuff Packs,3,2,0.6666666666666666,1
10959,2838,Expansion Packs,6,0,0.0,6
10960,2838,Game Packs,7,0,0.0,7
10961,2838,Kits,4,3,0.75,1
10962,2838,Stuff Packs,6,2,0.3333333333333333,4
10963,2839,Expansion Packs,16,0,0.0,16
10964,2839,Game Packs,6,0,0.0,6
10965,2839,Kits,8,2,0.25,6
10966,2839,Stuff Packs,8,3,0.375,5
10967,2840,Expansion Packs,16,0,0.0,16
10968,2840,Game Packs,12,0,0.0,12
10969,2840,Kits,33,0,0.0,33
10970,2840,Stuff Packs,20,0,0.0,20
10971,2841,Expansion Packs,6,0,0.0,6
10972,2841,Stuff Packs,1,0,0.0,1
10973,2842,Expansion Packs,14,1,0.07142857142857142,13
10974,2842,Game Packs,8,1,0.125,7
10975,2842,Kits,5,2,0.4,3
10976,2842,Stuff Packs,12,3,0.25,9
10977,2843,Expansion Packs,13,0,0.0,13
10978,2843,Game Packs,9,0,0.0,9
10979,2843,Kits,4,0,0.0,4
10980,2843,Stuff Packs,14,0,0.0,14
10981,2844,Expansion Packs,5,0,0.0,5
10982,2844,Game Packs,2,0,0.0,2
10983,2844,Kits,2,1,0.5,1
10984,2844,Stuff Packs,2,0,0.0,2
10985,2845,Expansion Packs,13,0,0.0,13
10986,2845,Game Packs,6,0,0.0,6
10987,2845,Kits,16,1,0.0625,15
10988,2845,Stuff Packs,12,1,0.08333333333333333,11
10989,2846,Expansion Packs,15,0,0.0,15
10990,2846,Game Packs,9,0,0.0,9
10991,2846,Kits,4,1,0.25,3
10992,2846,Stuff Packs,17,1,0.058823529411764705,16
10993,2847,Expansion Packs,16,0,0.0,16
10994,2847,Game Packs,11,0,0.0,11
10995,2847,Kits,26,2,0.07692307692307693,24
10996,2847,Stuff Packs,19,1,0.05263157894736842,18
10997,2848,Expansion Packs,14,0,0.0,14
10998,2848,Game Packs,9,0,0.0,9
10999,2848,Kits,2,0,0.0,2
11000,2848,Stuff Packs,10,0,0.0,10
11001,2849,Expansion Packs,15,0,0.0,15
11002,2849,Game Packs,7,0,0.0,7
11003,2849,Kits,1,0,0.0,1
11004,2849,Stuff Packs,9,1,0.1111111111111111,8
11005,2850,Expansion Packs,16,0,0.0,16
11006,2850,Game Packs,12,0,0.0,12
11007,2850,Kits,17,1,0.058823529411764705,16
11008,2850,Stuff Packs,20,0,0.0,20
11009,2851,Expansion Packs,14,0,0.0,14
11010,2851,Game Packs,10,0,0.0,10
11011,2851,Kits,4,1,0.25,3
11012,2851,Stuff Packs,18,0,0.0,18
11013,2852,Expansion Packs,16,0,0.0,16
11014,2852,Game Packs,12,0,0.0,12
11015,2852,Kits,33,0,0.0,33
11016,2852,Stuff Packs,20,0,0.0,20
11017,2853,Expansion Packs,15,0,0.0,15
11018,2853,Game Packs,12,0,0.0,12
11019,2853,Kits,16,1,0.0625,15
11020,2853,Stuff Packs,20,0,0.0,20
11021,2854,Expansion Packs,6,0,0.0,6
11022,2854,Game Packs,3,0,0.0,3
11023,2854,Kits,2,1,0.5,1
11024,2854,Stuff Packs,6,0,0.0,6
11025,2855,Expansion Packs,8,0,0.0,8
11026,2855,Game Packs,5,0,0.0,5
11027,2855,Kits,2,0,0.0,2
11028,2855,Stuff Packs,5,0,0.0,5
11029,2856,Expansion Packs,10,0,0.0,10
11030,2856,Game Packs,4,0,0.0,4
11031,2856,Kits,3,0,0.0,3
11032,2856,Stuff Packs,7,0,0.0,7
11033,2857,Expansion Packs,15,0,0.0,15
11034,2857,Game Packs,6,0,0.0,6
11035,2857,Kits,8,0,0.0,8
11036,2857,Stuff Packs,7,0,0.0,7
11037,2858,Expansion Packs,16,0,0.0,16
11038,2858,Game Packs,11,0,0.0,11
11039,2858,Kits,24,0,0.0,24
11040,2858,Stuff Packs,20,0,0.0,20
11041,2859,Expansion Packs,12,0,0.0,12
11042,2859,Game Packs,10,0,0.0,10
11043,2859,Kits,6,2,0.3333333333333333,4
11044,2859,Stuff Packs,18,0,0.0,18
11045,2860,Expansion Packs,15,0,0.0,15
11046,2860,Game Packs,11,0,0.0,11
11047,2860,Kits,6,0,0.0,6
11048,2860,Stuff Packs,19,0,0.0,19
11049,2861,Expansion Packs,15,0,0.0,15
11050,2861,Game Packs,12,0,0.0,12
11051,2861,Kits,1,0,0.0,1
11052,2861,Stuff Packs,20,0,0.0,20
11053,2862,Expansion Packs,16,0,0.0,16
11054,2862,Game Packs,12,0,0.0,12
11055,2862,Kits,33,0,0.0,33
11056,2862,Stuff Packs,20,0,0.0,20
11057,2863,Expansion Packs,14,0,0.0,14
11058,2863,Game Packs,11,1,0.09090909090909091,10
11059,2863,Kits,6,3,0.5,3
11060,2863,Stuff Packs,19,1,0.05263157894736842,18
11061,2864,Expansion Packs,13,1,0.07692307692307693,12
11062,2864,Game Packs,8,0,0.0,8
11063,2864,Kits,2,2,1.0,0
11064,2864,Stuff Packs,15,1,0.06666666666666667,14
11065,2865,Expansion Packs,14,0,0.0,14
11066,2865,Game Packs,9,0,0.0,9
11067,2865,Kits,2,0,0.0,2
11068,2865,Stuff Packs,14,1,0.07142857142857142,13
11069,2866,Expansion Packs,13,0,0.0,13
11070,2866,Game Packs,12,0,0.0,12
11071,2866,Kits,8,1,0.125,7
11072,2866,Stuff Packs,16,0,0.0,16
11073,2867,Expansion Packs,13,0,0.0,13
11074,2867,Game Packs,10,0,0.0,10
11075,2867,Kits,5,1,0.2,4
11076,2867,Stuff Packs,8,1,0.125,7
11077,2868,Expansion Packs,14,0,0.0,14
11078,2868,Game Packs,11,0,0.0,11
11079,2868,Kits,15,1,0.06666666666666667,14
11080,2868,Stuff Packs,20,0,0.0,20
11081,2869,Expansion Packs,16,0,0.0,16
11082,2869,Game Packs,12,0,0.0,12
11083,2869,Kits,33,0,0.0,33
11084,2869,Stuff Packs,20,0,0.0,20
11085,2870,Expansion Packs,16,0,0.0,16
11086,2870,Game Packs,12,0,0.0,12
11087,2870,Kits,33,1,0.030303030303030304,32
11088,2870,Stuff Packs,20,0,0.0,20
11089,2871,Expansion Packs,16,0,0.0,16
11090,2871,Game Packs,12,0,0.0,12
11091,2871,Kits,31,1,0.03225806451612903,30
11092,2871,Stuff Packs,20,0,0.0,20
11093,2872,Expansion Packs,16,0,0.0,16
11094,2872,Game Packs,12,0,0.0,12
11095,2872,Kits,29,0,0.0,29
11096,2872,Stuff Packs,19,0,0.0,19
11097,2873,Expansion Packs,15,0,0.0,15
11098,2873,Game Packs,12,0,0.0,12
11099,2873,Kits,7,0,0.0,7
11100,2873,Stuff Packs,16,2,0.125,14
11101,2874,Expansion Packs,4,0,0.0,4
11102,2874,Kits,1,1,1.0,0
11103,2874,Stuff Packs,3,1,0.3333333333333333,2
11104,2875,Expansion Packs,12,0,0.0,12
11105,2875,Game Packs,5,0,0.0,5
11106,2875,Kits,1,1,1.0,0
11107,2875,Stuff Packs,10,3,0.3,7
11108,2876,Expansion Packs,14,0,0.0,14
11109,2876,Game Packs,4,0,0.0,4
11110,2876,Kits,5,1,0.2,4
11111,2876,Stuff Packs,8,0,0.0,8
11112,2877,Expansion Packs,15,0,0.0,15
11113,2877,Game Packs,7,0,0.0,7
11114,2877,Kits,14,1,0.07142857142857142,13
11115,2877,Stuff Packs,14,0,0.0,14
11116,2878,Expansion Packs,12,0,0.0,12
11117,2878,Game Packs,9,0,0.0,9
11118,2878,Kits,12,2,0.16666666666666666,10
11119,2878,Stuff Packs,17,0,0.0,17
11120,2879,Expansion Packs,14,0,0.0,14
11121,2879,Game Packs,12,0,0.0,12
11122,2879,Kits,3,3,1.0,0
11123,2879,Stuff Packs,17,1,0.058823529411764705,16
11124,2880,Expansion Packs,16,1,0.0625,15
11125,2880,Game Packs,11,0,0.0,11
11126,2880,Kits,19,3,0.15789473684210525,16
11127,2880,Stuff Packs,20,2,0.1,18
11128,2881,Expansion Packs,5,0,0.0,5
11129,2881,Game Packs,1,0,0.0,1
11130,2881,Kits,1,1,1.0,0
11131,2881,Stuff Packs,3,3,1.0,0
11132,2882,Expansion Packs,16,0,0.0,16
11133,2882,Game Packs,12,0,0.0,12
11134,2882,Kits,7,2,0.2857142857142857,5
11135,2882,Stuff Packs,20,0,0.0,20
11136,2883,Expansion Packs,1,0,0.0,1
11137,2883,Stuff Packs,3,3,1.0,0
11138,2884,Expansion Packs,11,0,0.0,11
11139,2884,Game Packs,8,0,0.0,8
11140,2884,Kits,2,2,1.0,0
11141,2884,Stuff Packs,9,2,0.2222222222222222,7
11142,2885,Expansion Packs,16,0,0.0,16
11143,2885,Game Packs,11,0,0.0,11
11144,2885,Kits,3,0,0.0,3
11145,2885,Stuff Packs,14,0,0.0,14
11146,2886,Expansion Packs,16,0,0.0,16
11147,2886,Game Packs,12,0,0.0,12
11148,2886,Kits,32,0,0.0,32
11149,2886,Stuff Packs,20,0,0.0,20
11150,2887,Expansion Packs,15,0,0.0,15
11151,2887,Game Packs,11,0,0.0,11
11152,2887,Kits,5,1,0.2,4
11153,2887,Stuff Packs,14,0,0.0,14
11154,2888,Expansion Packs,15,1,0.06666666666666667,14
11155,2888,Game Packs,7,1,0.14285714285714285,6
11156,2888,Kits,11,1,0.09090909090909091,10
11157,2888,Stuff Packs,9,4,0.4444444444444444,5
11158,2889,Expansion Packs,16,0,0.0,16
11159,2889,Game Packs,9,0,0.0,9
11160,2889,Kits,12,1,0.08333333333333333,11
11161,2889,Stuff Packs,8,2,0.25,6
11162,2890,Expansion Packs,14,1,0.07142857142857142,13
11163,2890,Game Packs,6,0,0.0,6
11164,2890,Kits,4,0,0.0,4
11165,2890,Stuff Packs,4,0,0.0,4
11166,2891,Expansion Packs,16,0,0.0,16
11167,2891,Game Packs,12,0,0.0,12
11168,2891,Kits,33,0,0.0,33
11169,2891,Stuff Packs,20,3,0.15,17
11170,2892,Expansion Packs,13,0,0.0,13
11171,2892,Game Packs,8,1,0.125,7
11172,2892,Kits,5,2,0.4,3
11173,2892,Stuff Packs,10,3,0.3,7
11174,2893,Expansion Packs,15,0,0.0,15
11175,2893,Game Packs,11,0,0.0,11
11176,2893,Kits,6,1,0.16666666666666666,5
11177,2893,Stuff Packs,17,1,0.058823529411764705,16
11178,2894,Expansion Packs,4,0,0.0,4
11179,2894,Stuff Packs,2,0,0.0,2
11180,2895,Expansion Packs,16,0,0.0,16
11181,2895,Game Packs,12,0,0.0,12
11182,2895,Kits,25,1,0.04,24
11183,2895,Stuff Packs,20,0,0.0,20
11184,2896,Expansion Packs,15,0,0.0,15
11185,2896,Game Packs,9,0,0.0,9
11186,2896,Kits,7,1,0.14285714285714285,6
11187,2896,Stuff Packs,12,0,0.0,12
11188,2897,Expansion Packs,16,0,0.0,16
11189,2897,Game Packs,10,0,0.0,10
11190,2897,Kits,32,0,0.0,32
11191,2897,Stuff Packs,18,0,0.0,18
11192,2898,Expansion Packs,16,0,0.0,16
11193,2898,Game Packs,12,0,0.0,12
11194,2898,Kits,29,0,0.0,29
11195,2898,Stuff Packs,20,0,0.0,20
11196,2899,Expansion Packs,14,0,0.0,14
11197,2899,Game Packs,11,0,0.0,11
11198,2899,Kits,17,0,0.0,17
11199,2899,Stuff Packs,19,0,0.0,19
11200,2900,Expansion Packs,16,1,0.0625,15
11201,2900,Game Packs,12,0,0.0,12
11202,2900,Kits,33,1,0.030303030303030304,32
11203,2900,Stuff Packs,20,0,0.0,20
11204,2901,Expansion Packs,12,0,0.0,12
11205,2901,Game Packs,7,0,0.0,7
11206,2901,Kits,6,0,0.0,6
11207,2901,Stuff Packs,11,3,0.2727272727272727,8
11208,2902,Expansion Packs,16,0,0.0,16
11209,2902,Game Packs,12,0,0.0,12
11210,2902,Kits,11,1,0.09090909090909091,10
11211,2902,Stuff Packs,20,0,0.0,20
11212,2903,Expansion Packs,15,0,0.0,15
11213,2903,Game Packs,8,0,0.0,8
11214,2903,Kits,2,1,0.5,1
11215,2903,Stuff Packs,10,1,0.1,9
11216,2904,Expansion Packs,5,0,0.0,5
11217,2904,Game Packs,2,0,0.0,2
11218,2904,Kits,2,0,0.0,2
11219,2904,Stuff Packs,6,3,0.5,3
11220,2905,Expansion Packs,16,0,0.0,16
11221,2905,Game Packs,12,0,0.0,12
11222,2905,Kits,8,0,0.0,8
11223,2905,Stuff Packs,20,0,0.0,20
11224,2906,Expansion Packs,14,0,0.0,14
11225,2906,Game Packs,7,0,0.0,7
11226,2906,Kits,8,0,0.0,8
11227,2906,Stuff Packs,12,0,0.0,12
11228,2907,Expansion Packs,16,0,0.0,16
11229,2907,Game Packs,12,0,0.0,12
11230,2907,Kits,33,1,0.030303030303030304,32
11231,2907,Stuff Packs,20,0,0.0,20
11232,2908,Expansion Packs,16,0,0.0,16
11233,2908,Game Packs,12,1,0.08333333333333333,11
11234,2908,Kits,11,2,0.18181818181818182,9
11235,2908,Stuff Packs,20,1,0.05,19
11236,2909,Expansion Packs,16,0,0.0,16
11237,2909,Game Packs,9,0,0.0,9
11238,2909,Kits,21,1,0.047619047619047616,20
11239,2909,Stuff Packs,17,0,0.0,17
11240,2910,Expansion Packs,5,0,0.0,5
11241,2910,Game Packs,4,0,0.0,4
11242,2910,Stuff Packs,2,0,0.0,2
11243,2911,Expansion Packs,2,0,0.0,2
11244,2911,Kits,2,0,0.0,2
11245,2911,Stuff Packs,1,0,0.0,1
11246,2912,Expansion Packs,16,0,0.0,16
11247,2912,Game Packs,11,1,0.09090909090909091,10
11248,2912,Kits,25,2,0.08,23
11249,2912,Stuff Packs,18,3,0.16666666666666666,15
11250,2913,Expansion Packs,16,0,0.0,16
11251,2913,Game Packs,7,0,0.0,7
11252,2913,Kits,6,0,0.0,6
11253,2913,Stuff Packs,16,1,0.0625,15
11254,2914,Expansion Packs,15,1,0.06666666666666667,14
11255,2914,Game Packs,10,0,0.0,10
11256,2914,Kits,8,1,0.125,7
11257,2914,Stuff Packs,20,0,0.0,20
11258,2915,Expansion Packs,16,0,0.0,16
11259,2915,Game Packs,12,0,0.0,12
11260,2915,Kits,31,0,0.0,31
11261,2915,Stuff Packs,20,1,0.05,19
11262,2916,Expansion Packs,7,0,0.0,7
11263,2916,Game Packs,5,0,0.0,5
11264,2916,Stuff Packs,3,0,0.0,3
11265,2917,Expansion Packs,11,0,0.0,11
11266,2917,Game Packs,8,0,0.0,8
11267,2917,Kits,3,0,0.0,3
11268,2917,Stuff Packs,13,0,0.0,13
11269,2918,Expansion Packs,14,0,0.0,14
11270,2918,Game Packs,8,0,0.0,8
11271,2918,Kits,18,1,0.05555555555555555,17
11272,2918,Stuff Packs,19,1,0.05263157894736842,18
11273,2919,Expansion Packs,16,0,0.0,16
11274,2919,Game Packs,11,0,0.0,11
11275,2919,Kits,22,0,0.0,22
11276,2919,Stuff Packs,16,0,0.0,16
11277,2920,Expansion Packs,13,0,0.0,13
11278,2920,Game Packs,5,0,0.0,5
11279,2920,Kits,3,0,0.0,3
11280,2920,Stuff Packs,7,1,0.14285714285714285,6
11281,2921,Expansion Packs,16,0,0.0,16
11282,2921,Game Packs,12,0,0.0,12
11283,2921,Kits,33,1,0.030303030303030304,32
11284,2921,Stuff Packs,20,0,0.0,20
11285,2922,Expansion Packs,14,0,0.0,14
11286,2922,Game Packs,8,0,0.0,8
11287,2922,Kits,12,1,0.08333333333333333,11
11288,2922,Stuff Packs,12,2,0.16666666666666666,10
11289,2923,Expansion Packs,16,0,0.0,16
11290,2923,Game Packs,12,0,0.0,12
11291,2923,Kits,2,1,0.5,1
11292,2923,Stuff Packs,16,0,0.0,16
11293,2924,Expansion Packs,12,0,0.0,12
11294,2924,Game Packs,5,0,0.0,5
11295,2924,Kits,4,0,0.0,4
11296,2924,Stuff Packs,8,1,0.125,7
11297,2925,Expansion Packs,16,0,0.0,16
11298,2925,Game Packs,10,0,0.0,10
11299,2925,Kits,2,2,1.0,0
11300,2925,Stuff Packs,14,2,0.14285714285714285,12
11301,2926,Expansion Packs,16,0,0.0,16
11302,2926,Game Packs,12,0,0.0,12
11303,2926,Kits,33,1,0.030303030303030304,32
11304,2926,Stuff Packs,20,0,0.0,20
11305,2927,Expansion Packs,11,0,0.0,11
11306,2927,Game Packs,8,0,0.0,8
11307,2927,Stuff Packs,6,1,0.16666666666666666,5
11308,2928,Expansion Packs,8,0,0.0,8
11309,2928,Game Packs,6,1,0.16666666666666666,5
11310,2928,Kits,4,1,0.25,3
11311,2928,Stuff Packs,8,3,0.375,5
11312,2929,Expansion Packs,14,0,0.0,14
11313,2929,Game Packs,12,0,0.0,12
11314,2929,Kits,3,2,0.6666666666666666,1
11315,2929,Stuff Packs,19,0,0.0,19
11316,2930,Expansion Packs,15,0,0.0,15
11317,2930,Game Packs,12,0,0.0,12
11318,2930,Kits,28,1,0.03571428571428571,27
11319,2930,Stuff Packs,20,0,0.0,20
11320,2931,Expansion Packs,16,0,0.0,16
11321,2931,Game Packs,11,0,0.0,11
11322,2931,Kits,10,1,0.1,9
11323,2931,Stuff Packs,16,1,0.0625,15
11324,2932,Expansion Packs,16,0,0.0,16
11325,2932,Game Packs,12,0,0.0,12
11326,2932,Kits,33,0,0.0,33
11327,2932,Stuff Packs,20,0,0.0,20
11328,2933,Expansion Packs,6,0,0.0,6
11329,2933,Game Packs,6,0,0.0,6
11330,2933,Kits,5,3,0.6,2
11331,2933,Stuff Packs,8,4,0.5,4
11332,2934,Expansion Packs,11,0,0.0,11
11333,2934,Game Packs,5,1,0.2,4
11334,2934,Kits,3,2,0.6666666666666666,1
11335,2934,Stuff Packs,5,3,0.6,2
11336,2935,Expansion Packs,14,0,0.0,14
11337,2935,Game Packs,6,0,0.0,6
11338,2935,Kits,8,1,0.125,7
11339,2935,Stuff Packs,15,5,0.3333333333333333,10
11340,2936,Expansion Packs,14,0,0.0,14
11341,2936,Game Packs,11,0,0.0,11
11342,2936,Kits,5,2,0.4,3
11343,2936,Stuff Packs,19,0,0.0,19
11344,2937,Expansion Packs,16,0,0.0,16
11345,2937,Game Packs,9,0,0.0,9
11346,2937,Kits,11,1,0.09090909090909091,10
11347,2937,Stuff Packs,16,0,0.0,16
11348,2938,Expansion Packs,16,0,0.0,16
11349,2938,Game Packs,9,0,0.0,9
11350,2938,Kits,26,3,0.11538461538461539,23
11351,2938,Stuff Packs,10,0,0.0,10
11352,2939,Expansion Packs,2,0,0.0,2
11353,2939,Game Packs,3,0,0.0,3
11354,2939,Kits,1,1,1.0,0
11355,2939,Stuff Packs,4,3,0.75,1
11356,2940,Expansion Packs,16,0,0.0,16
11357,2940,Game Packs,11,0,0.0,11
11358,2940,Kits,3,1,0.3333333333333333,2
11359,2940,Stuff Packs,20,1,0.05,19
11360,2941,Expansion Packs,11,0,0.0,11
11361,2941,Game Packs,3,0,0.0,3
11362,2941,Kits,2,1,0.5,1
11363,2941,Stuff Packs,4,1,0.25,3
11364,2942,Expansion Packs,15,0,0.0,15
11365,2942,Game Packs,10,0,0.0,10
11366,2942,Kits,1,0,0.0,1
11367,2942,Stuff Packs,18,0,0.0,18
11368,2943,Expansion Packs,14,0,0.0,14
11369,2943,Game Packs,8,0,0.0,8
11370,2943,Kits,4,1,0.25,3
11371,2943,Stuff Packs,12,0,0.0,12
11372,2944,Expansion Packs,12,0,0.0,12
11373,2944,Game Packs,6,0,0.0,6
11374,2944,Kits,2,0,0.0,2
11375,2944,Stuff Packs,8,1,0.125,7
11376,2945,Expansion Packs,11,0,0.0,11
11377,2945,Game Packs,8,0,0.0,8
11378,2945,Kits,1,1,1.0,0
11379,2945,Stuff Packs,7,3,0.42857142857142855,4
11380,2946,Expansion Packs,15,0,0.0,15
11381,2946,Game Packs,11,0,0.0,11
11382,2946,Kits,16,0,0.0,16
11383,2946,Stuff Packs,18,2,0.1111111111111111,16
11384,2947,Expansion Packs,6,0,0.0,6
11385,2947,Game Packs,6,0,0.0,6
11386,2947,Kits,3,1,0.3333333333333333,2
11387,2947,Stuff Packs,7,4,0.5714285714285714,3
11388,2948,Expansion Packs,10,0,0.0,10
11389,2948,Game Packs,4,1,0.25,3
11390,2948,Kits,11,5,0.45454545454545453,6
11391,2948,Stuff Packs,9,3,0.3333333333333333,6
11392,2949,Expansion Packs,10,0,0.0,10
11393,2949,Game Packs,5,0,0.0,5
11394,2949,Kits,2,2,1.0,0
11395,2949,Stuff Packs,12,2,0.16666666666666666,10
11396,2950,Expansion Packs,7,0,0.0,7
11397,2950,Game Packs,4,0,0.0,4
11398,2950,Kits,5,2,0.4,3
11399,2950,Stuff Packs,5,2,0.4,3
11400,2951,Expansion Packs,16,0,0.0,16
11401,2951,Game Packs,12,1,0.08333333333333333,11
11402,2951,Kits,30,0,0.0,30
11403,2951,Stuff Packs,20,3,0.15,17
11404,2952,Expansion Packs,16,0,0.0,16
11405,2952,Game Packs,12,0,0.0,12
11406,2952,Kits,32,1,0.03125,31
11407,2952,Stuff Packs,20,2,0.1,18
11408,2953,Expansion Packs,4,0,0.0,4
11409,2953,Game Packs,4,0,0.0,4
11410,2953,Stuff Packs,1,1,1.0,0
11411,2954,Expansion Packs,12,0,0.0,12
11412,2954,Game Packs,4,0,0.0,4
11413,2954,Kits,2,2,1.0,0
11414,2954,Stuff Packs,4,3,0.75,1
11415,2955,Expansion Packs,10,0,0.0,10
11416,2955,Game Packs,10,0,0.0,10
11417,2955,Kits,2,1,0.5,1
11418,2955,Stuff Packs,10,0,0.0,10
11419,2956,Expansion Packs,11,0,0.0,11
11420,2956,Game Packs,5,0,0.0,5
11421,2956,Kits,7,0,0.0,7
11422,2956,Stuff Packs,5,0,0.0,5
11423,2957,Expansion Packs,6,0,0.0,6
11424,2957,Game Packs,5,0,0.0,5
11425,2957,Kits,1,1,1.0,0
11426,2957,Stuff Packs,4,0,0.0,4
11427,2958,Expansion Packs,16,0,0.0,16
11428,2958,Game Packs,9,0,0.0,9
11429,2958,Kits,4,1,0.25,3
11430,2958,Stuff Packs,11,2,0.18181818181818182,9
11431,2959,Expansion Packs,16,0,0.0,16
11432,2959,Game Packs,12,0,0.0,12
11433,2959,Kits,33,0,0.0,33
11434,2959,Stuff Packs,20,0,0.0,20
11435,2960,Expansion Packs,16,0,0.0,16
11436,2960,Game Packs,11,0,0.0,11
11437,2960,Kits,9,0,0.0,9
11438,2960,Stuff Packs,20,0,0.0,20
11439,2961,Expansion Packs,13,0,0.0,13
11440,2961,Game Packs,7,0,0.0,7
11441,2961,Kits,17,1,0.058823529411764705,16
11442,2961,Stuff Packs,14,1,0.07142857142857142,13
11443,2962,Expansion Packs,15,0,0.0,15
11444,2962,Game Packs,11,0,0.0,11
11445,2962,Kits,7,0,0.0,7
11446,2962,Stuff Packs,16,0,0.0,16
11447,2963,Expansion Packs,16,0,0.0,16
11448,2963,Game Packs,12,2,0.16666666666666666,10
11449,2963,Kits,33,0,0.0,33
11450,2963,Stuff Packs,20,0,0.0,20
11451,2964,Expansion Packs,2,0,0.0,2
11452,2964,Kits,2,2,1.0,0
11453,2964,Stuff Packs,1,1,1.0,0
11454,2965,Expansion Packs,12,1,0.08333333333333333,11
11455,2965,Game Packs,8,0,0.0,8
11456,2965,Kits,4,0,0.0,4
11457,2965,Stuff Packs,13,0,0.0,13
11458,2966,Expansion Packs,16,0,0.0,16
11459,2966,Game Packs,12,0,0.0,12
11460,2966,Kits,33,1,0.030303030303030304,32
11461,2966,Stuff Packs,20,1,0.05,19
11462,2967,Expansion Packs,8,0,0.0,8
11463,2967,Game Packs,7,0,0.0,7
11464,2967,Kits,7,3,0.42857142857142855,4
11465,2967,Stuff Packs,4,0,0.0,4
11466,2968,Expansion Packs,15,0,0.0,15
11467,2968,Game Packs,7,0,0.0,7
11468,2968,Kits,15,2,0.13333333333333333,13
11469,2968,Stuff Packs,16,3,0.1875,13
11470,2969,Expansion Packs,15,0,0.0,15
11471,2969,Game Packs,12,0,0.0,12
11472,2969,Kits,20,1,0.05,19
11473,2969,Stuff Packs,17,0,0.0,17
11474,2970,Expansion Packs,16,0,0.0,16
11475,2970,Game Packs,12,0,0.0,12
11476,2970,Kits,33,0,0.0,33
11477,2970,Stuff Packs,20,0,0.0,20
11478,2971,Expansion Packs,11,0,0.0,11
11479,2971,Game Packs,3,1,0.3333333333333333,2
11480,2971,Kits,1,1,1.0,0
11481,2971,Stuff Packs,4,2,0.5,2
11482,2972,Expansion Packs,16,0,0.0,16
11483,2972,Game Packs,12,0,0.0,12
11484,2972,Kits,26,0,0.0,26
11485,2972,Stuff Packs,20,0,0.0,20
11486,2973,Expansion Packs,7,0,0.0,7
11487,2973,Game Packs,5,1,0.2,4
11488,2973,Kits,3,3,1.0,0
11489,2973,Stuff Packs,7,4,0.5714285714285714,3
11490,2974,Expansion Packs,12,0,0.0,12
11491,2974,Game Packs,4,0,0.0,4
11492,2974,Kits,1,1,1.0,0
11493,2974,Stuff Packs,4,2,0.5,2
11494,2975,Expansion Packs,12,0,0.0,12
11495,2975,Game Packs,7,0,0.0,7
11496,2975,Kits,2,0,0.0,2
11497,2975,Stuff Packs,6,0,0.0,6
11498,2976,Expansion Packs,16,0,0.0,16
11499,2976,Game Packs,12,0,0.0,12
11500,2976,Kits,32,0,0.0,32
11501,2976,Stuff Packs,20,0,0.0,20
11502,2977,Expansion Packs,15,0,0.0,15
11503,2977,Game Packs,12,0,0.0,12
11504,2977,Kits,33,2,0.06060606060606061,31
11505,2977,Stuff Packs,20,0,0.0,20
11506,2978,Expansion Packs,16,0,0.0,16
11507,2978,Game Packs,12,0,0.0,12
11508,2978,Kits,33,0,0.0,33
11509,2978,Stuff Packs,20,6,0.3,14
11510,2979,Expansion Packs,12,0,0.0,12
11511,2979,Game Packs,2,0,0.0,2
11512,2979,Stuff Packs,10,1,0.1,9
11513,2980,Expansion Packs,3,0,0.0,3
11514,2980,Game Packs,4,0,0.0,4
11515,2980,Stuff Packs,6,4,0.6666666666666666,2
11516,2981,Expansion Packs,16,0,0.0,16
11517,2981,Game Packs,9,0,0.0,9
11518,2981,Kits,14,2,0.14285714285714285,12
11519,2981,Stuff Packs,15,0,0.0,15
11520,2982,Expansion Packs,13,0,0.0,13
11521,2982,Game Packs,10,0,0.0,10
11522,2982,Kits,2,1,0.5,1
11523,2982,Stuff Packs,12,0,0.0,12
11524,2983,Expansion Packs,16,0,0.0,16
11525,2983,Game Packs,12,0,0.0,12
11526,2983,Kits,10,0,0.0,10
11527,2983,Stuff Packs,20,0,0.0,20
11528,2984,Expansion Packs,16,0,0.0,16
11529,2984,Game Packs,12,0,0.0,12
11530,2984,Kits,33,0,0.0,33
11531,2984,Stuff Packs,20,1,0.05,19
11532,2985,Expansion Packs,14,0,0.0,14
11533,2985,Game Packs,8,0,0.0,8
11534,2985,Kits,4,2,0.5,2
11535,2985,Stuff Packs,9,0,0.0,9
11536,2986,Expansion Packs,10,0,0.0,10
11537,2986,Game Packs,2,0,0.0,2
11538,2986,Stuff Packs,8,0,0.0,8
11539,2987,Expansion Packs,16,0,0.0,16
11540,2987,Game Packs,7,0,0.0,7
11541,2987,Kits,14,0,0.0,14
11542,2987,Stuff Packs,13,0,0.0,13
11543,2988,Expansion Packs,14,0,0.0,14
11544,2988,Game Packs,9,0,0.0,9
11545,2988,Kits,13,2,0.15384615384615385,11
11546,2988,Stuff Packs,20,1,0.05,19
11547,2989,Expansion Packs,15,0,0.0,15
11548,2989,Game Packs,12,0,0.0,12
11549,2989,Stuff Packs,19,0,0.0,19
11550,2990,Expansion Packs,3,0,0.0,3
11551,2990,Game Packs,1,1,1.0,0
11552,2990,Kits,3,3,1.0,0
11553,2990,Stuff Packs,5,4,0.8,1
11554,2991,Expansion Packs,5,1,0.2,4
11555,2991,Game Packs,1,0,0.0,1
11556,2991,Kits,2,0,0.0,2
11557,2991,Stuff Packs,4,1,0.25,3
11558,2992,Expansion Packs,6,0,0.0,6
11559,2992,Game Packs,5,1,0.2,4
11560,2992,Stuff Packs,5,3,0.6,2
11561,2993,Expansion Packs,15,0,0.0,15
11562,2993,Game Packs,9,0,0.0,9
11563,2993,Kits,26,0,0.0,26
11564,2993,Stuff Packs,15,0,0.0,15
11565,2994,Expansion Packs,16,0,0.0,16
11566,2994,Game Packs,12,0,0.0,12
11567,2994,Kits,33,0,0.0,33
11568,2994,Stuff Packs,20,0,0.0,20
11569,2995,Expansion Packs,16,0,0.0,16
11570,2995,Game Packs,12,0,0.0,12
11571,2995,Kits,33,0,0.0,33
11572,2995,Stuff Packs,20,0,0.0,20
11573,2996,Expansion Packs,15,0,0.0,15
11574,2996,Game Packs,8,0,0.0,8
11575,2996,Stuff Packs,7,0,0.0,7
11576,2997,Expansion Packs,9,0,0.0,9
11577,2997,Game Packs,8,0,0.0,8
11578,2997,Kits,6,0,0.0,6
11579,2997,Stuff Packs,9,1,0.1111111111111111,8
11580,2998,Expansion Packs,8,0,0.0,8
11581,2998,Game Packs,3,0,0.0,3
11582,2998,Kits,5,1,0.2,4
11583,2998,Stuff Packs,6,0,0.0,6
11584,2999,Expansion Packs,14,0,0.0,14
11585,2999,Game Packs,8,0,0.0,8
11586,2999,Kits,7,1,0.14285714285714285,6
11587,2999,Stuff Packs,14,2,0.14285714285714285,12
11588,3000,Expansion Packs,12,0,0.0,12
11589,3000,Game Packs,6,0,0.0,6
11590,3000,Kits,6,0,0.0,6
11591,3000,Stuff Packs,6,1,0.16666666666666666,5
11592,3001,Expansion Packs,13,0,0.0,13
11593,3001,Game Packs,9,0,0.0,9
11594,3001,Kits,7,1,0.14285714285714285,6
11595,3001,Stuff Packs,16,0,0.0,16
11596,3002,Expansion Packs,15,0,0.0,15
11597,3002,Game Packs,12,0,0.0,12
11598,3002,Kits,26,1,0.038461538461538464,25
11599,3002,Stuff Packs,19,0,0.0,19
11600,3003,Expansion Packs,3,0,0.0,3
11601,3003,Game Packs,4,0,0.0,4
11602,3003,Kits,5,1,0.2,4
11603,3003,Stuff Packs,8,3,0.375,5
11604,3004,Expansion Packs,13,0,0.0,13
11605,3004,Game Packs,8,0,0.0,8
11606,3004,Kits,1,1,1.0,0
11607,3004,Stuff Packs,20,0,0.0,20
11608,3005,Expansion Packs,16,0,0.0,16
11609,3005,Game Packs,12,0,0.0,12
11610,3005,Kits,33,0,0.0,33
11611,3005,Stuff Packs,20,1,0.05,19
11612,3006,Expansion Packs,9,0,0.0,9
11613,3006,Game Packs,6,0,0.0,6
11614,3006,Stuff Packs,7,0,0.0,7
11615,3007,Expansion Packs,16,0,0.0,16
11616,3007,Game Packs,10,0,0.0,10
11617,3007,Kits,11,0,0.0,11
11618,3007,Stuff Packs,18,0,0.0,18
11619,3008,Expansion Packs,13,0,0.0,13
11620,3008,Game Packs,7,1,0.14285714285714285,6
11621,3008,Kits,14,4,0.2857142857142857,10
11622,3008,Stuff Packs,14,4,0.2857142857142857,10
11623,3009,Expansion Packs,16,0,0.0,16
11624,3009,Game Packs,12,0,0.0,12
11625,3009,Kits,27,0,0.0,27
11626,3009,Stuff Packs,20,0,0.0,20
11627,3010,Expansion Packs,6,0,0.0,6
11628,3010,Game Packs,1,1,1.0,0
11629,3010,Kits,1,1,1.0,0
11630,3010,Stuff Packs,7,5,0.7142857142857143,2
11631,3011,Expansion Packs,13,1,0.07692307692307693,12
11632,3011,Game Packs,9,0,0.0,9
11633,3011,Kits,5,1,0.2,4
11634,3011,Stuff Packs,14,2,0.14285714285714285,12
11635,3012,Expansion Packs,11,0,0.0,11
11636,3012,Game Packs,10,0,0.0,10
11637,3012,Kits,7,1,0.14285714285714285,6
11638,3012,Stuff Packs,15,2,0.13333333333333333,13
11639,3013,Expansion Packs,16,0,0.0,16
11640,3013,Game Packs,7,1,0.14285714285714285,6
11641,3013,Kits,12,2,0.16666666666666666,10
11642,3013,Stuff Packs,12,4,0.3333333333333333,8
11643,3014,Expansion Packs,7,0,0.0,7
11644,3014,Game Packs,5,0,0.0,5
11645,3014,Kits,2,0,0.0,2
11646,3014,Stuff Packs,3,0,0.0,3
11647,3015,Expansion Packs,9,0,0.0,9
11648,3015,Game Packs,5,1,0.2,4
11649,3015,Kits,2,2,1.0,0
11650,3015,Stuff Packs,11,3,0.2727272727272727,8
11651,3016,Expansion Packs,9,0,0.0,9
11652,3016,Game Packs,5,0,0.0,5
11653,3016,Kits,1,0,0.0,1
11654,3016,Stuff Packs,8,2,0.25,6
11655,3017,Expansion Packs,3,0,0.0,3
11656,3017,Game Packs,2,0,0.0,2
11657,3017,Kits,5,0,0.0,5
11658,3017,Stuff Packs,6,1,0.16666666666666666,5
11659,3018,Expansion Packs,14,0,0.0,14
11660,3018,Game Packs,6,0,0.0,6
11661,3018,Stuff Packs,4,0,0.0,4
11662,3019,Expansion Packs,9,0,0.0,9
11663,3019,Game Packs,3,0,0.0,3
11664,3019,Kits,4,0,0.0,4
11665,3019,Stuff Packs,6,2,0.3333333333333333,4
11666,3020,Expansion Packs,16,9,0.5625,7
11667,3020,Game Packs,12,2,0.16666666666666666,10
11668,3020,Kits,32,5,0.15625,27
11669,3020,Stuff Packs,20,2,0.1,18
11670,3021,Expansion Packs,16,0,0.0,16
11671,3021,Game Packs,12,0,0.0,12
11672,3021,Kits,10,0,0.0,10
11673,3021,Stuff Packs,16,0,0.0,16
11674,3022,Expansion Packs,16,0,0.0,16
11675,3022,Game Packs,9,0,0.0,9
11676,3022,Kits,13,1,0.07692307692307693,12
11677,3022,Stuff Packs,15,1,0.06666666666666667,14
11678,3023,Expansion Packs,16,0,0.0,16
11679,3023,Game Packs,12,0,0.0,12
11680,3023,Kits,32,0,0.0,32
11681,3023,Stuff Packs,20,0,0.0,20
11682,3024,Expansion Packs,11,0,0.0,11
11683,3024,Game Packs,6,0,0.0,6
11684,3024,Kits,1,1,1.0,0
11685,3024,Stuff Packs,11,1,0.09090909090909091,10
11686,3025,Expansion Packs,16,0,0.0,16
11687,3025,Game Packs,12,0,0.0,12
11688,3025,Kits,30,1,0.03333333333333333,29
11689,3025,Stuff Packs,20,1,0.05,19
11690,3026,Expansion Packs,13,0,0.0,13
11691,3026,Game Packs,7,1,0.14285714285714285,6
11692,3026,Kits,7,2,0.2857142857142857,5
11693,3026,Stuff Packs,10,4,0.4,6
11694,3027,Expansion Packs,11,0,0.0,11
11695,3027,Game Packs,5,0,0.0,5
11696,3027,Kits,2,0,0.0,2
11697,3027,Stuff Packs,9,2,0.2222222222222222,7
11698,3028,Expansion Packs,4,1,0.25,3
11699,3028,Game Packs,2,0,0.0,2
11700,3028,Stuff Packs,4,3,0.75,1
11701,3029,Expansion Packs,16,0,0.0,16
11702,3029,Game Packs,12,0,0.0,12
11703,3029,Kits,22,1,0.045454545454545456,21
11704,3029,Stuff Packs,20,0,0.0,20
11705,3030,Expansion Packs,15,0,0.0,15
11706,3030,Game Packs,7,0,0.0,7
11707,3030,Stuff Packs,4,0,0.0,4
11708,3031,Expansion Packs,16,0,0.0,16
11709,3031,Game Packs,12,0,0.0,12
11710,3031,Kits,30,2,0.06666666666666667,28
11711,3031,Stuff Packs,20,1,0.05,19
11712,3032,Expansion Packs,15,0,0.0,15
11713,3032,Game Packs,12,0,0.0,12
11714,3032,Kits,2,2,1.0,0
11715,3032,Stuff Packs,20,0,0.0,20
11716,3033,Expansion Packs,14,14,1.0,0
11717,3033,Game Packs,12,12,1.0,0
11718,3033,Kits,23,23,1.0,0
11719,3033,Stuff Packs,18,18,1.0,0
11720,3034,Expansion Packs,16,0,0.0,16
11721,3034,Game Packs,11,0,0.0,11
11722,3034,Kits,27,1,0.037037037037037035,26
11723,3034,Stuff Packs,20,2,0.1,18
11724,3035,Expansion Packs,14,0,0.0,14
11725,3035,Game Packs,10,0,0.0,10
11726,3035,Kits,7,2,0.2857142857142857,5
11727,3035,Stuff Packs,11,2,0.18181818181818182,9
11728,3036,Expansion Packs,13,0,0.0,13
11729,3036,Game Packs,10,0,0.0,10
11730,3036,Stuff Packs,7,0,0.0,7
11731,3037,Expansion Packs,12,0,0.0,12
11732,3037,Game Packs,9,0,0.0,9
11733,3037,Kits,2,2,1.0,0
11734,3037,Stuff Packs,17,0,0.0,17
11735,3038,Expansion Packs,16,0,0.0,16
11736,3038,Game Packs,11,0,0.0,11
11737,3038,Kits,15,0,0.0,15
11738,3038,Stuff Packs,19,0,0.0,19
11739,3039,Expansion Packs,5,0,0.0,5
11740,3039,Game Packs,3,0,0.0,3
11741,3039,Stuff Packs,3,0,0.0,3
11742,3040,Expansion Packs,15,2,0.13333333333333333,13
11743,3040,Game Packs,6,1,0.16666666666666666,5
11744,3040,Kits,1,1,1.0,0
11745,3040,Stuff Packs,7,3,0.42857142857142855,4
11746,3041,Expansion Packs,14,0,0.0,14
11747,3041,Game Packs,11,1,0.09090909090909091,10
11748,3041,Kits,16,1,0.0625,15
11749,3041,Stuff Packs,18,1,0.05555555555555555,17
11750,3042,Expansion Packs,8,0,0.0,8
11751,3042,Game Packs,2,0,0.0,2
11752,3042,Kits,1,0,0.0,1
11753,3042,Stuff Packs,4,0,0.0,4
11754,3043,Expansion Packs,16,8,0.5,8
11755,3043,Game Packs,12,9,0.75,3
11756,3043,Kits,33,33,1.0,0
11757,3043,Stuff Packs,20,14,0.7,6
11758,3044,Expansion Packs,12,0,0.0,12
11759,3044,Game Packs,4,0,0.0,4
11760,3044,Kits,5,2,0.4,3
11761,3044,Stuff Packs,12,5,0.4166666666666667,7
11762,3045,Expansion Packs,16,0,0.0,16
11763,3045,Game Packs,10,0,0.0,10
11764,3045,Kits,15,0,0.0,15
11765,3045,Stuff Packs,14,4,0.2857142857142857,10
11766,3046,Expansion Packs,14,0,0.0,14
11767,3046,Game Packs,7,0,0.0,7
11768,3046,Kits,3,2,0.6666666666666666,1
11769,3046,Stuff Packs,13,1,0.07692307692307693,12
11770,3047,Expansion Packs,8,0,0.0,8
11771,3047,Game Packs,1,0,0.0,1
11772,3047,Kits,3,2,0.6666666666666666,1
11773,3047,Stuff Packs,5,3,0.6,2
11774,3048,Expansion Packs,9,0,0.0,9
11775,3048,Game Packs,3,0,0.0,3
11776,3048,Stuff Packs,8,0,0.0,8
11777,3049,Expansion Packs,12,0,0.0,12
11778,3049,Game Packs,5,0,0.0,5
11779,3049,Kits,9,1,0.1111111111111111,8
11780,3049,Stuff Packs,9,3,0.3333333333333333,6
11781,3050,Expansion Packs,10,0,0.0,10
11782,3050,Game Packs,6,0,0.0,6
11783,3050,Kits,4,1,0.25,3
11784,3050,Stuff Packs,7,2,0.2857142857142857,5
11785,3051,Expansion Packs,15,0,0.0,15
11786,3051,Game Packs,12,0,0.0,12
11787,3051,Kits,19,0,0.0,19
11788,3051,Stuff Packs,19,0,0.0,19
11789,3052,Expansion Packs,14,0,0.0,14
11790,3052,Game Packs,8,0,0.0,8
11791,3052,Kits,1,1,1.0,0
11792,3052,Stuff Packs,8,0,0.0,8
11793,3053,Expansion Packs,8,0,0.0,8
11794,3053,Game Packs,2,0,0.0,2
11795,3053,Kits,7,0,0.0,7
11796,3053,Stuff Packs,2,0,0.0,2
11797,3054,Expansion Packs,16,0,0.0,16
11798,3054,Game Packs,9,0,0.0,9
11799,3054,Kits,6,2,0.3333333333333333,4
11800,3054,Stuff Packs,18,1,0.05555555555555555,17
11801,3055,Expansion Packs,13,0,0.0,13
11802,3055,Game Packs,9,0,0.0,9
11803,3055,Kits,10,1,0.1,9
11804,3055,Stuff Packs,13,0,0.0,13
11805,3056,Expansion Packs,16,0,0.0,16
11806,3056,Game Packs,12,0,0.0,12
11807,3056,Kits,18,0,0.0,18
11808,3056,Stuff Packs,18,0,0.0,18
11809,3057,Expansion Packs,11,0,0.0,11
11810,3057,Game Packs,10,0,0.0,10
11811,3057,Kits,3,1,0.3333333333333333,2
11812,3057,Stuff Packs,16,0,0.0,16
11813,3058,Expansion Packs,10,0,0.0,10
11814,3058,Game Packs,4,0,0.0,4
11815,3058,Kits,6,0,0.0,6
11816,3058,Stuff Packs,5,3,0.6,2
11817,3059,Expansion Packs,15,0,0.0,15
11818,3059,Game Packs,11,0,0.0,11
11819,3059,Kits,11,1,0.09090909090909091,10
11820,3059,Stuff Packs,18,1,0.05555555555555555,17
11821,3060,Expansion Packs,3,0,0.0,3
11822,3060,Game Packs,1,0,0.0,1
11823,3060,Kits,2,2,1.0,0
11824,3060,Stuff Packs,7,4,0.5714285714285714,3
11825,3061,Expansion Packs,16,0,0.0,16
11826,3061,Game Packs,12,0,0.0,12
11827,3061,Kits,33,0,0.0,33
11828,3061,Stuff Packs,20,0,0.0,20
11829,3062,Kits,1,1,1.0,0
11830,3062,Stuff Packs,3,3,1.0,0
11831,3063,Expansion Packs,13,0,0.0,13
11832,3063,Game Packs,5,0,0.0,5
11833,3063,Kits,8,1,0.125,7
11834,3063,Stuff Packs,11,1,0.09090909090909091,10
11835,3064,Expansion Packs,8,0,0.0,8
11836,3064,Game Packs,6,0,0.0,6
11837,3064,Kits,2,2,1.0,0
11838,3064,Stuff Packs,12,1,0.08333333333333333,11
11839,3065,Expansion Packs,16,0,0.0,16
11840,3065,Game Packs,12,0,0.0,12
11841,3065,Kits,30,0,0.0,30
11842,3065,Stuff Packs,20,0,0.0,20
11843,3066,Expansion Packs,14,0,0.0,14
11844,3066,Game Packs,11,1,0.09090909090909091,10
11845,3066,Kits,5,0,0.0,5
11846,3066,Stuff Packs,18,2,0.1111111111111111,16
11847,3067,Expansion Packs,13,0,0.0,13
11848,3067,Game Packs,4,0,0.0,4
11849,3067,Kits,3,3,1.0,0
11850,3067,Stuff Packs,11,3,0.2727272727272727,8
11851,3068,Expansion Packs,10,0,0.0,10
11852,3068,Game Packs,7,2,0.2857142857142857,5
11853,3068,Kits,16,1,0.0625,15
11854,3068,Stuff Packs,12,3,0.25,9
11855,3069,Expansion Packs,16,0,0.0,16
11856,3069,Game Packs,12,0,0.0,12
11857,3069,Kits,31,1,0.03225806451612903,30
11858,3069,Stuff Packs,20,0,0.0,20
11859,3070,Expansion Packs,14,0,0.0,14
11860,3070,Game Packs,12,0,0.0,12
11861,3070,Kits,25,1,0.04,24
11862,3070,Stuff Packs,20,1,0.05,19
11863,3071,Expansion Packs,15,0,0.0,15
11864,3071,Game Packs,10,0,0.0,10
11865,3071,Kits,28,1,0.03571428571428571,27
11866,3071,Stuff Packs,9,0,0.0,9
11867,3072,Expansion Packs,14,0,0.0,14
11868,3072,Game Packs,5,0,0.0,5
11869,3072,Kits,3,1,0.3333333333333333,2
11870,3072,Stuff Packs,15,3,0.2,12
11871,3073,Expansion Packs,7,0,0.0,7
11872,3073,Game Packs,2,1,0.5,1
11873,3073,Kits,1,1,1.0,0
11874,3073,Stuff Packs,4,3,0.75,1
11875,3074,Expansion Packs,7,0,0.0,7
11876,3074,Game Packs,4,0,0.0,4
11877,3074,Kits,1,1,1.0,0
11878,3074,Stuff Packs,10,1,0.1,9
11879,3075,Expansion Packs,15,0,0.0,15
11880,3075,Game Packs,11,0,0.0,11
11881,3075,Kits,23,1,0.043478260869565216,22
11882,3075,Stuff Packs,20,0,0.0,20
11883,3076,Expansion Packs,16,0,0.0,16
11884,3076,Game Packs,7,0,0.0,7
11885,3076,Kits,1,0,0.0,1
11886,3076,Stuff Packs,4,0,0.0,4
11887,3077,Expansion Packs,10,0,0.0,10
11888,3077,Game Packs,3,0,0.0,3
11889,3077,Kits,3,2,0.6666666666666666,1
11890,3077,Stuff Packs,8,3,0.375,5
11891,3078,Expansion Packs,16,0,0.0,16
11892,3078,Game Packs,12,0,0.0,12
11893,3078,Kits,33,1,0.030303030303030304,32
11894,3078,Stuff Packs,20,0,0.0,20
11895,3079,Expansion Packs,13,0,0.0,13
11896,3079,Game Packs,6,0,0.0,6
11897,3079,Kits,4,2,0.5,2
11898,3079,Stuff Packs,10,2,0.2,8
11899,3080,Expansion Packs,7,1,0.14285714285714285,6
11900,3080,Game Packs,1,0,0.0,1
11901,3080,Kits,6,0,0.0,6
11902,3080,Stuff Packs,5,2,0.4,3
11903,3081,Expansion Packs,14,1,0.07142857142857142,13
11904,3081,Game Packs,7,1,0.14285714285714285,6
11905,3081,Kits,2,2,1.0,0
11906,3081,Stuff Packs,15,4,0.26666666666666666,11
11907,3082,Expansion Packs,9,0,0.0,9
11908,3082,Game Packs,5,0,0.0,5
11909,3082,Stuff Packs,9,3,0.3333333333333333,6
11910,3083,Expansion Packs,16,0,0.0,16
11911,3083,Game Packs,9,0,0.0,9
11912,3083,Kits,5,0,0.0,5
11913,3083,Stuff Packs,16,3,0.1875,13
11914,3084,Expansion Packs,15,0,0.0,15
11915,3084,Game Packs,8,0,0.0,8
11916,3084,Kits,6,0,0.0,6
11917,3084,Stuff Packs,7,0,0.0,7
11918,3085,Expansion Packs,4,0,0.0,4
11919,3085,Game Packs,3,0,0.0,3
11920,3085,Kits,2,2,1.0,0
11921,3085,Stuff Packs,5,4,0.8,1
11922,3086,Expansion Packs,1,0,0.0,1
11923,3086,Game Packs,2,1,0.5,1
11924,3086,Kits,2,2,1.0,0
11925,3086,Stuff Packs,4,4,1.0,0
11926,3087,Expansion Packs,8,0,0.0,8
11927,3087,Game Packs,5,1,0.2,4
11928,3087,Kits,6,3,0.5,3
11929,3087,Stuff Packs,10,4,0.4,6
11930,3088,Expansion Packs,13,0,0.0,13
11931,3088,Game Packs,3,0,0.0,3
11932,3088,Kits,16,2,0.125,14
11933,3088,Stuff Packs,8,3,0.375,5
11934,3089,Expansion Packs,15,0,0.0,15
11935,3089,Game Packs,12,0,0.0,12
11936,3089,Kits,7,0,0.0,7
11937,3089,Stuff Packs,20,0,0.0,20
11938,3090,Expansion Packs,16,0,0.0,16
11939,3090,Game Packs,10,0,0.0,10
11940,3090,Kits,6,2,0.3333333333333333,4
11941,3090,Stuff Packs,9,2,0.2222222222222222,7
11942,3091,Expansion Packs,15,1,0.06666666666666667,14
11943,3091,Game Packs,9,1,0.1111111111111111,8
11944,3091,Kits,14,0,0.0,14
11945,3091,Stuff Packs,14,3,0.21428571428571427,11
11946,3092,Expansion Packs,16,0,0.0,16
11947,3092,Game Packs,10,0,0.0,10
11948,3092,Stuff Packs,13,1,0.07692307692307693,12
11949,3093,Expansion Packs,13,0,0.0,13
11950,3093,Game Packs,10,0,0.0,10
11951,3093,Kits,1,1,1.0,0
11952,3093,Stuff Packs,9,0,0.0,9
11953,3094,Expansion Packs,10,0,0.0,10
11954,3094,Game Packs,8,0,0.0,8
11955,3094,Kits,2,0,0.0,2
11956,3094,Stuff Packs,17,1,0.058823529411764705,16
11957,3095,Expansion Packs,16,0,0.0,16
11958,3095,Game Packs,12,0,0.0,12
11959,3095,Kits,32,1,0.03125,31
11960,3095,Stuff Packs,20,0,0.0,20
11961,3096,Expansion Packs,15,0,0.0,15
11962,3096,Game Packs,8,0,0.0,8
11963,3096,Kits,14,0,0.0,14
11964,3096,Stuff Packs,10,2,0.2,8
11965,3097,Expansion Packs,11,0,0.0,11
11966,3097,Game Packs,3,0,0.0,3
11967,3097,Kits,2,2,1.0,0
11968,3097,Stuff Packs,7,2,0.2857142857142857,5
11969,3098,Expansion Packs,14,0,0.0,14
11970,3098,Game Packs,11,0,0.0,11
11971,3098,Kits,18,2,0.1111111111111111,16
11972,3098,Stuff Packs,20,1,0.05,19
11973,3099,Expansion Packs,16,0,0.0,16
11974,3099,Game Packs,10,0,0.0,10
11975,3099,Kits,3,1,0.3333333333333333,2
11976,3099,Stuff Packs,10,4,0.4,6
11977,3100,Expansion Packs,16,0,0.0,16
11978,3100,Game Packs,11,0,0.0,11
11979,3100,Kits,18,1,0.05555555555555555,17
11980,3100,Stuff Packs,20,0,0.0,20
11981,3101,Expansion Packs,13,0,0.0,13
11982,3101,Game Packs,6,0,0.0,6
11983,3101,Kits,2,2,1.0,0
11984,3101,Stuff Packs,15,2,0.13333333333333333,13
11985,3102,Expansion Packs,4,0,0.0,4
11986,3102,Game Packs,5,0,0.0,5
11987,3102,Kits,1,0,0.0,1
11988,3102,Stuff Packs,4,0,0.0,4
11989,3103,Expansion Packs,7,0,0.0,7
11990,3103,Game Packs,4,0,0.0,4
11991,3103,Kits,2,1,0.5,1
11992,3103,Stuff Packs,7,2,0.2857142857142857,5
11993,3104,Expansion Packs,8,0,0.0,8
11994,3104,Game Packs,3,1,0.3333333333333333,2
11995,3104,Stuff Packs,2,0,0.0,2
11996,3105,Expansion Packs,16,0,0.0,16
11997,3105,Game Packs,11,0,0.0,11
11998,3105,Kits,27,1,0.037037037037037035,26
11999,3105,Stuff Packs,20,0,0.0,20
12000,3106,Expansion Packs,5,0,0.0,5
12001,3106,Game Packs,3,0,0.0,3
12002,3106,Kits,2,0,0.0,2
12003,3106,Stuff Packs,7,0,0.0,7
12004,3107,Expansion Packs,12,0,0.0,12
12005,3107,Game Packs,8,0,0.0,8
12006,3107,Kits,6,0,0.0,6
12007,3107,Stuff Packs,9,3,0.3333333333333333,6
12008,3108,Expansion Packs,9,0,0.0,9
12009,3108,Game Packs,7,0,0.0,7
12010,3108,Kits,2,2,1.0,0
12011,3108,Stuff Packs,6,0,0.0,6
12012,3109,Expansion Packs,8,0,0.0,8
12013,3109,Game Packs,4,0,0.0,4
12014,3109,Kits,9,0,0.0,9
12015,3109,Stuff Packs,11,0,0.0,11
12016,3110,Expansion Packs,11,1,0.09090909090909091,10
12017,3110,Game Packs,5,0,0.0,5
12018,3110,Kits,3,3,1.0,0
12019,3110,Stuff Packs,7,3,0.42857142857142855,4
12020,3111,Expansion Packs,4,0,0.0,4
12021,3111,Game Packs,2,0,0.0,2
12022,3112,Expansion Packs,9,0,0.0,9
12023,3112,Game Packs,5,1,0.2,4
12024,3112,Kits,2,0,0.0,2
12025,3112,Stuff Packs,8,4,0.5,4
12026,3113,Expansion Packs,5,0,0.0,5
12027,3113,Game Packs,3,0,0.0,3
12028,3113,Kits,1,0,0.0,1
12029,3113,Stuff Packs,5,2,0.4,3
12030,3114,Expansion Packs,16,0,0.0,16
12031,3114,Game Packs,11,0,0.0,11
12032,3114,Kits,30,1,0.03333333333333333,29
12033,3114,Stuff Packs,20,0,0.0,20
12034,3115,Expansion Packs,11,0,0.0,11
12035,3115,Game Packs,1,0,0.0,1
12036,3115,Stuff Packs,2,1,0.5,1
12037,3116,Expansion Packs,9,0,0.0,9
12038,3116,Game Packs,4,0,0.0,4
12039,3116,Stuff Packs,7,4,0.5714285714285714,3
12040,3117,Expansion Packs,16,0,0.0,16
12041,3117,Game Packs,11,0,0.0,11
12042,3117,Kits,26,0,0.0,26
12043,3117,Stuff Packs,20,0,0.0,20
12044,3118,Expansion Packs,16,0,0.0,16
12045,3118,Game Packs,11,0,0.0,11
12046,3118,Kits,16,1,0.0625,15
12047,3118,Stuff Packs,18,0,0.0,18
12048,3119,Expansion Packs,12,0,0.0,12
12049,3119,Game Packs,8,0,0.0,8
12050,3119,Kits,3,0,0.0,3
12051,3119,Stuff Packs,5,0,0.0,5
12052,3120,Expansion Packs,16,0,0.0,16
12053,3120,Game Packs,12,0,0.0,12
12054,3120,Kits,22,2,0.09090909090909091,20
12055,3120,Stuff Packs,20,1,0.05,19
12056,3121,Expansion Packs,16,0,0.0,16
12057,3121,Game Packs,12,0,0.0,12
12058,3121,Kits,30,1,0.03333333333333333,29
12059,3121,Stuff Packs,20,0,0.0,20
12060,3122,Expansion Packs,9,0,0.0,9
12061,3122,Game Packs,7,0,0.0,7
12062,3122,Kits,7,2,0.2857142857142857,5
12063,3122,Stuff Packs,11,2,0.18181818181818182,9
12064,3123,Expansion Packs,3,0,0.0,3
12065,3123,Game Packs,2,0,0.0,2
12066,3123,Kits,3,2,0.6666666666666666,1
12067,3123,Stuff Packs,5,3,0.6,2
12068,3124,Expansion Packs,5,0,0.0,5
12069,3124,Game Packs,3,2,0.6666666666666666,1
12070,3124,Kits,1,1,1.0,0
12071,3124,Stuff Packs,2,1,0.5,1
12072,3125,Expansion Packs,12,0,0.0,12
12073,3125,Game Packs,6,0,0.0,6
12074,3125,Kits,2,1,0.5,1
12075,3125,Stuff Packs,12,2,0.16666666666666666,10
12076,3126,Expansion Packs,15,0,0.0,15
12077,3126,Game Packs,9,0,0.0,9
12078,3126,Kits,11,1,0.09090909090909091,10
12079,3126,Stuff Packs,17,2,0.11764705882352941,15
12080,3127,Expansion Packs,9,0,0.0,9
12081,3127,Game Packs,2,0,0.0,2
12082,3127,Kits,2,1,0.5,1
12083,3127,Stuff Packs,4,1,0.25,3
12084,3128,Expansion Packs,14,0,0.0,14
12085,3128,Game Packs,8,0,0.0,8
12086,3128,Kits,19,1,0.05263157894736842,18
12087,3128,Stuff Packs,14,0,0.0,14
12088,3129,Expansion Packs,16,0,0.0,16
12089,3129,Game Packs,12,1,0.08333333333333333,11
12090,3129,Kits,33,0,0.0,33
12091,3129,Stuff Packs,20,0,0.0,20
12092,3130,Expansion Packs,16,0,0.0,16
12093,3130,Game Packs,9,0,0.0,9
12094,3130,Kits,10,0,0.0,10
12095,3130,Stuff Packs,12,0,0.0,12
12096,3131,Expansion Packs,15,0,0.0,15
12097,3131,Game Packs,11,0,0.0,11
12098,3131,Kits,6,0,0.0,6
12099,3131,Stuff Packs,13,0,0.0,13
12100,3132,Expansion Packs,16,0,0.0,16
12101,3132,Game Packs,10,0,0.0,10
12102,3132,Kits,23,3,0.13043478260869565,20
12103,3132,Stuff Packs,19,1,0.05263157894736842,18
12104,3133,Expansion Packs,14,0,0.0,14
12105,3133,Game Packs,11,0,0.0,11
12106,3133,Kits,26,1,0.038461538461538464,25
12107,3133,Stuff Packs,19,0,0.0,19
12108,3134,Expansion Packs,16,0,0.0,16
12109,3134,Game Packs,12,0,0.0,12
12110,3134,Kits,33,0,0.0,33
12111,3134,Stuff Packs,20,0,0.0,20
12112,3135,Expansion Packs,10,0,0.0,10
12113,3135,Game Packs,7,0,0.0,7
12114,3135,Kits,2,1,0.5,1
12115,3135,Stuff Packs,5,0,0.0,5
12116,3136,Expansion Packs,16,0,0.0,16
12117,3136,Game Packs,12,2,0.16666666666666666,10
12118,3136,Kits,33,0,0.0,33
12119,3136,Stuff Packs,20,0,0.0,20
12120,3137,Expansion Packs,3,0,0.0,3
12121,3137,Game Packs,1,0,0.0,1
12122,3137,Kits,1,1,1.0,0
12123,3137,Stuff Packs,1,0,0.0,1
12124,3138,Expansion Packs,16,0,0.0,16
12125,3138,Game Packs,12,0,0.0,12
12126,3138,Kits,32,0,0.0,32
12127,3138,Stuff Packs,20,1,0.05,19
12128,3139,Expansion Packs,15,0,0.0,15
12129,3139,Game Packs,11,0,0.0,11
12130,3139,Kits,3,2,0.6666666666666666,1
12131,3139,Stuff Packs,20,0,0.0,20
12132,3140,Expansion Packs,12,0,0.0,12
12133,3140,Game Packs,5,0,0.0,5
12134,3140,Kits,2,2,1.0,0
12135,3140,Stuff Packs,8,2,0.25,6
12136,3141,Expansion Packs,10,0,0.0,10
12137,3141,Game Packs,5,0,0.0,5
12138,3141,Kits,2,2,1.0,0
12139,3141,Stuff Packs,8,3,0.375,5
12140,3142,Expansion Packs,14,0,0.0,14
12141,3142,Game Packs,8,0,0.0,8
12142,3142,Kits,1,1,1.0,0
12143,3142,Stuff Packs,14,2,0.14285714285714285,12
12144,3143,Expansion Packs,15,0,0.0,15
12145,3143,Game Packs,9,0,0.0,9
12146,3143,Kits,8,1,0.125,7
12147,3143,Stuff Packs,17,0,0.0,17
12148,3144,Expansion Packs,14,0,0.0,14
12149,3144,Game Packs,8,1,0.125,7
12150,3144,Kits,15,3,0.2,12
12151,3144,Stuff Packs,13,3,0.23076923076923078,10
12152,3145,Expansion Packs,8,0,0.0,8
12153,3145,Game Packs,5,0,0.0,5
12154,3145,Kits,1,1,1.0,0
12155,3145,Stuff Packs,6,1,0.16666666666666666,5
12156,3146,Expansion Packs,11,0,0.0,11
12157,3146,Game Packs,6,0,0.0,6
12158,3146,Stuff Packs,8,1,0.125,7
12159,3147,Expansion Packs,6,0,0.0,6
12160,3147,Kits,3,1,0.3333333333333333,2
12161,3147,Stuff Packs,4,2,0.5,2
12162,3148,Expansion Packs,2,0,0.0,2
12163,3148,Game Packs,1,0,0.0,1
12164,3148,Kits,1,1,1.0,0
12165,3148,Stuff Packs,2,2,1.0,0
12166,3149,Expansion Packs,16,0,0.0,16
12167,3149,Game Packs,12,0,0.0,12
12168,3149,Kits,33,0,0.0,33
12169,3149,Stuff Packs,20,0,0.0,20
12170,3150,Expansion Packs,16,1,0.0625,15
12171,3150,Game Packs,12,0,0.0,12
12172,3150,Kits,33,0,0.0,33
12173,3150,Stuff Packs,20,0,0.0,20
12174,3151,Expansion Packs,8,0,0.0,8
12175,3151,Game Packs,5,1,0.2,4
12176,3151,Kits,2,2,1.0,0
12177,3151,Stuff Packs,5,2,0.4,3
12178,3152,Expansion Packs,7,0,0.0,7
12179,3152,Game Packs,4,0,0.0,4
12180,3152,Kits,2,2,1.0,0
12181,3152,Stuff Packs,6,1,0.16666666666666666,5
12182,3153,Expansion Packs,16,0,0.0,16
12183,3153,Game Packs,12,0,0.0,12
12184,3153,Kits,26,1,0.038461538461538464,25
12185,3153,Stuff Packs,20,0,0.0,20
12186,3154,Expansion Packs,16,0,0.0,16
12187,3154,Game Packs,12,0,0.0,12
12188,3154,Kits,31,1,0.03225806451612903,30
12189,3154,Stuff Packs,20,0,0.0,20
12190,3155,Expansion Packs,10,0,0.0,10
12191,3155,Game Packs,5,0,0.0,5
12192,3155,Kits,4,1,0.25,3
12193,3155,Stuff Packs,7,0,0.0,7
12194,3156,Expansion Packs,15,1,0.06666666666666667,14
12195,3156,Game Packs,12,1,0.08333333333333333,11
12196,3156,Kits,18,0,0.0,18
12197,3156,Stuff Packs,18,0,0.0,18
12198,3157,Expansion Packs,15,1,0.06666666666666667,14
12199,3157,Game Packs,11,0,0.0,11
12200,3157,Kits,18,0,0.0,18
12201,3157,Stuff Packs,15,0,0.0,15
12202,3158,Expansion Packs,11,0,0.0,11
12203,3158,Game Packs,4,1,0.25,3
12204,3158,Kits,5,2,0.4,3
12205,3158,Stuff Packs,6,4,0.6666666666666666,2
12206,3159,Expansion Packs,4,0,0.0,4
12207,3159,Game Packs,1,0,0.0,1
12208,3159,Kits,1,1,1.0,0
12209,3159,Stuff Packs,6,3,0.5,3
12210,3160,Expansion Packs,14,0,0.0,14
12211,3160,Game Packs,10,0,0.0,10
12212,3160,Kits,4,1,0.25,3
12213,3160,Stuff Packs,14,1,0.07142857142857142,13
12214,3161,Expansion Packs,16,0,0.0,16
12215,3161,Game Packs,12,0,0.0,12
12216,3161,Kits,33,2,0.06060606060606061,31
12217,3161,Stuff Packs,20,0,0.0,20
12218,3162,Expansion Packs,5,0,0.0,5
12219,3162,Game Packs,4,0,0.0,4
12220,3162,Stuff Packs,2,0,0.0,2
12221,3163,Expansion Packs,12,0,0.0,12
12222,3163,Game Packs,10,0,0.0,10
12223,3163,Kits,3,1,0.3333333333333333,2
12224,3163,Stuff Packs,12,3,0.25,9
12225,3164,Expansion Packs,12,0,0.0,12
12226,3164,Game Packs,8,0,0.0,8
12227,3164,Kits,5,0,0.0,5
12228,3164,Stuff Packs,6,0,0.0,6
12229,3165,Expansion Packs,14,0,0.0,14
12230,3165,Game Packs,9,0,0.0,9
12231,3165,Kits,9,1,0.1111111111111111,8
12232,3165,Stuff Packs,13,2,0.15384615384615385,11
12233,3166,Expansion Packs,13,0,0.0,13
12234,3166,Game Packs,8,0,0.0,8
12235,3166,Kits,2,1,0.5,1
12236,3166,Stuff Packs,5,0,0.0,5
12237,3167,Expansion Packs,16,0,0.0,16
12238,3167,Game Packs,12,0,0.0,12
12239,3167,Kits,6,2,0.3333333333333333,4
12240,3167,Stuff Packs,19,0,0.0,19
12241,3168,Expansion Packs,9,0,0.0,9
12242,3168,Game Packs,4,0,0.0,4
12243,3169,Expansion Packs,16,0,0.0,16
12244,3169,Game Packs,12,0,0.0,12
12245,3169,Kits,33,1,0.030303030303030304,32
12246,3169,Stuff Packs,20,0,0.0,20
12247,3170,Expansion Packs,14,0,0.0,14
12248,3170,Game Packs,12,0,0.0,12
12249,3170,Kits,1,0,0.0,1
12250,3170,Stuff Packs,12,0,0.0,12
12251,3171,Expansion Packs,15,0,0.0,15
12252,3171,Game Packs,6,1,0.16666666666666666,5
12253,3171,Kits,1,1,1.0,0
12254,3171,Stuff Packs,12,2,0.16666666666666666,10
12255,3172,Expansion Packs,16,0,0.0,16
12256,3172,Game Packs,12,0,0.0,12
12257,3172,Kits,22,0,0.0,22
12258,3172,Stuff Packs,20,0,0.0,20
12259,3173,Expansion Packs,16,0,0.0,16
12260,3173,Game Packs,12,0,0.0,12
12261,3173,Kits,10,0,0.0,10
12262,3173,Stuff Packs,20,0,0.0,20
12263,3174,Expansion Packs,13,0,0.0,13
12264,3174,Game Packs,11,0,0.0,11
12265,3174,Kits,7,2,0.2857142857142857,5
12266,3174,Stuff Packs,17,2,0.11764705882352941,15
12267,3175,Expansion Packs,16,0,0.0,16
12268,3175,Game Packs,12,0,0.0,12
12269,3175,Kits,33,1,0.030303030303030304,32
12270,3175,Stuff Packs,20,0,0.0,20
12271,3176,Expansion Packs,13,0,0.0,13
12272,3176,Game Packs,10,0,0.0,10
12273,3176,Kits,19,1,0.05263157894736842,18
12274,3176,Stuff Packs,17,2,0.11764705882352941,15
12275,3177,Expansion Packs,16,0,0.0,16
12276,3177,Game Packs,12,0,0.0,12
12277,3177,Kits,33,0,0.0,33
12278,3177,Stuff Packs,20,0,0.0,20
12279,3178,Expansion Packs,16,0,0.0,16
12280,3178,Game Packs,11,0,0.0,11
12281,3178,Kits,3,0,0.0,3
12282,3178,Stuff Packs,13,0,0.0,13
12283,3179,Expansion Packs,2,0,0.0,2
12284,3180,Expansion Packs,1,0,0.0,1
12285,3180,Game Packs,1,0,0.0,1
12286,3180,Kits,3,1,0.3333333333333333,2
12287,3180,Stuff Packs,2,1,0.5,1
12288,3181,Expansion Packs,16,0,0.0,16
12289,3181,Game Packs,9,0,0.0,9
12290,3181,Kits,15,2,0.13333333333333333,13
12291,3181,Stuff Packs,20,0,0.0,20
12292,3182,Expansion Packs,14,0,0.0,14
12293,3182,Game Packs,8,0,0.0,8
12294,3182,Kits,1,1,1.0,0
12295,3182,Stuff Packs,17,1,0.058823529411764705,16
12296,3183,Expansion Packs,16,0,0.0,16
12297,3183,Game Packs,11,0,0.0,11
12298,3183,Kits,27,0,0.0,27
12299,3183,Stuff Packs,20,0,0.0,20
12300,3184,Expansion Packs,3,0,0.0,3
12301,3184,Game Packs,1,0,0.0,1
12302,3184,Kits,1,1,1.0,0
12303,3184,Stuff Packs,1,0,0.0,1
12304,3185,Expansion Packs,15,0,0.0,15
12305,3185,Game Packs,12,0,0.0,12
12306,3185,Kits,11,1,0.09090909090909091,10
12307,3185,Stuff Packs,19,1,0.05263157894736842,18
12308,3186,Expansion Packs,8,0,0.0,8
12309,3186,Game Packs,6,1,0.16666666666666666,5
12310,3186,Kits,1,1,1.0,0
12311,3186,Stuff Packs,6,1,0.16666666666666666,5
12312,3187,Expansion Packs,12,1,0.08333333333333333,11
12313,3187,Game Packs,4,0,0.0,4
12314,3187,Stuff Packs,8,0,0.0,8
12315,3188,Expansion Packs,16,0,0.0,16
12316,3188,Game Packs,7,1,0.14285714285714285,6
12317,3188,Kits,9,2,0.2222222222222222,7
12318,3188,Stuff Packs,8,3,0.375,5
12319,3189,Expansion Packs,15,0,0.0,15
12320,3189,Game Packs,11,0,0.0,11
12321,3189,Kits,20,0,0.0,20
12322,3189,Stuff Packs,20,0,0.0,20
12323,3190,Expansion Packs,16,0,0.0,16
12324,3190,Game Packs,12,0,0.0,12
12325,3190,Kits,33,1,0.030303030303030304,32
12326,3190,Stuff Packs,20,0,0.0,20
12327,3191,Expansion Packs,12,0,0.0,12
12328,3191,Game Packs,7,0,0.0,7
12329,3191,Stuff Packs,7,0,0.0,7
12330,3192,Expansion Packs,11,0,0.0,11
12331,3192,Game Packs,9,0,0.0,9
12332,3192,Kits,4,1,0.25,3
12333,3192,Stuff Packs,12,1,0.08333333333333333,11
12334,3193,Expansion Packs,16,0,0.0,16
12335,3193,Game Packs,12,0,0.0,12
12336,3193,Kits,25,2,0.08,23
12337,3193,Stuff Packs,20,0,0.0,20
12338,3194,Expansion Packs,16,0,0.0,16
12339,3194,Game Packs,12,0,0.0,12
12340,3194,Kits,7,2,0.2857142857142857,5
12341,3194,Stuff Packs,16,0,0.0,16
12342,3195,Expansion Packs,16,0,0.0,16
12343,3195,Game Packs,12,0,0.0,12
12344,3195,Kits,33,0,0.0,33
12345,3195,Stuff Packs,20,0,0.0,20
12346,3196,Expansion Packs,16,0,0.0,16
12347,3196,Game Packs,4,0,0.0,4
12348,3196,Kits,6,1,0.16666666666666666,5
12349,3196,Stuff Packs,7,3,0.42857142857142855,4
12350,3197,Expansion Packs,14,0,0.0,14
12351,3197,Game Packs,8,0,0.0,8
12352,3197,Kits,21,1,0.047619047619047616,20
12353,3197,Stuff Packs,12,0,0.0,12
12354,3198,Kits,1,1,1.0,0
12355,3198,Stuff Packs,4,3,0.75,1
12356,3199,Expansion Packs,16,0,0.0,16
12357,3199,Game Packs,12,0,0.0,12
12358,3199,Kits,33,0,0.0,33
12359,3199,Stuff Packs,20,0,0.0,20
12360,3200,Expansion Packs,14,0,0.0,14
12361,3200,Game Packs,10,0,0.0,10
12362,3200,Kits,7,4,0.5714285714285714,3
12363,3200,Stuff Packs,14,3,0.21428571428571427,11
12364,3201,Expansion Packs,16,0,0.0,16
12365,3201,Game Packs,12,0,0.0,12
12366,3201,Kits,33,2,0.06060606060606061,31
12367,3201,Stuff Packs,20,1,0.05,19
12368,3202,Expansion Packs,5,0,0.0,5
12369,3202,Game Packs,2,1,0.5,1
12370,3202,Kits,5,3,0.6,2
12371,3202,Stuff Packs,6,4,0.6666666666666666,2
12372,3203,Expansion Packs,14,0,0.0,14
12373,3203,Game Packs,12,0,0.0,12
12374,3203,Kits,6,3,0.5,3
12375,3203,Stuff Packs,14,3,0.21428571428571427,11
12376,3204,Expansion Packs,16,0,0.0,16
12377,3204,Game Packs,12,0,0.0,12
12378,3204,Kits,33,0,0.0,33
12379,3204,Stuff Packs,20,0,0.0,20
12380,3205,Expansion Packs,16,0,0.0,16
12381,3205,Game Packs,12,0,0.0,12
12382,3205,Kits,22,1,0.045454545454545456,21
12383,3205,Stuff Packs,20,0,0.0,20
12384,3206,Expansion Packs,12,0,0.0,12
12385,3206,Game Packs,9,1,0.1111111111111111,8
12386,3206,Kits,14,1,0.07142857142857142,13
12387,3206,Stuff Packs,13,2,0.15384615384615385,11
12388,3207,Expansion Packs,16,0,0.0,16
12389,3207,Game Packs,12,0,0.0,12
12390,3207,Kits,22,1,0.045454545454545456,21
12391,3207,Stuff Packs,20,0,0.0,20
12392,3208,Expansion Packs,14,0,0.0,14
12393,3208,Game Packs,11,0,0.0,11
12394,3208,Kits,5,1,0.2,4
12395,3208,Stuff Packs,20,2,0.1,18
12396,3209,Expansion Packs,1,0,0.0,1
12397,3210,Expansion Packs,12,0,0.0,12
12398,3210,Game Packs,6,0,0.0,6
12399,3210,Stuff Packs,9,0,0.0,9
12400,3211,Expansion Packs,16,0,0.0,16
12401,3211,Game Packs,11,0,0.0,11
12402,3211,Kits,17,1,0.058823529411764705,16
12403,3211,Stuff Packs,15,0,0.0,15
12404,3212,Expansion Packs,6,0,0.0,6
12405,3212,Game Packs,4,0,0.0,4
12406,3212,Stuff Packs,6,3,0.5,3
12407,3213,Expansion Packs,6,0,0.0,6
12408,3213,Game Packs,4,0,0.0,4
12409,3213,Kits,14,0,0.0,14
12410,3213,Stuff Packs,7,0,0.0,7
12411,3214,Expansion Packs,16,0,0.0,16
12412,3214,Game Packs,10,0,0.0,10
12413,3214,Kits,11,1,0.09090909090909091,10
12414,3214,Stuff Packs,18,3,0.16666666666666666,15
12415,3215,Expansion Packs,15,0,0.0,15
12416,3215,Game Packs,7,0,0.0,7
12417,3215,Kits,13,1,0.07692307692307693,12
12418,3215,Stuff Packs,12,1,0.08333333333333333,11
12419,3216,Expansion Packs,16,0,0.0,16
12420,3216,Game Packs,12,0,0.0,12
12421,3216,Kits,33,1,0.030303030303030304,32
12422,3216,Stuff Packs,20,0,0.0,20
12423,3217,Expansion Packs,3,0,0.0,3
12424,3217,Game Packs,1,0,0.0,1
12425,3217,Kits,1,1,1.0,0
12426,3217,Stuff Packs,3,2,0.6666666666666666,1
12427,3218,Expansion Packs,6,0,0.0,6
12428,3218,Kits,1,1,1.0,0
12429,3218,Stuff Packs,4,1,0.25,3
12430,3219,Expansion Packs,16,0,0.0,16
12431,3219,Game Packs,11,1,0.09090909090909091,10
12432,3219,Kits,29,0,0.0,29
12433,3219,Stuff Packs,20,0,0.0,20
12434,3220,Expansion Packs,2,0,0.0,2
12435,3220,Game Packs,1,0,0.0,1
12436,3220,Kits,1,1,1.0,0
12437,3220,Stuff Packs,1,0,0.0,1
12438,3221,Expansion Packs,16,0,0.0,16
12439,3221,Game Packs,8,0,0.0,8
12440,3221,Kits,22,1,0.045454545454545456,21
12441,3221,Stuff Packs,14,3,0.21428571428571427,11
12442,3222,Expansion Packs,16,0,0.0,16
12443,3222,Game Packs,12,0,0.0,12
12444,3222,Kits,31,1,0.03225806451612903,30
12445,3222,Stuff Packs,20,0,0.0,20
12446,3223,Expansion Packs,16,0,0.0,16
12447,3223,Game Packs,12,0,0.0,12
12448,3223,Kits,33,1,0.030303030303030304,32
12449,3223,Stuff Packs,20,2,0.1,18
12450,3224,Expansion Packs,8,0,0.0,8
12451,3224,Game Packs,4,0,0.0,4
12452,3224,Kits,2,1,0.5,1
12453,3224,Stuff Packs,6,1,0.16666666666666666,5
12454,3225,Expansion Packs,3,0,0.0,3
12455,3225,Game Packs,5,0,0.0,5
12456,3225,Stuff Packs,4,1,0.25,3
12457,3226,Expansion Packs,13,0,0.0,13
12458,3226,Game Packs,11,0,0.0,11
12459,3226,Kits,3,1,0.3333333333333333,2
12460,3226,Stuff Packs,20,0,0.0,20
12461,3227,Expansion Packs,16,0,0.0,16
12462,3227,Game Packs,10,0,0.0,10
12463,3227,Kits,5,0,0.0,5
12464,3227,Stuff Packs,18,0,0.0,18
12465,3228,Expansion Packs,4,0,0.0,4
12466,3228,Game Packs,2,0,0.0,2
12467,3228,Kits,2,2,1.0,0
12468,3228,Stuff Packs,5,3,0.6,2
12469,3229,Expansion Packs,10,0,0.0,10
12470,3229,Game Packs,5,0,0.0,5
12471,3229,Kits,12,1,0.08333333333333333,11
12472,3229,Stuff Packs,11,0,0.0,11
12473,3230,Expansion Packs,13,0,0.0,13
12474,3230,Game Packs,6,2,0.3333333333333333,4
12475,3230,Kits,2,2,1.0,0
12476,3230,Stuff Packs,11,2,0.18181818181818182,9
12477,3231,Expansion Packs,16,0,0.0,16
12478,3231,Game Packs,12,0,0.0,12
12479,3231,Kits,33,0,0.0,33
12480,3231,Stuff Packs,20,0,0.0,20
12481,3232,Expansion Packs,5,0,0.0,5
12482,3232,Kits,1,1,1.0,0
12483,3233,Expansion Packs,16,0,0.0,16
12484,3233,Game Packs,11,0,0.0,11
12485,3233,Kits,32,0,0.0,32
12486,3233,Stuff Packs,20,0,0.0,20
12487,3234,Expansion Packs,6,0,0.0,6
12488,3234,Game Packs,3,0,0.0,3
12489,3234,Kits,1,1,1.0,0
12490,3234,Stuff Packs,2,1,0.5,1
12491,3235,Expansion Packs,7,0,0.0,7
12492,3235,Game Packs,6,0,0.0,6
12493,3235,Kits,5,2,0.4,3
12494,3235,Stuff Packs,7,3,0.42857142857142855,4
12495,3236,Expansion Packs,16,1,0.0625,15
12496,3236,Game Packs,12,0,0.0,12
12497,3236,Kits,33,0,0.0,33
12498,3236,Stuff Packs,20,0,0.0,20
12499,3237,Expansion Packs,16,0,0.0,16
12500,3237,Game Packs,11,0,0.0,11
12501,3237,Kits,23,0,0.0,23
12502,3237,Stuff Packs,20,0,0.0,20
12503,3238,Expansion Packs,9,0,0.0,9
12504,3238,Game Packs,6,1,0.16666666666666666,5
12505,3238,Kits,6,1,0.16666666666666666,5
12506,3238,Stuff Packs,13,4,0.3076923076923077,9
12507,3239,Expansion Packs,16,0,0.0,16
12508,3239,Game Packs,12,0,0.0,12
12509,3239,Kits,33,0,0.0,33
12510,3239,Stuff Packs,20,0,0.0,20
12511,3240,Expansion Packs,16,0,0.0,16
12512,3240,Game Packs,12,0,0.0,12
12513,3240,Kits,33,0,0.0,33
12514,3240,Stuff Packs,20,0,0.0,20
12515,3241,Expansion Packs,14,0,0.0,14
12516,3241,Game Packs,8,0,0.0,8
12517,3241,Kits,6,1,0.16666666666666666,5
12518,3241,Stuff Packs,12,5,0.4166666666666667,7
12519,3242,Expansion Packs,13,0,0.0,13
12520,3242,Game Packs,5,1,0.2,4
12521,3242,Stuff Packs,4,2,0.5,2
12522,3243,Expansion Packs,12,0,0.0,12
12523,3243,Game Packs,5,0,0.0,5
12524,3243,Kits,2,2,1.0,0
12525,3243,Stuff Packs,14,0,0.0,14
12526,3244,Expansion Packs,16,0,0.0,16
12527,3244,Game Packs,11,0,0.0,11
12528,3244,Kits,33,0,0.0,33
12529,3244,Stuff Packs,20,1,0.05,19
12530,3245,Expansion Packs,4,0,0.0,4
12531,3245,Game Packs,3,0,0.0,3
12532,3245,Kits,2,1,0.5,1
12533,3245,Stuff Packs,4,2,0.5,2
12534,3246,Expansion Packs,3,0,0.0,3
12535,3246,Game Packs,1,0,0.0,1
12536,3246,Kits,2,1,0.5,1
12537,3246,Stuff Packs,3,0,0.0,3
12538,3247,Expansion Packs,16,0,0.0,16
12539,3247,Game Packs,9,0,0.0,9
12540,3247,Kits,4,1,0.25,3
12541,3247,Stuff Packs,10,2,0.2,8
12542,3248,Expansion Packs,15,0,0.0,15
12543,3248,Game Packs,12,0,0.0,12
12544,3248,Kits,11,2,0.18181818181818182,9
12545,3248,Stuff Packs,13,2,0.15384615384615385,11
12546,3249,Expansion Packs,9,0,0.0,9
12547,3249,Game Packs,8,0,0.0,8
12548,3249,Stuff Packs,7,0,0.0,7
12549,3250,Expansion Packs,16,0,0.0,16
12550,3250,Game Packs,9,0,0.0,9
12551,3250,Kits,17,1,0.058823529411764705,16
12552,3250,Stuff Packs,16,0,0.0,16
12553,3251,Expansion Packs,16,0,0.0,16
12554,3251,Game Packs,12,0,0.0,12
12555,3251,Kits,22,0,0.0,22
12556,3251,Stuff Packs,20,0,0.0,20
12557,3252,Expansion Packs,11,0,0.0,11
12558,3252,Game Packs,4,0,0.0,4
12559,3252,Kits,2,1,0.5,1
12560,3252,Stuff Packs,6,1,0.16666666666666666,5
12561,3253,Expansion Packs,16,0,0.0,16
12562,3253,Game Packs,12,0,0.0,12
12563,3253,Kits,17,2,0.11764705882352941,15
12564,3253,Stuff Packs,20,0,0.0,20
12565,3254,Expansion Packs,16,0,0.0,16
12566,3254,Game Packs,11,0,0.0,11
12567,3254,Kits,27,0,0.0,27
12568,3254,Stuff Packs,20,0,0.0,20
12569,3255,Expansion Packs,16,16,1.0,0
12570,3255,Game Packs,12,12,1.0,0
12571,3255,Kits,33,33,1.0,0
12572,3255,Stuff Packs,20,19,0.95,1
12573,3256,Expansion Packs,16,0,0.0,16
12574,3256,Game Packs,12,0,0.0,12
12575,3256,Kits,33,0,0.0,33
12576,3256,Stuff Packs,20,0,0.0,20
12577,3257,Expansion Packs,16,0,0.0,16
12578,3257,Game Packs,11,0,0.0,11
12579,3257,Kits,2,2,1.0,0
12580,3257,Stuff Packs,20,0,0.0,20
12581,3258,Expansion Packs,16,0,0.0,16
12582,3258,Game Packs,11,0,0.0,11
12583,3258,Kits,17,1,0.058823529411764705,16
12584,3258,Stuff Packs,13,0,0.0,13
12585,3259,Expansion Packs,16,0,0.0,16
12586,3259,Game Packs,12,0,0.0,12
12587,3259,Kits,33,0,0.0,33
12588,3259,Stuff Packs,20,0,0.0,20
12589,3260,Expansion Packs,15,0,0.0,15
12590,3260,Game Packs,9,0,0.0,9
12591,3260,Kits,3,2,0.6666666666666666,1
12592,3260,Stuff Packs,14,4,0.2857142857142857,10
12593,3261,Expansion Packs,8,0,0.0,8
12594,3261,Game Packs,9,0,0.0,9
12595,3261,Kits,7,2,0.2857142857142857,5
12596,3261,Stuff Packs,13,3,0.23076923076923078,10
12597,3262,Expansion Packs,16,0,0.0,16
12598,3262,Game Packs,12,0,0.0,12
12599,3262,Kits,28,1,0.03571428571428571,27
12600,3262,Stuff Packs,20,0,0.0,20
12601,3263,Expansion Packs,16,0,0.0,16
12602,3263,Game Packs,12,0,0.0,12
12603,3263,Kits,22,1,0.045454545454545456,21
12604,3263,Stuff Packs,20,0,0.0,20
12605,3264,Expansion Packs,16,0,0.0,16
12606,3264,Game Packs,11,0,0.0,11
12607,3264,Kits,7,0,0.0,7
12608,3264,Stuff Packs,19,0,0.0,19
12609,3265,Expansion Packs,16,0,0.0,16
12610,3265,Game Packs,12,0,0.0,12
12611,3265,Kits,33,0,0.0,33
12612,3265,Stuff Packs,20,0,0.0,20
12613,3266,Expansion Packs,4,0,0.0,4
12614,3266,Game Packs,2,0,0.0,2
12615,3266,Kits,1,1,1.0,0
12616,3266,Stuff Packs,4,2,0.5,2
12617,3267,Expansion Packs,6,0,0.0,6
12618,3267,Game Packs,4,0,0.0,4
12619,3267,Kits,1,1,1.0,0
12620,3267,Stuff Packs,6,2,0.3333333333333333,4
12621,3268,Expansion Packs,16,0,0.0,16
12622,3268,Game Packs,11,0,0.0,11
12623,3268,Kits,5,2,0.4,3
12624,3268,Stuff Packs,17,1,0.058823529411764705,16
12625,3269,Expansion Packs,16,1,0.0625,15
12626,3269,Game Packs,12,1,0.08333333333333333,11
12627,3269,Kits,21,0,0.0,21
12628,3269,Stuff Packs,19,1,0.05263157894736842,18
12629,3270,Expansion Packs,11,0,0.0,11
12630,3270,Game Packs,7,0,0.0,7
12631,3270,Kits,3,1,0.3333333333333333,2
12632,3270,Stuff Packs,9,2,0.2222222222222222,7
12633,3271,Expansion Packs,16,0,0.0,16
12634,3271,Game Packs,11,0,0.0,11
12635,3271,Kits,29,1,0.034482758620689655,28
12636,3271,Stuff Packs,20,1,0.05,19
12637,3272,Expansion Packs,15,0,0.0,15
12638,3272,Game Packs,11,0,0.0,11
12639,3272,Kits,19,0,0.0,19
12640,3272,Stuff Packs,19,0,0.0,19
12641,3273,Expansion Packs,2,0,0.0,2
12642,3273,Game Packs,1,1,1.0,0
12643,3273,Stuff Packs,1,0,0.0,1
12644,3274,Expansion Packs,6,0,0.0,6
12645,3274,Game Packs,2,1,0.5,1
12646,3274,Stuff Packs,3,3,1.0,0
12647,3275,Expansion Packs,15,0,0.0,15
12648,3275,Game Packs,9,0,0.0,9
12649,3275,Kits,2,1,0.5,1
12650,3275,Stuff Packs,10,0,0.0,10
12651,3276,Expansion Packs,14,0,0.0,14
12652,3276,Game Packs,9,0,0.0,9
12653,3276,Kits,6,1,0.16666666666666666,5
12654,3276,Stuff Packs,9,2,0.2222222222222222,7
12655,3277,Expansion Packs,13,0,0.0,13
12656,3277,Game Packs,10,0,0.0,10
12657,3277,Kits,12,1,0.08333333333333333,11
12658,3277,Stuff Packs,18,0,0.0,18
12659,3278,Expansion Packs,16,0,0.0,16
12660,3278,Game Packs,11,0,0.0,11
12661,3278,Kits,27,0,0.0,27
12662,3278,Stuff Packs,20,0,0.0,20
12663,3279,Expansion Packs,14,0,0.0,14
12664,3279,Game Packs,10,0,0.0,10
12665,3279,Kits,11,1,0.09090909090909091,10
12666,3279,Stuff Packs,19,1,0.05263157894736842,18
12667,3280,Expansion Packs,15,0,0.0,15
12668,3280,Game Packs,12,1,0.08333333333333333,11
12669,3280,Kits,12,1,0.08333333333333333,11
12670,3280,Stuff Packs,19,3,0.15789473684210525,16
12671,3281,Expansion Packs,14,0,0.0,14
12672,3281,Game Packs,11,0,0.0,11
12673,3281,Kits,3,0,0.0,3
12674,3281,Stuff Packs,11,0,0.0,11
12675,3282,Expansion Packs,10,0,0.0,10
12676,3282,Game Packs,9,2,0.2222222222222222,7
12677,3282,Kits,3,0,0.0,3
12678,3282,Stuff Packs,18,11,0.6111111111111112,7
12679,3283,Expansion Packs,15,0,0.0,15
12680,3283,Game Packs,12,0,0.0,12
12681,3283,Kits,10,1,0.1,9
12682,3283,Stuff Packs,16,0,0.0,16
12683,3284,Expansion Packs,16,7,0.4375,9
12684,3284,Game Packs,10,5,0.5,5
12685,3284,Kits,7,0,0.0,7
12686,3284,Stuff Packs,6,3,0.5,3
12687,3285,Expansion Packs,13,0,0.0,13
12688,3285,Game Packs,7,0,0.0,7
12689,3285,Kits,1,0,0.0,1
12690,3285,Stuff Packs,6,1,0.16666666666666666,5
12691,3286,Expansion Packs,11,0,0.0,11
12692,3286,Game Packs,7,0,0.0,7
12693,3286,Stuff Packs,3,0,0.0,3
12694,3287,Expansion Packs,15,0,0.0,15
12695,3287,Game Packs,11,0,0.0,11
12696,3287,Kits,15,3,0.2,12
12697,3287,Stuff Packs,20,0,0.0,20
12698,3288,Expansion Packs,9,0,0.0,9
12699,3288,Game Packs,6,0,0.0,6
12700,3288,Kits,4,2,0.5,2
12701,3288,Stuff Packs,12,4,0.3333333333333333,8
12702,3289,Expansion Packs,13,0,0.0,13
12703,3289,Game Packs,7,0,0.0,7
12704,3289,Kits,6,0,0.0,6
12705,3289,Stuff Packs,9,0,0.0,9
12706,3290,Expansion Packs,7,1,0.14285714285714285,6
12707,3290,Game Packs,6,0,0.0,6
12708,3290,Kits,2,1,0.5,1
12709,3290,Stuff Packs,9,3,0.3333333333333333,6
12710,3291,Expansion Packs,12,0,0.0,12
12711,3291,Game Packs,3,0,0.0,3
12712,3291,Kits,9,1,0.1111111111111111,8
12713,3291,Stuff Packs,11,4,0.36363636363636365,7
12714,3292,Expansion Packs,6,0,0.0,6
12715,3292,Game Packs,6,0,0.0,6
12716,3292,Kits,4,1,0.25,3
12717,3292,Stuff Packs,5,0,0.0,5
12718,3293,Expansion Packs,15,0,0.0,15
12719,3293,Game Packs,12,0,0.0,12
12720,3293,Kits,8,1,0.125,7
12721,3293,Stuff Packs,19,0,0.0,19
12722,3294,Expansion Packs,16,0,0.0,16
12723,3294,Game Packs,11,0,0.0,11
12724,3294,Kits,26,0,0.0,26
12725,3294,Stuff Packs,20,1,0.05,19
12726,3295,Expansion Packs,13,0,0.0,13
12727,3295,Game Packs,10,0,0.0,10
12728,3295,Kits,10,1,0.1,9
12729,3295,Stuff Packs,8,2,0.25,6
12730,3296,Expansion Packs,16,0,0.0,16
12731,3296,Game Packs,12,0,0.0,12
12732,3296,Kits,33,1,0.030303030303030304,32
12733,3296,Stuff Packs,20,0,0.0,20
12734,3297,Expansion Packs,14,0,0.0,14
12735,3297,Game Packs,11,0,0.0,11
12736,3297,Kits,17,2,0.11764705882352941,15
12737,3297,Stuff Packs,16,4,0.25,12
12738,3298,Expansion Packs,14,0,0.0,14
12739,3298,Game Packs,6,0,0.0,6
12740,3298,Kits,2,2,1.0,0
12741,3298,Stuff Packs,9,3,0.3333333333333333,6
12742,3299,Expansion Packs,5,0,0.0,5
12743,3299,Game Packs,1,0,0.0,1
12744,3299,Kits,1,0,0.0,1
12745,3299,Stuff Packs,4,3,0.75,1
12746,3300,Expansion Packs,15,0,0.0,15
12747,3300,Game Packs,12,0,0.0,12
12748,3300,Kits,12,1,0.08333333333333333,11
12749,3300,Stuff Packs,19,0,0.0,19
12750,3301,Expansion Packs,16,0,0.0,16
12751,3301,Game Packs,12,0,0.0,12
12752,3301,Kits,32,4,0.125,28
12753,3301,Stuff Packs,20,4,0.2,16
12754,3302,Expansion Packs,9,0,0.0,9
12755,3302,Game Packs,6,0,0.0,6
12756,3302,Kits,8,1,0.125,7
12757,3302,Stuff Packs,12,3,0.25,9
12758,3303,Expansion Packs,16,1,0.0625,15
12759,3303,Game Packs,12,0,0.0,12
12760,3303,Kits,33,1,0.030303030303030304,32
12761,3303,Stuff Packs,20,0,0.0,20
12762,3304,Expansion Packs,16,0,0.0,16
12763,3304,Game Packs,12,0,0.0,12
12764,3304,Kits,33,0,0.0,33
12765,3304,Stuff Packs,20,0,0.0,20
12766,3305,Expansion Packs,16,0,0.0,16
12767,3305,Game Packs,12,0,0.0,12
12768,3305,Kits,33,1,0.030303030303030304,32
12769,3305,Stuff Packs,20,0,0.0,20
12770,3306,Expansion Packs,9,0,0.0,9
12771,3306,Game Packs,5,0,0.0,5
12772,3306,Kits,4,1,0.25,3
12773,3306,Stuff Packs,6,2,0.3333333333333333,4
12774,3307,Expansion Packs,8,0,0.0,8
12775,3307,Game Packs,4,0,0.0,4
12776,3307,Kits,1,1,1.0,0
12777,3307,Stuff Packs,7,2,0.2857142857142857,5
12778,3308,Expansion Packs,8,0,0.0,8
12779,3308,Game Packs,1,0,0.0,1
12780,3308,Stuff Packs,8,5,0.625,3
12781,3309,Expansion Packs,16,0,0.0,16
12782,3309,Game Packs,12,0,0.0,12
12783,3309,Kits,29,0,0.0,29
12784,3309,Stuff Packs,20,0,0.0,20
12785,3310,Expansion Packs,16,0,0.0,16
12786,3310,Game Packs,11,0,0.0,11
12787,3310,Kits,10,0,0.0,10
12788,3310,Stuff Packs,14,0,0.0,14
12789,3311,Expansion Packs,16,0,0.0,16
12790,3311,Game Packs,12,0,0.0,12
12791,3311,Kits,33,0,0.0,33
12792,3311,Stuff Packs,20,0,0.0,20
12793,3312,Expansion Packs,9,0,0.0,9
12794,3312,Game Packs,4,0,0.0,4
12795,3312,Stuff Packs,4,1,0.25,3
12796,3313,Expansion Packs,1,0,0.0,1
12797,3313,Game Packs,2,0,0.0,2
12798,3313,Kits,2,1,0.5,1
12799,3313,Stuff Packs,3,2,0.6666666666666666,1
12800,3314,Expansion Packs,10,0,0.0,10
12801,3314,Game Packs,5,0,0.0,5
12802,3314,Kits,7,1,0.14285714285714285,6
12803,3314,Stuff Packs,7,3,0.42857142857142855,4
12804,3315,Expansion Packs,16,0,0.0,16
12805,3315,Game Packs,11,0,0.0,11
12806,3315,Kits,33,0,0.0,33
12807,3315,Stuff Packs,20,0,0.0,20
12808,3316,Expansion Packs,11,0,0.0,11
12809,3316,Game Packs,7,0,0.0,7
12810,3316,Kits,2,1,0.5,1
12811,3316,Stuff Packs,15,0,0.0,15
12812,3317,Expansion Packs,16,0,0.0,16
12813,3317,Game Packs,12,0,0.0,12
12814,3317,Kits,33,0,0.0,33
12815,3317,Stuff Packs,20,0,0.0,20
12816,3318,Expansion Packs,16,0,0.0,16
12817,3318,Game Packs,12,0,0.0,12
12818,3318,Kits,33,1,0.030303030303030304,32
12819,3318,Stuff Packs,20,0,0.0,20
12820,3319,Expansion Packs,13,0,0.0,13
12821,3319,Game Packs,7,0,0.0,7
12822,3319,Kits,4,0,0.0,4
12823,3319,Stuff Packs,15,0,0.0,15
12824,3320,Expansion Packs,5,0,0.0,5
12825,3320,Game Packs,3,1,0.3333333333333333,2
12826,3320,Kits,3,3,1.0,0
12827,3320,Stuff Packs,9,3,0.3333333333333333,6
12828,3321,Expansion Packs,14,0,0.0,14
12829,3321,Game Packs,3,0,0.0,3
12830,3321,Kits,2,0,0.0,2
12831,3321,Stuff Packs,1,1,1.0,0
12832,3322,Expansion Packs,16,0,0.0,16
12833,3322,Game Packs,11,0,0.0,11
12834,3322,Kits,33,1,0.030303030303030304,32
12835,3322,Stuff Packs,20,0,0.0,20
12836,3323,Expansion Packs,16,0,0.0,16
12837,3323,Game Packs,10,1,0.1,9
12838,3323,Kits,10,2,0.2,8
12839,3323,Stuff Packs,19,1,0.05263157894736842,18
12840,3324,Expansion Packs,4,0,0.0,4
12841,3324,Game Packs,6,0,0.0,6
12842,3324,Kits,2,1,0.5,1
12843,3324,Stuff Packs,6,2,0.3333333333333333,4
12844,3325,Expansion Packs,7,0,0.0,7
12845,3325,Game Packs,5,1,0.2,4
12846,3325,Kits,1,1,1.0,0
12847,3325,Stuff Packs,6,3,0.5,3
12848,3326,Expansion Packs,16,0,0.0,16
12849,3326,Game Packs,11,0,0.0,11
12850,3326,Kits,15,1,0.06666666666666667,14
12851,3326,Stuff Packs,18,0,0.0,18
12852,3327,Expansion Packs,6,0,0.0,6
12853,3327,Game Packs,3,0,0.0,3
12854,3327,Kits,4,1,0.25,3
12855,3327,Stuff Packs,5,1,0.2,4
12856,3328,Expansion Packs,16,0,0.0,16
12857,3328,Game Packs,4,0,0.0,4
12858,3328,Kits,2,0,0.0,2
12859,3328,Stuff Packs,5,3,0.6,2
12860,3329,Expansion Packs,11,0,0.0,11
12861,3329,Game Packs,6,1,0.16666666666666666,5
12862,3329,Kits,8,0,0.0,8
12863,3329,Stuff Packs,6,0,0.0,6
12864,3330,Expansion Packs,15,0,0.0,15
12865,3330,Game Packs,12,0,0.0,12
12866,3330,Kits,6,1,0.16666666666666666,5
12867,3330,Stuff Packs,15,1,0.06666666666666667,14
12868,3331,Expansion Packs,16,0,0.0,16
12869,3331,Game Packs,11,0,0.0,11
12870,3331,Kits,23,0,0.0,23
12871,3331,Stuff Packs,20,0,0.0,20
12872,3332,Expansion Packs,16,0,0.0,16
12873,3332,Game Packs,12,0,0.0,12
12874,3332,Kits,32,0,0.0,32
12875,3332,Stuff Packs,20,0,0.0,20
12876,3333,Expansion Packs,16,0,0.0,16
12877,3333,Game Packs,12,1,0.08333333333333333,11
12878,3333,Kits,18,1,0.05555555555555555,17
12879,3333,Stuff Packs,20,0,0.0,20
12880,3334,Expansion Packs,13,0,0.0,13
12881,3334,Game Packs,9,0,0.0,9
12882,3334,Kits,4,1,0.25,3
12883,3334,Stuff Packs,6,0,0.0,6
12884,3335,Expansion Packs,11,0,0.0,11
12885,3335,Game Packs,10,0,0.0,10
12886,3335,Stuff Packs,17,1,0.058823529411764705,16
12887,3336,Expansion Packs,15,0,0.0,15
12888,3336,Game Packs,12,0,0.0,12
12889,3336,Kits,21,2,0.09523809523809523,19
12890,3336,Stuff Packs,20,1,0.05,19
12891,3337,Expansion Packs,3,0,0.0,3
12892,3337,Game Packs,6,1,0.16666666666666666,5
12893,3337,Kits,3,1,0.3333333333333333,2
12894,3337,Stuff Packs,7,4,0.5714285714285714,3
12895,3338,Expansion Packs,14,0,0.0,14
12896,3338,Game Packs,4,1,0.25,3
12897,3338,Stuff Packs,9,3,0.3333333333333333,6
12898,3339,Expansion Packs,14,1,0.07142857142857142,13
12899,3339,Game Packs,6,1,0.16666666666666666,5
12900,3339,Kits,6,2,0.3333333333333333,4
12901,3339,Stuff Packs,12,2,0.16666666666666666,10
12902,3340,Expansion Packs,7,0,0.0,7
12903,3340,Game Packs,2,0,0.0,2
12904,3340,Kits,1,1,1.0,0
12905,3340,Stuff Packs,5,3,0.6,2
12906,3341,Expansion Packs,4,0,0.0,4
12907,3341,Game Packs,4,0,0.0,4
12908,3341,Kits,5,0,0.0,5
12909,3341,Stuff Packs,7,0,0.0,7
12910,3342,Expansion Packs,11,0,0.0,11
12911,3342,Game Packs,4,0,0.0,4
12912,3342,Kits,4,1,0.25,3
12913,3342,Stuff Packs,5,0,0.0,5
12914,3343,Expansion Packs,8,0,0.0,8
12915,3343,Game Packs,4,0,0.0,4
12916,3343,Kits,6,1,0.16666666666666666,5
12917,3343,Stuff Packs,8,3,0.375,5
12918,3344,Expansion Packs,16,0,0.0,16
12919,3344,Game Packs,12,0,0.0,12
12920,3344,Kits,33,0,0.0,33
12921,3344,Stuff Packs,20,0,0.0,20
12922,3345,Expansion Packs,16,0,0.0,16
12923,3345,Game Packs,12,0,0.0,12
12924,3345,Kits,24,1,0.041666666666666664,23
12925,3345,Stuff Packs,20,1,0.05,19
12926,3346,Expansion Packs,13,0,0.0,13
12927,3346,Game Packs,9,0,0.0,9
12928,3346,Kits,3,3,1.0,0
12929,3346,Stuff Packs,18,3,0.16666666666666666,15
12930,3347,Expansion Packs,5,1,0.2,4
12931,3347,Game Packs,3,0,0.0,3
12932,3347,Stuff Packs,2,0,0.0,2
12933,3348,Expansion Packs,12,0,0.0,12
12934,3348,Game Packs,12,0,0.0,12
12935,3348,Kits,6,0,0.0,6
12936,3348,Stuff Packs,19,0,0.0,19
12937,3349,Expansion Packs,16,0,0.0,16
12938,3349,Game Packs,12,0,0.0,12
12939,3349,Kits,33,0,0.0,33
12940,3349,Stuff Packs,20,0,0.0,20
12941,3350,Expansion Packs,10,0,0.0,10
12942,3350,Game Packs,5,0,0.0,5
12943,3350,Kits,1,1,1.0,0
12944,3350,Stuff Packs,6,0,0.0,6
12945,3351,Expansion Packs,16,0,0.0,16
12946,3351,Game Packs,12,0,0.0,12
12947,3351,Kits,33,0,0.0,33
12948,3351,Stuff Packs,20,0,0.0,20
12949,3352,Expansion Packs,16,0,0.0,16
12950,3352,Game Packs,11,0,0.0,11
12951,3352,Kits,13,0,0.0,13
12952,3352,Stuff Packs,20,1,0.05,19
12953,3353,Expansion Packs,16,0,0.0,16
12954,3353,Game Packs,12,0,0.0,12
12955,3353,Kits,33,0,0.0,33
12956,3353,Stuff Packs,20,0,0.0,20
12957,3354,Expansion Packs,16,2,0.125,14
12958,3354,Game Packs,12,1,0.08333333333333333,11
12959,3354,Kits,26,3,0.11538461538461539,23
12960,3354,Stuff Packs,16,2,0.125,14
12961,3355,Expansion Packs,10,0,0.0,10
12962,3355,Game Packs,3,1,0.3333333333333333,2
12963,3355,Kits,3,3,1.0,0
12964,3355,Stuff Packs,6,4,0.6666666666666666,2
12965,3356,Expansion Packs,16,0,0.0,16
12966,3356,Game Packs,9,0,0.0,9
12967,3356,Kits,1,1,1.0,0
12968,3356,Stuff Packs,13,1,0.07692307692307693,12
12969,3357,Expansion Packs,16,0,0.0,16
12970,3357,Game Packs,11,0,0.0,11
12971,3357,Kits,17,1,0.058823529411764705,16
12972,3357,Stuff Packs,17,0,0.0,17
12973,3358,Expansion Packs,9,0,0.0,9
12974,3358,Game Packs,2,0,0.0,2
12975,3358,Kits,3,1,0.3333333333333333,2
12976,3358,Stuff Packs,5,2,0.4,3
12977,3359,Expansion Packs,10,1,0.1,9
12978,3359,Game Packs,6,1,0.16666666666666666,5
12979,3359,Kits,2,1,0.5,1
12980,3359,Stuff Packs,6,0,0.0,6
12981,3360,Expansion Packs,15,0,0.0,15
12982,3360,Game Packs,10,0,0.0,10
12983,3360,Kits,11,1,0.09090909090909091,10
12984,3360,Stuff Packs,17,0,0.0,17
12985,3361,Expansion Packs,11,0,0.0,11
12986,3361,Game Packs,9,0,0.0,9
12987,3361,Kits,2,1,0.5,1
12988,3361,Stuff Packs,15,0,0.0,15
12989,3362,Expansion Packs,16,0,0.0,16
12990,3362,Game Packs,12,0,0.0,12
12991,3362,Kits,33,2,0.06060606060606061,31
12992,3362,Stuff Packs,20,0,0.0,20
12993,3363,Expansion Packs,12,0,0.0,12
12994,3363,Game Packs,8,1,0.125,7
12995,3363,Kits,1,1,1.0,0
12996,3363,Stuff Packs,14,1,0.07142857142857142,13
12997,3364,Expansion Packs,16,0,0.0,16
12998,3364,Game Packs,12,0,0.0,12
12999,3364,Kits,26,2,0.07692307692307693,24
13000,3364,Stuff Packs,20,1,0.05,19
13001,3365,Expansion Packs,1,0,0.0,1
13002,3365,Game Packs,1,0,0.0,1
13003,3365,Kits,3,0,0.0,3
13004,3365,Stuff Packs,5,0,0.0,5
13005,3366,Expansion Packs,5,0,0.0,5
13006,3366,Game Packs,2,0,0.0,2
13007,3366,Kits,1,1,1.0,0
13008,3366,Stuff Packs,7,3,0.42857142857142855,4
13009,3367,Expansion Packs,16,0,0.0,16
13010,3367,Game Packs,12,0,0.0,12
13011,3367,Kits,33,0,0.0,33
13012,3367,Stuff Packs,20,0,0.0,20
13013,3368,Expansion Packs,11,2,0.18181818181818182,9
13014,3368,Game Packs,6,6,1.0,0
13015,3368,Stuff Packs,8,4,0.5,4
13016,3369,Expansion Packs,7,0,0.0,7
13017,3369,Game Packs,3,0,0.0,3
13018,3369,Kits,4,2,0.5,2
13019,3369,Stuff Packs,3,2,0.6666666666666666,1
13020,3370,Expansion Packs,16,0,0.0,16
13021,3370,Game Packs,11,0,0.0,11
13022,3370,Kits,12,1,0.08333333333333333,11
13023,3370,Stuff Packs,15,0,0.0,15
13024,3371,Expansion Packs,16,0,0.0,16
13025,3371,Game Packs,7,1,0.14285714285714285,6
13026,3371,Kits,5,1,0.2,4
13027,3371,Stuff Packs,15,1,0.06666666666666667,14
13028,3372,Expansion Packs,16,0,0.0,16
13029,3372,Game Packs,12,0,0.0,12
13030,3372,Kits,13,2,0.15384615384615385,11
13031,3372,Stuff Packs,12,1,0.08333333333333333,11
13032,3373,Expansion Packs,15,0,0.0,15
13033,3373,Game Packs,10,0,0.0,10
13034,3373,Kits,5,0,0.0,5
13035,3373,Stuff Packs,7,3,0.42857142857142855,4
13036,3374,Expansion Packs,16,0,0.0,16
13037,3374,Game Packs,12,0,0.0,12
13038,3374,Kits,33,1,0.030303030303030304,32
13039,3374,Stuff Packs,20,0,0.0,20
13040,3375,Expansion Packs,6,0,0.0,6
13041,3375,Game Packs,2,1,0.5,1
13042,3375,Kits,3,3,1.0,0
13043,3375,Stuff Packs,6,4,0.6666666666666666,2
13044,3376,Expansion Packs,16,0,0.0,16
13045,3376,Game Packs,12,2,0.16666666666666666,10
13046,3376,Kits,33,0,0.0,33
13047,3376,Stuff Packs,20,4,0.2,16
13048,3377,Expansion Packs,2,0,0.0,2
13049,3377,Game Packs,2,1,0.5,1
13050,3377,Kits,2,2,1.0,0
13051,3377,Stuff Packs,5,4,0.8,1
13052,3378,Expansion Packs,5,0,0.0,5
13053,3378,Game Packs,5,1,0.2,4
13054,3378,Kits,5,2,0.4,3
13055,3378,Stuff Packs,4,2,0.5,2
13056,3379,Expansion Packs,16,0,0.0,16
13057,3379,Game Packs,11,0,0.0,11
13058,3379,Kits,9,2,0.2222222222222222,7
13059,3379,Stuff Packs,12,2,0.16666666666666666,10
13060,3380,Expansion Packs,16,0,0.0,16
13061,3380,Game Packs,12,0,0.0,12
13062,3380,Kits,33,1,0.030303030303030304,32
13063,3380,Stuff Packs,20,0,0.0,20
13064,3381,Expansion Packs,16,0,0.0,16
13065,3381,Game Packs,8,0,0.0,8
13066,3381,Stuff Packs,13,0,0.0,13
13067,3382,Expansion Packs,11,0,0.0,11
13068,3382,Game Packs,5,0,0.0,5
13069,3382,Kits,7,2,0.2857142857142857,5
13070,3382,Stuff Packs,8,2,0.25,6
13071,3383,Expansion Packs,11,0,0.0,11
13072,3383,Game Packs,3,0,0.0,3
13073,3383,Kits,11,1,0.09090909090909091,10
13074,3383,Stuff Packs,13,1,0.07692307692307693,12
13075,3384,Expansion Packs,16,0,0.0,16
13076,3384,Game Packs,10,0,0.0,10
13077,3384,Kits,27,1,0.037037037037037035,26
13078,3384,Stuff Packs,18,0,0.0,18
13079,3385,Expansion Packs,2,0,0.0,2
13080,3385,Game Packs,1,1,1.0,0
13081,3385,Kits,3,2,0.6666666666666666,1
13082,3385,Stuff Packs,5,3,0.6,2
13083,3386,Expansion Packs,16,0,0.0,16
13084,3386,Game Packs,12,0,0.0,12
13085,3386,Kits,33,0,0.0,33
13086,3386,Stuff Packs,20,0,0.0,20
13087,3387,Expansion Packs,16,0,0.0,16
13088,3387,Game Packs,12,0,0.0,12
13089,3387,Kits,24,0,0.0,24
13090,3387,Stuff Packs,20,0,0.0,20
13091,3388,Expansion Packs,1,0,0.0,1
13092,3388,Stuff Packs,1,0,0.0,1
13093,3389,Expansion Packs,16,0,0.0,16
13094,3389,Game Packs,11,0,0.0,11
13095,3389,Kits,21,0,0.0,21
13096,3389,Stuff Packs,16,0,0.0,16
13097,3390,Expansion Packs,16,0,0.0,16
13098,3390,Game Packs,12,0,0.0,12
13099,3390,Kits,30,1,0.03333333333333333,29
13100,3390,Stuff Packs,20,0,0.0,20
13101,3391,Expansion Packs,16,0,0.0,16
13102,3391,Game Packs,10,0,0.0,10
13103,3391,Kits,23,0,0.0,23
13104,3391,Stuff Packs,19,0,0.0,19
13105,3392,Expansion Packs,15,0,0.0,15
13106,3392,Game Packs,10,0,0.0,10
13107,3392,Kits,15,1,0.06666666666666667,14
13108,3392,Stuff Packs,20,1,0.05,19
13109,3393,Expansion Packs,7,0,0.0,7
13110,3393,Game Packs,2,0,0.0,2
13111,3393,Kits,2,2,1.0,0
13112,3393,Stuff Packs,6,3,0.5,3
13113,3394,Expansion Packs,7,0,0.0,7
13114,3394,Game Packs,3,1,0.3333333333333333,2
13115,3394,Kits,5,1,0.2,4
13116,3394,Stuff Packs,6,5,0.8333333333333334,1
13117,3395,Expansion Packs,14,0,0.0,14
13118,3395,Game Packs,10,0,0.0,10
13119,3395,Kits,5,1,0.2,4
13120,3395,Stuff Packs,17,3,0.17647058823529413,14
13121,3396,Expansion Packs,16,0,0.0,16
13122,3396,Game Packs,12,0,0.0,12
13123,3396,Kits,32,0,0.0,32
13124,3396,Stuff Packs,20,0,0.0,20
13125,3397,Expansion Packs,16,0,0.0,16
13126,3397,Game Packs,12,0,0.0,12
13127,3397,Kits,31,0,0.0,31
13128,3397,Stuff Packs,20,0,0.0,20
13129,3398,Expansion Packs,16,0,0.0,16
13130,3398,Game Packs,12,0,0.0,12
13131,3398,Kits,33,0,0.0,33
13132,3398,Stuff Packs,20,0,0.0,20
13133,3399,Expansion Packs,10,1,0.1,9
13134,3399,Game Packs,7,0,0.0,7
13135,3399,Kits,20,3,0.15,17
13136,3399,Stuff Packs,11,3,0.2727272727272727,8
13137,3400,Expansion Packs,16,0,0.0,16
13138,3400,Game Packs,12,0,0.0,12
13139,3400,Kits,33,0,0.0,33
13140,3400,Stuff Packs,20,0,0.0,20
13141,3401,Expansion Packs,6,0,0.0,6
13142,3401,Game Packs,3,0,0.0,3
13143,3401,Stuff Packs,3,1,0.3333333333333333,2
13144,3402,Expansion Packs,16,0,0.0,16
13145,3402,Game Packs,12,0,0.0,12
13146,3402,Kits,31,0,0.0,31
13147,3402,Stuff Packs,20,0,0.0,20
13148,3403,Expansion Packs,10,0,0.0,10
13149,3403,Game Packs,6,0,0.0,6
13150,3403,Kits,3,1,0.3333333333333333,2
13151,3403,Stuff Packs,8,2,0.25,6
13152,3404,Expansion Packs,15,0,0.0,15
13153,3404,Game Packs,7,0,0.0,7
13154,3404,Kits,1,1,1.0,0
13155,3404,Stuff Packs,8,2,0.25,6
13156,3405,Expansion Packs,15,0,0.0,15
13157,3405,Game Packs,12,0,0.0,12
13158,3405,Kits,33,1,0.030303030303030304,32
13159,3405,Stuff Packs,20,0,0.0,20
13160,3406,Expansion Packs,9,0,0.0,9
13161,3406,Game Packs,4,0,0.0,4
13162,3406,Stuff Packs,4,2,0.5,2
13163,3407,Expansion Packs,16,0,0.0,16
13164,3407,Game Packs,12,0,0.0,12
13165,3407,Kits,33,0,0.0,33
13166,3407,Stuff Packs,20,0,0.0,20
13167,3408,Expansion Packs,16,0,0.0,16
13168,3408,Game Packs,12,0,0.0,12
13169,3408,Kits,14,2,0.14285714285714285,12
13170,3408,Stuff Packs,18,0,0.0,18
13171,3409,Expansion Packs,13,0,0.0,13
13172,3409,Game Packs,4,0,0.0,4
13173,3409,Kits,3,2,0.6666666666666666,1
13174,3409,Stuff Packs,3,2,0.6666666666666666,1
13175,3410,Expansion Packs,13,0,0.0,13
13176,3410,Game Packs,8,1,0.125,7
13177,3410,Kits,7,3,0.42857142857142855,4
13178,3410,Stuff Packs,13,4,0.3076923076923077,9
13179,3411,Expansion Packs,3,0,0.0,3
13180,3411,Game Packs,4,0,0.0,4
13181,3411,Kits,3,1,0.3333333333333333,2
13182,3411,Stuff Packs,7,3,0.42857142857142855,4
13183,3412,Expansion Packs,16,0,0.0,16
13184,3412,Game Packs,12,0,0.0,12
13185,3412,Kits,12,1,0.08333333333333333,11
13186,3412,Stuff Packs,20,0,0.0,20
13187,3413,Expansion Packs,14,0,0.0,14
13188,3413,Game Packs,8,0,0.0,8
13189,3413,Kits,27,1,0.037037037037037035,26
13190,3413,Stuff Packs,17,0,0.0,17
13191,3414,Expansion Packs,4,0,0.0,4
13192,3414,Game Packs,5,0,0.0,5
13193,3414,Stuff Packs,4,0,0.0,4
13194,3415,Expansion Packs,11,0,0.0,11
13195,3415,Game Packs,6,1,0.16666666666666666,5
13196,3415,Kits,4,2,0.5,2
13197,3415,Stuff Packs,8,4,0.5,4
13198,3416,Expansion Packs,13,0,0.0,13
13199,3416,Game Packs,5,0,0.0,5
13200,3416,Kits,3,2,0.6666666666666666,1
13201,3416,Stuff Packs,12,2,0.16666666666666666,10
13202,3417,Expansion Packs,6,0,0.0,6
13203,3417,Game Packs,2,0,0.0,2
13204,3417,Kits,1,1,1.0,0
13205,3417,Stuff Packs,2,1,0.5,1
13206,3418,Expansion Packs,7,0,0.0,7
13207,3418,Game Packs,5,0,0.0,5
13208,3418,Kits,2,2,1.0,0
13209,3418,Stuff Packs,5,2,0.4,3
13210,3419,Expansion Packs,6,0,0.0,6
13211,3419,Game Packs,3,0,0.0,3
13212,3419,Kits,2,2,1.0,0
13213,3419,Stuff Packs,3,3,1.0,0
13214,3420,Expansion Packs,16,0,0.0,16
13215,3420,Game Packs,11,0,0.0,11
13216,3420,Kits,28,1,0.03571428571428571,27
13217,3420,Stuff Packs,20,0,0.0,20
13218,3421,Expansion Packs,16,0,0.0,16
13219,3421,Game Packs,9,0,0.0,9
13220,3421,Kits,11,1,0.09090909090909091,10
13221,3421,Stuff Packs,17,0,0.0,17
13222,3422,Expansion Packs,15,0,0.0,15
13223,3422,Game Packs,12,0,0.0,12
13224,3422,Kits,18,3,0.16666666666666666,15
13225,3422,Stuff Packs,20,0,0.0,20
13226,3423,Expansion Packs,16,0,0.0,16
13227,3423,Game Packs,10,0,0.0,10
13228,3423,Kits,2,2,1.0,0
13229,3423,Stuff Packs,8,3,0.375,5
13230,3424,Expansion Packs,16,0,0.0,16
13231,3424,Game Packs,12,0,0.0,12
13232,3424,Kits,18,1,0.05555555555555555,17
13233,3424,Stuff Packs,20,0,0.0,20
13234,3425,Expansion Packs,5,0,0.0,5
13235,3425,Game Packs,4,1,0.25,3
13236,3425,Kits,2,2,1.0,0
13237,3425,Stuff Packs,6,3,0.5,3
13238,3426,Expansion Packs,15,0,0.0,15
13239,3426,Game Packs,10,0,0.0,10
13240,3426,Kits,3,1,0.3333333333333333,2
13241,3426,Stuff Packs,16,1,0.0625,15
13242,3427,Expansion Packs,15,0,0.0,15
13243,3427,Game Packs,12,0,0.0,12
13244,3427,Kits,8,1,0.125,7
13245,3427,Stuff Packs,20,0,0.0,20
13246,3428,Expansion Packs,16,0,0.0,16
13247,3428,Game Packs,11,0,0.0,11
13248,3428,Kits,20,0,0.0,20
13249,3428,Stuff Packs,18,2,0.1111111111111111,16
13250,3429,Expansion Packs,11,0,0.0,11
13251,3429,Game Packs,5,1,0.2,4
13252,3429,Kits,3,2,0.6666666666666666,1
13253,3429,Stuff Packs,10,4,0.4,6
13254,3430,Expansion Packs,16,0,0.0,16
13255,3430,Game Packs,12,0,0.0,12
13256,3430,Kits,30,1,0.03333333333333333,29
13257,3430,Stuff Packs,20,3,0.15,17
13258,3431,Expansion Packs,16,0,0.0,16
13259,3431,Game Packs,11,1,0.09090909090909091,10
13260,3431,Kits,8,3,0.375,5
13261,3431,Stuff Packs,20,4,0.2,16
13262,3432,Expansion Packs,16,0,0.0,16
13263,3432,Game Packs,10,0,0.0,10
13264,3432,Kits,33,0,0.0,33
13265,3432,Stuff Packs,20,0,0.0,20
13266,3433,Expansion Packs,6,0,0.0,6
13267,3433,Game Packs,4,0,0.0,4
13268,3433,Kits,2,2,1.0,0
13269,3433,Stuff Packs,8,4,0.5,4
13270,3434,Expansion Packs,12,0,0.0,12
13271,3434,Game Packs,6,0,0.0,6
13272,3434,Kits,2,2,1.0,0
13273,3434,Stuff Packs,11,3,0.2727272727272727,8
13274,3435,Expansion Packs,10,0,0.0,10
13275,3435,Game Packs,7,0,0.0,7
13276,3435,Kits,2,2,1.0,0
13277,3435,Stuff Packs,13,2,0.15384615384615385,11
13278,3436,Expansion Packs,11,0,0.0,11
13279,3436,Game Packs,8,0,0.0,8
13280,3436,Kits,7,0,0.0,7
13281,3436,Stuff Packs,5,0,0.0,5
13282,3437,Expansion Packs,16,0,0.0,16
13283,3437,Game Packs,10,0,0.0,10
13284,3437,Kits,11,0,0.0,11
13285,3437,Stuff Packs,20,0,0.0,20
13286,3438,Expansion Packs,11,0,0.0,11
13287,3438,Game Packs,7,1,0.14285714285714285,6
13288,3438,Kits,3,2,0.6666666666666666,1
13289,3438,Stuff Packs,12,4,0.3333333333333333,8
13290,3439,Expansion Packs,13,0,0.0,13
13291,3439,Game Packs,8,0,0.0,8
13292,3439,Kits,1,0,0.0,1
13293,3439,Stuff Packs,3,0,0.0,3
13294,3440,Expansion Packs,16,0,0.0,16
13295,3440,Game Packs,12,0,0.0,12
13296,3440,Kits,33,1,0.030303030303030304,32
13297,3440,Stuff Packs,20,0,0.0,20
13298,3441,Expansion Packs,16,0,0.0,16
13299,3441,Game Packs,12,0,0.0,12
13300,3441,Kits,33,0,0.0,33
13301,3441,Stuff Packs,20,0,0.0,20
13302,3442,Expansion Packs,16,0,0.0,16
13303,3442,Game Packs,11,0,0.0,11
13304,3442,Kits,7,2,0.2857142857142857,5
13305,3442,Stuff Packs,20,1,0.05,19
13306,3443,Expansion Packs,16,0,0.0,16
13307,3443,Game Packs,10,0,0.0,10
13308,3443,Kits,18,1,0.05555555555555555,17
13309,3443,Stuff Packs,18,1,0.05555555555555555,17
13310,3444,Expansion Packs,8,0,0.0,8
13311,3444,Game Packs,2,0,0.0,2
13312,3444,Kits,2,2,1.0,0
13313,3444,Stuff Packs,5,3,0.6,2
13314,3445,Expansion Packs,16,0,0.0,16
13315,3445,Game Packs,11,0,0.0,11
13316,3445,Kits,21,0,0.0,21
13317,3445,Stuff Packs,20,0,0.0,20
13318,3446,Expansion Packs,16,0,0.0,16
13319,3446,Game Packs,12,0,0.0,12
13320,3446,Kits,31,1,0.03225806451612903,30
13321,3446,Stuff Packs,20,0,0.0,20
13322,3447,Expansion Packs,14,0,0.0,14
13323,3447,Game Packs,7,0,0.0,7
13324,3447,Kits,2,2,1.0,0
13325,3447,Stuff Packs,9,2,0.2222222222222222,7
13326,3448,Expansion Packs,3,0,0.0,3
13327,3448,Game Packs,1,0,0.0,1
13328,3448,Kits,1,1,1.0,0
13329,3448,Stuff Packs,1,1,1.0,0
13330,3449,Expansion Packs,13,3,0.23076923076923078,10
13331,3449,Game Packs,6,1,0.16666666666666666,5
13332,3449,Kits,6,6,1.0,0
13333,3449,Stuff Packs,11,7,0.6363636363636364,4
13334,3450,Expansion Packs,7,0,0.0,7
13335,3450,Game Packs,6,1,0.16666666666666666,5
13336,3450,Kits,2,1,0.5,1
13337,3450,Stuff Packs,4,1,0.25,3
13338,3451,Expansion Packs,15,0,0.0,15
13339,3451,Game Packs,4,0,0.0,4
13340,3451,Kits,2,1,0.5,1
13341,3451,Stuff Packs,4,2,0.5,2
13342,3452,Expansion Packs,16,0,0.0,16
13343,3452,Game Packs,12,0,0.0,12
13344,3452,Kits,33,1,0.030303030303030304,32
13345,3452,Stuff Packs,20,0,0.0,20
13346,3453,Expansion Packs,16,0,0.0,16
13347,3453,Game Packs,11,0,0.0,11
13348,3453,Kits,32,1,0.03125,31
13349,3453,Stuff Packs,20,0,0.0,20
13350,3454,Expansion Packs,10,0,0.0,10
13351,3454,Game Packs,5,0,0.0,5
13352,3454,Kits,1,1,1.0,0
13353,3454,Stuff Packs,10,0,0.0,10
13354,3455,Expansion Packs,14,0,0.0,14
13355,3455,Game Packs,12,0,0.0,12
13356,3455,Kits,23,0,0.0,23
13357,3455,Stuff Packs,18,0,0.0,18
13358,3456,Expansion Packs,6,0,0.0,6
13359,3456,Game Packs,2,1,0.5,1
13360,3456,Kits,4,3,0.75,1
13361,3456,Stuff Packs,5,4,0.8,1
13362,3457,Expansion Packs,16,0,0.0,16
13363,3457,Game Packs,12,2,0.16666666666666666,10
13364,3457,Kits,32,1,0.03125,31
13365,3457,Stuff Packs,20,0,0.0,20
13366,3458,Expansion Packs,8,0,0.0,8
13367,3458,Game Packs,4,0,0.0,4
13368,3458,Kits,2,2,1.0,0
13369,3458,Stuff Packs,7,4,0.5714285714285714,3
13370,3459,Expansion Packs,13,0,0.0,13
13371,3459,Game Packs,10,0,0.0,10
13372,3459,Kits,6,0,0.0,6
13373,3459,Stuff Packs,6,0,0.0,6
13374,3460,Expansion Packs,16,0,0.0,16
13375,3460,Game Packs,12,0,0.0,12
13376,3460,Kits,33,0,0.0,33
13377,3460,Stuff Packs,20,1,0.05,19
13378,3461,Expansion Packs,6,0,0.0,6
13379,3461,Game Packs,1,1,1.0,0
13380,3461,Stuff Packs,3,3,1.0,0
13381,3462,Expansion Packs,16,0,0.0,16
13382,3462,Game Packs,12,0,0.0,12
13383,3462,Kits,33,0,0.0,33
13384,3462,Stuff Packs,20,0,0.0,20
13385,3463,Expansion Packs,16,0,0.0,16
13386,3463,Game Packs,12,0,0.0,12
13387,3463,Kits,18,2,0.1111111111111111,16
13388,3463,Stuff Packs,20,1,0.05,19
13389,3464,Expansion Packs,16,0,0.0,16
13390,3464,Game Packs,12,0,0.0,12
13391,3464,Kits,33,0,0.0,33
13392,3464,Stuff Packs,20,0,0.0,20
13393,3465,Expansion Packs,12,0,0.0,12
13394,3465,Game Packs,9,0,0.0,9
13395,3465,Kits,2,2,1.0,0
13396,3465,Stuff Packs,8,4,0.5,4
13397,3466,Expansion Packs,12,0,0.0,12
13398,3466,Game Packs,4,0,0.0,4
13399,3466,Kits,3,1,0.3333333333333333,2
13400,3466,Stuff Packs,7,3,0.42857142857142855,4
13401,3467,Expansion Packs,16,0,0.0,16
13402,3467,Game Packs,12,0,0.0,12
13403,3467,Kits,32,1,0.03125,31
13404,3467,Stuff Packs,20,0,0.0,20
13405,3468,Expansion Packs,16,0,0.0,16
13406,3468,Game Packs,12,0,0.0,12
13407,3468,Kits,33,0,0.0,33
13408,3468,Stuff Packs,20,0,0.0,20
13409,3469,Expansion Packs,16,0,0.0,16
13410,3469,Game Packs,12,0,0.0,12
13411,3469,Kits,33,1,0.030303030303030304,32
13412,3469,Stuff Packs,20,0,0.0,20
13413,3470,Expansion Packs,16,0,0.0,16
13414,3470,Game Packs,12,0,0.0,12
13415,3470,Kits,25,3,0.12,22
13416,3470,Stuff Packs,14,3,0.21428571428571427,11
13417,3471,Expansion Packs,16,0,0.0,16
13418,3471,Game Packs,11,0,0.0,11
13419,3471,Kits,15,1,0.06666666666666667,14
13420,3471,Stuff Packs,20,0,0.0,20
13421,3472,Expansion Packs,5,0,0.0,5
13422,3472,Game Packs,2,0,0.0,2
13423,3472,Kits,1,1,1.0,0
13424,3472,Stuff Packs,4,3,0.75,1
13425,3473,Expansion Packs,6,0,0.0,6
13426,3473,Game Packs,1,1,1.0,0
13427,3473,Kits,2,2,1.0,0
13428,3473,Stuff Packs,4,4,1.0,0
13429,3474,Expansion Packs,14,0,0.0,14
13430,3474,Game Packs,3,0,0.0,3
13431,3474,Kits,6,2,0.3333333333333333,4
13432,3474,Stuff Packs,12,0,0.0,12
13433,3475,Expansion Packs,14,0,0.0,14
13434,3475,Game Packs,10,2,0.2,8
13435,3475,Kits,7,0,0.0,7
13436,3475,Stuff Packs,10,5,0.5,5
13437,3476,Expansion Packs,16,0,0.0,16
13438,3476,Game Packs,11,0,0.0,11
13439,3476,Kits,22,2,0.09090909090909091,20
13440,3476,Stuff Packs,20,1,0.05,19
13441,3477,Expansion Packs,16,0,0.0,16
13442,3477,Game Packs,11,0,0.0,11
13443,3477,Kits,32,1,0.03125,31
13444,3477,Stuff Packs,20,0,0.0,20
13445,3478,Expansion Packs,16,0,0.0,16
13446,3478,Game Packs,12,0,0.0,12
13447,3478,Kits,33,0,0.0,33
13448,3478,Stuff Packs,20,0,0.0,20
13449,3479,Expansion Packs,16,0,0.0,16
13450,3479,Game Packs,12,0,0.0,12
13451,3479,Kits,33,0,0.0,33
13452,3479,Stuff Packs,20,0,0.0,20
13453,3480,Expansion Packs,12,0,0.0,12
13454,3480,Game Packs,2,0,0.0,2
13455,3480,Kits,3,2,0.6666666666666666,1
13456,3480,Stuff Packs,8,3,0.375,5
13457,3481,Expansion Packs,6,0,0.0,6
13458,3481,Game Packs,3,0,0.0,3
13459,3481,Kits,1,1,1.0,0
13460,3481,Stuff Packs,6,0,0.0,6
13461,3482,Expansion Packs,16,16,1.0,0
13462,3482,Game Packs,12,12,1.0,0
13463,3482,Kits,33,33,1.0,0
13464,3482,Stuff Packs,20,20,1.0,0
13465,3483,Expansion Packs,11,0,0.0,11
13466,3483,Game Packs,3,0,0.0,3
13467,3483,Kits,5,1,0.2,4
13468,3483,Stuff Packs,8,0,0.0,8
13469,3484,Expansion Packs,16,0,0.0,16
13470,3484,Game Packs,12,0,0.0,12
13471,3484,Kits,12,1,0.08333333333333333,11
13472,3484,Stuff Packs,20,0,0.0,20
13473,3485,Expansion Packs,16,0,0.0,16
13474,3485,Game Packs,12,0,0.0,12
13475,3485,Kits,33,1,0.030303030303030304,32
13476,3485,Stuff Packs,20,0,0.0,20
13477,3486,Expansion Packs,16,0,0.0,16
13478,3486,Game Packs,12,0,0.0,12
13479,3486,Kits,33,0,0.0,33
13480,3486,Stuff Packs,20,0,0.0,20
13481,3487,Expansion Packs,12,0,0.0,12
13482,3487,Game Packs,7,0,0.0,7
13483,3487,Kits,12,0,0.0,12
13484,3487,Stuff Packs,11,0,0.0,11
13485,3488,Expansion Packs,13,0,0.0,13
13486,3488,Game Packs,11,0,0.0,11
13487,3488,Kits,2,1,0.5,1
13488,3488,Stuff Packs,19,0,0.0,19
13489,3489,Expansion Packs,14,0,0.0,14
13490,3489,Game Packs,6,0,0.0,6
13491,3489,Kits,4,2,0.5,2
13492,3489,Stuff Packs,9,2,0.2222222222222222,7
13493,3490,Expansion Packs,16,0,0.0,16
13494,3490,Game Packs,12,1,0.08333333333333333,11
13495,3490,Kits,33,4,0.12121212121212122,29
13496,3490,Stuff Packs,20,3,0.15,17
13497,3491,Expansion Packs,10,0,0.0,10
13498,3491,Game Packs,4,0,0.0,4
13499,3491,Kits,2,2,1.0,0
13500,3491,Stuff Packs,4,3,0.75,1
13501,3492,Expansion Packs,10,0,0.0,10
13502,3492,Game Packs,7,0,0.0,7
13503,3492,Kits,3,0,0.0,3
13504,3492,Stuff Packs,9,0,0.0,9
13505,3493,Expansion Packs,15,0,0.0,15
13506,3493,Game Packs,11,0,0.0,11
13507,3493,Kits,13,1,0.07692307692307693,12
13508,3493,Stuff Packs,20,0,0.0,20
13509,3494,Expansion Packs,16,0,0.0,16
13510,3494,Game Packs,12,0,0.0,12
13511,3494,Kits,22,0,0.0,22
13512,3494,Stuff Packs,20,0,0.0,20
13513,3495,Expansion Packs,16,0,0.0,16
13514,3495,Game Packs,8,0,0.0,8
13515,3495,Kits,5,2,0.4,3
13516,3495,Stuff Packs,11,3,0.2727272727272727,8
13517,3496,Expansion Packs,15,0,0.0,15
13518,3496,Game Packs,12,0,0.0,12
13519,3496,Kits,15,0,0.0,15
13520,3496,Stuff Packs,20,0,0.0,20
13521,3497,Expansion Packs,15,0,0.0,15
13522,3497,Game Packs,12,0,0.0,12
13523,3497,Kits,11,1,0.09090909090909091,10
13524,3497,Stuff Packs,20,0,0.0,20
13525,3498,Expansion Packs,14,0,0.0,14
13526,3498,Game Packs,11,0,0.0,11
13527,3498,Kits,8,1,0.125,7
13528,3498,Stuff Packs,18,0,0.0,18
13529,3499,Expansion Packs,16,0,0.0,16
13530,3499,Game Packs,12,0,0.0,12
13531,3499,Kits,31,0,0.0,31
13532,3499,Stuff Packs,20,0,0.0,20
13533,3500,Expansion Packs,16,0,0.0,16
13534,3500,Game Packs,12,0,0.0,12
13535,3500,Kits,33,0,0.0,33
13536,3500,Stuff Packs,20,0,0.0,20
13537,3501,Expansion Packs,16,0,0.0,16
13538,3501,Game Packs,12,0,0.0,12
13539,3501,Kits,26,0,0.0,26
13540,3501,Stuff Packs,20,0,0.0,20
13541,3502,Expansion Packs,13,0,0.0,13
13542,3502,Game Packs,9,0,0.0,9
13543,3502,Kits,12,12,1.0,0
13544,3502,Stuff Packs,16,1,0.0625,15
13545,3503,Expansion Packs,13,0,0.0,13
13546,3503,Game Packs,10,0,0.0,10
13547,3503,Kits,2,2,1.0,0
13548,3503,Stuff Packs,18,2,0.1111111111111111,16
13549,3504,Expansion Packs,14,0,0.0,14
13550,3504,Game Packs,7,0,0.0,7
13551,3504,Kits,12,0,0.0,12
13552,3504,Stuff Packs,13,2,0.15384615384615385,11
13553,3505,Expansion Packs,12,0,0.0,12
13554,3505,Game Packs,7,0,0.0,7
13555,3505,Kits,6,0,0.0,6
13556,3505,Stuff Packs,9,1,0.1111111111111111,8
13557,3506,Expansion Packs,3,0,0.0,3
13558,3506,Game Packs,4,0,0.0,4
13559,3506,Stuff Packs,5,2,0.4,3
13560,3507,Expansion Packs,15,0,0.0,15
13561,3507,Game Packs,10,0,0.0,10
13562,3507,Kits,4,2,0.5,2
13563,3507,Stuff Packs,14,0,0.0,14
13564,3508,Expansion Packs,15,0,0.0,15
13565,3508,Game Packs,8,1,0.125,7
13566,3508,Kits,20,1,0.05,19
13567,3508,Stuff Packs,18,1,0.05555555555555555,17
13568,3509,Expansion Packs,13,0,0.0,13
13569,3509,Game Packs,10,0,0.0,10
13570,3509,Kits,2,0,0.0,2
13571,3509,Stuff Packs,20,0,0.0,20
13572,3510,Expansion Packs,16,0,0.0,16
13573,3510,Game Packs,12,0,0.0,12
13574,3510,Kits,33,1,0.030303030303030304,32
13575,3510,Stuff Packs,20,0,0.0,20
13576,3511,Expansion Packs,12,0,0.0,12
13577,3511,Game Packs,10,0,0.0,10
13578,3511,Kits,9,1,0.1111111111111111,8
13579,3511,Stuff Packs,14,1,0.07142857142857142,13
13580,3512,Expansion Packs,16,0,0.0,16
13581,3512,Game Packs,11,0,0.0,11
13582,3512,Kits,33,0,0.0,33
13583,3512,Stuff Packs,20,0,0.0,20
13584,3513,Expansion Packs,13,0,0.0,13
13585,3513,Game Packs,8,0,0.0,8
13586,3513,Kits,18,0,0.0,18
13587,3513,Stuff Packs,10,1,0.1,9
13588,3514,Expansion Packs,10,0,0.0,10
13589,3514,Game Packs,9,0,0.0,9
13590,3514,Kits,12,2,0.16666666666666666,10
13591,3514,Stuff Packs,18,0,0.0,18
13592,3515,Expansion Packs,15,0,0.0,15
13593,3515,Game Packs,3,0,0.0,3
13594,3515,Kits,2,2,1.0,0
13595,3515,Stuff Packs,8,1,0.125,7
13596,3516,Expansion Packs,14,0,0.0,14
13597,3516,Game Packs,9,0,0.0,9
13598,3516,Kits,2,0,0.0,2
13599,3516,Stuff Packs,13,2,0.15384615384615385,11
13600,3517,Expansion Packs,11,0,0.0,11
13601,3517,Game Packs,3,0,0.0,3
13602,3517,Kits,1,0,0.0,1
13603,3517,Stuff Packs,4,0,0.0,4
13604,3518,Expansion Packs,16,0,0.0,16
13605,3518,Game Packs,12,0,0.0,12
13606,3518,Kits,32,1,0.03125,31
13607,3518,Stuff Packs,20,0,0.0,20
13608,3519,Expansion Packs,16,0,0.0,16
13609,3519,Game Packs,12,0,0.0,12
13610,3519,Kits,33,0,0.0,33
13611,3519,Stuff Packs,20,0,0.0,20
13612,3520,Expansion Packs,14,0,0.0,14
13613,3520,Game Packs,12,0,0.0,12
13614,3520,Kits,3,1,0.3333333333333333,2
13615,3520,Stuff Packs,20,0,0.0,20
13616,3521,Expansion Packs,15,0,0.0,15
13617,3521,Game Packs,10,0,0.0,10
13618,3521,Kits,14,1,0.07142857142857142,13
13619,3521,Stuff Packs,20,0,0.0,20
13620,3522,Expansion Packs,16,0,0.0,16
13621,3522,Game Packs,10,0,0.0,10
13622,3522,Kits,25,0,0.0,25
13623,3522,Stuff Packs,19,0,0.0,19
13624,3523,Expansion Packs,16,0,0.0,16
13625,3523,Game Packs,8,0,0.0,8
13626,3523,Kits,8,0,0.0,8
13627,3523,Stuff Packs,13,0,0.0,13
13628,3524,Expansion Packs,16,1,0.0625,15
13629,3524,Game Packs,9,1,0.1111111111111111,8
13630,3524,Kits,5,2,0.4,3
13631,3524,Stuff Packs,11,4,0.36363636363636365,7
13632,3525,Expansion Packs,16,5,0.3125,11
13633,3525,Game Packs,12,1,0.08333333333333333,11
13634,3525,Kits,33,8,0.24242424242424243,25
13635,3525,Stuff Packs,20,4,0.2,16
13636,3526,Expansion Packs,8,0,0.0,8
13637,3526,Game Packs,2,0,0.0,2
13638,3526,Kits,7,0,0.0,7
13639,3526,Stuff Packs,8,0,0.0,8
13640,3527,Expansion Packs,16,0,0.0,16
13641,3527,Game Packs,12,0,0.0,12
13642,3527,Kits,33,0,0.0,33
13643,3527,Stuff Packs,20,1,0.05,19
13644,3528,Expansion Packs,8,0,0.0,8
13645,3528,Game Packs,7,0,0.0,7
13646,3528,Stuff Packs,8,0,0.0,8
13647,3529,Expansion Packs,8,0,0.0,8
13648,3529,Game Packs,5,0,0.0,5
13649,3529,Kits,1,0,0.0,1
13650,3529,Stuff Packs,5,2,0.4,3
13651,3530,Expansion Packs,16,0,0.0,16
13652,3530,Game Packs,12,0,0.0,12
13653,3530,Kits,22,0,0.0,22
13654,3530,Stuff Packs,20,0,0.0,20
13655,3531,Expansion Packs,12,0,0.0,12
13656,3531,Game Packs,7,1,0.14285714285714285,6
13657,3531,Kits,4,1,0.25,3
13658,3531,Stuff Packs,7,2,0.2857142857142857,5
13659,3532,Expansion Packs,14,0,0.0,14
13660,3532,Game Packs,9,0,0.0,9
13661,3532,Kits,2,2,1.0,0
13662,3532,Stuff Packs,18,1,0.05555555555555555,17
13663,3533,Expansion Packs,7,0,0.0,7
13664,3533,Game Packs,4,1,0.25,3
13665,3533,Kits,2,2,1.0,0
13666,3533,Stuff Packs,8,4,0.5,4
13667,3534,Expansion Packs,12,0,0.0,12
13668,3534,Game Packs,9,1,0.1111111111111111,8
13669,3534,Kits,3,3,1.0,0
13670,3534,Stuff Packs,12,3,0.25,9
13671,3535,Expansion Packs,16,0,0.0,16
13672,3535,Game Packs,9,0,0.0,9
13673,3535,Kits,10,1,0.1,9
13674,3535,Stuff Packs,14,0,0.0,14
13675,3536,Expansion Packs,16,0,0.0,16
13676,3536,Game Packs,12,0,0.0,12
13677,3536,Kits,33,0,0.0,33
13678,3536,Stuff Packs,20,0,0.0,20
13679,3537,Expansion Packs,16,0,0.0,16
13680,3537,Game Packs,11,0,0.0,11
13681,3537,Kits,27,1,0.037037037037037035,26
13682,3537,Stuff Packs,20,0,0.0,20
13683,3538,Expansion Packs,13,0,0.0,13
13684,3538,Game Packs,11,0,0.0,11
13685,3538,Kits,1,1,1.0,0
13686,3538,Stuff Packs,9,2,0.2222222222222222,7
13687,3539,Expansion Packs,16,0,0.0,16
13688,3539,Game Packs,11,0,0.0,11
13689,3539,Kits,12,1,0.08333333333333333,11
13690,3539,Stuff Packs,19,1,0.05263157894736842,18
13691,3540,Expansion Packs,16,0,0.0,16
13692,3540,Game Packs,12,0,0.0,12
13693,3540,Kits,22,1,0.045454545454545456,21
13694,3540,Stuff Packs,20,0,0.0,20
13695,3541,Expansion Packs,15,0,0.0,15
13696,3541,Game Packs,10,0,0.0,10
13697,3541,Kits,4,1,0.25,3
13698,3541,Stuff Packs,19,1,0.05263157894736842,18
13699,3542,Expansion Packs,7,0,0.0,7
13700,3542,Game Packs,4,0,0.0,4
13701,3542,Kits,1,0,0.0,1
13702,3542,Stuff Packs,5,3,0.6,2
13703,3543,Kits,2,2,1.0,0
13704,3543,Stuff Packs,3,3,1.0,0
13705,3544,Expansion Packs,15,0,0.0,15
13706,3544,Game Packs,10,0,0.0,10
13707,3544,Kits,1,0,0.0,1
13708,3544,Stuff Packs,11,1,0.09090909090909091,10
13709,3545,Expansion Packs,15,0,0.0,15
13710,3545,Game Packs,10,1,0.1,9
13711,3545,Kits,7,1,0.14285714285714285,6
13712,3545,Stuff Packs,13,2,0.15384615384615385,11
13713,3546,Expansion Packs,13,0,0.0,13
13714,3546,Game Packs,12,0,0.0,12
13715,3546,Kits,2,1,0.5,1
13716,3546,Stuff Packs,7,1,0.14285714285714285,6
13717,3547,Expansion Packs,15,0,0.0,15
13718,3547,Game Packs,11,0,0.0,11
13719,3547,Kits,6,1,0.16666666666666666,5
13720,3547,Stuff Packs,18,0,0.0,18
13721,3548,Expansion Packs,16,0,0.0,16
13722,3548,Game Packs,12,0,0.0,12
13723,3548,Kits,32,0,0.0,32
13724,3548,Stuff Packs,20,0,0.0,20
13725,3549,Expansion Packs,16,0,0.0,16
13726,3549,Game Packs,12,0,0.0,12
13727,3549,Kits,2,0,0.0,2
13728,3549,Stuff Packs,18,0,0.0,18
13729,3550,Expansion Packs,16,0,0.0,16
13730,3550,Game Packs,12,0,0.0,12
13731,3550,Kits,20,1,0.05,19
13732,3550,Stuff Packs,20,1,0.05,19
13733,3551,Expansion Packs,16,0,0.0,16
13734,3551,Game Packs,12,0,0.0,12
13735,3551,Kits,21,0,0.0,21
13736,3551,Stuff Packs,20,0,0.0,20
13737,3552,Expansion Packs,6,0,0.0,6
13738,3552,Game Packs,2,0,0.0,2
13739,3552,Kits,2,1,0.5,1
13740,3552,Stuff Packs,3,1,0.3333333333333333,2
13741,3553,Expansion Packs,12,12,1.0,0
13742,3553,Game Packs,4,4,1.0,0
13743,3553,Kits,1,1,1.0,0
13744,3553,Stuff Packs,2,2,1.0,0
13745,3554,Expansion Packs,16,0,0.0,16
13746,3554,Game Packs,12,0,0.0,12
13747,3554,Kits,28,0,0.0,28
13748,3554,Stuff Packs,20,0,0.0,20
13749,3555,Expansion Packs,2,0,0.0,2
13750,3555,Game Packs,1,0,0.0,1
13751,3555,Kits,5,0,0.0,5
13752,3555,Stuff Packs,7,3,0.42857142857142855,4
13753,3556,Expansion Packs,16,0,0.0,16
13754,3556,Game Packs,9,0,0.0,9
13755,3556,Kits,9,1,0.1111111111111111,8
13756,3556,Stuff Packs,15,2,0.13333333333333333,13
13757,3557,Expansion Packs,16,0,0.0,16
13758,3557,Game Packs,12,0,0.0,12
13759,3557,Kits,33,1,0.030303030303030304,32
13760,3557,Stuff Packs,20,0,0.0,20
13761,3558,Expansion Packs,16,0,0.0,16
13762,3558,Game Packs,12,0,0.0,12
13763,3558,Kits,33,0,0.0,33
13764,3558,Stuff Packs,20,0,0.0,20
13765,3559,Expansion Packs,16,0,0.0,16
13766,3559,Game Packs,12,0,0.0,12
13767,3559,Kits,27,0,0.0,27
13768,3559,Stuff Packs,20,0,0.0,20
13769,3560,Expansion Packs,16,0,0.0,16
13770,3560,Game Packs,6,0,0.0,6
13771,3560,Stuff Packs,7,1,0.14285714285714285,6
13772,3561,Game Packs,1,1,1.0,0
13773,3561,Kits,2,2,1.0,0
13774,3561,Stuff Packs,4,4,1.0,0
13775,3562,Expansion Packs,16,0,0.0,16
13776,3562,Game Packs,12,0,0.0,12
13777,3562,Kits,29,1,0.034482758620689655,28
13778,3562,Stuff Packs,20,0,0.0,20
13779,3563,Expansion Packs,16,0,0.0,16
13780,3563,Game Packs,11,0,0.0,11
13781,3563,Kits,4,0,0.0,4
13782,3563,Stuff Packs,9,0,0.0,9
13783,3564,Expansion Packs,7,0,0.0,7
13784,3564,Game Packs,2,0,0.0,2
13785,3564,Kits,2,1,0.5,1
13786,3564,Stuff Packs,8,3,0.375,5
13787,3565,Expansion Packs,16,0,0.0,16
13788,3565,Game Packs,12,0,0.0,12
13789,3565,Kits,33,0,0.0,33
13790,3565,Stuff Packs,20,0,0.0,20
13791,3566,Expansion Packs,14,0,0.0,14
13792,3566,Game Packs,5,0,0.0,5
13793,3566,Kits,18,1,0.05555555555555555,17
13794,3566,Stuff Packs,13,2,0.15384615384615385,11
13795,3567,Expansion Packs,16,0,0.0,16
13796,3567,Game Packs,11,2,0.18181818181818182,9
13797,3567,Kits,28,0,0.0,28
13798,3567,Stuff Packs,18,3,0.16666666666666666,15
13799,3568,Expansion Packs,16,0,0.0,16
13800,3568,Game Packs,6,0,0.0,6
13801,3568,Kits,8,0,0.0,8
13802,3568,Stuff Packs,11,3,0.2727272727272727,8
13803,3569,Expansion Packs,9,0,0.0,9
13804,3569,Game Packs,8,0,0.0,8
13805,3569,Stuff Packs,14,0,0.0,14
13806,3570,Expansion Packs,1,0,0.0,1
13807,3570,Game Packs,1,0,0.0,1
13808,3570,Kits,3,1,0.3333333333333333,2
13809,3570,Stuff Packs,3,1,0.3333333333333333,2
13810,3571,Expansion Packs,16,0,0.0,16
13811,3571,Game Packs,9,1,0.1111111111111111,8
13812,3571,Kits,9,3,0.3333333333333333,6
13813,3571,Stuff Packs,14,2,0.14285714285714285,12
13814,3572,Expansion Packs,3,0,0.0,3
13815,3572,Game Packs,1,0,0.0,1
13816,3572,Stuff Packs,1,0,0.0,1
13817,3573,Expansion Packs,12,0,0.0,12
13818,3573,Game Packs,8,0,0.0,8
13819,3573,Kits,4,2,0.5,2
13820,3573,Stuff Packs,17,2,0.11764705882352941,15
13821,3574,Expansion Packs,16,0,0.0,16
13822,3574,Game Packs,12,0,0.0,12
13823,3574,Kits,30,2,0.06666666666666667,28
13824,3574,Stuff Packs,20,0,0.0,20
13825,3575,Expansion Packs,16,0,0.0,16
13826,3575,Game Packs,12,0,0.0,12
13827,3575,Kits,33,0,0.0,33
13828,3575,Stuff Packs,20,0,0.0,20
13829,3576,Expansion Packs,15,0,0.0,15
13830,3576,Game Packs,12,0,0.0,12
13831,3576,Kits,25,1,0.04,24
13832,3576,Stuff Packs,20,0,0.0,20
13833,3577,Expansion Packs,13,0,0.0,13
13834,3577,Game Packs,5,0,0.0,5
13835,3577,Kits,8,0,0.0,8
13836,3577,Stuff Packs,12,2,0.16666666666666666,10
13837,3578,Expansion Packs,11,1,0.09090909090909091,10
13838,3578,Game Packs,3,0,0.0,3
13839,3578,Kits,2,2,1.0,0
13840,3578,Stuff Packs,9,3,0.3333333333333333,6
13841,3579,Expansion Packs,14,0,0.0,14
13842,3579,Game Packs,11,0,0.0,11
13843,3579,Kits,9,0,0.0,9
13844,3579,Stuff Packs,13,1,0.07692307692307693,12
13845,3580,Expansion Packs,16,0,0.0,16
13846,3580,Game Packs,12,0,0.0,12
13847,3580,Kits,33,1,0.030303030303030304,32
13848,3580,Stuff Packs,20,0,0.0,20
13849,3581,Expansion Packs,16,0,0.0,16
13850,3581,Game Packs,11,0,0.0,11
13851,3581,Kits,16,1,0.0625,15
13852,3581,Stuff Packs,18,3,0.16666666666666666,15
13853,3582,Expansion Packs,14,0,0.0,14
13854,3582,Game Packs,6,1,0.16666666666666666,5
13855,3582,Kits,3,3,1.0,0
13856,3582,Stuff Packs,12,4,0.3333333333333333,8
13857,3583,Expansion Packs,12,0,0.0,12
13858,3583,Game Packs,6,1,0.16666666666666666,5
13859,3583,Kits,5,3,0.6,2
13860,3583,Stuff Packs,11,4,0.36363636363636365,7
13861,3584,Expansion Packs,15,0,0.0,15
13862,3584,Game Packs,10,0,0.0,10
13863,3584,Kits,9,1,0.1111111111111111,8
13864,3584,Stuff Packs,19,0,0.0,19
13865,3585,Expansion Packs,15,0,0.0,15
13866,3585,Game Packs,9,0,0.0,9
13867,3585,Kits,4,1,0.25,3
13868,3585,Stuff Packs,14,1,0.07142857142857142,13
13869,3586,Expansion Packs,16,0,0.0,16
13870,3586,Game Packs,10,0,0.0,10
13871,3586,Kits,10,3,0.3,7
13872,3586,Stuff Packs,20,1,0.05,19
13873,3587,Expansion Packs,13,0,0.0,13
13874,3587,Game Packs,7,0,0.0,7
13875,3587,Kits,4,3,0.75,1
13876,3587,Stuff Packs,11,3,0.2727272727272727,8
13877,3588,Expansion Packs,16,0,0.0,16
13878,3588,Game Packs,11,0,0.0,11
13879,3588,Kits,11,1,0.09090909090909091,10
13880,3588,Stuff Packs,20,0,0.0,20
13881,3589,Expansion Packs,15,0,0.0,15
13882,3589,Game Packs,9,0,0.0,9
13883,3589,Kits,3,1,0.3333333333333333,2
13884,3589,Stuff Packs,10,0,0.0,10
13885,3590,Expansion Packs,16,0,0.0,16
13886,3590,Game Packs,10,0,0.0,10
13887,3590,Kits,4,0,0.0,4
13888,3590,Stuff Packs,17,0,0.0,17
13889,3591,Expansion Packs,15,0,0.0,15
13890,3591,Game Packs,7,0,0.0,7
13891,3591,Kits,3,2,0.6666666666666666,1
13892,3591,Stuff Packs,12,0,0.0,12
13893,3592,Expansion Packs,8,0,0.0,8
13894,3592,Game Packs,2,1,0.5,1
13895,3592,Kits,3,3,1.0,0
13896,3592,Stuff Packs,7,3,0.42857142857142855,4
13897,3593,Expansion Packs,5,0,0.0,5
13898,3593,Game Packs,2,0,0.0,2
13899,3593,Kits,1,1,1.0,0
13900,3593,Stuff Packs,6,3,0.5,3
13901,3594,Expansion Packs,13,0,0.0,13
13902,3594,Game Packs,8,1,0.125,7
13903,3594,Kits,2,0,0.0,2
13904,3594,Stuff Packs,11,1,0.09090909090909091,10
13905,3595,Expansion Packs,11,0,0.0,11
13906,3595,Game Packs,7,0,0.0,7
13907,3595,Kits,4,4,1.0,0
13908,3595,Stuff Packs,10,3,0.3,7
13909,3596,Expansion Packs,14,0,0.0,14
13910,3596,Game Packs,11,0,0.0,11
13911,3596,Kits,14,1,0.07142857142857142,13
13912,3596,Stuff Packs,19,0,0.0,19
13913,3597,Expansion Packs,14,0,0.0,14
13914,3597,Game Packs,7,0,0.0,7
13915,3597,Kits,2,1,0.5,1
13916,3597,Stuff Packs,8,0,0.0,8
13917,3598,Expansion Packs,10,1,0.1,9
13918,3598,Game Packs,3,0,0.0,3
13919,3598,Kits,7,1,0.14285714285714285,6
13920,3598,Stuff Packs,8,1,0.125,7
13921,3599,Expansion Packs,16,0,0.0,16
13922,3599,Game Packs,12,0,0.0,12
13923,3599,Kits,33,0,0.0,33
13924,3599,Stuff Packs,20,0,0.0,20
13925,3600,Expansion Packs,16,0,0.0,16
13926,3600,Game Packs,12,0,0.0,12
13927,3600,Kits,33,0,0.0,33
13928,3600,Stuff Packs,20,0,0.0,20
13929,3601,Expansion Packs,14,0,0.0,14
13930,3601,Game Packs,6,3,0.5,3
13931,3601,Kits,9,0,0.0,9
13932,3601,Stuff Packs,8,1,0.125,7
13933,3602,Expansion Packs,8,0,0.0,8
13934,3602,Game Packs,2,0,0.0,2
13935,3602,Stuff Packs,1,1,1.0,0
13936,3603,Expansion Packs,4,0,0.0,4
13937,3603,Game Packs,1,0,0.0,1
13938,3603,Kits,1,1,1.0,0
13939,3603,Stuff Packs,1,1,1.0,0
13940,3604,Expansion Packs,14,0,0.0,14
13941,3604,Game Packs,10,0,0.0,10
13942,3604,Kits,17,2,0.11764705882352941,15
13943,3604,Stuff Packs,19,3,0.15789473684210525,16
13944,3605,Expansion Packs,14,0,0.0,14
13945,3605,Game Packs,5,0,0.0,5
13946,3605,Kits,11,1,0.09090909090909091,10
13947,3605,Stuff Packs,7,3,0.42857142857142855,4
13948,3606,Expansion Packs,15,0,0.0,15
13949,3606,Game Packs,12,0,0.0,12
13950,3606,Kits,22,1,0.045454545454545456,21
13951,3606,Stuff Packs,20,0,0.0,20
13952,3607,Expansion Packs,13,0,0.0,13
13953,3607,Game Packs,8,0,0.0,8
13954,3607,Kits,2,0,0.0,2
13955,3607,Stuff Packs,14,3,0.21428571428571427,11
13956,3608,Expansion Packs,16,0,0.0,16
13957,3608,Game Packs,10,0,0.0,10
13958,3608,Kits,3,2,0.6666666666666666,1
13959,3608,Stuff Packs,12,0,0.0,12
13960,3609,Expansion Packs,16,0,0.0,16
13961,3609,Game Packs,10,1,0.1,9
13962,3609,Kits,5,3,0.6,2
13963,3609,Stuff Packs,10,1,0.1,9
13964,3610,Expansion Packs,16,0,0.0,16
13965,3610,Game Packs,12,0,0.0,12
13966,3610,Kits,33,0,0.0,33
13967,3610,Stuff Packs,20,0,0.0,20
13968,3611,Expansion Packs,8,0,0.0,8
13969,3611,Game Packs,6,0,0.0,6
13970,3611,Stuff Packs,5,0,0.0,5
13971,3612,Expansion Packs,15,0,0.0,15
13972,3612,Game Packs,10,0,0.0,10
13973,3612,Kits,11,0,0.0,11
13974,3612,Stuff Packs,11,3,0.2727272727272727,8
13975,3613,Expansion Packs,15,0,0.0,15
13976,3613,Game Packs,4,0,0.0,4
13977,3613,Kits,4,0,0.0,4
13978,3613,Stuff Packs,6,0,0.0,6
13979,3614,Expansion Packs,15,0,0.0,15
13980,3614,Game Packs,11,0,0.0,11
13981,3614,Kits,15,1,0.06666666666666667,14
13982,3614,Stuff Packs,18,1,0.05555555555555555,17
13983,3615,Expansion Packs,16,0,0.0,16
13984,3615,Game Packs,12,0,0.0,12
13985,3615,Kits,31,0,0.0,31
13986,3615,Stuff Packs,20,0,0.0,20
13987,3616,Expansion Packs,11,0,0.0,11
13988,3616,Game Packs,7,0,0.0,7
13989,3616,Kits,4,1,0.25,3
13990,3616,Stuff Packs,10,3,0.3,7
13991,3617,Expansion Packs,16,0,0.0,16
13992,3617,Game Packs,11,0,0.0,11
13993,3617,Kits,20,0,0.0,20
13994,3617,Stuff Packs,20,0,0.0,20
13995,3618,Expansion Packs,16,0,0.0,16
13996,3618,Game Packs,3,0,0.0,3
13997,3618,Kits,11,0,0.0,11
13998,3618,Stuff Packs,4,0,0.0,4
13999,3619,Expansion Packs,5,0,0.0,5
14000,3619,Game Packs,1,1,1.0,0
14001,3619,Kits,1,1,1.0,0
14002,3619,Stuff Packs,1,1,1.0,0
14003,3620,Expansion Packs,14,0,0.0,14
14004,3620,Game Packs,6,1,0.16666666666666666,5
14005,3620,Kits,5,3,0.6,2
14006,3620,Stuff Packs,8,4,0.5,4
14007,3621,Expansion Packs,16,0,0.0,16
14008,3621,Game Packs,12,0,0.0,12
14009,3621,Kits,33,0,0.0,33
14010,3621,Stuff Packs,20,0,0.0,20
14011,3622,Expansion Packs,11,0,0.0,11
14012,3622,Game Packs,3,0,0.0,3
14013,3622,Stuff Packs,7,0,0.0,7
14014,3623,Expansion Packs,16,0,0.0,16
14015,3623,Game Packs,12,0,0.0,12
14016,3623,Kits,33,7,0.21212121212121213,26
14017,3623,Stuff Packs,20,0,0.0,20
14018,3624,Expansion Packs,15,0,0.0,15
14019,3624,Game Packs,10,1,0.1,9
14020,3624,Kits,21,2,0.09523809523809523,19
14021,3624,Stuff Packs,18,2,0.1111111111111111,16
14022,3625,Expansion Packs,16,0,0.0,16
14023,3625,Game Packs,11,0,0.0,11
14024,3625,Kits,14,1,0.07142857142857142,13
14025,3625,Stuff Packs,19,4,0.21052631578947367,15
14026,3626,Expansion Packs,16,0,0.0,16
14027,3626,Game Packs,12,0,0.0,12
14028,3626,Kits,31,0,0.0,31
14029,3626,Stuff Packs,20,0,0.0,20
14030,3627,Expansion Packs,6,0,0.0,6
14031,3627,Game Packs,4,0,0.0,4
14032,3627,Kits,2,2,1.0,0
14033,3627,Stuff Packs,5,1,0.2,4
14034,3628,Expansion Packs,13,0,0.0,13
14035,3628,Game Packs,10,0,0.0,10
14036,3628,Kits,1,0,0.0,1
14037,3628,Stuff Packs,17,0,0.0,17
14038,3629,Expansion Packs,14,1,0.07142857142857142,13
14039,3629,Game Packs,8,1,0.125,7
14040,3629,Kits,10,1,0.1,9
14041,3629,Stuff Packs,14,2,0.14285714285714285,12
14042,3630,Expansion Packs,14,0,0.0,14
14043,3630,Game Packs,6,1,0.16666666666666666,5
14044,3630,Stuff Packs,4,2,0.5,2
14045,3631,Expansion Packs,8,1,0.125,7
14046,3631,Game Packs,1,0,0.0,1
14047,3631,Kits,1,0,0.0,1
14048,3631,Stuff Packs,4,2,0.5,2
14049,3632,Expansion Packs,16,0,0.0,16
14050,3632,Game Packs,11,0,0.0,11
14051,3632,Kits,27,1,0.037037037037037035,26
14052,3632,Stuff Packs,20,0,0.0,20
14053,3633,Expansion Packs,16,0,0.0,16
14054,3633,Game Packs,12,0,0.0,12
14055,3633,Kits,33,0,0.0,33
14056,3633,Stuff Packs,20,0,0.0,20
14057,3634,Expansion Packs,1,0,0.0,1
14058,3634,Stuff Packs,1,0,0.0,1
14059,3635,Expansion Packs,15,0,0.0,15
14060,3635,Game Packs,12,0,0.0,12
14061,3635,Kits,23,0,0.0,23
14062,3635,Stuff Packs,19,0,0.0,19
14063,3636,Expansion Packs,16,0,0.0,16
14064,3636,Game Packs,12,0,0.0,12
14065,3636,Kits,33,0,0.0,33
14066,3636,Stuff Packs,20,0,0.0,20
14067,3637,Expansion Packs,16,0,0.0,16
14068,3637,Game Packs,11,1,0.09090909090909091,10
14069,3637,Kits,14,1,0.07142857142857142,13
14070,3637,Stuff Packs,18,1,0.05555555555555555,17
14071,3638,Expansion Packs,16,0,0.0,16
14072,3638,Game Packs,12,0,0.0,12
14073,3638,Kits,33,0,0.0,33
14074,3638,Stuff Packs,20,0,0.0,20
14075,3639,Expansion Packs,16,0,0.0,16
14076,3639,Game Packs,12,0,0.0,12
14077,3639,Kits,33,1,0.030303030303030304,32
14078,3639,Stuff Packs,20,0,0.0,20
14079,3640,Expansion Packs,9,0,0.0,9
14080,3640,Game Packs,6,1,0.16666666666666666,5
14081,3640,Kits,1,0,0.0,1
14082,3640,Stuff Packs,9,0,0.0,9
14083,3641,Expansion Packs,13,0,0.0,13
14084,3641,Game Packs,6,0,0.0,6
14085,3641,Kits,8,0,0.0,8
14086,3641,Stuff Packs,7,0,0.0,7
14087,3642,Expansion Packs,10,0,0.0,10
14088,3642,Game Packs,4,0,0.0,4
14089,3642,Kits,3,2,0.6666666666666666,1
14090,3642,Stuff Packs,6,0,0.0,6
14091,3643,Expansion Packs,15,0,0.0,15
14092,3643,Game Packs,11,0,0.0,11
14093,3643,Kits,20,1,0.05,19
14094,3643,Stuff Packs,20,1,0.05,19
14095,3644,Expansion Packs,16,0,0.0,16
14096,3644,Game Packs,11,0,0.0,11
14097,3644,Kits,25,0,0.0,25
14098,3644,Stuff Packs,18,0,0.0,18
14099,3645,Expansion Packs,13,13,1.0,0
14100,3645,Game Packs,12,11,0.9166666666666666,1
14101,3645,Kits,16,16,1.0,0
14102,3645,Stuff Packs,18,17,0.9444444444444444,1
14103,3646,Expansion Packs,12,0,0.0,12
14104,3646,Game Packs,9,0,0.0,9
14105,3646,Kits,7,1,0.14285714285714285,6
14106,3646,Stuff Packs,4,0,0.0,4
14107,3647,Expansion Packs,7,0,0.0,7
14108,3647,Game Packs,5,0,0.0,5
14109,3647,Kits,2,2,1.0,0
14110,3647,Stuff Packs,5,3,0.6,2
14111,3648,Expansion Packs,7,1,0.14285714285714285,6
14112,3648,Game Packs,4,0,0.0,4
14113,3648,Kits,4,2,0.5,2
14114,3648,Stuff Packs,10,3,0.3,7
14115,3649,Expansion Packs,16,0,0.0,16
14116,3649,Game Packs,12,0,0.0,12
14117,3649,Kits,25,2,0.08,23
14118,3649,Stuff Packs,20,0,0.0,20
14119,3650,Expansion Packs,16,0,0.0,16
14120,3650,Game Packs,8,0,0.0,8
14121,3650,Kits,33,0,0.0,33
14122,3650,Stuff Packs,20,0,0.0,20
14123,3651,Expansion Packs,16,0,0.0,16
14124,3651,Game Packs,11,1,0.09090909090909091,10
14125,3651,Kits,32,1,0.03125,31
14126,3651,Stuff Packs,20,1,0.05,19
14127,3652,Expansion Packs,16,0,0.0,16
14128,3652,Game Packs,8,0,0.0,8
14129,3652,Kits,8,1,0.125,7
14130,3652,Stuff Packs,17,3,0.17647058823529413,14
14131,3653,Expansion Packs,16,0,0.0,16
14132,3653,Game Packs,11,0,0.0,11
14133,3653,Kits,25,1,0.04,24
14134,3653,Stuff Packs,20,0,0.0,20
14135,3654,Expansion Packs,15,0,0.0,15
14136,3654,Game Packs,10,0,0.0,10
14137,3654,Kits,7,2,0.2857142857142857,5
14138,3654,Stuff Packs,14,4,0.2857142857142857,10
14139,3655,Expansion Packs,16,0,0.0,16
14140,3655,Game Packs,12,0,0.0,12
14141,3655,Kits,22,0,0.0,22
14142,3655,Stuff Packs,20,0,0.0,20
14143,3656,Expansion Packs,10,0,0.0,10
14144,3656,Game Packs,6,0,0.0,6
14145,3656,Kits,7,1,0.14285714285714285,6
14146,3656,Stuff Packs,9,3,0.3333333333333333,6
14147,3657,Expansion Packs,16,0,0.0,16
14148,3657,Game Packs,12,0,0.0,12
14149,3657,Kits,28,0,0.0,28
14150,3657,Stuff Packs,20,0,0.0,20
14151,3658,Expansion Packs,12,0,0.0,12
14152,3658,Game Packs,8,0,0.0,8
14153,3658,Kits,4,1,0.25,3
14154,3658,Stuff Packs,14,1,0.07142857142857142,13
14155,3659,Expansion Packs,16,0,0.0,16
14156,3659,Game Packs,12,0,0.0,12
14157,3659,Kits,33,1,0.030303030303030304,32
14158,3659,Stuff Packs,20,0,0.0,20
14159,3660,Expansion Packs,5,0,0.0,5
14160,3660,Game Packs,4,1,0.25,3
14161,3660,Kits,4,2,0.5,2
14162,3660,Stuff Packs,4,3,0.75,1
14163,3661,Expansion Packs,13,0,0.0,13
14164,3661,Game Packs,10,0,0.0,10
14165,3661,Kits,7,2,0.2857142857142857,5
14166,3661,Stuff Packs,15,1,0.06666666666666667,14
14167,3662,Expansion Packs,13,0,0.0,13
14168,3662,Game Packs,10,0,0.0,10
14169,3662,Kits,5,1,0.2,4
14170,3662,Stuff Packs,17,0,0.0,17
14171,3663,Expansion Packs,16,0,0.0,16
14172,3663,Game Packs,12,0,0.0,12
14173,3663,Kits,32,0,0.0,32
14174,3663,Stuff Packs,20,0,0.0,20
14175,3664,Expansion Packs,16,0,0.0,16
14176,3664,Game Packs,7,0,0.0,7
14177,3664,Kits,7,0,0.0,7
14178,3664,Stuff Packs,16,2,0.125,14
14179,3665,Expansion Packs,15,0,0.0,15
14180,3665,Game Packs,12,0,0.0,12
14181,3665,Kits,27,2,0.07407407407407407,25
14182,3665,Stuff Packs,20,3,0.15,17
14183,3666,Expansion Packs,15,0,0.0,15
14184,3666,Game Packs,12,0,0.0,12
14185,3666,Kits,33,0,0.0,33
14186,3666,Stuff Packs,20,0,0.0,20
14187,3667,Expansion Packs,16,0,0.0,16
14188,3667,Game Packs,12,0,0.0,12
14189,3667,Kits,27,0,0.0,27
14190,3667,Stuff Packs,20,0,0.0,20
14191,3668,Expansion Packs,11,0,0.0,11
14192,3668,Game Packs,8,0,0.0,8
14193,3668,Stuff Packs,12,0,0.0,12
14194,3669,Expansion Packs,16,0,0.0,16
14195,3669,Game Packs,12,0,0.0,12
14196,3669,Kits,33,0,0.0,33
14197,3669,Stuff Packs,20,0,0.0,20
14198,3670,Expansion Packs,10,0,0.0,10
14199,3670,Game Packs,1,0,0.0,1
14200,3670,Kits,3,1,0.3333333333333333,2
14201,3670,Stuff Packs,2,1,0.5,1
14202,3671,Expansion Packs,8,0,0.0,8
14203,3671,Game Packs,1,0,0.0,1
14204,3671,Kits,3,0,0.0,3
14205,3671,Stuff Packs,3,0,0.0,3
14206,3672,Expansion Packs,16,0,0.0,16
14207,3672,Game Packs,12,0,0.0,12
14208,3672,Kits,29,1,0.034482758620689655,28
14209,3672,Stuff Packs,20,0,0.0,20
14210,3673,Expansion Packs,16,0,0.0,16
14211,3673,Game Packs,12,0,0.0,12
14212,3673,Kits,33,0,0.0,33
14213,3673,Stuff Packs,20,0,0.0,20
14214,3674,Expansion Packs,10,0,0.0,10
14215,3674,Game Packs,6,0,0.0,6
14216,3674,Kits,2,2,1.0,0
14217,3674,Stuff Packs,10,0,0.0,10
14218,3675,Expansion Packs,6,0,0.0,6
14219,3675,Kits,1,1,1.0,0
14220,3676,Expansion Packs,6,0,0.0,6
14221,3676,Game Packs,6,1,0.16666666666666666,5
14222,3676,Kits,3,1,0.3333333333333333,2
14223,3676,Stuff Packs,8,3,0.375,5
14224,3677,Expansion Packs,4,0,0.0,4
14225,3677,Game Packs,4,1,0.25,3
14226,3677,Kits,3,3,1.0,0
14227,3677,Stuff Packs,5,4,0.8,1
14228,3678,Expansion Packs,14,0,0.0,14
14229,3678,Game Packs,9,0,0.0,9
14230,3678,Kits,5,2,0.4,3
14231,3678,Stuff Packs,19,3,0.15789473684210525,16
14232,3679,Expansion Packs,8,0,0.0,8
14233,3679,Game Packs,3,0,0.0,3
14234,3679,Stuff Packs,10,1,0.1,9
14235,3680,Expansion Packs,16,0,0.0,16
14236,3680,Game Packs,12,0,0.0,12
14237,3680,Kits,33,0,0.0,33
14238,3680,Stuff Packs,20,0,0.0,20
14239,3681,Expansion Packs,13,0,0.0,13
14240,3681,Game Packs,7,0,0.0,7
14241,3681,Kits,6,2,0.3333333333333333,4
14242,3681,Stuff Packs,13,2,0.15384615384615385,11
14243,3682,Expansion Packs,16,0,0.0,16
14244,3682,Game Packs,12,0,0.0,12
14245,3682,Kits,7,1,0.14285714285714285,6
14246,3682,Stuff Packs,20,0,0.0,20
14247,3683,Expansion Packs,16,0,0.0,16
14248,3683,Game Packs,11,0,0.0,11
14249,3683,Kits,29,1,0.034482758620689655,28
14250,3683,Stuff Packs,20,0,0.0,20
14251,3684,Expansion Packs,14,0,0.0,14
14252,3684,Game Packs,6,2,0.3333333333333333,4
14253,3684,Kits,11,4,0.36363636363636365,7
14254,3684,Stuff Packs,10,5,0.5,5
14255,3685,Game Packs,3,0,0.0,3
14256,3685,Stuff Packs,5,2,0.4,3
14257,3686,Expansion Packs,16,0,0.0,16
14258,3686,Game Packs,12,0,0.0,12
14259,3686,Kits,31,1,0.03225806451612903,30
14260,3686,Stuff Packs,20,0,0.0,20
14261,3687,Expansion Packs,13,0,0.0,13
14262,3687,Game Packs,11,1,0.09090909090909091,10
14263,3687,Kits,7,2,0.2857142857142857,5
14264,3687,Stuff Packs,20,0,0.0,20
14265,3688,Expansion Packs,6,0,0.0,6
14266,3688,Game Packs,6,0,0.0,6
14267,3688,Kits,1,1,1.0,0
14268,3688,Stuff Packs,9,3,0.3333333333333333,6
14269,3689,Expansion Packs,15,0,0.0,15
14270,3689,Game Packs,10,0,0.0,10
14271,3689,Kits,7,1,0.14285714285714285,6
14272,3689,Stuff Packs,13,2,0.15384615384615385,11
14273,3690,Expansion Packs,16,0,0.0,16
14274,3690,Game Packs,11,1,0.09090909090909091,10
14275,3690,Kits,22,1,0.045454545454545456,21
14276,3690,Stuff Packs,18,1,0.05555555555555555,17
14277,3691,Expansion Packs,16,0,0.0,16
14278,3691,Game Packs,12,1,0.08333333333333333,11
14279,3691,Kits,6,5,0.8333333333333334,1
14280,3691,Stuff Packs,16,4,0.25,12
14281,3692,Expansion Packs,16,0,0.0,16
14282,3692,Game Packs,11,0,0.0,11
14283,3692,Kits,10,2,0.2,8
14284,3692,Stuff Packs,9,3,0.3333333333333333,6
14285,3693,Expansion Packs,16,0,0.0,16
14286,3693,Game Packs,11,0,0.0,11
14287,3693,Kits,19,0,0.0,19
14288,3693,Stuff Packs,20,0,0.0,20
14289,3694,Expansion Packs,2,0,0.0,2
14290,3694,Game Packs,2,0,0.0,2
14291,3694,Kits,3,3,1.0,0
14292,3694,Stuff Packs,4,4,1.0,0
14293,3695,Expansion Packs,15,0,0.0,15
14294,3695,Game Packs,10,0,0.0,10
14295,3695,Kits,3,3,1.0,0
14296,3695,Stuff Packs,16,2,0.125,14
14297,3696,Expansion Packs,12,0,0.0,12
14298,3696,Game Packs,10,0,0.0,10
14299,3696,Kits,10,1,0.1,9
14300,3696,Stuff Packs,20,1,0.05,19
14301,3697,Expansion Packs,16,0,0.0,16
14302,3697,Game Packs,9,0,0.0,9
14303,3697,Kits,4,3,0.75,1
14304,3697,Stuff Packs,8,3,0.375,5
14305,3698,Expansion Packs,15,0,0.0,15
14306,3698,Game Packs,11,0,0.0,11
14307,3698,Kits,7,1,0.14285714285714285,6
14308,3698,Stuff Packs,10,0,0.0,10
14309,3699,Expansion Packs,16,3,0.1875,13
14310,3699,Game Packs,12,1,0.08333333333333333,11
14311,3699,Kits,30,10,0.3333333333333333,20
14312,3699,Stuff Packs,20,1,0.05,19
14313,3700,Expansion Packs,15,0,0.0,15
14314,3700,Game Packs,12,0,0.0,12
14315,3700,Kits,14,0,0.0,14
14316,3700,Stuff Packs,18,0,0.0,18
14317,3701,Expansion Packs,15,0,0.0,15
14318,3701,Game Packs,8,0,0.0,8
14319,3701,Kits,6,0,0.0,6
14320,3701,Stuff Packs,10,0,0.0,10
14321,3702,Expansion Packs,12,0,0.0,12
14322,3702,Game Packs,12,1,0.08333333333333333,11
14323,3702,Kits,18,2,0.1111111111111111,16
14324,3702,Stuff Packs,19,1,0.05263157894736842,18
14325,3703,Expansion Packs,15,0,0.0,15
14326,3703,Game Packs,9,0,0.0,9
14327,3703,Kits,18,0,0.0,18
14328,3703,Stuff Packs,14,0,0.0,14
14329,3704,Expansion Packs,16,0,0.0,16
14330,3704,Game Packs,11,0,0.0,11
14331,3704,Kits,22,0,0.0,22
14332,3704,Stuff Packs,17,0,0.0,17
14333,3705,Expansion Packs,7,0,0.0,7
14334,3705,Game Packs,6,0,0.0,6
14335,3705,Kits,6,1,0.16666666666666666,5
14336,3705,Stuff Packs,5,0,0.0,5
14337,3706,Expansion Packs,14,0,0.0,14
14338,3706,Game Packs,11,0,0.0,11
14339,3706,Kits,21,0,0.0,21
14340,3706,Stuff Packs,19,1,0.05263157894736842,18
14341,3707,Expansion Packs,15,0,0.0,15
14342,3707,Game Packs,10,0,0.0,10
14343,3707,Kits,3,0,0.0,3
14344,3707,Stuff Packs,19,1,0.05263157894736842,18
14345,3708,Expansion Packs,1,0,0.0,1
14346,3708,Game Packs,1,1,1.0,0
14347,3708,Stuff Packs,3,3,1.0,0
14348,3709,Expansion Packs,16,0,0.0,16
14349,3709,Game Packs,11,0,0.0,11
14350,3709,Kits,31,0,0.0,31
14351,3709,Stuff Packs,20,0,0.0,20
14352,3710,Expansion Packs,13,0,0.0,13
14353,3710,Game Packs,6,1,0.16666666666666666,5
14354,3710,Kits,15,2,0.13333333333333333,13
14355,3710,Stuff Packs,13,4,0.3076923076923077,9
14356,3711,Expansion Packs,16,0,0.0,16
14357,3711,Game Packs,12,0,0.0,12
14358,3711,Kits,33,0,0.0,33
14359,3711,Stuff Packs,20,0,0.0,20
14360,3712,Kits,1,0,0.0,1
14361,3712,Stuff Packs,2,2,1.0,0
14362,3713,Expansion Packs,16,0,0.0,16
14363,3713,Game Packs,11,0,0.0,11
14364,3713,Kits,11,1,0.09090909090909091,10
14365,3713,Stuff Packs,12,0,0.0,12
14366,3714,Expansion Packs,16,0,0.0,16
14367,3714,Game Packs,12,1,0.08333333333333333,11
14368,3714,Kits,33,0,0.0,33
14369,3714,Stuff Packs,20,0,0.0,20
14370,3715,Expansion Packs,11,0,0.0,11
14371,3715,Game Packs,4,0,0.0,4
14372,3715,Stuff Packs,4,0,0.0,4
14373,3716,Expansion Packs,8,0,0.0,8
14374,3716,Game Packs,7,0,0.0,7
14375,3716,Kits,1,1,1.0,0
14376,3716,Stuff Packs,6,0,0.0,6
14377,3717,Expansion Packs,15,0,0.0,15
14378,3717,Game Packs,12,0,0.0,12
14379,3717,Kits,16,2,0.125,14
14380,3717,Stuff Packs,15,0,0.0,15
14381,3718,Expansion Packs,14,0,0.0,14
14382,3718,Game Packs,12,0,0.0,12
14383,3718,Kits,18,0,0.0,18
14384,3718,Stuff Packs,18,0,0.0,18
14385,3719,Expansion Packs,11,0,0.0,11
14386,3719,Game Packs,3,0,0.0,3
14387,3719,Kits,2,2,1.0,0
14388,3719,Stuff Packs,5,3,0.6,2
14389,3720,Expansion Packs,15,0,0.0,15
14390,3720,Game Packs,9,1,0.1111111111111111,8
14391,3720,Kits,2,1,0.5,1
14392,3720,Stuff Packs,9,0,0.0,9
14393,3721,Expansion Packs,13,0,0.0,13
14394,3721,Game Packs,12,0,0.0,12
14395,3721,Kits,7,0,0.0,7
14396,3721,Stuff Packs,19,0,0.0,19
14397,3722,Expansion Packs,11,2,0.18181818181818182,9
14398,3722,Game Packs,5,1,0.2,4
14399,3722,Kits,3,0,0.0,3
14400,3722,Stuff Packs,7,3,0.42857142857142855,4
14401,3723,Expansion Packs,2,1,0.5,1
14402,3723,Game Packs,4,0,0.0,4
14403,3723,Kits,11,0,0.0,11
14404,3723,Stuff Packs,3,0,0.0,3
14405,3724,Expansion Packs,14,0,0.0,14
14406,3724,Game Packs,9,0,0.0,9
14407,3724,Stuff Packs,5,2,0.4,3
14408,3725,Expansion Packs,15,0,0.0,15
14409,3725,Game Packs,7,0,0.0,7
14410,3725,Kits,3,2,0.6666666666666666,1
14411,3725,Stuff Packs,6,3,0.5,3
14412,3726,Expansion Packs,12,0,0.0,12
14413,3726,Game Packs,8,1,0.125,7
14414,3726,Kits,3,3,1.0,0
14415,3726,Stuff Packs,12,4,0.3333333333333333,8
14416,3727,Expansion Packs,7,0,0.0,7
14417,3727,Game Packs,5,0,0.0,5
14418,3727,Kits,5,1,0.2,4
14419,3727,Stuff Packs,5,0,0.0,5
14420,3728,Expansion Packs,14,0,0.0,14
14421,3728,Game Packs,11,0,0.0,11
14422,3728,Kits,12,1,0.08333333333333333,11
14423,3728,Stuff Packs,20,0,0.0,20
14424,3729,Expansion Packs,16,0,0.0,16
14425,3729,Game Packs,11,0,0.0,11
14426,3729,Kits,20,0,0.0,20
14427,3729,Stuff Packs,18,0,0.0,18
14428,3730,Expansion Packs,15,0,0.0,15
14429,3730,Game Packs,9,0,0.0,9
14430,3730,Kits,7,2,0.2857142857142857,5
14431,3730,Stuff Packs,15,3,0.2,12
14432,3731,Expansion Packs,16,0,0.0,16
14433,3731,Game Packs,12,1,0.08333333333333333,11
14434,3731,Kits,30,3,0.1,27
14435,3731,Stuff Packs,20,3,0.15,17
14436,3732,Expansion Packs,16,0,0.0,16
14437,3732,Game Packs,12,0,0.0,12
14438,3732,Kits,27,1,0.037037037037037035,26
14439,3732,Stuff Packs,20,0,0.0,20
14440,3733,Expansion Packs,13,1,0.07692307692307693,12
14441,3733,Game Packs,12,0,0.0,12
14442,3733,Kits,20,0,0.0,20
14443,3733,Stuff Packs,20,0,0.0,20
14444,3734,Expansion Packs,12,0,0.0,12
14445,3734,Game Packs,6,0,0.0,6
14446,3734,Kits,2,2,1.0,0
14447,3734,Stuff Packs,6,1,0.16666666666666666,5
14448,3735,Expansion Packs,9,0,0.0,9
14449,3735,Game Packs,5,2,0.4,3
14450,3735,Kits,3,3,1.0,0
14451,3735,Stuff Packs,10,4,0.4,6
14452,3736,Expansion Packs,14,0,0.0,14
14453,3736,Game Packs,11,0,0.0,11
14454,3736,Kits,10,1,0.1,9
14455,3736,Stuff Packs,16,0,0.0,16
14456,3737,Expansion Packs,15,0,0.0,15
14457,3737,Game Packs,12,0,0.0,12
14458,3737,Kits,19,0,0.0,19
14459,3737,Stuff Packs,20,0,0.0,20
14460,3738,Expansion Packs,16,0,0.0,16
14461,3738,Game Packs,10,0,0.0,10
14462,3738,Kits,3,1,0.3333333333333333,2
14463,3738,Stuff Packs,14,0,0.0,14
14464,3739,Expansion Packs,7,0,0.0,7
14465,3739,Game Packs,1,0,0.0,1
14466,3739,Kits,3,0,0.0,3
14467,3739,Stuff Packs,3,1,0.3333333333333333,2
14468,3740,Expansion Packs,9,0,0.0,9
14469,3740,Game Packs,3,0,0.0,3
14470,3740,Kits,12,2,0.16666666666666666,10
14471,3740,Stuff Packs,10,2,0.2,8
14472,3741,Expansion Packs,15,0,0.0,15
14473,3741,Game Packs,10,0,0.0,10
14474,3741,Kits,13,0,0.0,13
14475,3741,Stuff Packs,19,0,0.0,19
14476,3742,Expansion Packs,12,0,0.0,12
14477,3742,Game Packs,7,0,0.0,7
14478,3742,Kits,3,3,1.0,0
14479,3742,Stuff Packs,11,2,0.18181818181818182,9
14480,3743,Expansion Packs,5,0,0.0,5
14481,3743,Kits,1,0,0.0,1
14482,3744,Expansion Packs,16,0,0.0,16
14483,3744,Game Packs,12,0,0.0,12
14484,3744,Kits,33,0,0.0,33
14485,3744,Stuff Packs,20,0,0.0,20
14486,3745,Expansion Packs,12,0,0.0,12
14487,3745,Game Packs,9,0,0.0,9
14488,3745,Kits,3,2,0.6666666666666666,1
14489,3745,Stuff Packs,9,3,0.3333333333333333,6
14490,3746,Expansion Packs,13,0,0.0,13
14491,3746,Game Packs,4,0,0.0,4
14492,3746,Stuff Packs,7,0,0.0,7
14493,3747,Expansion Packs,7,0,0.0,7
14494,3747,Game Packs,3,0,0.0,3
14495,3747,Kits,3,0,0.0,3
14496,3747,Stuff Packs,8,1,0.125,7
14497,3748,Expansion Packs,10,0,0.0,10
14498,3748,Game Packs,4,0,0.0,4
14499,3748,Stuff Packs,4,1,0.25,3
14500,3749,Expansion Packs,13,0,0.0,13
14501,3749,Game Packs,9,0,0.0,9
14502,3749,Stuff Packs,13,0,0.0,13
14503,3750,Expansion Packs,14,0,0.0,14
14504,3750,Game Packs,8,0,0.0,8
14505,3750,Stuff Packs,14,2,0.14285714285714285,12
14506,3751,Expansion Packs,15,0,0.0,15
14507,3751,Game Packs,12,0,0.0,12
14508,3751,Kits,29,0,0.0,29
14509,3751,Stuff Packs,17,0,0.0,17
14510,3752,Expansion Packs,16,0,0.0,16
14511,3752,Game Packs,12,0,0.0,12
14512,3752,Kits,33,0,0.0,33
14513,3752,Stuff Packs,20,0,0.0,20
14514,3753,Expansion Packs,16,0,0.0,16
14515,3753,Game Packs,12,0,0.0,12
14516,3753,Kits,33,0,0.0,33
14517,3753,Stuff Packs,20,0,0.0,20
14518,3754,Expansion Packs,16,0,0.0,16
14519,3754,Game Packs,11,0,0.0,11
14520,3754,Kits,9,1,0.1111111111111111,8
14521,3754,Stuff Packs,19,1,0.05263157894736842,18
14522,3755,Expansion Packs,16,0,0.0,16
14523,3755,Game Packs,12,0,0.0,12
14524,3755,Kits,33,0,0.0,33
14525,3755,Stuff Packs,20,0,0.0,20
14526,3756,Expansion Packs,16,0,0.0,16
14527,3756,Game Packs,12,0,0.0,12
14528,3756,Kits,31,0,0.0,31
14529,3756,Stuff Packs,17,1,0.058823529411764705,16
14530,3757,Expansion Packs,10,0,0.0,10
14531,3757,Game Packs,5,0,0.0,5
14532,3757,Stuff Packs,2,0,0.0,2
14533,3758,Expansion Packs,7,0,0.0,7
14534,3758,Game Packs,1,0,0.0,1
14535,3758,Stuff Packs,2,0,0.0,2
14536,3759,Expansion Packs,16,3,0.1875,13
14537,3759,Game Packs,12,0,0.0,12
14538,3759,Kits,32,1,0.03125,31
14539,3759,Stuff Packs,16,1,0.0625,15
14540,3760,Expansion Packs,16,0,0.0,16
14541,3760,Game Packs,12,0,0.0,12
14542,3760,Kits,8,2,0.25,6
14543,3760,Stuff Packs,20,0,0.0,20
14544,3761,Expansion Packs,16,1,0.0625,15
14545,3761,Game Packs,12,0,0.0,12
14546,3761,Kits,21,3,0.14285714285714285,18
14547,3761,Stuff Packs,18,2,0.1111111111111111,16
14548,3762,Expansion Packs,16,0,0.0,16
14549,3762,Game Packs,12,0,0.0,12
14550,3762,Kits,26,0,0.0,26
14551,3762,Stuff Packs,20,0,0.0,20
14552,3763,Expansion Packs,16,0,0.0,16
14553,3763,Game Packs,12,0,0.0,12
14554,3763,Kits,20,1,0.05,19
14555,3763,Stuff Packs,20,0,0.0,20
14556,3764,Expansion Packs,13,3,0.23076923076923078,10
14557,3764,Game Packs,11,0,0.0,11
14558,3764,Kits,10,1,0.1,9
14559,3764,Stuff Packs,17,0,0.0,17
14560,3765,Expansion Packs,7,0,0.0,7
14561,3765,Game Packs,3,0,0.0,3
14562,3765,Kits,2,0,0.0,2
14563,3765,Stuff Packs,3,0,0.0,3
14564,3766,Expansion Packs,15,0,0.0,15
14565,3766,Game Packs,12,0,0.0,12
14566,3766,Kits,8,0,0.0,8
14567,3766,Stuff Packs,14,0,0.0,14
14568,3767,Expansion Packs,6,0,0.0,6
14569,3767,Game Packs,4,1,0.25,3
14570,3767,Kits,1,1,1.0,0
14571,3767,Stuff Packs,6,4,0.6666666666666666,2
14572,3768,Expansion Packs,4,0,0.0,4
14573,3768,Game Packs,3,1,0.3333333333333333,2
14574,3768,Kits,3,3,1.0,0
14575,3768,Stuff Packs,4,4,1.0,0
14576,3769,Expansion Packs,14,0,0.0,14
14577,3769,Game Packs,11,0,0.0,11
14578,3769,Kits,4,1,0.25,3
14579,3769,Stuff Packs,15,1,0.06666666666666667,14
14580,3770,Expansion Packs,10,0,0.0,10
14581,3770,Game Packs,7,0,0.0,7
14582,3770,Stuff Packs,6,1,0.16666666666666666,5
14583,3771,Expansion Packs,16,1,0.0625,15
14584,3771,Game Packs,12,8,0.6666666666666666,4
14585,3771,Kits,33,13,0.3939393939393939,20
14586,3771,Stuff Packs,20,13,0.65,7
14587,3772,Expansion Packs,16,0,0.0,16
14588,3772,Game Packs,12,0,0.0,12
14589,3772,Kits,18,1,0.05555555555555555,17
14590,3772,Stuff Packs,18,0,0.0,18
14591,3773,Expansion Packs,16,1,0.0625,15
14592,3773,Game Packs,12,0,0.0,12
14593,3773,Kits,33,0,0.0,33
14594,3773,Stuff Packs,20,0,0.0,20
14595,3774,Expansion Packs,16,0,0.0,16
14596,3774,Game Packs,12,0,0.0,12
14597,3774,Kits,13,1,0.07692307692307693,12
14598,3774,Stuff Packs,18,1,0.05555555555555555,17
14599,3775,Expansion Packs,14,0,0.0,14
14600,3775,Game Packs,8,0,0.0,8
14601,3775,Kits,8,1,0.125,7
14602,3775,Stuff Packs,17,2,0.11764705882352941,15
14603,3776,Expansion Packs,16,0,0.0,16
14604,3776,Game Packs,12,0,0.0,12
14605,3776,Kits,9,2,0.2222222222222222,7
14606,3776,Stuff Packs,20,0,0.0,20
14607,3777,Expansion Packs,16,0,0.0,16
14608,3777,Game Packs,12,0,0.0,12
14609,3777,Kits,33,2,0.06060606060606061,31
14610,3777,Stuff Packs,20,2,0.1,18
14611,3778,Expansion Packs,7,0,0.0,7
14612,3778,Game Packs,4,0,0.0,4
14613,3778,Kits,3,3,1.0,0
14614,3778,Stuff Packs,6,4,0.6666666666666666,2
14615,3779,Expansion Packs,16,0,0.0,16
14616,3779,Game Packs,12,0,0.0,12
14617,3779,Kits,33,1,0.030303030303030304,32
14618,3779,Stuff Packs,20,0,0.0,20
14619,3780,Expansion Packs,11,0,0.0,11
14620,3780,Game Packs,9,0,0.0,9
14621,3780,Kits,2,2,1.0,0
14622,3780,Stuff Packs,12,2,0.16666666666666666,10
14623,3781,Expansion Packs,16,0,0.0,16
14624,3781,Game Packs,12,0,0.0,12
14625,3781,Kits,33,0,0.0,33
14626,3781,Stuff Packs,20,0,0.0,20
14627,3782,Expansion Packs,13,0,0.0,13
14628,3782,Game Packs,7,0,0.0,7
14629,3782,Kits,1,1,1.0,0
14630,3782,Stuff Packs,14,0,0.0,14
14631,3783,Expansion Packs,12,0,0.0,12
14632,3783,Game Packs,7,2,0.2857142857142857,5
14633,3783,Kits,1,0,0.0,1
14634,3783,Stuff Packs,5,2,0.4,3
14635,3784,Expansion Packs,16,0,0.0,16
14636,3784,Game Packs,12,0,0.0,12
14637,3784,Kits,33,0,0.0,33
14638,3784,Stuff Packs,20,0,0.0,20
14639,3785,Expansion Packs,16,0,0.0,16
14640,3785,Game Packs,12,0,0.0,12
14641,3785,Kits,32,0,0.0,32
14642,3785,Stuff Packs,20,0,0.0,20
14643,3786,Expansion Packs,15,0,0.0,15
14644,3786,Game Packs,11,0,0.0,11
14645,3786,Kits,21,0,0.0,21
14646,3786,Stuff Packs,18,0,0.0,18
14647,3787,Expansion Packs,7,0,0.0,7
14648,3787,Game Packs,5,0,0.0,5
14649,3787,Kits,5,0,0.0,5
14650,3787,Stuff Packs,6,0,0.0,6
14651,3788,Expansion Packs,13,0,0.0,13
14652,3788,Game Packs,6,0,0.0,6
14653,3788,Kits,2,1,0.5,1
14654,3788,Stuff Packs,8,1,0.125,7
14655,3789,Expansion Packs,15,0,0.0,15
14656,3789,Game Packs,11,0,0.0,11
14657,3789,Kits,5,2,0.4,3
14658,3789,Stuff Packs,18,0,0.0,18
14659,3790,Expansion Packs,12,0,0.0,12
14660,3790,Game Packs,7,0,0.0,7
14661,3790,Kits,5,1,0.2,4
14662,3790,Stuff Packs,11,0,0.0,11
14663,3791,Expansion Packs,16,0,0.0,16
14664,3791,Game Packs,11,0,0.0,11
14665,3791,Kits,23,0,0.0,23
14666,3791,Stuff Packs,17,0,0.0,17
14667,3792,Expansion Packs,7,0,0.0,7
14668,3792,Game Packs,1,0,0.0,1
14669,3792,Kits,1,1,1.0,0
14670,3792,Stuff Packs,2,0,0.0,2
14671,3793,Expansion Packs,10,0,0.0,10
14672,3793,Game Packs,7,0,0.0,7
14673,3793,Kits,6,2,0.3333333333333333,4
14674,3793,Stuff Packs,15,2,0.13333333333333333,13
14675,3794,Expansion Packs,16,0,0.0,16
14676,3794,Game Packs,12,0,0.0,12
14677,3794,Kits,31,0,0.0,31
14678,3794,Stuff Packs,20,0,0.0,20
14679,3795,Expansion Packs,15,0,0.0,15
14680,3795,Game Packs,11,0,0.0,11
14681,3795,Kits,14,0,0.0,14
14682,3795,Stuff Packs,19,0,0.0,19
14683,3796,Expansion Packs,15,0,0.0,15
14684,3796,Game Packs,10,0,0.0,10
14685,3796,Kits,11,0,0.0,11
14686,3796,Stuff Packs,19,0,0.0,19
14687,3797,Expansion Packs,15,0,0.0,15
14688,3797,Game Packs,7,1,0.14285714285714285,6
14689,3797,Stuff Packs,14,0,0.0,14
14690,3798,Expansion Packs,16,0,0.0,16
14691,3798,Game Packs,12,0,0.0,12
14692,3798,Kits,33,0,0.0,33
14693,3798,Stuff Packs,20,0,0.0,20
14694,3799,Expansion Packs,16,0,0.0,16
14695,3799,Game Packs,12,0,0.0,12
14696,3799,Kits,33,0,0.0,33
14697,3799,Stuff Packs,20,0,0.0,20
14698,3800,Expansion Packs,16,0,0.0,16
14699,3800,Game Packs,12,0,0.0,12
14700,3800,Kits,26,0,0.0,26
14701,3800,Stuff Packs,20,0,0.0,20
14702,3801,Expansion Packs,7,0,0.0,7
14703,3801,Game Packs,4,0,0.0,4
14704,3801,Stuff Packs,3,1,0.3333333333333333,2
14705,3802,Expansion Packs,16,0,0.0,16
14706,3802,Game Packs,11,0,0.0,11
14707,3802,Kits,27,0,0.0,27
14708,3802,Stuff Packs,17,0,0.0,17
14709,3803,Expansion Packs,16,0,0.0,16
14710,3803,Game Packs,11,0,0.0,11
14711,3803,Kits,18,0,0.0,18
14712,3803,Stuff Packs,18,2,0.1111111111111111,16
14713,3804,Expansion Packs,15,0,0.0,15
14714,3804,Game Packs,5,0,0.0,5
14715,3804,Kits,2,1,0.5,1
14716,3804,Stuff Packs,6,3,0.5,3
14717,3805,Expansion Packs,15,0,0.0,15
14718,3805,Game Packs,5,0,0.0,5
14719,3805,Kits,2,1,0.5,1
14720,3805,Stuff Packs,6,3,0.5,3
14721,3806,Expansion Packs,14,0,0.0,14
14722,3806,Game Packs,10,1,0.1,9
14723,3806,Kits,16,0,0.0,16
14724,3806,Stuff Packs,17,0,0.0,17
14725,3807,Expansion Packs,12,0,0.0,12
14726,3807,Game Packs,7,0,0.0,7
14727,3807,Kits,3,1,0.3333333333333333,2
14728,3807,Stuff Packs,12,0,0.0,12
14729,3808,Expansion Packs,16,0,0.0,16
14730,3808,Game Packs,11,0,0.0,11
14731,3808,Kits,12,1,0.08333333333333333,11
14732,3808,Stuff Packs,15,0,0.0,15
14733,3809,Expansion Packs,14,0,0.0,14
14734,3809,Game Packs,5,0,0.0,5
14735,3809,Kits,8,2,0.25,6
14736,3809,Stuff Packs,13,3,0.23076923076923078,10
14737,3810,Expansion Packs,5,0,0.0,5
14738,3810,Game Packs,4,0,0.0,4
14739,3810,Stuff Packs,1,1,1.0,0
14740,3811,Expansion Packs,9,3,0.3333333333333333,6
14741,3811,Game Packs,1,1,1.0,0
14742,3811,Kits,2,2,1.0,0
14743,3811,Stuff Packs,4,4,1.0,0
14744,3812,Expansion Packs,15,1,0.06666666666666667,14
14745,3812,Game Packs,8,0,0.0,8
14746,3812,Kits,9,1,0.1111111111111111,8
14747,3812,Stuff Packs,18,0,0.0,18
14748,3813,Expansion Packs,15,0,0.0,15
14749,3813,Game Packs,10,0,0.0,10
14750,3813,Kits,5,2,0.4,3
14751,3813,Stuff Packs,18,2,0.1111111111111111,16
14752,3814,Expansion Packs,16,0,0.0,16
14753,3814,Game Packs,9,0,0.0,9
14754,3814,Kits,8,1,0.125,7
14755,3814,Stuff Packs,10,0,0.0,10
14756,3815,Expansion Packs,16,0,0.0,16
14757,3815,Game Packs,12,0,0.0,12
14758,3815,Kits,29,0,0.0,29
14759,3815,Stuff Packs,18,0,0.0,18
14760,3816,Expansion Packs,1,0,0.0,1
14761,3816,Game Packs,1,1,1.0,0
14762,3816,Kits,2,2,1.0,0
14763,3816,Stuff Packs,4,4,1.0,0
14764,3817,Expansion Packs,15,0,0.0,15
14765,3817,Game Packs,7,0,0.0,7
14766,3817,Kits,4,2,0.5,2
14767,3817,Stuff Packs,4,1,0.25,3
14768,3818,Expansion Packs,16,0,0.0,16
14769,3818,Game Packs,12,0,0.0,12
14770,3818,Kits,31,0,0.0,31
14771,3818,Stuff Packs,20,1,0.05,19
14772,3819,Expansion Packs,16,0,0.0,16
14773,3819,Game Packs,12,0,0.0,12
14774,3819,Kits,32,1,0.03125,31
14775,3819,Stuff Packs,20,0,0.0,20
14776,3820,Expansion Packs,2,0,0.0,2
14777,3820,Game Packs,2,1,0.5,1
14778,3820,Kits,17,2,0.11764705882352941,15
14779,3820,Stuff Packs,10,3,0.3,7
14780,3821,Expansion Packs,16,0,0.0,16
14781,3821,Game Packs,11,0,0.0,11
14782,3821,Kits,19,0,0.0,19
14783,3821,Stuff Packs,20,0,0.0,20
14784,3822,Expansion Packs,16,0,0.0,16
14785,3822,Game Packs,12,0,0.0,12
14786,3822,Kits,14,1,0.07142857142857142,13
14787,3822,Stuff Packs,20,0,0.0,20
14788,3823,Expansion Packs,14,0,0.0,14
14789,3823,Game Packs,10,0,0.0,10
14790,3823,Kits,17,0,0.0,17
14791,3823,Stuff Packs,16,0,0.0,16
14792,3824,Expansion Packs,11,0,0.0,11
14793,3824,Game Packs,10,0,0.0,10
14794,3824,Kits,10,1,0.1,9
14795,3824,Stuff Packs,13,0,0.0,13
14796,3825,Expansion Packs,8,0,0.0,8
14797,3825,Game Packs,6,0,0.0,6
14798,3825,Kits,4,0,0.0,4
14799,3825,Stuff Packs,7,1,0.14285714285714285,6
14800,3826,Expansion Packs,16,0,0.0,16
14801,3826,Game Packs,12,0,0.0,12
14802,3826,Kits,33,0,0.0,33
14803,3826,Stuff Packs,20,0,0.0,20
14804,3827,Expansion Packs,15,0,0.0,15
14805,3827,Game Packs,11,0,0.0,11
14806,3827,Kits,7,0,0.0,7
14807,3827,Stuff Packs,20,0,0.0,20
14808,3828,Expansion Packs,14,0,0.0,14
14809,3828,Game Packs,8,0,0.0,8
14810,3828,Kits,2,2,1.0,0
14811,3828,Stuff Packs,8,2,0.25,6
14812,3829,Expansion Packs,16,0,0.0,16
14813,3829,Game Packs,12,0,0.0,12
14814,3829,Kits,33,0,0.0,33
14815,3829,Stuff Packs,20,0,0.0,20
14816,3830,Expansion Packs,16,0,0.0,16
14817,3830,Game Packs,12,0,0.0,12
14818,3830,Kits,31,1,0.03225806451612903,30
14819,3830,Stuff Packs,20,0,0.0,20
14820,3831,Expansion Packs,6,0,0.0,6
14821,3831,Game Packs,2,0,0.0,2
14822,3831,Kits,3,1,0.3333333333333333,2
14823,3831,Stuff Packs,13,1,0.07692307692307693,12
14824,3832,Expansion Packs,14,0,0.0,14
14825,3832,Game Packs,6,0,0.0,6
14826,3832,Kits,3,1,0.3333333333333333,2
14827,3832,Stuff Packs,2,1,0.5,1
14828,3833,Expansion Packs,9,0,0.0,9
14829,3833,Game Packs,2,0,0.0,2
14830,3833,Stuff Packs,2,1,0.5,1
14831,3834,Expansion Packs,10,0,0.0,10
14832,3834,Game Packs,7,0,0.0,7
14833,3834,Stuff Packs,11,0,0.0,11
14834,3835,Expansion Packs,10,0,0.0,10
14835,3835,Game Packs,6,1,0.16666666666666666,5
14836,3835,Kits,3,3,1.0,0
14837,3835,Stuff Packs,11,4,0.36363636363636365,7
14838,3836,Expansion Packs,12,0,0.0,12
14839,3836,Game Packs,9,1,0.1111111111111111,8
14840,3836,Kits,2,1,0.5,1
14841,3836,Stuff Packs,11,3,0.2727272727272727,8
14842,3837,Expansion Packs,4,0,0.0,4
14843,3837,Game Packs,3,0,0.0,3
14844,3837,Stuff Packs,2,0,0.0,2
14845,3838,Expansion Packs,16,0,0.0,16
14846,3838,Game Packs,12,0,0.0,12
14847,3838,Kits,33,1,0.030303030303030304,32
14848,3838,Stuff Packs,20,0,0.0,20
14849,3839,Expansion Packs,10,0,0.0,10
14850,3839,Game Packs,5,0,0.0,5
14851,3839,Kits,3,1,0.3333333333333333,2
14852,3839,Stuff Packs,4,1,0.25,3
14853,3840,Expansion Packs,15,0,0.0,15
14854,3840,Game Packs,12,0,0.0,12
14855,3840,Kits,20,0,0.0,20
14856,3840,Stuff Packs,19,0,0.0,19
14857,3841,Expansion Packs,11,0,0.0,11
14858,3841,Game Packs,8,1,0.125,7
14859,3841,Kits,3,3,1.0,0
14860,3841,Stuff Packs,8,4,0.5,4
14861,3842,Expansion Packs,7,0,0.0,7
14862,3842,Game Packs,2,0,0.0,2
14863,3842,Kits,5,2,0.4,3
14864,3842,Stuff Packs,9,3,0.3333333333333333,6
14865,3843,Expansion Packs,16,0,0.0,16
14866,3843,Game Packs,6,1,0.16666666666666666,5
14867,3843,Kits,5,3,0.6,2
14868,3843,Stuff Packs,20,3,0.15,17
14869,3844,Game Packs,3,1,0.3333333333333333,2
14870,3844,Kits,3,3,1.0,0
14871,3844,Stuff Packs,5,3,0.6,2
14872,3845,Expansion Packs,16,0,0.0,16
14873,3845,Game Packs,11,0,0.0,11
14874,3845,Kits,7,4,0.5714285714285714,3
14875,3845,Stuff Packs,20,0,0.0,20
14876,3846,Expansion Packs,16,0,0.0,16
14877,3846,Game Packs,11,0,0.0,11
14878,3846,Kits,13,0,0.0,13
14879,3846,Stuff Packs,13,0,0.0,13
14880,3847,Expansion Packs,15,0,0.0,15
14881,3847,Game Packs,12,0,0.0,12
14882,3847,Kits,25,1,0.04,24
14883,3847,Stuff Packs,19,0,0.0,19
14884,3848,Expansion Packs,14,0,0.0,14
14885,3848,Game Packs,7,0,0.0,7
14886,3848,Kits,1,0,0.0,1
14887,3848,Stuff Packs,5,0,0.0,5
14888,3849,Expansion Packs,16,0,0.0,16
14889,3849,Game Packs,11,0,0.0,11
14890,3849,Kits,4,1,0.25,3
14891,3849,Stuff Packs,12,1,0.08333333333333333,11
14892,3850,Expansion Packs,16,0,0.0,16
14893,3850,Game Packs,12,0,0.0,12
14894,3850,Kits,21,2,0.09523809523809523,19
14895,3850,Stuff Packs,19,0,0.0,19
14896,3851,Expansion Packs,16,0,0.0,16
14897,3851,Game Packs,11,0,0.0,11
14898,3851,Kits,27,1,0.037037037037037035,26
14899,3851,Stuff Packs,20,0,0.0,20
14900,3852,Expansion Packs,12,0,0.0,12
14901,3852,Game Packs,7,0,0.0,7
14902,3852,Kits,13,1,0.07692307692307693,12
14903,3852,Stuff Packs,10,3,0.3,7
14904,3853,Expansion Packs,14,0,0.0,14
14905,3853,Game Packs,7,0,0.0,7
14906,3853,Kits,2,2,1.0,0
14907,3853,Stuff Packs,8,2,0.25,6
14908,3854,Expansion Packs,11,0,0.0,11
14909,3854,Game Packs,6,0,0.0,6
14910,3854,Kits,2,2,1.0,0
14911,3854,Stuff Packs,8,2,0.25,6
14912,3855,Expansion Packs,15,0,0.0,15
14913,3855,Game Packs,11,1,0.09090909090909091,10
14914,3855,Kits,2,2,1.0,0
14915,3855,Stuff Packs,17,4,0.23529411764705882,13
14916,3856,Expansion Packs,10,0,0.0,10
14917,3856,Game Packs,7,0,0.0,7
14918,3856,Kits,24,1,0.041666666666666664,23
14919,3856,Stuff Packs,17,0,0.0,17
14920,3857,Expansion Packs,15,0,0.0,15
14921,3857,Game Packs,7,1,0.14285714285714285,6
14922,3857,Kits,15,2,0.13333333333333333,13
14923,3857,Stuff Packs,16,4,0.25,12
14924,3858,Expansion Packs,3,0,0.0,3
14925,3858,Game Packs,3,0,0.0,3
14926,3858,Kits,5,0,0.0,5
14927,3858,Stuff Packs,7,0,0.0,7
14928,3859,Expansion Packs,15,0,0.0,15
14929,3859,Game Packs,11,0,0.0,11
14930,3859,Kits,3,2,0.6666666666666666,1
14931,3859,Stuff Packs,17,1,0.058823529411764705,16
14932,3860,Expansion Packs,14,0,0.0,14
14933,3860,Game Packs,9,0,0.0,9
14934,3860,Kits,5,1,0.2,4
14935,3860,Stuff Packs,8,3,0.375,5
14936,3861,Expansion Packs,16,0,0.0,16
14937,3861,Game Packs,12,0,0.0,12
14938,3861,Kits,22,0,0.0,22
14939,3861,Stuff Packs,20,0,0.0,20
14940,3862,Expansion Packs,16,1,0.0625,15
14941,3862,Game Packs,12,0,0.0,12
14942,3862,Kits,14,0,0.0,14
14943,3862,Stuff Packs,18,0,0.0,18
14944,3863,Expansion Packs,13,0,0.0,13
14945,3863,Game Packs,7,0,0.0,7
14946,3863,Kits,19,1,0.05263157894736842,18
14947,3863,Stuff Packs,12,0,0.0,12
14948,3864,Expansion Packs,15,0,0.0,15
14949,3864,Game Packs,9,0,0.0,9
14950,3864,Kits,5,3,0.6,2
14951,3864,Stuff Packs,8,4,0.5,4
14952,3865,Expansion Packs,13,0,0.0,13
14953,3865,Game Packs,5,0,0.0,5
14954,3865,Kits,4,2,0.5,2
14955,3865,Stuff Packs,8,1,0.125,7
14956,3866,Expansion Packs,16,0,0.0,16
14957,3866,Game Packs,10,0,0.0,10
14958,3866,Kits,2,2,1.0,0
14959,3866,Stuff Packs,13,2,0.15384615384615385,11
14960,3867,Expansion Packs,16,0,0.0,16
14961,3867,Game Packs,12,0,0.0,12
14962,3867,Kits,33,0,0.0,33
14963,3867,Stuff Packs,20,0,0.0,20
14964,3868,Expansion Packs,16,0,0.0,16
14965,3868,Game Packs,12,0,0.0,12
14966,3868,Kits,33,2,0.06060606060606061,31
14967,3868,Stuff Packs,20,0,0.0,20
14968,3869,Expansion Packs,11,0,0.0,11
14969,3869,Game Packs,7,0,0.0,7
14970,3869,Kits,12,0,0.0,12
14971,3869,Stuff Packs,16,0,0.0,16
14972,3870,Expansion Packs,11,0,0.0,11
14973,3870,Game Packs,6,1,0.16666666666666666,5
14974,3870,Kits,3,3,1.0,0
14975,3870,Stuff Packs,6,1,0.16666666666666666,5
14976,3871,Expansion Packs,16,0,0.0,16
14977,3871,Game Packs,12,0,0.0,12
14978,3871,Kits,21,2,0.09523809523809523,19
14979,3871,Stuff Packs,19,1,0.05263157894736842,18
14980,3872,Expansion Packs,14,0,0.0,14
14981,3872,Game Packs,9,0,0.0,9
14982,3872,Kits,9,1,0.1111111111111111,8
14983,3872,Stuff Packs,10,0,0.0,10
14984,3873,Expansion Packs,16,0,0.0,16
14985,3873,Game Packs,11,0,0.0,11
14986,3873,Kits,8,1,0.125,7
14987,3873,Stuff Packs,19,0,0.0,19
14988,3874,Expansion Packs,16,0,0.0,16
14989,3874,Game Packs,11,0,0.0,11
14990,3874,Kits,2,2,1.0,0
14991,3874,Stuff Packs,16,1,0.0625,15
14992,3875,Expansion Packs,16,0,0.0,16
14993,3875,Game Packs,11,0,0.0,11
14994,3875,Kits,27,0,0.0,27
14995,3875,Stuff Packs,20,0,0.0,20
14996,3876,Expansion Packs,16,0,0.0,16
14997,3876,Game Packs,12,0,0.0,12
14998,3876,Kits,14,2,0.14285714285714285,12
14999,3876,Stuff Packs,20,0,0.0,20
15000,3877,Expansion Packs,15,0,0.0,15
15001,3877,Game Packs,12,0,0.0,12
15002,3877,Kits,26,0,0.0,26
15003,3877,Stuff Packs,20,0,0.0,20
15004,3878,Expansion Packs,16,0,0.0,16
15005,3878,Game Packs,12,0,0.0,12
15006,3878,Kits,32,1,0.03125,31
15007,3878,Stuff Packs,20,0,0.0,20
15008,3879,Expansion Packs,15,1,0.06666666666666667,14
15009,3879,Game Packs,11,1,0.09090909090909091,10
15010,3879,Kits,2,1,0.5,1
15011,3879,Stuff Packs,16,2,0.125,14
15012,3880,Expansion Packs,10,0,0.0,10
15013,3880,Game Packs,7,0,0.0,7
15014,3880,Kits,1,1,1.0,0
15015,3880,Stuff Packs,8,1,0.125,7
15016,3881,Expansion Packs,9,0,0.0,9
15017,3881,Game Packs,4,1,0.25,3
15018,3881,Kits,2,2,1.0,0
15019,3881,Stuff Packs,7,4,0.5714285714285714,3
15020,3882,Expansion Packs,3,0,0.0,3
15021,3882,Game Packs,2,1,0.5,1
15022,3882,Kits,1,1,1.0,0
15023,3882,Stuff Packs,4,3,0.75,1
15024,3883,Expansion Packs,3,0,0.0,3
15025,3883,Game Packs,2,0,0.0,2
15026,3883,Kits,2,2,1.0,0
15027,3883,Stuff Packs,4,3,0.75,1
15028,3884,Expansion Packs,2,0,0.0,2
15029,3884,Game Packs,3,1,0.3333333333333333,2
15030,3884,Kits,2,1,0.5,1
15031,3884,Stuff Packs,6,4,0.6666666666666666,2
15032,3885,Expansion Packs,5,0,0.0,5
15033,3885,Game Packs,2,0,0.0,2
15034,3885,Kits,1,1,1.0,0
15035,3885,Stuff Packs,8,1,0.125,7
15036,3886,Expansion Packs,13,0,0.0,13
15037,3886,Game Packs,9,0,0.0,9
15038,3886,Kits,9,0,0.0,9
15039,3886,Stuff Packs,20,0,0.0,20
15040,3887,Expansion Packs,11,0,0.0,11
15041,3887,Game Packs,8,0,0.0,8
15042,3887,Kits,2,1,0.5,1
15043,3887,Stuff Packs,9,0,0.0,9
15044,3888,Expansion Packs,9,0,0.0,9
15045,3888,Game Packs,3,0,0.0,3
15046,3888,Kits,1,1,1.0,0
15047,3888,Stuff Packs,4,2,0.5,2
15048,3889,Expansion Packs,1,0,0.0,1
15049,3889,Game Packs,1,1,1.0,0
15050,3889,Kits,2,2,1.0,0
15051,3889,Stuff Packs,4,4,1.0,0
15052,3890,Expansion Packs,16,0,0.0,16
15053,3890,Game Packs,12,0,0.0,12
15054,3890,Kits,10,0,0.0,10
15055,3890,Stuff Packs,20,0,0.0,20
15056,3891,Expansion Packs,12,0,0.0,12
15057,3891,Game Packs,7,1,0.14285714285714285,6
15058,3891,Kits,8,1,0.125,7
15059,3891,Stuff Packs,12,1,0.08333333333333333,11
15060,3892,Expansion Packs,16,0,0.0,16
15061,3892,Game Packs,12,0,0.0,12
15062,3892,Kits,19,1,0.05263157894736842,18
15063,3892,Stuff Packs,20,0,0.0,20
15064,3893,Expansion Packs,16,0,0.0,16
15065,3893,Game Packs,12,0,0.0,12
15066,3893,Kits,33,0,0.0,33
15067,3893,Stuff Packs,20,0,0.0,20
15068,3894,Expansion Packs,16,0,0.0,16
15069,3894,Game Packs,12,0,0.0,12
15070,3894,Kits,33,0,0.0,33
15071,3894,Stuff Packs,20,0,0.0,20
15072,3895,Expansion Packs,15,0,0.0,15
15073,3895,Game Packs,10,0,0.0,10
15074,3895,Kits,12,1,0.08333333333333333,11
15075,3895,Stuff Packs,14,0,0.0,14
15076,3896,Expansion Packs,15,0,0.0,15
15077,3896,Game Packs,10,0,0.0,10
15078,3896,Kits,2,1,0.5,1
15079,3896,Stuff Packs,12,2,0.16666666666666666,10
15080,3897,Expansion Packs,13,0,0.0,13
15081,3897,Game Packs,10,0,0.0,10
15082,3897,Kits,6,1,0.16666666666666666,5
15083,3897,Stuff Packs,12,1,0.08333333333333333,11
15084,3898,Expansion Packs,11,0,0.0,11
15085,3898,Game Packs,10,0,0.0,10
15086,3898,Kits,1,1,1.0,0
15087,3898,Stuff Packs,9,2,0.2222222222222222,7
15088,3899,Expansion Packs,11,0,0.0,11
15089,3899,Game Packs,9,0,0.0,9
15090,3899,Stuff Packs,13,0,0.0,13
15091,3900,Expansion Packs,15,1,0.06666666666666667,14
15092,3900,Game Packs,4,0,0.0,4
15093,3900,Kits,11,0,0.0,11
15094,3900,Stuff Packs,8,3,0.375,5
15095,3901,Expansion Packs,15,0,0.0,15
15096,3901,Game Packs,12,0,0.0,12
15097,3901,Kits,27,1,0.037037037037037035,26
15098,3901,Stuff Packs,20,1,0.05,19
15099,3902,Expansion Packs,10,0,0.0,10
15100,3902,Game Packs,6,0,0.0,6
15101,3902,Kits,1,0,0.0,1
15102,3902,Stuff Packs,2,0,0.0,2
15103,3903,Expansion Packs,13,0,0.0,13
15104,3903,Game Packs,9,0,0.0,9
15105,3903,Kits,9,2,0.2222222222222222,7
15106,3903,Stuff Packs,20,2,0.1,18
15107,3904,Expansion Packs,9,0,0.0,9
15108,3904,Game Packs,1,0,0.0,1
15109,3904,Kits,8,0,0.0,8
15110,3904,Stuff Packs,5,2,0.4,3
15111,3905,Expansion Packs,16,0,0.0,16
15112,3905,Game Packs,12,0,0.0,12
15113,3905,Kits,33,0,0.0,33
15114,3905,Stuff Packs,20,0,0.0,20
15115,3906,Expansion Packs,11,0,0.0,11
15116,3906,Game Packs,6,0,0.0,6
15117,3906,Stuff Packs,8,2,0.25,6
15118,3907,Expansion Packs,9,0,0.0,9
15119,3907,Game Packs,5,0,0.0,5
15120,3907,Kits,6,1,0.16666666666666666,5
15121,3907,Stuff Packs,5,1,0.2,4
15122,3908,Expansion Packs,13,0,0.0,13
15123,3908,Game Packs,8,0,0.0,8
15124,3908,Kits,1,0,0.0,1
15125,3908,Stuff Packs,15,0,0.0,15
15126,3909,Expansion Packs,16,0,0.0,16
15127,3909,Game Packs,12,0,0.0,12
15128,3909,Kits,29,0,0.0,29
15129,3909,Stuff Packs,20,1,0.05,19
15130,3910,Expansion Packs,16,0,0.0,16
15131,3910,Game Packs,12,0,0.0,12
15132,3910,Kits,26,0,0.0,26
15133,3910,Stuff Packs,20,1,0.05,19
15134,3911,Expansion Packs,16,0,0.0,16
15135,3911,Game Packs,12,0,0.0,12
15136,3911,Kits,33,1,0.030303030303030304,32
15137,3911,Stuff Packs,20,3,0.15,17
15138,3912,Expansion Packs,16,0,0.0,16
15139,3912,Game Packs,12,0,0.0,12
15140,3912,Kits,33,1,0.030303030303030304,32
15141,3912,Stuff Packs,20,0,0.0,20
15142,3913,Expansion Packs,12,0,0.0,12
15143,3913,Game Packs,9,0,0.0,9
15144,3913,Kits,5,1,0.2,4
15145,3913,Stuff Packs,12,0,0.0,12
15146,3914,Expansion Packs,14,13,0.9285714285714286,1
15147,3914,Game Packs,5,4,0.8,1
15148,3914,Kits,5,1,0.2,4
15149,3914,Stuff Packs,8,8,1.0,0
15150,3915,Expansion Packs,14,0,0.0,14
15151,3915,Game Packs,5,0,0.0,5
15152,3915,Stuff Packs,6,3,0.5,3
15153,3916,Expansion Packs,13,0,0.0,13
15154,3916,Game Packs,6,1,0.16666666666666666,5
15155,3916,Kits,1,1,1.0,0
15156,3916,Stuff Packs,9,4,0.4444444444444444,5
15157,3917,Expansion Packs,3,0,0.0,3
15158,3917,Game Packs,1,0,0.0,1
15159,3917,Kits,2,2,1.0,0
15160,3917,Stuff Packs,3,3,1.0,0
15161,3918,Expansion Packs,16,0,0.0,16
15162,3918,Game Packs,12,0,0.0,12
15163,3918,Kits,20,2,0.1,18
15164,3918,Stuff Packs,20,1,0.05,19
15165,3919,Expansion Packs,9,0,0.0,9
15166,3919,Game Packs,4,0,0.0,4
15167,3919,Stuff Packs,2,0,0.0,2
15168,3920,Expansion Packs,1,0,0.0,1
15169,3920,Game Packs,1,0,0.0,1
15170,3920,Stuff Packs,1,0,0.0,1
15171,3921,Expansion Packs,16,0,0.0,16
15172,3921,Game Packs,11,0,0.0,11
15173,3921,Kits,32,0,0.0,32
15174,3921,Stuff Packs,20,0,0.0,20
15175,3922,Expansion Packs,13,0,0.0,13
15176,3922,Game Packs,11,0,0.0,11
15177,3922,Kits,6,0,0.0,6
15178,3922,Stuff Packs,19,0,0.0,19
15179,3923,Expansion Packs,11,0,0.0,11
15180,3923,Game Packs,7,0,0.0,7
15181,3923,Kits,3,3,1.0,0
15182,3923,Stuff Packs,13,4,0.3076923076923077,9
15183,3924,Expansion Packs,9,0,0.0,9
15184,3924,Game Packs,7,0,0.0,7
15185,3924,Kits,4,1,0.25,3
15186,3924,Stuff Packs,10,3,0.3,7
15187,3925,Expansion Packs,2,0,0.0,2
15188,3925,Kits,1,0,0.0,1
15189,3925,Stuff Packs,1,0,0.0,1
15190,3926,Expansion Packs,14,0,0.0,14
15191,3926,Game Packs,11,0,0.0,11
15192,3926,Kits,10,0,0.0,10
15193,3926,Stuff Packs,11,0,0.0,11
15194,3927,Expansion Packs,15,1,0.06666666666666667,14
15195,3927,Game Packs,12,0,0.0,12
15196,3927,Kits,26,1,0.038461538461538464,25
15197,3927,Stuff Packs,19,3,0.15789473684210525,16
15198,3928,Expansion Packs,16,0,0.0,16
15199,3928,Game Packs,12,0,0.0,12
15200,3928,Kits,31,0,0.0,31
15201,3928,Stuff Packs,20,0,0.0,20
15202,3929,Expansion Packs,5,0,0.0,5
15203,3929,Stuff Packs,4,0,0.0,4
15204,3930,Expansion Packs,4,0,0.0,4
15205,3930,Game Packs,4,0,0.0,4
15206,3930,Stuff Packs,1,0,0.0,1
15207,3931,Expansion Packs,16,0,0.0,16
15208,3931,Game Packs,12,0,0.0,12
15209,3931,Kits,27,1,0.037037037037037035,26
15210,3931,Stuff Packs,20,0,0.0,20
15211,3932,Expansion Packs,16,3,0.1875,13
15212,3932,Game Packs,12,1,0.08333333333333333,11
15213,3932,Kits,22,3,0.13636363636363635,19
15214,3932,Stuff Packs,20,0,0.0,20
15215,3933,Expansion Packs,7,0,0.0,7
15216,3933,Game Packs,4,0,0.0,4
15217,3933,Stuff Packs,1,0,0.0,1
15218,3934,Expansion Packs,16,0,0.0,16
15219,3934,Game Packs,10,0,0.0,10
15220,3934,Kits,18,1,0.05555555555555555,17
15221,3934,Stuff Packs,20,0,0.0,20
15222,3935,Expansion Packs,4,0,0.0,4
15223,3935,Stuff Packs,1,1,1.0,0
15224,3936,Expansion Packs,16,0,0.0,16
15225,3936,Game Packs,11,0,0.0,11
15226,3936,Kits,33,1,0.030303030303030304,32
15227,3936,Stuff Packs,20,0,0.0,20
15228,3937,Kits,1,1,1.0,0
15229,3937,Stuff Packs,3,3,1.0,0
15230,3938,Expansion Packs,11,2,0.18181818181818182,9
15231,3938,Game Packs,9,2,0.2222222222222222,7
15232,3938,Kits,4,0,0.0,4
15233,3938,Stuff Packs,12,0,0.0,12
15234,3939,Expansion Packs,15,0,0.0,15
15235,3939,Game Packs,8,0,0.0,8
15236,3939,Kits,16,1,0.0625,15
15237,3939,Stuff Packs,14,1,0.07142857142857142,13
15238,3940,Expansion Packs,15,0,0.0,15
15239,3940,Game Packs,11,0,0.0,11
15240,3940,Kits,3,0,0.0,3
15241,3940,Stuff Packs,20,0,0.0,20
15242,3941,Expansion Packs,11,0,0.0,11
15243,3941,Game Packs,8,0,0.0,8
15244,3941,Kits,3,0,0.0,3
15245,3941,Stuff Packs,12,0,0.0,12
15246,3942,Expansion Packs,16,0,0.0,16
15247,3942,Game Packs,11,0,0.0,11
15248,3942,Kits,15,1,0.06666666666666667,14
15249,3942,Stuff Packs,10,2,0.2,8
15250,3943,Expansion Packs,11,0,0.0,11
15251,3943,Game Packs,6,0,0.0,6
15252,3943,Kits,13,0,0.0,13
15253,3943,Stuff Packs,12,0,0.0,12
15254,3944,Expansion Packs,16,0,0.0,16
15255,3944,Game Packs,11,0,0.0,11
15256,3944,Kits,17,1,0.058823529411764705,16
15257,3944,Stuff Packs,19,1,0.05263157894736842,18
15258,3945,Expansion Packs,16,0,0.0,16
15259,3945,Game Packs,12,0,0.0,12
15260,3945,Kits,33,0,0.0,33
15261,3945,Stuff Packs,20,0,0.0,20
15262,3946,Expansion Packs,15,0,0.0,15
15263,3946,Game Packs,12,0,0.0,12
15264,3946,Kits,28,1,0.03571428571428571,27
15265,3946,Stuff Packs,20,0,0.0,20
15266,3947,Expansion Packs,3,0,0.0,3
15267,3947,Game Packs,3,0,0.0,3
15268,3947,Kits,3,0,0.0,3
15269,3947,Stuff Packs,4,1,0.25,3
15270,3948,Expansion Packs,16,0,0.0,16
15271,3948,Game Packs,12,0,0.0,12
15272,3948,Kits,21,1,0.047619047619047616,20
15273,3948,Stuff Packs,17,0,0.0,17
15274,3949,Expansion Packs,8,0,0.0,8
15275,3949,Game Packs,5,0,0.0,5
15276,3949,Stuff Packs,5,0,0.0,5
15277,3950,Expansion Packs,9,0,0.0,9
15278,3950,Game Packs,3,1,0.3333333333333333,2
15279,3950,Kits,2,2,1.0,0
15280,3950,Stuff Packs,7,4,0.5714285714285714,3
15281,3951,Expansion Packs,16,0,0.0,16
15282,3951,Game Packs,12,0,0.0,12
15283,3951,Kits,33,0,0.0,33
15284,3951,Stuff Packs,20,0,0.0,20
15285,3952,Expansion Packs,15,0,0.0,15
15286,3952,Game Packs,11,0,0.0,11
15287,3952,Kits,2,2,1.0,0
15288,3952,Stuff Packs,19,0,0.0,19
15289,3953,Expansion Packs,16,0,0.0,16
15290,3953,Game Packs,10,0,0.0,10
15291,3953,Kits,22,1,0.045454545454545456,21
15292,3953,Stuff Packs,18,2,0.1111111111111111,16
15293,3954,Expansion Packs,16,0,0.0,16
15294,3954,Game Packs,11,0,0.0,11
15295,3954,Kits,28,0,0.0,28
15296,3954,Stuff Packs,20,0,0.0,20
15297,3955,Expansion Packs,6,0,0.0,6
15298,3955,Game Packs,2,0,0.0,2
15299,3955,Kits,1,1,1.0,0
15300,3955,Stuff Packs,4,4,1.0,0
15301,3956,Expansion Packs,5,0,0.0,5
15302,3956,Game Packs,4,0,0.0,4
15303,3956,Kits,2,1,0.5,1
15304,3956,Stuff Packs,2,0,0.0,2
15305,3957,Expansion Packs,15,0,0.0,15
15306,3957,Game Packs,8,0,0.0,8
15307,3957,Stuff Packs,14,4,0.2857142857142857,10
15308,3958,Expansion Packs,15,0,0.0,15
15309,3958,Game Packs,11,0,0.0,11
15310,3958,Kits,13,1,0.07692307692307693,12
15311,3958,Stuff Packs,19,1,0.05263157894736842,18
15312,3959,Expansion Packs,14,0,0.0,14
15313,3959,Game Packs,10,1,0.1,9
15314,3959,Kits,3,1,0.3333333333333333,2
15315,3959,Stuff Packs,11,3,0.2727272727272727,8
15316,3960,Expansion Packs,9,0,0.0,9
15317,3960,Game Packs,3,0,0.0,3
15318,3960,Kits,2,0,0.0,2
15319,3960,Stuff Packs,4,1,0.25,3
15320,3961,Expansion Packs,11,0,0.0,11
15321,3961,Game Packs,1,0,0.0,1
15322,3961,Kits,1,1,1.0,0
15323,3961,Stuff Packs,9,4,0.4444444444444444,5
15324,3962,Expansion Packs,12,0,0.0,12
15325,3962,Game Packs,7,0,0.0,7
15326,3962,Kits,2,2,1.0,0
15327,3962,Stuff Packs,9,0,0.0,9
15328,3963,Expansion Packs,12,0,0.0,12
15329,3963,Game Packs,8,0,0.0,8
15330,3963,Kits,1,1,1.0,0
15331,3963,Stuff Packs,14,2,0.14285714285714285,12
15332,3964,Expansion Packs,15,0,0.0,15
15333,3964,Game Packs,6,0,0.0,6
15334,3964,Stuff Packs,5,0,0.0,5
15335,3965,Expansion Packs,16,0,0.0,16
15336,3965,Game Packs,11,1,0.09090909090909091,10
15337,3965,Kits,7,0,0.0,7
15338,3965,Stuff Packs,19,2,0.10526315789473684,17
15339,3966,Expansion Packs,3,0,0.0,3
15340,3966,Game Packs,1,0,0.0,1
15341,3966,Kits,2,2,1.0,0
15342,3966,Stuff Packs,4,3,0.75,1
15343,3967,Expansion Packs,16,0,0.0,16
15344,3967,Game Packs,12,0,0.0,12
15345,3967,Kits,19,0,0.0,19
15346,3967,Stuff Packs,20,0,0.0,20
15347,3968,Expansion Packs,3,0,0.0,3
15348,3968,Game Packs,2,1,0.5,1
15349,3968,Kits,2,2,1.0,0
15350,3968,Stuff Packs,3,2,0.6666666666666666,1
15351,3969,Expansion Packs,11,0,0.0,11
15352,3969,Game Packs,7,0,0.0,7
15353,3969,Kits,2,2,1.0,0
15354,3969,Stuff Packs,5,2,0.4,3
15355,3970,Expansion Packs,16,0,0.0,16
15356,3970,Game Packs,11,0,0.0,11
15357,3970,Kits,33,0,0.0,33
15358,3970,Stuff Packs,20,0,0.0,20
15359,3971,Expansion Packs,16,0,0.0,16
15360,3971,Game Packs,12,0,0.0,12
15361,3971,Kits,32,0,0.0,32
15362,3971,Stuff Packs,20,0,0.0,20
15363,3972,Expansion Packs,3,0,0.0,3
15364,3973,Expansion Packs,16,0,0.0,16
15365,3973,Game Packs,12,0,0.0,12
15366,3973,Kits,25,0,0.0,25
15367,3973,Stuff Packs,20,0,0.0,20
15368,3974,Expansion Packs,7,0,0.0,7
15369,3974,Game Packs,2,0,0.0,2
15370,3974,Kits,1,1,1.0,0
15371,3974,Stuff Packs,1,0,0.0,1
15372,3975,Expansion Packs,5,0,0.0,5
15373,3975,Game Packs,1,0,0.0,1
15374,3975,Kits,1,1,1.0,0
15375,3975,Stuff Packs,1,0,0.0,1
15376,3976,Expansion Packs,6,0,0.0,6
15377,3977,Expansion Packs,4,0,0.0,4
15378,3977,Game Packs,3,0,0.0,3
15379,3977,Kits,2,2,1.0,0
15380,3977,Stuff Packs,6,4,0.6666666666666666,2
15381,3978,Expansion Packs,16,0,0.0,16
15382,3978,Game Packs,12,0,0.0,12
15383,3978,Kits,17,1,0.058823529411764705,16
15384,3978,Stuff Packs,20,0,0.0,20
15385,3979,Expansion Packs,16,0,0.0,16
15386,3979,Game Packs,12,0,0.0,12
15387,3979,Kits,33,1,0.030303030303030304,32
15388,3979,Stuff Packs,20,0,0.0,20
15389,3980,Expansion Packs,2,0,0.0,2
15390,3980,Kits,1,1,1.0,0
15391,3980,Stuff Packs,3,3,1.0,0
15392,3981,Expansion Packs,15,0,0.0,15
15393,3981,Game Packs,9,0,0.0,9
15394,3981,Kits,3,0,0.0,3
15395,3981,Stuff Packs,4,1,0.25,3
15396,3982,Expansion Packs,14,0,0.0,14
15397,3982,Game Packs,10,1,0.1,9
15398,3982,Kits,11,2,0.18181818181818182,9
15399,3982,Stuff Packs,18,1,0.05555555555555555,17
15400,3983,Expansion Packs,12,0,0.0,12
15401,3983,Game Packs,7,0,0.0,7
15402,3983,Kits,1,1,1.0,0
15403,3983,Stuff Packs,16,2,0.125,14
15404,3984,Expansion Packs,14,1,0.07142857142857142,13
15405,3984,Game Packs,10,0,0.0,10
15406,3984,Kits,3,0,0.0,3
15407,3984,Stuff Packs,17,0,0.0,17
15408,3985,Expansion Packs,5,0,0.0,5
15409,3985,Game Packs,6,1,0.16666666666666666,5
15410,3985,Kits,3,3,1.0,0
15411,3985,Stuff Packs,8,4,0.5,4
15412,3986,Expansion Packs,16,0,0.0,16
15413,3986,Game Packs,12,0,0.0,12
15414,3986,Kits,33,0,0.0,33
15415,3986,Stuff Packs,20,0,0.0,20
15416,3987,Expansion Packs,16,0,0.0,16
15417,3987,Game Packs,12,0,0.0,12
15418,3987,Kits,33,0,0.0,33
15419,3987,Stuff Packs,20,0,0.0,20
15420,3988,Expansion Packs,13,0,0.0,13
15421,3988,Game Packs,9,2,0.2222222222222222,7
15422,3988,Kits,5,0,0.0,5
15423,3988,Stuff Packs,11,0,0.0,11
15424,3989,Expansion Packs,9,0,0.0,9
15425,3989,Game Packs,4,0,0.0,4
15426,3989,Kits,1,1,1.0,0
15427,3989,Stuff Packs,8,2,0.25,6
15428,3990,Expansion Packs,16,0,0.0,16
15429,3990,Game Packs,12,0,0.0,12
15430,3990,Kits,4,2,0.5,2
15431,3990,Stuff Packs,20,0,0.0,20
15432,3991,Expansion Packs,16,0,0.0,16
15433,3991,Game Packs,11,0,0.0,11
15434,3991,Kits,33,3,0.09090909090909091,30
15435,3991,Stuff Packs,17,0,0.0,17
15436,3992,Expansion Packs,6,0,0.0,6
15437,3992,Game Packs,5,1,0.2,4
15438,3992,Kits,4,2,0.5,2
15439,3992,Stuff Packs,10,4,0.4,6
15440,3993,Expansion Packs,16,0,0.0,16
15441,3993,Game Packs,11,0,0.0,11
15442,3993,Kits,20,0,0.0,20
15443,3993,Stuff Packs,16,2,0.125,14
15444,3994,Expansion Packs,16,0,0.0,16
15445,3994,Game Packs,12,0,0.0,12
15446,3994,Kits,33,0,0.0,33
15447,3994,Stuff Packs,20,0,0.0,20
15448,3995,Expansion Packs,6,0,0.0,6
15449,3995,Kits,1,1,1.0,0
15450,3995,Stuff Packs,2,2,1.0,0
15451,3996,Expansion Packs,4,0,0.0,4
15452,3996,Game Packs,2,1,0.5,1
15453,3996,Kits,2,1,0.5,1
15454,3996,Stuff Packs,4,3,0.75,1
15455,3997,Expansion Packs,16,0,0.0,16
15456,3997,Game Packs,7,0,0.0,7
15457,3997,Kits,3,2,0.6666666666666666,1
15458,3997,Stuff Packs,8,3,0.375,5
15459,3998,Expansion Packs,15,0,0.0,15
15460,3998,Game Packs,10,0,0.0,10
15461,3998,Kits,2,2,1.0,0
15462,3998,Stuff Packs,13,1,0.07692307692307693,12
15463,3999,Expansion Packs,15,2,0.13333333333333333,13
15464,3999,Game Packs,11,0,0.0,11
15465,3999,Kits,24,1,0.041666666666666664,23
15466,3999,Stuff Packs,20,0,0.0,20
15467,4000,Expansion Packs,3,0,0.0,3
15468,4000,Game Packs,2,0,0.0,2
15469,4000,Stuff Packs,4,0,0.0,4
15470,4001,Expansion Packs,13,0,0.0,13
15471,4001,Game Packs,8,0,0.0,8
15472,4001,Kits,3,0,0.0,3
15473,4001,Stuff Packs,4,0,0.0,4
15474,4002,Expansion Packs,8,0,0.0,8
15475,4002,Game Packs,4,0,0.0,4
15476,4002,Kits,4,2,0.5,2
15477,4002,Stuff Packs,6,4,0.6666666666666666,2
15478,4003,Expansion Packs,13,0,0.0,13
15479,4003,Game Packs,10,0,0.0,10
15480,4003,Kits,9,2,0.2222222222222222,7
15481,4003,Stuff Packs,18,0,0.0,18
15482,4004,Expansion Packs,15,0,0.0,15
15483,4004,Game Packs,10,0,0.0,10
15484,4004,Kits,4,1,0.25,3
15485,4004,Stuff Packs,16,0,0.0,16
15486,4005,Expansion Packs,16,0,0.0,16
15487,4005,Game Packs,12,0,0.0,12
15488,4005,Kits,31,0,0.0,31
15489,4005,Stuff Packs,20,0,0.0,20
15490,4006,Expansion Packs,16,0,0.0,16
15491,4006,Game Packs,11,0,0.0,11
15492,4006,Kits,33,0,0.0,33
15493,4006,Stuff Packs,20,0,0.0,20
15494,4007,Expansion Packs,13,0,0.0,13
15495,4007,Game Packs,10,0,0.0,10
15496,4007,Kits,11,2,0.18181818181818182,9
15497,4007,Stuff Packs,20,0,0.0,20
15498,4008,Expansion Packs,15,0,0.0,15
15499,4008,Game Packs,6,1,0.16666666666666666,5
15500,4008,Kits,8,2,0.25,6
15501,4008,Stuff Packs,11,5,0.45454545454545453,6
15502,4009,Expansion Packs,6,1,0.16666666666666666,5
15503,4009,Game Packs,4,0,0.0,4
15504,4009,Kits,2,1,0.5,1
15505,4009,Stuff Packs,5,2,0.4,3
15506,4010,Expansion Packs,14,0,0.0,14
15507,4010,Game Packs,11,0,0.0,11
15508,4010,Kits,21,1,0.047619047619047616,20
15509,4010,Stuff Packs,19,1,0.05263157894736842,18
15510,4011,Expansion Packs,14,0,0.0,14
15511,4011,Game Packs,11,0,0.0,11
15512,4011,Kits,2,0,0.0,2
15513,4011,Stuff Packs,17,1,0.058823529411764705,16
15514,4012,Expansion Packs,6,0,0.0,6
15515,4012,Game Packs,2,0,0.0,2
15516,4012,Stuff Packs,2,0,0.0,2
15517,4013,Expansion Packs,12,0,0.0,12
15518,4013,Game Packs,2,0,0.0,2
15519,4013,Kits,1,1,1.0,0
15520,4013,Stuff Packs,2,0,0.0,2
15521,4014,Expansion Packs,15,0,0.0,15
15522,4014,Game Packs,12,1,0.08333333333333333,11
15523,4014,Kits,11,1,0.09090909090909091,10
15524,4014,Stuff Packs,17,4,0.23529411764705882,13
15525,4015,Expansion Packs,15,0,0.0,15
15526,4015,Game Packs,11,0,0.0,11
15527,4015,Kits,22,3,0.13636363636363635,19
15528,4015,Stuff Packs,20,2,0.1,18
15529,4016,Expansion Packs,8,0,0.0,8
15530,4016,Game Packs,4,1,0.25,3
15531,4016,Kits,7,0,0.0,7
15532,4016,Stuff Packs,8,3,0.375,5
15533,4017,Expansion Packs,15,0,0.0,15
15534,4017,Game Packs,8,1,0.125,7
15535,4017,Kits,14,3,0.21428571428571427,11
15536,4017,Stuff Packs,12,3,0.25,9
15537,4018,Expansion Packs,16,0,0.0,16
15538,4018,Game Packs,12,0,0.0,12
15539,4018,Kits,33,0,0.0,33
15540,4018,Stuff Packs,20,0,0.0,20
15541,4019,Expansion Packs,16,0,0.0,16
15542,4019,Game Packs,12,0,0.0,12
15543,4019,Kits,33,0,0.0,33
15544,4019,Stuff Packs,20,0,0.0,20
15545,4020,Expansion Packs,3,0,0.0,3
15546,4020,Game Packs,4,0,0.0,4
15547,4020,Kits,2,1,0.5,1
15548,4020,Stuff Packs,2,0,0.0,2
15549,4021,Expansion Packs,8,0,0.0,8
15550,4021,Game Packs,3,0,0.0,3
15551,4021,Stuff Packs,3,2,0.6666666666666666,1
15552,4022,Expansion Packs,11,0,0.0,11
15553,4022,Game Packs,2,0,0.0,2
15554,4022,Kits,8,0,0.0,8
15555,4022,Stuff Packs,11,3,0.2727272727272727,8
15556,4023,Expansion Packs,4,0,0.0,4
15557,4023,Game Packs,3,0,0.0,3
15558,4023,Kits,3,2,0.6666666666666666,1
15559,4023,Stuff Packs,4,2,0.5,2
15560,4024,Expansion Packs,8,0,0.0,8
15561,4024,Game Packs,7,0,0.0,7
15562,4024,Kits,2,0,0.0,2
15563,4024,Stuff Packs,5,3,0.6,2
15564,4025,Expansion Packs,9,2,0.2222222222222222,7
15565,4025,Game Packs,8,3,0.375,5
15566,4025,Stuff Packs,11,10,0.9090909090909091,1
15567,4026,Expansion Packs,11,0,0.0,11
15568,4026,Game Packs,7,0,0.0,7
15569,4026,Kits,4,0,0.0,4
15570,4026,Stuff Packs,5,1,0.2,4
15571,4027,Expansion Packs,7,0,0.0,7
15572,4027,Game Packs,1,0,0.0,1
15573,4027,Kits,6,1,0.16666666666666666,5
15574,4027,Stuff Packs,4,0,0.0,4
15575,4028,Expansion Packs,16,0,0.0,16
15576,4028,Game Packs,12,0,0.0,12
15577,4028,Kits,33,1,0.030303030303030304,32
15578,4028,Stuff Packs,20,0,0.0,20
15579,4029,Expansion Packs,14,0,0.0,14
15580,4029,Game Packs,7,0,0.0,7
15581,4029,Kits,4,0,0.0,4
15582,4029,Stuff Packs,7,0,0.0,7
15583,4030,Expansion Packs,10,0,0.0,10
15584,4030,Game Packs,3,0,0.0,3
15585,4030,Kits,2,2,1.0,0
15586,4030,Stuff Packs,6,3,0.5,3
15587,4031,Expansion Packs,8,0,0.0,8
15588,4031,Game Packs,7,0,0.0,7
15589,4031,Kits,1,1,1.0,0
15590,4031,Stuff Packs,7,2,0.2857142857142857,5
15591,4032,Expansion Packs,15,1,0.06666666666666667,14
15592,4032,Game Packs,10,0,0.0,10
15593,4032,Kits,7,2,0.2857142857142857,5
15594,4032,Stuff Packs,12,2,0.16666666666666666,10
15595,4033,Expansion Packs,15,0,0.0,15
15596,4033,Game Packs,9,0,0.0,9
15597,4033,Kits,3,1,0.3333333333333333,2
15598,4033,Stuff Packs,16,2,0.125,14
15599,4034,Expansion Packs,15,0,0.0,15
15600,4034,Game Packs,9,0,0.0,9
15601,4034,Kits,2,2,1.0,0
15602,4034,Stuff Packs,11,3,0.2727272727272727,8
15603,4035,Expansion Packs,7,0,0.0,7
15604,4035,Game Packs,4,0,0.0,4
15605,4035,Kits,3,1,0.3333333333333333,2
15606,4035,Stuff Packs,4,2,0.5,2
15607,4036,Expansion Packs,11,0,0.0,11
15608,4036,Game Packs,3,0,0.0,3
15609,4036,Stuff Packs,2,0,0.0,2
15610,4037,Expansion Packs,12,0,0.0,12
15611,4037,Game Packs,8,0,0.0,8
15612,4037,Kits,3,2,0.6666666666666666,1
15613,4037,Stuff Packs,10,0,0.0,10
15614,4038,Expansion Packs,16,0,0.0,16
15615,4038,Game Packs,12,0,0.0,12
15616,4038,Kits,33,0,0.0,33
15617,4038,Stuff Packs,20,0,0.0,20
15618,4039,Expansion Packs,15,0,0.0,15
15619,4039,Game Packs,10,0,0.0,10
15620,4039,Kits,3,0,0.0,3
15621,4039,Stuff Packs,13,0,0.0,13
15622,4040,Expansion Packs,11,0,0.0,11
15623,4040,Game Packs,3,0,0.0,3
15624,4040,Kits,2,1,0.5,1
15625,4040,Stuff Packs,8,2,0.25,6
15626,4041,Expansion Packs,11,0,0.0,11
15627,4041,Game Packs,6,0,0.0,6
15628,4041,Kits,1,0,0.0,1
15629,4041,Stuff Packs,3,1,0.3333333333333333,2
15630,4042,Expansion Packs,2,0,0.0,2
15631,4042,Game Packs,1,0,0.0,1
15632,4042,Stuff Packs,1,0,0.0,1
15633,4043,Expansion Packs,13,0,0.0,13
15634,4043,Game Packs,11,0,0.0,11
15635,4043,Kits,1,0,0.0,1
15636,4043,Stuff Packs,12,0,0.0,12
15637,4044,Expansion Packs,10,0,0.0,10
15638,4044,Game Packs,7,1,0.14285714285714285,6
15639,4044,Kits,2,0,0.0,2
15640,4044,Stuff Packs,15,2,0.13333333333333333,13
15641,4045,Expansion Packs,16,0,0.0,16
15642,4045,Game Packs,11,0,0.0,11
15643,4045,Kits,15,1,0.06666666666666667,14
15644,4045,Stuff Packs,14,0,0.0,14
15645,4046,Expansion Packs,5,0,0.0,5
15646,4046,Game Packs,2,0,0.0,2
15647,4046,Stuff Packs,5,3,0.6,2
15648,4047,Expansion Packs,8,0,0.0,8
15649,4047,Game Packs,2,0,0.0,2
15650,4047,Kits,3,0,0.0,3
15651,4047,Stuff Packs,3,2,0.6666666666666666,1
15652,4048,Expansion Packs,7,0,0.0,7
15653,4048,Game Packs,2,0,0.0,2
15654,4048,Stuff Packs,4,2,0.5,2
15655,4049,Expansion Packs,16,0,0.0,16
15656,4049,Game Packs,11,0,0.0,11
15657,4049,Kits,16,0,0.0,16
15658,4049,Stuff Packs,19,0,0.0,19
15659,4050,Expansion Packs,3,0,0.0,3
15660,4050,Game Packs,4,0,0.0,4
15661,4050,Stuff Packs,3,0,0.0,3
15662,4051,Expansion Packs,6,0,0.0,6
15663,4051,Game Packs,2,0,0.0,2
15664,4051,Kits,2,1,0.5,1
15665,4051,Stuff Packs,5,3,0.6,2
15666,4052,Expansion Packs,13,0,0.0,13
15667,4052,Game Packs,9,0,0.0,9
15668,4052,Kits,4,0,0.0,4
15669,4052,Stuff Packs,7,0,0.0,7
15670,4053,Expansion Packs,11,0,0.0,11
15671,4053,Game Packs,6,0,0.0,6
15672,4053,Kits,3,2,0.6666666666666666,1
15673,4053,Stuff Packs,7,3,0.42857142857142855,4
15674,4054,Expansion Packs,3,0,0.0,3
15675,4054,Game Packs,2,0,0.0,2
15676,4054,Kits,1,1,1.0,0
15677,4054,Stuff Packs,4,1,0.25,3
15678,4055,Expansion Packs,4,0,0.0,4
15679,4055,Game Packs,2,1,0.5,1
15680,4055,Kits,1,1,1.0,0
15681,4055,Stuff Packs,5,3,0.6,2
15682,4056,Expansion Packs,16,0,0.0,16
15683,4056,Game Packs,11,0,0.0,11
15684,4056,Kits,24,1,0.041666666666666664,23
15685,4056,Stuff Packs,20,0,0.0,20
15686,4057,Expansion Packs,2,0,0.0,2
15687,4057,Kits,1,0,0.0,1
15688,4057,Stuff Packs,2,2,1.0,0
15689,4058,Expansion Packs,15,0,0.0,15
15690,4058,Game Packs,11,0,0.0,11
15691,4058,Kits,18,1,0.05555555555555555,17
15692,4058,Stuff Packs,19,0,0.0,19
15693,4059,Expansion Packs,13,0,0.0,13
15694,4059,Game Packs,10,0,0.0,10
15695,4059,Kits,2,2,1.0,0
15696,4059,Stuff Packs,17,1,0.058823529411764705,16
15697,4060,Expansion Packs,3,0,0.0,3
15698,4060,Game Packs,1,0,0.0,1
15699,4060,Kits,3,2,0.6666666666666666,1
15700,4060,Stuff Packs,4,3,0.75,1
15701,4061,Expansion Packs,15,1,0.06666666666666667,14
15702,4061,Game Packs,10,0,0.0,10
15703,4061,Kits,9,0,0.0,9
15704,4061,Stuff Packs,11,0,0.0,11
15705,4062,Expansion Packs,16,0,0.0,16
15706,4062,Game Packs,12,0,0.0,12
15707,4062,Kits,33,1,0.030303030303030304,32
15708,4062,Stuff Packs,20,0,0.0,20
15709,4063,Expansion Packs,8,0,0.0,8
15710,4063,Game Packs,3,0,0.0,3
15711,4063,Stuff Packs,3,0,0.0,3
15712,4064,Expansion Packs,6,0,0.0,6
15713,4064,Game Packs,4,0,0.0,4
15714,4064,Kits,1,1,1.0,0
15715,4064,Stuff Packs,7,0,0.0,7
15716,4065,Expansion Packs,12,1,0.08333333333333333,11
15717,4065,Game Packs,4,0,0.0,4
15718,4065,Kits,1,1,1.0,0
15719,4065,Stuff Packs,4,2,0.5,2
15720,4066,Expansion Packs,4,0,0.0,4
15721,4066,Game Packs,3,0,0.0,3
15722,4066,Kits,1,1,1.0,0
15723,4066,Stuff Packs,4,3,0.75,1
15724,4067,Expansion Packs,15,0,0.0,15
15725,4067,Game Packs,11,0,0.0,11
15726,4067,Kits,16,0,0.0,16
15727,4067,Stuff Packs,19,0,0.0,19
15728,4068,Expansion Packs,15,0,0.0,15
15729,4068,Game Packs,11,0,0.0,11
15730,4068,Kits,13,0,0.0,13
15731,4068,Stuff Packs,20,0,0.0,20
15732,4069,Expansion Packs,16,0,0.0,16
15733,4069,Game Packs,12,0,0.0,12
15734,4069,Kits,27,0,0.0,27
15735,4069,Stuff Packs,20,0,0.0,20
15736,4070,Expansion Packs,16,0,0.0,16
15737,4070,Game Packs,12,0,0.0,12
15738,4070,Kits,32,0,0.0,32
15739,4070,Stuff Packs,20,0,0.0,20
15740,4071,Expansion Packs,16,0,0.0,16
15741,4071,Game Packs,11,1,0.09090909090909091,10
15742,4071,Kits,33,2,0.06060606060606061,31
15743,4071,Stuff Packs,20,4,0.2,16
15744,4072,Expansion Packs,15,0,0.0,15
15745,4072,Game Packs,8,0,0.0,8
15746,4072,Kits,3,0,0.0,3
15747,4072,Stuff Packs,4,0,0.0,4
15748,4073,Expansion Packs,16,0,0.0,16
15749,4073,Game Packs,12,0,0.0,12
15750,4073,Kits,29,0,0.0,29
15751,4073,Stuff Packs,20,0,0.0,20
15752,4074,Expansion Packs,15,0,0.0,15
15753,4074,Game Packs,12,0,0.0,12
15754,4074,Kits,5,1,0.2,4
15755,4074,Stuff Packs,10,2,0.2,8
15756,4075,Expansion Packs,16,0,0.0,16
15757,4075,Game Packs,12,0,0.0,12
15758,4075,Kits,33,0,0.0,33
15759,4075,Stuff Packs,20,0,0.0,20
15760,4076,Expansion Packs,16,0,0.0,16
15761,4076,Game Packs,12,0,0.0,12
15762,4076,Kits,23,1,0.043478260869565216,22
15763,4076,Stuff Packs,20,0,0.0,20
15764,4077,Expansion Packs,16,0,0.0,16
15765,4077,Game Packs,12,0,0.0,12
15766,4077,Kits,25,2,0.08,23
15767,4077,Stuff Packs,20,0,0.0,20
15768,4078,Expansion Packs,6,0,0.0,6
15769,4078,Game Packs,3,0,0.0,3
15770,4078,Stuff Packs,6,3,0.5,3
15771,4079,Expansion Packs,9,0,0.0,9
15772,4079,Game Packs,3,0,0.0,3
15773,4079,Kits,1,1,1.0,0
15774,4079,Stuff Packs,3,1,0.3333333333333333,2
15775,4080,Expansion Packs,16,0,0.0,16
15776,4080,Game Packs,11,0,0.0,11
15777,4080,Kits,7,0,0.0,7
15778,4080,Stuff Packs,12,2,0.16666666666666666,10
15779,4081,Expansion Packs,16,0,0.0,16
15780,4081,Game Packs,10,0,0.0,10
15781,4081,Kits,25,1,0.04,24
15782,4081,Stuff Packs,20,0,0.0,20
15783,4082,Expansion Packs,13,0,0.0,13
15784,4082,Game Packs,12,0,0.0,12
15785,4082,Kits,12,0,0.0,12
15786,4082,Stuff Packs,18,0,0.0,18
15787,4083,Expansion Packs,16,0,0.0,16
15788,4083,Game Packs,9,0,0.0,9
15789,4083,Kits,4,1,0.25,3
15790,4083,Stuff Packs,10,0,0.0,10
15791,4084,Expansion Packs,16,0,0.0,16
15792,4084,Game Packs,12,0,0.0,12
15793,4084,Kits,23,0,0.0,23
15794,4084,Stuff Packs,20,0,0.0,20
15795,4085,Expansion Packs,13,0,0.0,13
15796,4085,Game Packs,10,0,0.0,10
15797,4085,Kits,8,0,0.0,8
15798,4085,Stuff Packs,17,0,0.0,17
15799,4086,Expansion Packs,2,0,0.0,2
15800,4086,Game Packs,3,0,0.0,3
15801,4086,Kits,1,0,0.0,1
15802,4086,Stuff Packs,3,2,0.6666666666666666,1
15803,4087,Expansion Packs,16,1,0.0625,15
15804,4087,Game Packs,12,0,0.0,12
15805,4087,Kits,30,3,0.1,27
15806,4087,Stuff Packs,20,1,0.05,19
15807,4088,Expansion Packs,16,0,0.0,16
15808,4088,Game Packs,11,0,0.0,11
15809,4088,Kits,20,0,0.0,20
15810,4088,Stuff Packs,17,0,0.0,17
15811,4089,Expansion Packs,16,0,0.0,16
15812,4089,Game Packs,12,0,0.0,12
15813,4089,Kits,33,1,0.030303030303030304,32
15814,4089,Stuff Packs,20,0,0.0,20
15815,4090,Expansion Packs,12,0,0.0,12
15816,4090,Game Packs,4,0,0.0,4
15817,4090,Kits,3,1,0.3333333333333333,2
15818,4090,Stuff Packs,5,2,0.4,3
15819,4091,Expansion Packs,6,0,0.0,6
15820,4091,Game Packs,1,0,0.0,1
15821,4091,Stuff Packs,2,0,0.0,2
15822,4092,Expansion Packs,14,0,0.0,14
15823,4092,Game Packs,11,1,0.09090909090909091,10
15824,4092,Kits,19,0,0.0,19
15825,4092,Stuff Packs,20,0,0.0,20
15826,4093,Expansion Packs,9,0,0.0,9
15827,4093,Game Packs,5,0,0.0,5
15828,4093,Kits,2,2,1.0,0
15829,4093,Stuff Packs,8,3,0.375,5
15830,4094,Expansion Packs,13,0,0.0,13
15831,4094,Game Packs,10,0,0.0,10
15832,4094,Stuff Packs,10,2,0.2,8
15833,4095,Expansion Packs,3,1,0.3333333333333333,2
15834,4095,Stuff Packs,4,3,0.75,1
15835,4096,Expansion Packs,15,0,0.0,15
15836,4096,Game Packs,11,0,0.0,11
15837,4096,Kits,18,0,0.0,18
15838,4096,Stuff Packs,18,0,0.0,18
15839,4097,Expansion Packs,16,0,0.0,16
15840,4097,Game Packs,11,0,0.0,11
15841,4097,Kits,15,1,0.06666666666666667,14
15842,4097,Stuff Packs,20,0,0.0,20
15843,4098,Expansion Packs,15,0,0.0,15
15844,4098,Game Packs,12,0,0.0,12
15845,4098,Kits,8,1,0.125,7
15846,4098,Stuff Packs,20,0,0.0,20
15847,4099,Expansion Packs,16,0,0.0,16
15848,4099,Game Packs,12,0,0.0,12
15849,4099,Kits,33,0,0.0,33
15850,4099,Stuff Packs,20,1,0.05,19
15851,4100,Expansion Packs,8,0,0.0,8
15852,4100,Game Packs,3,1,0.3333333333333333,2
15853,4100,Kits,2,2,1.0,0
15854,4100,Stuff Packs,2,1,0.5,1
15855,4101,Expansion Packs,16,0,0.0,16
15856,4101,Game Packs,10,1,0.1,9
15857,4101,Kits,13,0,0.0,13
15858,4101,Stuff Packs,12,4,0.3333333333333333,8
15859,4102,Expansion Packs,14,0,0.0,14
15860,4102,Game Packs,10,0,0.0,10
15861,4102,Kits,2,2,1.0,0
15862,4102,Stuff Packs,6,2,0.3333333333333333,4
15863,4103,Expansion Packs,15,0,0.0,15
15864,4103,Game Packs,12,0,0.0,12
15865,4103,Kits,14,1,0.07142857142857142,13
15866,4103,Stuff Packs,20,0,0.0,20
15867,4104,Expansion Packs,16,0,0.0,16
15868,4104,Game Packs,12,0,0.0,12
15869,4104,Kits,22,0,0.0,22
15870,4104,Stuff Packs,20,0,0.0,20
15871,4105,Expansion Packs,15,0,0.0,15
15872,4105,Game Packs,6,0,0.0,6
15873,4105,Kits,13,1,0.07692307692307693,12
15874,4105,Stuff Packs,14,3,0.21428571428571427,11
15875,4106,Expansion Packs,15,0,0.0,15
15876,4106,Game Packs,7,0,0.0,7
15877,4106,Kits,2,1,0.5,1
15878,4106,Stuff Packs,11,4,0.36363636363636365,7
15879,4107,Expansion Packs,15,0,0.0,15
15880,4107,Game Packs,11,0,0.0,11
15881,4107,Kits,6,1,0.16666666666666666,5
15882,4107,Stuff Packs,19,0,0.0,19
15883,4108,Expansion Packs,16,1,0.0625,15
15884,4108,Game Packs,12,1,0.08333333333333333,11
15885,4108,Kits,17,3,0.17647058823529413,14
15886,4108,Stuff Packs,18,3,0.16666666666666666,15
15887,4109,Expansion Packs,11,0,0.0,11
15888,4109,Game Packs,2,1,0.5,1
15889,4109,Kits,3,3,1.0,0
15890,4109,Stuff Packs,6,3,0.5,3
15891,4110,Expansion Packs,12,0,0.0,12
15892,4110,Game Packs,8,0,0.0,8
15893,4110,Kits,14,2,0.14285714285714285,12
15894,4110,Stuff Packs,15,1,0.06666666666666667,14
15895,4111,Expansion Packs,16,0,0.0,16
15896,4111,Game Packs,12,0,0.0,12
15897,4111,Kits,24,1,0.041666666666666664,23
15898,4111,Stuff Packs,18,0,0.0,18
15899,4112,Expansion Packs,16,0,0.0,16
15900,4112,Game Packs,8,0,0.0,8
15901,4112,Kits,3,1,0.3333333333333333,2
15902,4112,Stuff Packs,10,3,0.3,7
15903,4113,Expansion Packs,4,0,0.0,4
15904,4113,Game Packs,1,0,0.0,1
15905,4113,Stuff Packs,1,0,0.0,1
15906,4114,Expansion Packs,10,0,0.0,10
15907,4114,Game Packs,3,0,0.0,3
15908,4114,Stuff Packs,5,0,0.0,5
15909,4115,Expansion Packs,12,0,0.0,12
15910,4115,Game Packs,10,0,0.0,10
15911,4115,Kits,10,1,0.1,9
15912,4115,Stuff Packs,15,0,0.0,15
15913,4116,Expansion Packs,9,0,0.0,9
15914,4116,Game Packs,2,1,0.5,1
15915,4116,Kits,3,3,1.0,0
15916,4116,Stuff Packs,7,4,0.5714285714285714,3
15917,4117,Expansion Packs,15,0,0.0,15
15918,4117,Game Packs,10,0,0.0,10
15919,4117,Kits,1,1,1.0,0
15920,4117,Stuff Packs,8,1,0.125,7
15921,4118,Expansion Packs,14,0,0.0,14
15922,4118,Game Packs,10,0,0.0,10
15923,4118,Kits,13,1,0.07692307692307693,12
15924,4118,Stuff Packs,15,1,0.06666666666666667,14
15925,4119,Expansion Packs,14,0,0.0,14
15926,4119,Game Packs,11,0,0.0,11
15927,4119,Kits,9,1,0.1111111111111111,8
15928,4119,Stuff Packs,19,0,0.0,19
15929,4120,Expansion Packs,16,0,0.0,16
15930,4120,Game Packs,10,0,0.0,10
15931,4120,Kits,3,2,0.6666666666666666,1
15932,4120,Stuff Packs,14,1,0.07142857142857142,13
15933,4121,Expansion Packs,13,0,0.0,13
15934,4121,Game Packs,7,1,0.14285714285714285,6
15935,4121,Kits,4,2,0.5,2
15936,4121,Stuff Packs,15,1,0.06666666666666667,14
15937,4122,Expansion Packs,8,1,0.125,7
15938,4122,Game Packs,4,0,0.0,4
15939,4122,Kits,2,0,0.0,2
15940,4122,Stuff Packs,7,2,0.2857142857142857,5
15941,4123,Expansion Packs,16,0,0.0,16
15942,4123,Game Packs,11,0,0.0,11
15943,4123,Kits,9,0,0.0,9
15944,4123,Stuff Packs,20,0,0.0,20
15945,4124,Expansion Packs,16,0,0.0,16
15946,4124,Game Packs,11,0,0.0,11
15947,4124,Kits,28,2,0.07142857142857142,26
15948,4124,Stuff Packs,20,0,0.0,20
15949,4125,Expansion Packs,16,0,0.0,16
15950,4125,Game Packs,11,0,0.0,11
15951,4125,Kits,17,1,0.058823529411764705,16
15952,4125,Stuff Packs,18,0,0.0,18
15953,4126,Expansion Packs,9,0,0.0,9
15954,4126,Game Packs,3,0,0.0,3
15955,4126,Kits,3,0,0.0,3
15956,4126,Stuff Packs,4,0,0.0,4
15957,4127,Expansion Packs,7,0,0.0,7
15958,4127,Game Packs,7,0,0.0,7
15959,4127,Kits,1,0,0.0,1
15960,4127,Stuff Packs,9,1,0.1111111111111111,8
15961,4128,Expansion Packs,16,0,0.0,16
15962,4128,Game Packs,12,0,0.0,12
15963,4128,Kits,32,0,0.0,32
15964,4128,Stuff Packs,20,0,0.0,20
15965,4129,Expansion Packs,11,0,0.0,11
15966,4129,Game Packs,9,0,0.0,9
15967,4129,Stuff Packs,9,0,0.0,9
15968,4130,Expansion Packs,12,0,0.0,12
15969,4130,Game Packs,7,0,0.0,7
15970,4130,Kits,9,4,0.4444444444444444,5
15971,4130,Stuff Packs,13,1,0.07692307692307693,12
15972,4131,Expansion Packs,15,0,0.0,15
15973,4131,Game Packs,11,0,0.0,11
15974,4131,Kits,3,2,0.6666666666666666,1
15975,4131,Stuff Packs,15,1,0.06666666666666667,14
15976,4132,Expansion Packs,7,0,0.0,7
15977,4132,Game Packs,2,0,0.0,2
15978,4132,Kits,2,1,0.5,1
15979,4132,Stuff Packs,6,1,0.16666666666666666,5
15980,4133,Expansion Packs,14,0,0.0,14
15981,4133,Game Packs,9,0,0.0,9
15982,4133,Kits,2,0,0.0,2
15983,4133,Stuff Packs,6,2,0.3333333333333333,4
15984,4134,Expansion Packs,3,0,0.0,3
15985,4134,Game Packs,1,1,1.0,0
15986,4135,Expansion Packs,15,1,0.06666666666666667,14
15987,4135,Game Packs,10,0,0.0,10
15988,4135,Kits,20,1,0.05,19
15989,4135,Stuff Packs,20,4,0.2,16
15990,4136,Expansion Packs,9,0,0.0,9
15991,4136,Game Packs,5,0,0.0,5
15992,4136,Kits,12,1,0.08333333333333333,11
15993,4136,Stuff Packs,10,1,0.1,9
15994,4137,Expansion Packs,15,0,0.0,15
15995,4137,Game Packs,9,0,0.0,9
15996,4137,Kits,6,0,0.0,6
15997,4137,Stuff Packs,13,2,0.15384615384615385,11
15998,4138,Expansion Packs,10,2,0.2,8
15999,4138,Game Packs,3,1,0.3333333333333333,2
16000,4138,Kits,2,0,0.0,2
16001,4138,Stuff Packs,3,0,0.0,3
16002,4139,Expansion Packs,10,0,0.0,10
16003,4139,Game Packs,3,0,0.0,3
16004,4139,Kits,3,0,0.0,3
16005,4139,Stuff Packs,10,1,0.1,9
16006,4140,Expansion Packs,16,0,0.0,16
16007,4140,Game Packs,12,0,0.0,12
16008,4140,Kits,19,1,0.05263157894736842,18
16009,4140,Stuff Packs,20,0,0.0,20
16010,4141,Expansion Packs,9,0,0.0,9
16011,4141,Game Packs,7,0,0.0,7
16012,4141,Stuff Packs,14,0,0.0,14
16013,4142,Expansion Packs,5,0,0.0,5
16014,4142,Game Packs,5,1,0.2,4
16015,4142,Kits,2,2,1.0,0
16016,4142,Stuff Packs,8,4,0.5,4
16017,4143,Expansion Packs,15,0,0.0,15
16018,4143,Game Packs,12,0,0.0,12
16019,4143,Kits,28,0,0.0,28
16020,4143,Stuff Packs,20,0,0.0,20
16021,4144,Expansion Packs,16,0,0.0,16
16022,4144,Game Packs,7,0,0.0,7
16023,4144,Kits,17,1,0.058823529411764705,16
16024,4144,Stuff Packs,10,4,0.4,6
16025,4145,Expansion Packs,13,0,0.0,13
16026,4145,Game Packs,10,0,0.0,10
16027,4145,Kits,3,2,0.6666666666666666,1
16028,4145,Stuff Packs,13,1,0.07692307692307693,12
16029,4146,Expansion Packs,16,0,0.0,16
16030,4146,Game Packs,7,0,0.0,7
16031,4146,Stuff Packs,14,1,0.07142857142857142,13
16032,4147,Kits,2,2,1.0,0
16033,4147,Stuff Packs,3,3,1.0,0
16034,4148,Expansion Packs,7,1,0.14285714285714285,6
16035,4148,Game Packs,4,1,0.25,3
16036,4148,Stuff Packs,2,1,0.5,1
16037,4149,Expansion Packs,8,0,0.0,8
16038,4149,Game Packs,5,0,0.0,5
16039,4149,Kits,5,2,0.4,3
16040,4149,Stuff Packs,4,0,0.0,4
16041,4150,Expansion Packs,12,0,0.0,12
16042,4150,Game Packs,8,0,0.0,8
16043,4150,Kits,13,2,0.15384615384615385,11
16044,4150,Stuff Packs,13,0,0.0,13
16045,4151,Expansion Packs,10,0,0.0,10
16046,4151,Game Packs,3,0,0.0,3
16047,4151,Stuff Packs,4,0,0.0,4
16048,4152,Expansion Packs,16,0,0.0,16
16049,4152,Game Packs,9,0,0.0,9
16050,4152,Kits,8,1,0.125,7
16051,4152,Stuff Packs,11,4,0.36363636363636365,7
16052,4153,Expansion Packs,8,0,0.0,8
16053,4153,Game Packs,6,0,0.0,6
16054,4153,Kits,2,1,0.5,1
16055,4153,Stuff Packs,9,2,0.2222222222222222,7
16056,4154,Expansion Packs,16,0,0.0,16
16057,4154,Game Packs,12,0,0.0,12
16058,4154,Kits,33,0,0.0,33
16059,4154,Stuff Packs,20,0,0.0,20
16060,4155,Expansion Packs,12,0,0.0,12
16061,4155,Game Packs,3,0,0.0,3
16062,4155,Kits,1,0,0.0,1
16063,4155,Stuff Packs,3,0,0.0,3
16064,4156,Expansion Packs,13,0,0.0,13
16065,4156,Game Packs,10,1,0.1,9
16066,4156,Kits,3,3,1.0,0
16067,4156,Stuff Packs,15,2,0.13333333333333333,13
16068,4157,Expansion Packs,14,0,0.0,14
16069,4157,Game Packs,9,0,0.0,9
16070,4157,Kits,7,0,0.0,7
16071,4157,Stuff Packs,17,1,0.058823529411764705,16
16072,4158,Expansion Packs,4,0,0.0,4
16073,4158,Stuff Packs,2,0,0.0,2
16074,4159,Expansion Packs,15,0,0.0,15
16075,4159,Game Packs,4,0,0.0,4
16076,4159,Kits,11,1,0.09090909090909091,10
16077,4159,Stuff Packs,12,0,0.0,12
16078,4160,Expansion Packs,13,0,0.0,13
16079,4160,Game Packs,9,0,0.0,9
16080,4160,Kits,1,1,1.0,0
16081,4160,Stuff Packs,15,1,0.06666666666666667,14
16082,4161,Expansion Packs,16,0,0.0,16
16083,4161,Game Packs,12,0,0.0,12
16084,4161,Kits,33,0,0.0,33
16085,4161,Stuff Packs,20,0,0.0,20
16086,4162,Expansion Packs,12,0,0.0,12
16087,4162,Game Packs,5,0,0.0,5
16088,4162,Kits,3,2,0.6666666666666666,1
16089,4162,Stuff Packs,7,3,0.42857142857142855,4
16090,4163,Expansion Packs,16,0,0.0,16
16091,4163,Game Packs,9,1,0.1111111111111111,8
16092,4163,Kits,26,2,0.07692307692307693,24
16093,4163,Stuff Packs,17,2,0.11764705882352941,15
16094,4164,Expansion Packs,16,0,0.0,16
16095,4164,Game Packs,12,0,0.0,12
16096,4164,Kits,33,1,0.030303030303030304,32
16097,4164,Stuff Packs,20,0,0.0,20
16098,4165,Expansion Packs,16,0,0.0,16
16099,4165,Game Packs,11,0,0.0,11
16100,4165,Kits,33,1,0.030303030303030304,32
16101,4165,Stuff Packs,20,0,0.0,20
16102,4166,Expansion Packs,15,1,0.06666666666666667,14
16103,4166,Game Packs,4,0,0.0,4
16104,4166,Kits,2,1,0.5,1
16105,4166,Stuff Packs,10,5,0.5,5
16106,4167,Expansion Packs,6,0,0.0,6
16107,4167,Game Packs,4,0,0.0,4
16108,4167,Kits,7,0,0.0,7
16109,4167,Stuff Packs,6,4,0.6666666666666666,2
16110,4168,Expansion Packs,15,0,0.0,15
16111,4168,Game Packs,12,0,0.0,12
16112,4168,Kits,33,1,0.030303030303030304,32
16113,4168,Stuff Packs,20,0,0.0,20
16114,4169,Expansion Packs,16,0,0.0,16
16115,4169,Game Packs,11,0,0.0,11
16116,4169,Kits,18,1,0.05555555555555555,17
16117,4169,Stuff Packs,18,0,0.0,18
16118,4170,Expansion Packs,15,0,0.0,15
16119,4170,Game Packs,12,0,0.0,12
16120,4170,Kits,26,1,0.038461538461538464,25
16121,4170,Stuff Packs,20,0,0.0,20
16122,4171,Expansion Packs,16,0,0.0,16
16123,4171,Game Packs,12,0,0.0,12
16124,4171,Kits,32,0,0.0,32
16125,4171,Stuff Packs,20,2,0.1,18
16126,4172,Expansion Packs,11,0,0.0,11
16127,4172,Game Packs,3,1,0.3333333333333333,2
16128,4172,Kits,5,2,0.4,3
16129,4172,Stuff Packs,11,2,0.18181818181818182,9
16130,4173,Expansion Packs,15,0,0.0,15
16131,4173,Game Packs,11,2,0.18181818181818182,9
16132,4173,Kits,10,2,0.2,8
16133,4173,Stuff Packs,16,4,0.25,12
16134,4174,Expansion Packs,14,0,0.0,14
16135,4174,Game Packs,12,0,0.0,12
16136,4174,Kits,2,2,1.0,0
16137,4174,Stuff Packs,11,0,0.0,11
16138,4175,Expansion Packs,10,0,0.0,10
16139,4175,Game Packs,6,0,0.0,6
16140,4175,Kits,3,0,0.0,3
16141,4175,Stuff Packs,5,0,0.0,5
16142,4176,Expansion Packs,16,0,0.0,16
16143,4176,Game Packs,12,0,0.0,12
16144,4176,Kits,32,1,0.03125,31
16145,4176,Stuff Packs,19,0,0.0,19
16146,4177,Expansion Packs,14,0,0.0,14
16147,4177,Game Packs,10,0,0.0,10
16148,4177,Kits,17,1,0.058823529411764705,16
16149,4177,Stuff Packs,20,0,0.0,20
16150,4178,Expansion Packs,16,0,0.0,16
16151,4178,Game Packs,12,0,0.0,12
16152,4178,Kits,20,2,0.1,18
16153,4178,Stuff Packs,20,1,0.05,19
16154,4179,Expansion Packs,13,0,0.0,13
16155,4179,Game Packs,1,0,0.0,1
16156,4179,Kits,1,1,1.0,0
16157,4179,Stuff Packs,5,0,0.0,5
16158,4180,Expansion Packs,16,0,0.0,16
16159,4180,Game Packs,11,0,0.0,11
16160,4180,Kits,28,0,0.0,28
16161,4180,Stuff Packs,18,0,0.0,18
16162,4181,Game Packs,1,1,1.0,0
16163,4181,Kits,2,1,0.5,1
16164,4181,Stuff Packs,2,2,1.0,0
16165,4182,Expansion Packs,9,0,0.0,9
16166,4182,Game Packs,4,0,0.0,4
16167,4182,Kits,2,2,1.0,0
16168,4182,Stuff Packs,9,3,0.3333333333333333,6
16169,4183,Expansion Packs,15,0,0.0,15
16170,4183,Game Packs,8,0,0.0,8
16171,4183,Kits,13,0,0.0,13
16172,4183,Stuff Packs,17,0,0.0,17
16173,4184,Expansion Packs,3,0,0.0,3
16174,4184,Game Packs,3,0,0.0,3
16175,4184,Stuff Packs,5,2,0.4,3
16176,4185,Expansion Packs,15,1,0.06666666666666667,14
16177,4185,Game Packs,6,0,0.0,6
16178,4185,Kits,8,1,0.125,7
16179,4185,Stuff Packs,9,1,0.1111111111111111,8
16180,4186,Expansion Packs,4,0,0.0,4
16181,4186,Game Packs,2,0,0.0,2
16182,4186,Kits,2,2,1.0,0
16183,4186,Stuff Packs,6,3,0.5,3
16184,4187,Expansion Packs,4,0,0.0,4
16185,4187,Game Packs,2,1,0.5,1
16186,4187,Kits,2,1,0.5,1
16187,4187,Stuff Packs,4,4,1.0,0
16188,4188,Expansion Packs,15,0,0.0,15
16189,4188,Game Packs,11,0,0.0,11
16190,4188,Kits,9,0,0.0,9
16191,4188,Stuff Packs,10,0,0.0,10
16192,4189,Expansion Packs,16,0,0.0,16
16193,4189,Game Packs,12,0,0.0,12
16194,4189,Kits,21,1,0.047619047619047616,20
16195,4189,Stuff Packs,18,1,0.05555555555555555,17
16196,4190,Expansion Packs,16,0,0.0,16
16197,4190,Game Packs,12,0,0.0,12
16198,4190,Kits,33,0,0.0,33
16199,4190,Stuff Packs,20,0,0.0,20
16200,4191,Expansion Packs,16,0,0.0,16
16201,4191,Game Packs,12,0,0.0,12
16202,4191,Kits,27,1,0.037037037037037035,26
16203,4191,Stuff Packs,20,0,0.0,20
16204,4192,Expansion Packs,15,0,0.0,15
16205,4192,Game Packs,6,1,0.16666666666666666,5
16206,4192,Kits,7,2,0.2857142857142857,5
16207,4192,Stuff Packs,7,3,0.42857142857142855,4
16208,4193,Expansion Packs,15,0,0.0,15
16209,4193,Game Packs,12,0,0.0,12
16210,4193,Kits,13,1,0.07692307692307693,12
16211,4193,Stuff Packs,20,0,0.0,20
16212,4194,Expansion Packs,16,0,0.0,16
16213,4194,Game Packs,11,1,0.09090909090909091,10
16214,4194,Kits,7,3,0.42857142857142855,4
16215,4194,Stuff Packs,17,1,0.058823529411764705,16
16216,4195,Expansion Packs,9,0,0.0,9
16217,4195,Game Packs,5,0,0.0,5
16218,4195,Stuff Packs,3,0,0.0,3
16219,4196,Expansion Packs,15,0,0.0,15
16220,4196,Game Packs,12,0,0.0,12
16221,4196,Kits,27,0,0.0,27
16222,4196,Stuff Packs,20,0,0.0,20
16223,4197,Expansion Packs,15,0,0.0,15
16224,4197,Game Packs,10,0,0.0,10
16225,4197,Kits,9,2,0.2222222222222222,7
16226,4197,Stuff Packs,19,2,0.10526315789473684,17
16227,4198,Expansion Packs,16,0,0.0,16
16228,4198,Game Packs,11,0,0.0,11
16229,4198,Kits,12,1,0.08333333333333333,11
16230,4198,Stuff Packs,20,1,0.05,19
16231,4199,Expansion Packs,15,0,0.0,15
16232,4199,Game Packs,9,0,0.0,9
16233,4199,Kits,8,2,0.25,6
16234,4199,Stuff Packs,20,1,0.05,19
16235,4200,Expansion Packs,12,0,0.0,12
16236,4200,Game Packs,7,0,0.0,7
16237,4200,Kits,3,1,0.3333333333333333,2
16238,4200,Stuff Packs,10,0,0.0,10
16239,4201,Expansion Packs,15,0,0.0,15
16240,4201,Game Packs,11,0,0.0,11
16241,4201,Kits,11,0,0.0,11
16242,4201,Stuff Packs,15,0,0.0,15
16243,4202,Expansion Packs,16,0,0.0,16
16244,4202,Game Packs,12,0,0.0,12
16245,4202,Kits,23,0,0.0,23
16246,4202,Stuff Packs,20,0,0.0,20
16247,4203,Expansion Packs,16,0,0.0,16
16248,4203,Game Packs,11,0,0.0,11
16249,4203,Kits,17,1,0.058823529411764705,16
16250,4203,Stuff Packs,20,0,0.0,20
16251,4204,Expansion Packs,5,0,0.0,5
16252,4204,Game Packs,1,0,0.0,1
16253,4204,Kits,3,0,0.0,3
16254,4204,Stuff Packs,2,0,0.0,2
16255,4205,Expansion Packs,16,0,0.0,16
16256,4205,Game Packs,12,0,0.0,12
16257,4205,Kits,16,1,0.0625,15
16258,4205,Stuff Packs,20,0,0.0,20
16259,4206,Expansion Packs,3,0,0.0,3
16260,4206,Game Packs,1,0,0.0,1
16261,4206,Kits,6,1,0.16666666666666666,5
16262,4206,Stuff Packs,8,1,0.125,7
16263,4207,Expansion Packs,6,0,0.0,6
16264,4207,Game Packs,2,0,0.0,2
16265,4207,Kits,3,1,0.3333333333333333,2
16266,4207,Stuff Packs,6,2,0.3333333333333333,4
16267,4208,Expansion Packs,7,0,0.0,7
16268,4208,Game Packs,3,0,0.0,3
16269,4208,Stuff Packs,5,1,0.2,4
16270,4209,Expansion Packs,15,0,0.0,15
16271,4209,Game Packs,12,0,0.0,12
16272,4209,Kits,20,0,0.0,20
16273,4209,Stuff Packs,19,0,0.0,19
16274,4210,Expansion Packs,12,1,0.08333333333333333,11
16275,4210,Game Packs,5,0,0.0,5
16276,4210,Kits,3,1,0.3333333333333333,2
16277,4210,Stuff Packs,6,0,0.0,6
16278,4211,Expansion Packs,16,0,0.0,16
16279,4211,Game Packs,8,0,0.0,8
16280,4211,Kits,16,1,0.0625,15
16281,4211,Stuff Packs,20,1,0.05,19
16282,4212,Expansion Packs,14,0,0.0,14
16283,4212,Game Packs,6,0,0.0,6
16284,4212,Kits,17,0,0.0,17
16285,4212,Stuff Packs,17,2,0.11764705882352941,15
16286,4213,Expansion Packs,16,0,0.0,16
16287,4213,Game Packs,12,0,0.0,12
16288,4213,Kits,33,1,0.030303030303030304,32
16289,4213,Stuff Packs,20,0,0.0,20
16290,4214,Expansion Packs,15,0,0.0,15
16291,4214,Game Packs,11,0,0.0,11
16292,4214,Kits,20,2,0.1,18
16293,4214,Stuff Packs,19,0,0.0,19
16294,4215,Expansion Packs,12,0,0.0,12
16295,4215,Game Packs,6,0,0.0,6
16296,4215,Kits,4,0,0.0,4
16297,4215,Stuff Packs,12,0,0.0,12
16298,4216,Stuff Packs,1,1,1.0,0
16299,4217,Expansion Packs,16,0,0.0,16
16300,4217,Game Packs,11,0,0.0,11
16301,4217,Kits,16,1,0.0625,15
16302,4217,Stuff Packs,20,2,0.1,18
16303,4218,Expansion Packs,13,0,0.0,13
16304,4218,Game Packs,6,0,0.0,6
16305,4218,Kits,1,1,1.0,0
16306,4218,Stuff Packs,5,3,0.6,2
16307,4219,Expansion Packs,14,0,0.0,14
16308,4219,Game Packs,11,0,0.0,11
16309,4219,Kits,31,1,0.03225806451612903,30
16310,4219,Stuff Packs,20,0,0.0,20
16311,4220,Expansion Packs,13,0,0.0,13
16312,4220,Game Packs,9,1,0.1111111111111111,8
16313,4220,Kits,15,1,0.06666666666666667,14
16314,4220,Stuff Packs,19,0,0.0,19
16315,4221,Expansion Packs,2,0,0.0,2
16316,4221,Game Packs,1,0,0.0,1
16317,4221,Kits,1,1,1.0,0
16318,4221,Stuff Packs,1,0,0.0,1
16319,4222,Expansion Packs,16,0,0.0,16
16320,4222,Game Packs,10,0,0.0,10
16321,4222,Kits,7,1,0.14285714285714285,6
16322,4222,Stuff Packs,11,1,0.09090909090909091,10
16323,4223,Expansion Packs,16,0,0.0,16
16324,4223,Game Packs,12,0,0.0,12
16325,4223,Kits,33,0,0.0,33
16326,4223,Stuff Packs,20,0,0.0,20
16327,4224,Expansion Packs,16,0,0.0,16
16328,4224,Game Packs,12,0,0.0,12
16329,4224,Kits,19,0,0.0,19
16330,4224,Stuff Packs,20,0,0.0,20
16331,4225,Expansion Packs,16,0,0.0,16
16332,4225,Game Packs,11,0,0.0,11
16333,4225,Kits,7,1,0.14285714285714285,6
16334,4225,Stuff Packs,20,1,0.05,19
16335,4226,Expansion Packs,11,0,0.0,11
16336,4226,Game Packs,6,0,0.0,6
16337,4226,Kits,15,0,0.0,15
16338,4226,Stuff Packs,13,0,0.0,13
16339,4227,Expansion Packs,15,1,0.06666666666666667,14
16340,4227,Game Packs,11,0,0.0,11
16341,4227,Kits,12,2,0.16666666666666666,10
16342,4227,Stuff Packs,20,0,0.0,20
16343,4228,Expansion Packs,9,0,0.0,9
16344,4228,Game Packs,8,2,0.25,6
16345,4228,Kits,3,3,1.0,0
16346,4228,Stuff Packs,8,4,0.5,4
16347,4229,Expansion Packs,16,0,0.0,16
16348,4229,Game Packs,9,0,0.0,9
16349,4229,Kits,11,1,0.09090909090909091,10
16350,4229,Stuff Packs,15,3,0.2,12
16351,4230,Expansion Packs,15,0,0.0,15
16352,4230,Game Packs,10,0,0.0,10
16353,4230,Kits,7,1,0.14285714285714285,6
16354,4230,Stuff Packs,20,2,0.1,18
16355,4231,Expansion Packs,14,0,0.0,14
16356,4231,Game Packs,12,0,0.0,12
16357,4231,Stuff Packs,18,0,0.0,18
16358,4232,Expansion Packs,16,0,0.0,16
16359,4232,Game Packs,12,0,0.0,12
16360,4232,Kits,33,1,0.030303030303030304,32
16361,4232,Stuff Packs,20,0,0.0,20
16362,4233,Expansion Packs,16,0,0.0,16
16363,4233,Game Packs,12,0,0.0,12
16364,4233,Kits,33,0,0.0,33
16365,4233,Stuff Packs,20,0,0.0,20
16366,4234,Expansion Packs,13,0,0.0,13
16367,4234,Game Packs,9,0,0.0,9
16368,4234,Kits,14,0,0.0,14
16369,4234,Stuff Packs,14,2,0.14285714285714285,12
16370,4235,Expansion Packs,16,0,0.0,16
16371,4235,Game Packs,10,0,0.0,10
16372,4235,Kits,9,1,0.1111111111111111,8
16373,4235,Stuff Packs,20,0,0.0,20
16374,4236,Expansion Packs,6,0,0.0,6
16375,4236,Game Packs,3,1,0.3333333333333333,2
16376,4236,Kits,3,1,0.3333333333333333,2
16377,4236,Stuff Packs,7,4,0.5714285714285714,3
16378,4237,Expansion Packs,4,0,0.0,4
16379,4237,Kits,1,0,0.0,1
16380,4237,Stuff Packs,5,2,0.4,3
16381,4238,Expansion Packs,6,0,0.0,6
16382,4238,Game Packs,3,0,0.0,3
16383,4238,Kits,6,2,0.3333333333333333,4
16384,4238,Stuff Packs,5,2,0.4,3
16385,4239,Expansion Packs,2,0,0.0,2
16386,4239,Game Packs,3,0,0.0,3
16387,4240,Expansion Packs,10,0,0.0,10
16388,4240,Game Packs,3,0,0.0,3
16389,4240,Kits,5,1,0.2,4
16390,4240,Stuff Packs,7,1,0.14285714285714285,6
16391,4241,Expansion Packs,2,0,0.0,2
16392,4241,Game Packs,1,0,0.0,1
16393,4241,Kits,1,1,1.0,0
16394,4241,Stuff Packs,3,3,1.0,0
16395,4242,Expansion Packs,15,0,0.0,15
16396,4242,Game Packs,11,0,0.0,11
16397,4242,Kits,16,1,0.0625,15
16398,4242,Stuff Packs,19,0,0.0,19
16399,4243,Expansion Packs,16,0,0.0,16
16400,4243,Game Packs,12,0,0.0,12
16401,4243,Kits,20,1,0.05,19
16402,4243,Stuff Packs,16,0,0.0,16
16403,4244,Expansion Packs,12,0,0.0,12
16404,4244,Game Packs,9,0,0.0,9
16405,4244,Kits,3,2,0.6666666666666666,1
16406,4244,Stuff Packs,17,1,0.058823529411764705,16
16407,4245,Expansion Packs,4,0,0.0,4
16408,4245,Game Packs,2,0,0.0,2
16409,4245,Kits,1,1,1.0,0
16410,4245,Stuff Packs,3,2,0.6666666666666666,1
16411,4246,Expansion Packs,16,0,0.0,16
16412,4246,Game Packs,12,0,0.0,12
16413,4246,Kits,1,0,0.0,1
16414,4246,Stuff Packs,20,0,0.0,20
16415,4247,Expansion Packs,13,0,0.0,13
16416,4247,Game Packs,12,0,0.0,12
16417,4247,Kits,6,0,0.0,6
16418,4247,Stuff Packs,16,1,0.0625,15
16419,4248,Expansion Packs,16,0,0.0,16
16420,4248,Game Packs,12,0,0.0,12
16421,4248,Kits,29,1,0.034482758620689655,28
16422,4248,Stuff Packs,20,0,0.0,20
16423,4249,Expansion Packs,5,0,0.0,5
16424,4249,Game Packs,3,0,0.0,3
16425,4249,Kits,2,0,0.0,2
16426,4249,Stuff Packs,2,0,0.0,2
16427,4250,Expansion Packs,16,0,0.0,16
16428,4250,Game Packs,11,0,0.0,11
16429,4250,Kits,20,1,0.05,19
16430,4250,Stuff Packs,16,4,0.25,12
16431,4251,Expansion Packs,16,0,0.0,16
16432,4251,Game Packs,12,0,0.0,12
16433,4251,Kits,33,0,0.0,33
16434,4251,Stuff Packs,20,0,0.0,20
16435,4252,Expansion Packs,13,0,0.0,13
16436,4252,Game Packs,9,0,0.0,9
16437,4252,Kits,9,1,0.1111111111111111,8
16438,4252,Stuff Packs,15,2,0.13333333333333333,13
16439,4253,Expansion Packs,15,0,0.0,15
16440,4253,Game Packs,11,0,0.0,11
16441,4253,Kits,6,3,0.5,3
16442,4253,Stuff Packs,20,0,0.0,20
16443,4254,Expansion Packs,16,0,0.0,16
16444,4254,Game Packs,9,0,0.0,9
16445,4254,Kits,7,0,0.0,7
16446,4254,Stuff Packs,16,0,0.0,16
16447,4255,Expansion Packs,14,0,0.0,14
16448,4255,Game Packs,9,0,0.0,9
16449,4255,Kits,6,0,0.0,6
16450,4255,Stuff Packs,13,0,0.0,13
16451,4256,Expansion Packs,12,0,0.0,12
16452,4256,Game Packs,8,0,0.0,8
16453,4256,Kits,6,4,0.6666666666666666,2
16454,4256,Stuff Packs,10,3,0.3,7
16455,4257,Expansion Packs,15,0,0.0,15
16456,4257,Game Packs,8,0,0.0,8
16457,4257,Kits,3,0,0.0,3
16458,4257,Stuff Packs,15,0,0.0,15
16459,4258,Expansion Packs,16,0,0.0,16
16460,4258,Game Packs,11,0,0.0,11
16461,4258,Kits,22,1,0.045454545454545456,21
16462,4258,Stuff Packs,16,2,0.125,14
16463,4259,Expansion Packs,16,0,0.0,16
16464,4259,Game Packs,12,0,0.0,12
16465,4259,Kits,33,1,0.030303030303030304,32
16466,4259,Stuff Packs,20,0,0.0,20
16467,4260,Expansion Packs,13,0,0.0,13
16468,4260,Game Packs,9,0,0.0,9
16469,4260,Kits,9,2,0.2222222222222222,7
16470,4260,Stuff Packs,10,2,0.2,8
16471,4261,Expansion Packs,16,0,0.0,16
16472,4261,Game Packs,12,0,0.0,12
16473,4261,Kits,33,0,0.0,33
16474,4261,Stuff Packs,20,0,0.0,20
16475,4262,Expansion Packs,16,0,0.0,16
16476,4262,Game Packs,12,0,0.0,12
16477,4262,Kits,33,0,0.0,33
16478,4262,Stuff Packs,20,0,0.0,20
16479,4263,Expansion Packs,12,0,0.0,12
16480,4263,Game Packs,9,0,0.0,9
16481,4263,Kits,5,2,0.4,3
16482,4263,Stuff Packs,17,3,0.17647058823529413,14
16483,4264,Expansion Packs,4,0,0.0,4
16484,4264,Game Packs,2,0,0.0,2
16485,4264,Kits,1,0,0.0,1
16486,4264,Stuff Packs,5,3,0.6,2
16487,4265,Expansion Packs,14,0,0.0,14
16488,4265,Game Packs,8,0,0.0,8
16489,4265,Kits,8,1,0.125,7
16490,4265,Stuff Packs,14,4,0.2857142857142857,10
16491,4266,Expansion Packs,6,0,0.0,6
16492,4266,Game Packs,3,0,0.0,3
16493,4266,Kits,5,1,0.2,4
16494,4266,Stuff Packs,3,1,0.3333333333333333,2
16495,4267,Expansion Packs,11,0,0.0,11
16496,4267,Game Packs,9,0,0.0,9
16497,4267,Kits,6,2,0.3333333333333333,4
16498,4267,Stuff Packs,16,2,0.125,14
16499,4268,Expansion Packs,16,0,0.0,16
16500,4268,Game Packs,11,0,0.0,11
16501,4268,Kits,23,1,0.043478260869565216,22
16502,4268,Stuff Packs,18,1,0.05555555555555555,17
16503,4269,Expansion Packs,16,0,0.0,16
16504,4269,Game Packs,12,0,0.0,12
16505,4269,Kits,13,1,0.07692307692307693,12
16506,4269,Stuff Packs,15,1,0.06666666666666667,14
16507,4270,Expansion Packs,6,0,0.0,6
16508,4270,Game Packs,6,0,0.0,6
16509,4270,Kits,1,1,1.0,0
16510,4270,Stuff Packs,8,2,0.25,6
16511,4271,Expansion Packs,16,0,0.0,16
16512,4271,Game Packs,11,1,0.09090909090909091,10
16513,4271,Kits,19,1,0.05263157894736842,18
16514,4271,Stuff Packs,19,2,0.10526315789473684,17
16515,4272,Expansion Packs,11,0,0.0,11
16516,4272,Game Packs,10,0,0.0,10
16517,4272,Kits,7,2,0.2857142857142857,5
16518,4272,Stuff Packs,16,3,0.1875,13
16519,4273,Expansion Packs,16,0,0.0,16
16520,4273,Game Packs,12,0,0.0,12
16521,4273,Kits,17,0,0.0,17
16522,4273,Stuff Packs,20,0,0.0,20
16523,4274,Expansion Packs,14,0,0.0,14
16524,4274,Game Packs,9,0,0.0,9
16525,4274,Kits,5,2,0.4,3
16526,4274,Stuff Packs,15,0,0.0,15
16527,4275,Expansion Packs,7,0,0.0,7
16528,4275,Game Packs,1,1,1.0,0
16529,4275,Kits,4,2,0.5,2
16530,4275,Stuff Packs,7,2,0.2857142857142857,5
16531,4276,Expansion Packs,10,0,0.0,10
16532,4276,Game Packs,8,0,0.0,8
16533,4276,Stuff Packs,18,0,0.0,18
16534,4277,Expansion Packs,15,0,0.0,15
16535,4277,Game Packs,11,0,0.0,11
16536,4277,Kits,18,0,0.0,18
16537,4277,Stuff Packs,18,0,0.0,18
16538,4278,Expansion Packs,16,0,0.0,16
16539,4278,Game Packs,12,0,0.0,12
16540,4278,Kits,33,0,0.0,33
16541,4278,Stuff Packs,20,0,0.0,20
16542,4279,Expansion Packs,16,0,0.0,16
16543,4279,Game Packs,12,0,0.0,12
16544,4279,Kits,15,2,0.13333333333333333,13
16545,4279,Stuff Packs,20,1,0.05,19
16546,4280,Expansion Packs,16,0,0.0,16
16547,4280,Game Packs,12,0,0.0,12
16548,4280,Kits,33,1,0.030303030303030304,32
16549,4280,Stuff Packs,20,0,0.0,20
16550,4281,Expansion Packs,16,0,0.0,16
16551,4281,Game Packs,12,0,0.0,12
16552,4281,Kits,25,0,0.0,25
16553,4281,Stuff Packs,19,0,0.0,19
16554,4282,Expansion Packs,16,0,0.0,16
16555,4282,Game Packs,11,0,0.0,11
16556,4282,Kits,30,1,0.03333333333333333,29
16557,4282,Stuff Packs,19,0,0.0,19
16558,4283,Expansion Packs,12,0,0.0,12
16559,4283,Game Packs,9,0,0.0,9
16560,4283,Kits,5,2,0.4,3
16561,4283,Stuff Packs,10,3,0.3,7
16562,4284,Expansion Packs,15,0,0.0,15
16563,4284,Game Packs,9,0,0.0,9
16564,4284,Kits,14,1,0.07142857142857142,13
16565,4284,Stuff Packs,18,0,0.0,18
16566,4285,Expansion Packs,13,0,0.0,13
16567,4285,Game Packs,8,0,0.0,8
16568,4285,Kits,3,1,0.3333333333333333,2
16569,4285,Stuff Packs,12,2,0.16666666666666666,10
16570,4286,Expansion Packs,11,0,0.0,11
16571,4286,Game Packs,10,0,0.0,10
16572,4286,Kits,1,1,1.0,0
16573,4286,Stuff Packs,7,2,0.2857142857142857,5
16574,4287,Expansion Packs,16,0,0.0,16
16575,4287,Game Packs,12,1,0.08333333333333333,11
16576,4287,Kits,30,1,0.03333333333333333,29
16577,4287,Stuff Packs,19,0,0.0,19
16578,4288,Expansion Packs,13,0,0.0,13
16579,4288,Game Packs,10,0,0.0,10
16580,4288,Kits,13,0,0.0,13
16581,4288,Stuff Packs,17,0,0.0,17
16582,4289,Expansion Packs,1,0,0.0,1
16583,4289,Game Packs,2,1,0.5,1
16584,4289,Kits,3,3,1.0,0
16585,4289,Stuff Packs,8,4,0.5,4
16586,4290,Expansion Packs,15,0,0.0,15
16587,4290,Game Packs,9,0,0.0,9
16588,4290,Kits,11,1,0.09090909090909091,10
16589,4290,Stuff Packs,10,1,0.1,9
16590,4291,Expansion Packs,12,0,0.0,12
16591,4291,Game Packs,4,0,0.0,4
16592,4291,Kits,9,1,0.1111111111111111,8
16593,4291,Stuff Packs,9,1,0.1111111111111111,8
16594,4292,Expansion Packs,5,0,0.0,5
16595,4292,Game Packs,5,1,0.2,4
16596,4292,Kits,3,2,0.6666666666666666,1
16597,4292,Stuff Packs,6,3,0.5,3
16598,4293,Expansion Packs,10,0,0.0,10
16599,4293,Game Packs,6,1,0.16666666666666666,5
16600,4293,Kits,1,0,0.0,1
16601,4293,Stuff Packs,5,2,0.4,3
16602,4294,Expansion Packs,7,0,0.0,7
16603,4294,Game Packs,3,0,0.0,3
16604,4294,Kits,2,1,0.5,1
16605,4294,Stuff Packs,4,2,0.5,2
16606,4295,Expansion Packs,15,0,0.0,15
16607,4295,Game Packs,12,0,0.0,12
16608,4295,Kits,12,0,0.0,12
16609,4295,Stuff Packs,14,0,0.0,14
16610,4296,Expansion Packs,1,0,0.0,1
16611,4296,Game Packs,2,0,0.0,2
16612,4296,Kits,2,1,0.5,1
16613,4296,Stuff Packs,4,3,0.75,1
16614,4297,Expansion Packs,13,0,0.0,13
16615,4297,Game Packs,8,0,0.0,8
16616,4297,Kits,15,1,0.06666666666666667,14
16617,4297,Stuff Packs,15,1,0.06666666666666667,14
16618,4298,Expansion Packs,14,0,0.0,14
16619,4298,Game Packs,9,0,0.0,9
16620,4298,Kits,2,2,1.0,0
16621,4298,Stuff Packs,15,2,0.13333333333333333,13
16622,4299,Expansion Packs,16,0,0.0,16
16623,4299,Game Packs,11,0,0.0,11
16624,4299,Kits,22,1,0.045454545454545456,21
16625,4299,Stuff Packs,14,1,0.07142857142857142,13
16626,4300,Expansion Packs,6,0,0.0,6
16627,4300,Game Packs,2,0,0.0,2
16628,4300,Kits,1,1,1.0,0
16629,4300,Stuff Packs,3,2,0.6666666666666666,1
16630,4301,Expansion Packs,16,0,0.0,16
16631,4301,Game Packs,11,1,0.09090909090909091,10
16632,4301,Kits,23,2,0.08695652173913043,21
16633,4301,Stuff Packs,19,3,0.15789473684210525,16
16634,4302,Expansion Packs,4,0,0.0,4
16635,4302,Game Packs,1,0,0.0,1
16636,4302,Stuff Packs,1,0,0.0,1
16637,4303,Expansion Packs,12,0,0.0,12
16638,4303,Game Packs,7,0,0.0,7
16639,4303,Kits,2,1,0.5,1
16640,4303,Stuff Packs,14,0,0.0,14
16641,4304,Expansion Packs,5,0,0.0,5
16642,4304,Game Packs,2,0,0.0,2
16643,4304,Stuff Packs,2,2,1.0,0
16644,4305,Expansion Packs,11,0,0.0,11
16645,4305,Game Packs,8,0,0.0,8
16646,4305,Kits,3,3,1.0,0
16647,4305,Stuff Packs,16,0,0.0,16
16648,4306,Expansion Packs,16,0,0.0,16
16649,4306,Game Packs,7,0,0.0,7
16650,4306,Kits,2,1,0.5,1
16651,4306,Stuff Packs,7,3,0.42857142857142855,4
16652,4307,Expansion Packs,13,0,0.0,13
16653,4307,Game Packs,7,0,0.0,7
16654,4307,Kits,1,1,1.0,0
16655,4307,Stuff Packs,6,2,0.3333333333333333,4
16656,4308,Expansion Packs,16,0,0.0,16
16657,4308,Game Packs,12,0,0.0,12
16658,4308,Kits,22,0,0.0,22
16659,4308,Stuff Packs,17,0,0.0,17
16660,4309,Expansion Packs,11,0,0.0,11
16661,4309,Game Packs,4,0,0.0,4
16662,4309,Kits,3,3,1.0,0
16663,4309,Stuff Packs,4,3,0.75,1
16664,4310,Expansion Packs,15,1,0.06666666666666667,14
16665,4310,Game Packs,3,0,0.0,3
16666,4310,Kits,6,2,0.3333333333333333,4
16667,4310,Stuff Packs,6,4,0.6666666666666666,2
16668,4311,Expansion Packs,16,0,0.0,16
16669,4311,Game Packs,12,0,0.0,12
16670,4311,Kits,30,1,0.03333333333333333,29
16671,4311,Stuff Packs,20,1,0.05,19
16672,4312,Expansion Packs,16,0,0.0,16
16673,4312,Game Packs,12,0,0.0,12
16674,4312,Kits,33,1,0.030303030303030304,32
16675,4312,Stuff Packs,20,3,0.15,17
16676,4313,Expansion Packs,12,0,0.0,12
16677,4313,Game Packs,4,0,0.0,4
16678,4313,Kits,6,1,0.16666666666666666,5
16679,4313,Stuff Packs,8,3,0.375,5
16680,4314,Expansion Packs,16,0,0.0,16
16681,4314,Game Packs,12,0,0.0,12
16682,4314,Kits,33,0,0.0,33
16683,4314,Stuff Packs,20,0,0.0,20
16684,4315,Expansion Packs,4,0,0.0,4
16685,4315,Kits,2,2,1.0,0
16686,4316,Expansion Packs,16,0,0.0,16
16687,4316,Game Packs,10,1,0.1,9
16688,4316,Kits,6,2,0.3333333333333333,4
16689,4316,Stuff Packs,16,2,0.125,14
16690,4317,Expansion Packs,15,0,0.0,15
16691,4317,Game Packs,8,0,0.0,8
16692,4317,Kits,4,2,0.5,2
16693,4317,Stuff Packs,13,3,0.23076923076923078,10
16694,4318,Expansion Packs,9,0,0.0,9
16695,4318,Game Packs,3,1,0.3333333333333333,2
16696,4318,Kits,2,1,0.5,1
16697,4318,Stuff Packs,6,1,0.16666666666666666,5
16698,4319,Expansion Packs,13,0,0.0,13
16699,4319,Game Packs,11,0,0.0,11
16700,4319,Kits,16,1,0.0625,15
16701,4319,Stuff Packs,18,0,0.0,18
16702,4320,Expansion Packs,10,0,0.0,10
16703,4320,Game Packs,5,0,0.0,5
16704,4320,Kits,6,2,0.3333333333333333,4
16705,4320,Stuff Packs,14,2,0.14285714285714285,12
16706,4321,Expansion Packs,16,0,0.0,16
16707,4321,Game Packs,9,0,0.0,9
16708,4321,Kits,23,3,0.13043478260869565,20
16709,4321,Stuff Packs,19,4,0.21052631578947367,15
16710,4322,Expansion Packs,11,0,0.0,11
16711,4322,Game Packs,10,0,0.0,10
16712,4322,Kits,3,0,0.0,3
16713,4322,Stuff Packs,17,2,0.11764705882352941,15
16714,4323,Expansion Packs,9,0,0.0,9
16715,4323,Game Packs,4,0,0.0,4
16716,4323,Kits,3,1,0.3333333333333333,2
16717,4323,Stuff Packs,11,2,0.18181818181818182,9
16718,4324,Expansion Packs,15,0,0.0,15
16719,4324,Game Packs,9,0,0.0,9
16720,4324,Kits,3,1,0.3333333333333333,2
16721,4324,Stuff Packs,15,1,0.06666666666666667,14
16722,4325,Expansion Packs,16,0,0.0,16
16723,4325,Game Packs,12,0,0.0,12
16724,4325,Kits,33,0,0.0,33
16725,4325,Stuff Packs,20,0,0.0,20
16726,4326,Expansion Packs,15,0,0.0,15
16727,4326,Game Packs,12,0,0.0,12
16728,4326,Kits,17,0,0.0,17
16729,4326,Stuff Packs,19,0,0.0,19
16730,4327,Expansion Packs,9,9,1.0,0
16731,4327,Game Packs,2,2,1.0,0
16732,4328,Expansion Packs,10,0,0.0,10
16733,4328,Game Packs,6,0,0.0,6
16734,4328,Kits,3,1,0.3333333333333333,2
16735,4328,Stuff Packs,9,2,0.2222222222222222,7
16736,4329,Expansion Packs,10,0,0.0,10
16737,4329,Game Packs,3,0,0.0,3
16738,4329,Kits,1,1,1.0,0
16739,4329,Stuff Packs,7,0,0.0,7
16740,4330,Expansion Packs,16,0,0.0,16
16741,4330,Game Packs,12,0,0.0,12
16742,4330,Kits,20,0,0.0,20
16743,4330,Stuff Packs,20,0,0.0,20
16744,4331,Expansion Packs,14,0,0.0,14
16745,4331,Game Packs,8,0,0.0,8
16746,4331,Kits,12,1,0.08333333333333333,11
16747,4331,Stuff Packs,15,1,0.06666666666666667,14
16748,4332,Expansion Packs,1,0,0.0,1
16749,4332,Kits,1,1,1.0,0
16750,4332,Stuff Packs,3,3,1.0,0
16751,4333,Expansion Packs,15,0,0.0,15
16752,4333,Game Packs,6,0,0.0,6
16753,4333,Kits,16,1,0.0625,15
16754,4333,Stuff Packs,7,1,0.14285714285714285,6
16755,4334,Expansion Packs,6,0,0.0,6
16756,4334,Game Packs,3,1,0.3333333333333333,2
16757,4334,Kits,1,1,1.0,0
16758,4334,Stuff Packs,7,3,0.42857142857142855,4
16759,4335,Expansion Packs,11,1,0.09090909090909091,10
16760,4335,Game Packs,3,0,0.0,3
16761,4335,Kits,1,0,0.0,1
16762,4335,Stuff Packs,6,0,0.0,6
16763,4336,Expansion Packs,16,0,0.0,16
16764,4336,Game Packs,11,0,0.0,11
16765,4336,Kits,7,1,0.14285714285714285,6
16766,4336,Stuff Packs,13,3,0.23076923076923078,10
16767,4337,Expansion Packs,16,0,0.0,16
16768,4337,Game Packs,12,0,0.0,12
16769,4337,Kits,19,0,0.0,19
16770,4337,Stuff Packs,20,0,0.0,20
16771,4338,Expansion Packs,1,1,1.0,0
16772,4338,Game Packs,1,1,1.0,0
16773,4338,Kits,2,2,1.0,0
16774,4338,Stuff Packs,5,3,0.6,2
16775,4339,Expansion Packs,6,0,0.0,6
16776,4339,Game Packs,1,0,0.0,1
16777,4339,Kits,1,1,1.0,0
16778,4339,Stuff Packs,4,2,0.5,2
16779,4340,Expansion Packs,16,0,0.0,16
16780,4340,Game Packs,12,0,0.0,12
16781,4340,Kits,18,0,0.0,18
16782,4340,Stuff Packs,13,0,0.0,13
16783,4341,Expansion Packs,15,0,0.0,15
16784,4341,Game Packs,11,0,0.0,11
16785,4341,Kits,7,0,0.0,7
16786,4341,Stuff Packs,19,0,0.0,19
16787,4342,Expansion Packs,3,0,0.0,3
16788,4342,Game Packs,3,0,0.0,3
16789,4342,Kits,1,1,1.0,0
16790,4342,Stuff Packs,4,2,0.5,2
16791,4343,Expansion Packs,14,0,0.0,14
16792,4343,Game Packs,7,0,0.0,7
16793,4343,Kits,2,2,1.0,0
16794,4343,Stuff Packs,6,2,0.3333333333333333,4
16795,4344,Expansion Packs,13,0,0.0,13
16796,4344,Game Packs,9,0,0.0,9
16797,4344,Kits,2,0,0.0,2
16798,4344,Stuff Packs,18,0,0.0,18
16799,4345,Expansion Packs,16,0,0.0,16
16800,4345,Game Packs,12,0,0.0,12
16801,4345,Kits,28,0,0.0,28
16802,4345,Stuff Packs,18,0,0.0,18
16803,4346,Expansion Packs,16,1,0.0625,15
16804,4346,Game Packs,6,0,0.0,6
16805,4346,Kits,9,1,0.1111111111111111,8
16806,4346,Stuff Packs,11,1,0.09090909090909091,10
16807,4347,Expansion Packs,13,0,0.0,13
16808,4347,Game Packs,11,0,0.0,11
16809,4347,Kits,10,1,0.1,9
16810,4347,Stuff Packs,15,3,0.2,12
16811,4348,Expansion Packs,16,16,1.0,0
16812,4348,Game Packs,12,12,1.0,0
16813,4348,Kits,33,33,1.0,0
16814,4348,Stuff Packs,20,20,1.0,0
16815,4349,Expansion Packs,11,0,0.0,11
16816,4349,Game Packs,6,0,0.0,6
16817,4349,Kits,6,1,0.16666666666666666,5
16818,4349,Stuff Packs,10,3,0.3,7
16819,4350,Expansion Packs,4,0,0.0,4
16820,4350,Game Packs,1,0,0.0,1
16821,4350,Stuff Packs,5,0,0.0,5
16822,4351,Expansion Packs,16,0,0.0,16
16823,4351,Game Packs,12,0,0.0,12
16824,4351,Kits,17,2,0.11764705882352941,15
16825,4351,Stuff Packs,20,0,0.0,20
16826,4352,Expansion Packs,3,0,0.0,3
16827,4352,Game Packs,1,1,1.0,0
16828,4352,Kits,4,1,0.25,3
16829,4352,Stuff Packs,4,3,0.75,1
16830,4353,Expansion Packs,16,0,0.0,16
16831,4353,Game Packs,11,0,0.0,11
16832,4353,Kits,33,0,0.0,33
16833,4353,Stuff Packs,20,1,0.05,19
16834,4354,Expansion Packs,5,0,0.0,5
16835,4354,Game Packs,1,0,0.0,1
16836,4354,Kits,3,2,0.6666666666666666,1
16837,4354,Stuff Packs,2,0,0.0,2
16838,4355,Expansion Packs,16,0,0.0,16
16839,4355,Game Packs,12,0,0.0,12
16840,4355,Kits,20,1,0.05,19
16841,4355,Stuff Packs,20,1,0.05,19
16842,4356,Expansion Packs,15,0,0.0,15
16843,4356,Game Packs,6,1,0.16666666666666666,5
16844,4356,Kits,3,3,1.0,0
16845,4356,Stuff Packs,5,2,0.4,3
16846,4357,Expansion Packs,14,0,0.0,14
16847,4357,Game Packs,4,0,0.0,4
16848,4357,Kits,5,1,0.2,4
16849,4357,Stuff Packs,10,2,0.2,8
16850,4358,Expansion Packs,14,1,0.07142857142857142,13
16851,4358,Game Packs,10,1,0.1,9
16852,4358,Kits,2,2,1.0,0
16853,4358,Stuff Packs,11,2,0.18181818181818182,9
16854,4359,Expansion Packs,16,0,0.0,16
16855,4359,Game Packs,11,0,0.0,11
16856,4359,Kits,28,0,0.0,28
16857,4359,Stuff Packs,20,0,0.0,20
16858,4360,Expansion Packs,5,0,0.0,5
16859,4360,Game Packs,3,0,0.0,3
16860,4360,Kits,1,0,0.0,1
16861,4360,Stuff Packs,9,0,0.0,9
16862,4361,Expansion Packs,13,0,0.0,13
16863,4361,Game Packs,12,0,0.0,12
16864,4361,Kits,9,3,0.3333333333333333,6
16865,4361,Stuff Packs,18,0,0.0,18
16866,4362,Expansion Packs,3,0,0.0,3
16867,4362,Game Packs,1,0,0.0,1
16868,4362,Kits,1,1,1.0,0
16869,4363,Expansion Packs,8,0,0.0,8
16870,4363,Game Packs,3,0,0.0,3
16871,4363,Stuff Packs,2,0,0.0,2
16872,4364,Expansion Packs,7,0,0.0,7
16873,4364,Game Packs,1,0,0.0,1
16874,4364,Kits,1,1,1.0,0
16875,4364,Stuff Packs,4,3,0.75,1
16876,4365,Expansion Packs,16,0,0.0,16
16877,4365,Game Packs,10,0,0.0,10
16878,4365,Kits,7,1,0.14285714285714285,6
16879,4365,Stuff Packs,16,3,0.1875,13
16880,4366,Expansion Packs,15,0,0.0,15
16881,4366,Game Packs,11,0,0.0,11
16882,4366,Kits,22,1,0.045454545454545456,21
16883,4366,Stuff Packs,20,0,0.0,20
16884,4367,Expansion Packs,13,0,0.0,13
16885,4367,Game Packs,9,0,0.0,9
16886,4367,Kits,5,1,0.2,4
16887,4367,Stuff Packs,10,0,0.0,10
16888,4368,Expansion Packs,6,0,0.0,6
16889,4368,Game Packs,3,0,0.0,3
16890,4368,Kits,4,1,0.25,3
16891,4368,Stuff Packs,4,2,0.5,2
16892,4369,Expansion Packs,7,0,0.0,7
16893,4369,Game Packs,6,0,0.0,6
16894,4369,Stuff Packs,6,0,0.0,6
16895,4370,Expansion Packs,12,0,0.0,12
16896,4370,Game Packs,9,0,0.0,9
16897,4370,Kits,2,2,1.0,0
16898,4370,Stuff Packs,17,0,0.0,17
16899,4371,Expansion Packs,8,0,0.0,8
16900,4371,Game Packs,1,1,1.0,0
16901,4371,Kits,3,3,1.0,0
16902,4371,Stuff Packs,4,4,1.0,0
16903,4372,Expansion Packs,12,0,0.0,12
16904,4372,Game Packs,3,1,0.3333333333333333,2
16905,4372,Kits,3,3,1.0,0
16906,4372,Stuff Packs,11,3,0.2727272727272727,8
16907,4373,Expansion Packs,7,0,0.0,7
16908,4373,Game Packs,2,0,0.0,2
16909,4373,Kits,1,1,1.0,0
16910,4373,Stuff Packs,6,3,0.5,3
16911,4374,Expansion Packs,3,0,0.0,3
16912,4374,Game Packs,2,1,0.5,1
16913,4374,Kits,2,2,1.0,0
16914,4374,Stuff Packs,5,4,0.8,1
16915,4375,Expansion Packs,8,1,0.125,7
16916,4375,Game Packs,2,1,0.5,1
16917,4375,Kits,3,3,1.0,0
16918,4375,Stuff Packs,7,4,0.5714285714285714,3
16919,4376,Expansion Packs,16,0,0.0,16
16920,4376,Game Packs,8,0,0.0,8
16921,4376,Kits,2,2,1.0,0
16922,4376,Stuff Packs,11,3,0.2727272727272727,8
16923,4377,Expansion Packs,12,0,0.0,12
16924,4377,Game Packs,4,0,0.0,4
16925,4377,Kits,3,2,0.6666666666666666,1
16926,4377,Stuff Packs,6,4,0.6666666666666666,2
16927,4378,Expansion Packs,14,0,0.0,14
16928,4378,Game Packs,8,0,0.0,8
16929,4378,Kits,4,2,0.5,2
16930,4378,Stuff Packs,8,0,0.0,8
16931,4379,Expansion Packs,12,2,0.16666666666666666,10
16932,4379,Game Packs,10,0,0.0,10
16933,4379,Kits,7,2,0.2857142857142857,5
16934,4379,Stuff Packs,15,0,0.0,15
16935,4380,Expansion Packs,14,1,0.07142857142857142,13
16936,4380,Game Packs,11,0,0.0,11
16937,4380,Kits,18,1,0.05555555555555555,17
16938,4380,Stuff Packs,17,0,0.0,17
16939,4381,Expansion Packs,13,0,0.0,13
16940,4381,Game Packs,8,0,0.0,8
16941,4381,Kits,1,1,1.0,0
16942,4381,Stuff Packs,7,1,0.14285714285714285,6
16943,4382,Expansion Packs,16,0,0.0,16
16944,4382,Game Packs,12,0,0.0,12
16945,4382,Kits,14,0,0.0,14
16946,4382,Stuff Packs,20,0,0.0,20
16947,4383,Expansion Packs,7,1,0.14285714285714285,6
16948,4383,Game Packs,5,0,0.0,5
16949,4383,Kits,8,1,0.125,7
16950,4383,Stuff Packs,6,0,0.0,6
16951,4384,Expansion Packs,15,0,0.0,15
16952,4384,Game Packs,9,0,0.0,9
16953,4384,Kits,2,0,0.0,2
16954,4384,Stuff Packs,16,0,0.0,16
16955,4385,Expansion Packs,13,0,0.0,13
16956,4385,Game Packs,8,0,0.0,8
16957,4385,Stuff Packs,10,0,0.0,10
16958,4386,Expansion Packs,12,0,0.0,12
16959,4386,Game Packs,6,0,0.0,6
16960,4386,Kits,2,0,0.0,2
16961,4386,Stuff Packs,8,3,0.375,5
16962,4387,Expansion Packs,6,1,0.16666666666666666,5
16963,4387,Game Packs,4,0,0.0,4
16964,4387,Kits,1,0,0.0,1
16965,4387,Stuff Packs,3,0,0.0,3
16966,4388,Expansion Packs,16,3,0.1875,13
16967,4388,Game Packs,12,0,0.0,12
16968,4388,Kits,33,15,0.45454545454545453,18
16969,4388,Stuff Packs,20,2,0.1,18
16970,4389,Expansion Packs,8,0,0.0,8
16971,4389,Game Packs,3,0,0.0,3
16972,4389,Kits,2,2,1.0,0
16973,4389,Stuff Packs,5,2,0.4,3
16974,4390,Expansion Packs,16,0,0.0,16
16975,4390,Game Packs,11,0,0.0,11
16976,4390,Kits,7,0,0.0,7
16977,4390,Stuff Packs,14,0,0.0,14
16978,4391,Expansion Packs,3,0,0.0,3
16979,4391,Game Packs,4,0,0.0,4
16980,4391,Kits,14,2,0.14285714285714285,12
16981,4391,Stuff Packs,10,0,0.0,10
16982,4392,Expansion Packs,8,0,0.0,8
16983,4392,Game Packs,2,0,0.0,2
16984,4392,Kits,6,1,0.16666666666666666,5
16985,4392,Stuff Packs,5,3,0.6,2
16986,4393,Expansion Packs,13,0,0.0,13
16987,4393,Game Packs,10,1,0.1,9
16988,4393,Kits,9,4,0.4444444444444444,5
16989,4393,Stuff Packs,10,0,0.0,10
16990,4394,Expansion Packs,2,0,0.0,2
16991,4394,Kits,2,0,0.0,2
16992,4394,Stuff Packs,6,3,0.5,3
16993,4395,Expansion Packs,5,0,0.0,5
16994,4395,Game Packs,4,0,0.0,4
16995,4395,Kits,1,1,1.0,0
16996,4395,Stuff Packs,5,3,0.6,2
16997,4396,Expansion Packs,16,0,0.0,16
16998,4396,Game Packs,11,0,0.0,11
16999,4396,Kits,2,2,1.0,0
17000,4396,Stuff Packs,18,0,0.0,18
17001,4397,Expansion Packs,8,0,0.0,8
17002,4397,Game Packs,5,0,0.0,5
17003,4397,Kits,2,0,0.0,2
17004,4397,Stuff Packs,9,0,0.0,9
17005,4398,Expansion Packs,16,1,0.0625,15
17006,4398,Game Packs,10,0,0.0,10
17007,4398,Kits,16,1,0.0625,15
17008,4398,Stuff Packs,20,0,0.0,20
17009,4399,Expansion Packs,4,0,0.0,4
17010,4399,Game Packs,2,0,0.0,2
17011,4399,Kits,1,0,0.0,1
17012,4399,Stuff Packs,4,2,0.5,2
17013,4400,Expansion Packs,16,0,0.0,16
17014,4400,Game Packs,12,0,0.0,12
17015,4400,Kits,13,1,0.07692307692307693,12
17016,4400,Stuff Packs,18,0,0.0,18
17017,4401,Expansion Packs,13,0,0.0,13
17018,4401,Game Packs,8,1,0.125,7
17019,4401,Kits,4,2,0.5,2
17020,4401,Stuff Packs,13,4,0.3076923076923077,9
17021,4402,Expansion Packs,7,0,0.0,7
17022,4402,Game Packs,2,0,0.0,2
17023,4402,Kits,4,1,0.25,3
17024,4402,Stuff Packs,3,3,1.0,0
17025,4403,Expansion Packs,15,0,0.0,15
17026,4403,Game Packs,11,0,0.0,11
17027,4403,Kits,9,0,0.0,9
17028,4403,Stuff Packs,16,0,0.0,16
17029,4404,Expansion Packs,15,0,0.0,15
17030,4404,Game Packs,10,0,0.0,10
17031,4404,Kits,5,2,0.4,3
17032,4404,Stuff Packs,16,1,0.0625,15
17033,4405,Expansion Packs,16,0,0.0,16
17034,4405,Game Packs,10,0,0.0,10
17035,4405,Kits,20,0,0.0,20
17036,4405,Stuff Packs,16,0,0.0,16
17037,4406,Expansion Packs,14,0,0.0,14
17038,4406,Game Packs,10,0,0.0,10
17039,4406,Kits,3,2,0.6666666666666666,1
17040,4406,Stuff Packs,19,1,0.05263157894736842,18
17041,4407,Expansion Packs,16,0,0.0,16
17042,4407,Game Packs,12,0,0.0,12
17043,4407,Kits,33,0,0.0,33
17044,4407,Stuff Packs,20,2,0.1,18
17045,4408,Expansion Packs,2,0,0.0,2
17046,4408,Game Packs,2,0,0.0,2
17047,4408,Stuff Packs,4,0,0.0,4
17048,4409,Expansion Packs,12,0,0.0,12
17049,4409,Game Packs,8,0,0.0,8
17050,4409,Kits,3,2,0.6666666666666666,1
17051,4409,Stuff Packs,10,3,0.3,7
17052,4410,Expansion Packs,16,0,0.0,16
17053,4410,Game Packs,12,0,0.0,12
17054,4410,Kits,33,0,0.0,33
17055,4410,Stuff Packs,20,0,0.0,20
17056,4411,Expansion Packs,14,0,0.0,14
17057,4411,Game Packs,9,0,0.0,9
17058,4411,Kits,5,0,0.0,5
17059,4411,Stuff Packs,17,0,0.0,17
17060,4412,Expansion Packs,16,0,0.0,16
17061,4412,Game Packs,12,0,0.0,12
17062,4412,Kits,33,0,0.0,33
17063,4412,Stuff Packs,20,0,0.0,20
17064,4413,Expansion Packs,10,0,0.0,10
17065,4413,Game Packs,7,0,0.0,7
17066,4413,Kits,6,0,0.0,6
17067,4413,Stuff Packs,9,1,0.1111111111111111,8
17068,4414,Expansion Packs,7,0,0.0,7
17069,4414,Game Packs,1,0,0.0,1
17070,4415,Expansion Packs,14,0,0.0,14
17071,4415,Game Packs,6,0,0.0,6
17072,4415,Stuff Packs,9,1,0.1111111111111111,8
17073,4416,Expansion Packs,5,0,0.0,5
17074,4416,Game Packs,1,0,0.0,1
17075,4416,Kits,2,0,0.0,2
17076,4416,Stuff Packs,5,1,0.2,4
17077,4417,Game Packs,1,1,1.0,0
17078,4417,Kits,3,3,1.0,0
17079,4417,Stuff Packs,4,4,1.0,0
17080,4418,Expansion Packs,8,0,0.0,8
17081,4418,Game Packs,4,1,0.25,3
17082,4418,Stuff Packs,5,2,0.4,3
17083,4419,Expansion Packs,11,0,0.0,11
17084,4419,Game Packs,6,0,0.0,6
17085,4419,Kits,3,2,0.6666666666666666,1
17086,4419,Stuff Packs,15,1,0.06666666666666667,14
17087,4420,Expansion Packs,8,0,0.0,8
17088,4420,Game Packs,2,1,0.5,1
17089,4420,Kits,1,0,0.0,1
17090,4420,Stuff Packs,3,3,1.0,0
17091,4421,Expansion Packs,14,0,0.0,14
17092,4421,Game Packs,12,0,0.0,12
17093,4421,Kits,1,0,0.0,1
17094,4421,Stuff Packs,20,0,0.0,20
17095,4422,Expansion Packs,16,0,0.0,16
17096,4422,Game Packs,12,0,0.0,12
17097,4422,Kits,33,0,0.0,33
17098,4422,Stuff Packs,20,0,0.0,20
17099,4423,Expansion Packs,16,0,0.0,16
17100,4423,Game Packs,11,0,0.0,11
17101,4423,Kits,10,1,0.1,9
17102,4423,Stuff Packs,18,1,0.05555555555555555,17
17103,4424,Expansion Packs,16,0,0.0,16
17104,4424,Game Packs,11,0,0.0,11
17105,4424,Kits,33,0,0.0,33
17106,4424,Stuff Packs,20,1,0.05,19
17107,4425,Expansion Packs,16,0,0.0,16
17108,4425,Game Packs,12,0,0.0,12
17109,4425,Kits,33,1,0.030303030303030304,32
17110,4425,Stuff Packs,20,5,0.25,15
17111,4426,Expansion Packs,11,0,0.0,11
17112,4426,Game Packs,5,0,0.0,5
17113,4426,Kits,1,1,1.0,0
17114,4426,Stuff Packs,13,0,0.0,13
17115,4427,Expansion Packs,16,0,0.0,16
17116,4427,Game Packs,12,1,0.08333333333333333,11
17117,4427,Kits,31,1,0.03225806451612903,30
17118,4427,Stuff Packs,20,0,0.0,20
17119,4428,Expansion Packs,16,0,0.0,16
17120,4428,Game Packs,11,0,0.0,11
17121,4428,Kits,13,1,0.07692307692307693,12
17122,4428,Stuff Packs,20,0,0.0,20
17123,4429,Expansion Packs,1,0,0.0,1
17124,4429,Game Packs,2,1,0.5,1
17125,4429,Kits,2,2,1.0,0
17126,4429,Stuff Packs,4,4,1.0,0
17127,4430,Expansion Packs,14,0,0.0,14
17128,4430,Game Packs,10,0,0.0,10
17129,4430,Kits,10,7,0.7,3
17130,4430,Stuff Packs,13,2,0.15384615384615385,11
17131,4431,Expansion Packs,16,0,0.0,16
17132,4431,Game Packs,12,0,0.0,12
17133,4431,Kits,33,0,0.0,33
17134,4431,Stuff Packs,20,0,0.0,20
17135,4432,Expansion Packs,16,0,0.0,16
17136,4432,Game Packs,12,0,0.0,12
17137,4432,Kits,33,0,0.0,33
17138,4432,Stuff Packs,20,0,0.0,20
17139,4433,Expansion Packs,8,0,0.0,8
17140,4433,Game Packs,5,0,0.0,5
17141,4433,Stuff Packs,4,0,0.0,4
17142,4434,Expansion Packs,4,0,0.0,4
17143,4434,Game Packs,1,0,0.0,1
17144,4434,Kits,1,0,0.0,1
17145,4434,Stuff Packs,8,3,0.375,5
17146,4435,Expansion Packs,13,0,0.0,13
17147,4435,Game Packs,12,0,0.0,12
17148,4435,Kits,23,0,0.0,23
17149,4435,Stuff Packs,19,0,0.0,19
17150,4436,Expansion Packs,11,0,0.0,11
17151,4436,Game Packs,9,0,0.0,9
17152,4436,Kits,27,2,0.07407407407407407,25
17153,4436,Stuff Packs,20,0,0.0,20
17154,4437,Expansion Packs,16,0,0.0,16
17155,4437,Game Packs,12,0,0.0,12
17156,4437,Kits,33,0,0.0,33
17157,4437,Stuff Packs,20,0,0.0,20
17158,4438,Expansion Packs,16,0,0.0,16
17159,4438,Game Packs,12,0,0.0,12
17160,4438,Kits,33,0,0.0,33
17161,4438,Stuff Packs,20,0,0.0,20
17162,4439,Expansion Packs,16,0,0.0,16
17163,4439,Game Packs,12,0,0.0,12
17164,4439,Kits,33,1,0.030303030303030304,32
17165,4439,Stuff Packs,20,0,0.0,20
17166,4440,Expansion Packs,16,0,0.0,16
17167,4440,Game Packs,11,0,0.0,11
17168,4440,Kits,15,1,0.06666666666666667,14
17169,4440,Stuff Packs,17,2,0.11764705882352941,15
17170,4441,Expansion Packs,4,0,0.0,4
17171,4441,Game Packs,2,0,0.0,2
17172,4441,Kits,2,0,0.0,2
17173,4441,Stuff Packs,6,0,0.0,6
17174,4442,Expansion Packs,5,0,0.0,5
17175,4442,Game Packs,3,0,0.0,3
17176,4442,Kits,1,0,0.0,1
17177,4442,Stuff Packs,6,2,0.3333333333333333,4
17178,4443,Expansion Packs,16,0,0.0,16
17179,4443,Game Packs,12,0,0.0,12
17180,4443,Kits,33,2,0.06060606060606061,31
17181,4443,Stuff Packs,20,0,0.0,20
17182,4444,Expansion Packs,15,0,0.0,15
17183,4444,Game Packs,9,0,0.0,9
17184,4444,Stuff Packs,20,0,0.0,20
17185,4445,Expansion Packs,16,0,0.0,16
17186,4445,Game Packs,12,0,0.0,12
17187,4445,Kits,13,0,0.0,13
17188,4445,Stuff Packs,18,0,0.0,18
17189,4446,Expansion Packs,15,0,0.0,15
17190,4446,Game Packs,9,1,0.1111111111111111,8
17191,4446,Kits,6,1,0.16666666666666666,5
17192,4446,Stuff Packs,13,0,0.0,13
17193,4447,Expansion Packs,16,0,0.0,16
17194,4447,Game Packs,12,0,0.0,12
17195,4447,Kits,32,0,0.0,32
17196,4447,Stuff Packs,20,0,0.0,20
17197,4448,Expansion Packs,10,0,0.0,10
17198,4448,Game Packs,4,0,0.0,4
17199,4448,Kits,6,2,0.3333333333333333,4
17200,4448,Stuff Packs,4,0,0.0,4
17201,4449,Expansion Packs,14,3,0.21428571428571427,11
17202,4449,Game Packs,12,2,0.16666666666666666,10
17203,4449,Kits,4,3,0.75,1
17204,4449,Stuff Packs,17,15,0.8823529411764706,2
17205,4450,Expansion Packs,2,0,0.0,2
17206,4450,Game Packs,1,1,1.0,0
17207,4450,Kits,3,3,1.0,0
17208,4450,Stuff Packs,4,4,1.0,0
17209,4451,Expansion Packs,16,0,0.0,16
17210,4451,Game Packs,12,0,0.0,12
17211,4451,Kits,33,0,0.0,33
17212,4451,Stuff Packs,20,0,0.0,20
17213,4452,Expansion Packs,12,0,0.0,12
17214,4452,Game Packs,7,0,0.0,7
17215,4452,Stuff Packs,11,3,0.2727272727272727,8
17216,4453,Expansion Packs,16,0,0.0,16
17217,4453,Game Packs,11,0,0.0,11
17218,4453,Kits,4,0,0.0,4
17219,4453,Stuff Packs,9,2,0.2222222222222222,7
17220,4454,Expansion Packs,12,0,0.0,12
17221,4454,Game Packs,7,0,0.0,7
17222,4454,Stuff Packs,5,0,0.0,5
17223,4455,Expansion Packs,16,0,0.0,16
17224,4455,Game Packs,12,0,0.0,12
17225,4455,Kits,20,0,0.0,20
17226,4455,Stuff Packs,20,1,0.05,19
17227,4456,Expansion Packs,16,0,0.0,16
17228,4456,Game Packs,12,0,0.0,12
17229,4456,Kits,6,1,0.16666666666666666,5
17230,4456,Stuff Packs,19,0,0.0,19
17231,4457,Expansion Packs,14,0,0.0,14
17232,4457,Game Packs,10,0,0.0,10
17233,4457,Kits,1,1,1.0,0
17234,4457,Stuff Packs,17,0,0.0,17
17235,4458,Expansion Packs,14,0,0.0,14
17236,4458,Game Packs,11,0,0.0,11
17237,4458,Kits,8,1,0.125,7
17238,4458,Stuff Packs,20,0,0.0,20
17239,4459,Expansion Packs,16,0,0.0,16
17240,4459,Game Packs,12,0,0.0,12
17241,4459,Kits,33,1,0.030303030303030304,32
17242,4459,Stuff Packs,20,0,0.0,20
17243,4460,Expansion Packs,11,0,0.0,11
17244,4460,Game Packs,5,1,0.2,4
17245,4460,Kits,8,2,0.25,6
17246,4460,Stuff Packs,9,4,0.4444444444444444,5
17247,4461,Expansion Packs,14,0,0.0,14
17248,4461,Game Packs,4,0,0.0,4
17249,4461,Kits,7,0,0.0,7
17250,4461,Stuff Packs,13,2,0.15384615384615385,11
17251,4462,Expansion Packs,15,0,0.0,15
17252,4462,Game Packs,8,0,0.0,8
17253,4462,Kits,9,2,0.2222222222222222,7
17254,4462,Stuff Packs,16,1,0.0625,15
17255,4463,Expansion Packs,9,0,0.0,9
17256,4463,Game Packs,6,0,0.0,6
17257,4463,Stuff Packs,6,2,0.3333333333333333,4
17258,4464,Expansion Packs,14,0,0.0,14
17259,4464,Game Packs,11,0,0.0,11
17260,4464,Kits,11,3,0.2727272727272727,8
17261,4464,Stuff Packs,17,4,0.23529411764705882,13
17262,4465,Expansion Packs,10,0,0.0,10
17263,4465,Game Packs,4,0,0.0,4
17264,4465,Kits,1,0,0.0,1
17265,4465,Stuff Packs,6,0,0.0,6
17266,4466,Expansion Packs,14,0,0.0,14
17267,4466,Game Packs,11,0,0.0,11
17268,4466,Kits,2,0,0.0,2
17269,4466,Stuff Packs,13,0,0.0,13
17270,4467,Expansion Packs,15,0,0.0,15
17271,4467,Game Packs,9,0,0.0,9
17272,4467,Kits,5,0,0.0,5
17273,4467,Stuff Packs,15,0,0.0,15
17274,4468,Expansion Packs,4,0,0.0,4
17275,4468,Game Packs,2,0,0.0,2
17276,4468,Kits,3,0,0.0,3
17277,4468,Stuff Packs,4,0,0.0,4
17278,4469,Expansion Packs,16,0,0.0,16
17279,4469,Game Packs,11,0,0.0,11
17280,4469,Kits,27,0,0.0,27
17281,4469,Stuff Packs,20,0,0.0,20
17282,4470,Expansion Packs,15,0,0.0,15
17283,4470,Game Packs,12,0,0.0,12
17284,4470,Kits,19,0,0.0,19
17285,4470,Stuff Packs,20,0,0.0,20
17286,4471,Expansion Packs,1,0,0.0,1
17287,4471,Kits,3,2,0.6666666666666666,1
17288,4471,Stuff Packs,3,3,1.0,0
17289,4472,Expansion Packs,16,0,0.0,16
17290,4472,Game Packs,7,0,0.0,7
17291,4472,Kits,11,2,0.18181818181818182,9
17292,4472,Stuff Packs,6,0,0.0,6
17293,4473,Expansion Packs,16,0,0.0,16
17294,4473,Game Packs,12,0,0.0,12
17295,4473,Kits,33,1,0.030303030303030304,32
17296,4473,Stuff Packs,20,0,0.0,20
17297,4474,Expansion Packs,7,0,0.0,7
17298,4474,Game Packs,3,0,0.0,3
17299,4474,Kits,2,0,0.0,2
17300,4474,Stuff Packs,5,0,0.0,5
17301,4475,Expansion Packs,7,0,0.0,7
17302,4475,Game Packs,5,1,0.2,4
17303,4475,Kits,3,3,1.0,0
17304,4475,Stuff Packs,5,4,0.8,1
17305,4476,Expansion Packs,4,0,0.0,4
17306,4476,Game Packs,3,1,0.3333333333333333,2
17307,4476,Kits,2,2,1.0,0
17308,4476,Stuff Packs,5,4,0.8,1
17309,4477,Expansion Packs,15,0,0.0,15
17310,4477,Game Packs,10,0,0.0,10
17311,4477,Kits,6,0,0.0,6
17312,4477,Stuff Packs,12,6,0.5,6
17313,4478,Expansion Packs,16,0,0.0,16
17314,4478,Game Packs,12,0,0.0,12
17315,4478,Kits,28,1,0.03571428571428571,27
17316,4478,Stuff Packs,20,0,0.0,20
17317,4479,Expansion Packs,16,0,0.0,16
17318,4479,Game Packs,12,0,0.0,12
17319,4479,Kits,31,1,0.03225806451612903,30
17320,4479,Stuff Packs,20,0,0.0,20
17321,4480,Expansion Packs,6,0,0.0,6
17322,4480,Game Packs,5,2,0.4,3
17323,4480,Kits,3,3,1.0,0
17324,4480,Stuff Packs,5,4,0.8,1
17325,4481,Expansion Packs,16,0,0.0,16
17326,4481,Game Packs,12,0,0.0,12
17327,4481,Kits,22,0,0.0,22
17328,4481,Stuff Packs,20,0,0.0,20
17329,4482,Expansion Packs,16,0,0.0,16
17330,4482,Game Packs,11,0,0.0,11
17331,4482,Kits,33,1,0.030303030303030304,32
17332,4482,Stuff Packs,20,0,0.0,20
17333,4483,Expansion Packs,7,0,0.0,7
17334,4483,Game Packs,7,0,0.0,7
17335,4483,Kits,2,2,1.0,0
17336,4483,Stuff Packs,8,2,0.25,6
17337,4484,Expansion Packs,16,0,0.0,16
17338,4484,Game Packs,12,0,0.0,12
17339,4484,Kits,33,0,0.0,33
17340,4484,Stuff Packs,20,0,0.0,20
17341,4485,Expansion Packs,16,0,0.0,16
17342,4485,Game Packs,12,0,0.0,12
17343,4485,Kits,25,0,0.0,25
17344,4485,Stuff Packs,20,0,0.0,20
17345,4486,Expansion Packs,6,0,0.0,6
17346,4486,Game Packs,1,0,0.0,1
17347,4486,Stuff Packs,4,2,0.5,2
17348,4487,Expansion Packs,13,0,0.0,13
17349,4487,Game Packs,6,0,0.0,6
17350,4487,Kits,2,2,1.0,0
17351,4487,Stuff Packs,12,3,0.25,9
17352,4488,Expansion Packs,16,0,0.0,16
17353,4488,Game Packs,12,0,0.0,12
17354,4488,Kits,25,1,0.04,24
17355,4488,Stuff Packs,20,1,0.05,19
17356,4489,Expansion Packs,15,0,0.0,15
17357,4489,Game Packs,9,3,0.3333333333333333,6
17358,4489,Kits,7,1,0.14285714285714285,6
17359,4489,Stuff Packs,10,2,0.2,8
17360,4490,Expansion Packs,6,0,0.0,6
17361,4490,Game Packs,1,0,0.0,1
17362,4490,Kits,1,1,1.0,0
17363,4490,Stuff Packs,5,3,0.6,2
17364,4491,Expansion Packs,11,0,0.0,11
17365,4491,Game Packs,5,0,0.0,5
17366,4491,Kits,6,1,0.16666666666666666,5
17367,4491,Stuff Packs,10,0,0.0,10
17368,4492,Expansion Packs,15,0,0.0,15
17369,4492,Game Packs,12,0,0.0,12
17370,4492,Kits,25,0,0.0,25
17371,4492,Stuff Packs,19,1,0.05263157894736842,18
17372,4493,Expansion Packs,15,0,0.0,15
17373,4493,Game Packs,12,0,0.0,12
17374,4493,Kits,3,2,0.6666666666666666,1
17375,4493,Stuff Packs,20,2,0.1,18
17376,4494,Expansion Packs,15,0,0.0,15
17377,4494,Game Packs,11,0,0.0,11
17378,4494,Kits,9,1,0.1111111111111111,8
17379,4494,Stuff Packs,17,1,0.058823529411764705,16
17380,4495,Expansion Packs,16,0,0.0,16
17381,4495,Game Packs,12,0,0.0,12
17382,4495,Kits,29,1,0.034482758620689655,28
17383,4495,Stuff Packs,19,1,0.05263157894736842,18
17384,4496,Expansion Packs,16,0,0.0,16
17385,4496,Game Packs,12,0,0.0,12
17386,4496,Kits,33,0,0.0,33
17387,4496,Stuff Packs,20,0,0.0,20
17388,4497,Expansion Packs,12,0,0.0,12
17389,4497,Game Packs,5,0,0.0,5
17390,4497,Kits,1,1,1.0,0
17391,4497,Stuff Packs,2,0,0.0,2
17392,4498,Expansion Packs,16,0,0.0,16
17393,4498,Game Packs,11,0,0.0,11
17394,4498,Kits,21,1,0.047619047619047616,20
17395,4498,Stuff Packs,20,1,0.05,19
17396,4499,Expansion Packs,16,0,0.0,16
17397,4499,Game Packs,12,0,0.0,12
17398,4499,Kits,21,0,0.0,21
17399,4499,Stuff Packs,20,0,0.0,20
17400,4500,Expansion Packs,3,0,0.0,3
17401,4500,Game Packs,4,1,0.25,3
17402,4500,Stuff Packs,9,1,0.1111111111111111,8
17403,4501,Expansion Packs,16,0,0.0,16
17404,4501,Game Packs,12,0,0.0,12
17405,4501,Kits,7,0,0.0,7
17406,4501,Stuff Packs,17,1,0.058823529411764705,16
17407,4502,Expansion Packs,6,0,0.0,6
17408,4502,Game Packs,5,2,0.4,3
17409,4502,Kits,1,1,1.0,0
17410,4502,Stuff Packs,5,2,0.4,3
17411,4503,Expansion Packs,2,0,0.0,2
17412,4503,Kits,2,1,0.5,1
17413,4503,Stuff Packs,2,1,0.5,1
17414,4504,Expansion Packs,7,0,0.0,7
17415,4504,Game Packs,1,0,0.0,1
17416,4504,Kits,2,1,0.5,1
17417,4504,Stuff Packs,6,1,0.16666666666666666,5
17418,4505,Expansion Packs,13,0,0.0,13
17419,4505,Game Packs,9,0,0.0,9
17420,4505,Kits,1,1,1.0,0
17421,4505,Stuff Packs,16,0,0.0,16
17422,4506,Expansion Packs,9,0,0.0,9
17423,4506,Game Packs,5,0,0.0,5
17424,4506,Kits,1,1,1.0,0
17425,4506,Stuff Packs,5,2,0.4,3
17426,4507,Expansion Packs,14,0,0.0,14
17427,4507,Game Packs,10,0,0.0,10
17428,4507,Kits,2,2,1.0,0
17429,4507,Stuff Packs,17,0,0.0,17
17430,4508,Expansion Packs,10,0,0.0,10
17431,4508,Game Packs,6,0,0.0,6
17432,4508,Kits,1,0,0.0,1
17433,4508,Stuff Packs,9,0,0.0,9
17434,4509,Expansion Packs,16,0,0.0,16
17435,4509,Game Packs,12,0,0.0,12
17436,4509,Kits,31,0,0.0,31
17437,4509,Stuff Packs,20,0,0.0,20
17438,4510,Expansion Packs,15,0,0.0,15
17439,4510,Game Packs,8,0,0.0,8
17440,4510,Kits,1,1,1.0,0
17441,4510,Stuff Packs,13,3,0.23076923076923078,10
17442,4511,Expansion Packs,12,0,0.0,12
17443,4511,Game Packs,6,1,0.16666666666666666,5
17444,4511,Kits,17,0,0.0,17
17445,4511,Stuff Packs,7,0,0.0,7
17446,4512,Expansion Packs,16,0,0.0,16
17447,4512,Game Packs,12,0,0.0,12
17448,4512,Kits,10,1,0.1,9
17449,4512,Stuff Packs,20,0,0.0,20
17450,4513,Expansion Packs,15,0,0.0,15
17451,4513,Game Packs,11,0,0.0,11
17452,4513,Kits,5,0,0.0,5
17453,4513,Stuff Packs,14,0,0.0,14
17454,4514,Expansion Packs,14,0,0.0,14
17455,4514,Game Packs,11,1,0.09090909090909091,10
17456,4514,Kits,23,2,0.08695652173913043,21
17457,4514,Stuff Packs,17,2,0.11764705882352941,15
17458,4515,Expansion Packs,12,0,0.0,12
17459,4515,Game Packs,3,0,0.0,3
17460,4515,Kits,1,1,1.0,0
17461,4515,Stuff Packs,5,3,0.6,2
17462,4516,Expansion Packs,14,0,0.0,14
17463,4516,Game Packs,6,0,0.0,6
17464,4516,Kits,4,1,0.25,3
17465,4516,Stuff Packs,5,1,0.2,4
17466,4517,Expansion Packs,2,0,0.0,2
17467,4517,Game Packs,1,0,0.0,1
17468,4517,Stuff Packs,2,2,1.0,0
17469,4518,Expansion Packs,16,0,0.0,16
17470,4518,Game Packs,10,0,0.0,10
17471,4518,Kits,8,1,0.125,7
17472,4518,Stuff Packs,15,4,0.26666666666666666,11
17473,4519,Expansion Packs,6,0,0.0,6
17474,4519,Game Packs,2,1,0.5,1
17475,4519,Kits,2,2,1.0,0
17476,4519,Stuff Packs,2,1,0.5,1
17477,4520,Expansion Packs,15,0,0.0,15
17478,4520,Game Packs,9,0,0.0,9
17479,4520,Kits,10,1,0.1,9
17480,4520,Stuff Packs,16,1,0.0625,15
17481,4521,Expansion Packs,5,0,0.0,5
17482,4521,Kits,1,1,1.0,0
17483,4521,Stuff Packs,2,1,0.5,1
17484,4522,Expansion Packs,16,0,0.0,16
17485,4522,Game Packs,12,0,0.0,12
17486,4522,Kits,33,0,0.0,33
17487,4522,Stuff Packs,20,0,0.0,20
17488,4523,Expansion Packs,12,1,0.08333333333333333,11
17489,4523,Game Packs,4,0,0.0,4
17490,4523,Kits,1,0,0.0,1
17491,4523,Stuff Packs,4,0,0.0,4
17492,4524,Expansion Packs,9,0,0.0,9
17493,4524,Game Packs,4,0,0.0,4
17494,4524,Stuff Packs,3,1,0.3333333333333333,2
17495,4525,Expansion Packs,15,0,0.0,15
17496,4525,Game Packs,10,0,0.0,10
17497,4525,Kits,2,2,1.0,0
17498,4525,Stuff Packs,17,1,0.058823529411764705,16
17499,4526,Expansion Packs,14,1,0.07142857142857142,13
17500,4526,Game Packs,12,1,0.08333333333333333,11
17501,4526,Kits,14,2,0.14285714285714285,12
17502,4526,Stuff Packs,18,1,0.05555555555555555,17
17503,4527,Expansion Packs,16,0,0.0,16
17504,4527,Game Packs,7,0,0.0,7
17505,4527,Kits,14,0,0.0,14
17506,4527,Stuff Packs,14,3,0.21428571428571427,11
17507,4528,Expansion Packs,9,0,0.0,9
17508,4528,Game Packs,7,1,0.14285714285714285,6
17509,4528,Kits,4,3,0.75,1
17510,4528,Stuff Packs,10,4,0.4,6
17511,4529,Expansion Packs,15,0,0.0,15
17512,4529,Game Packs,5,1,0.2,4
17513,4529,Kits,1,0,0.0,1
17514,4529,Stuff Packs,5,2,0.4,3
17515,4530,Expansion Packs,13,0,0.0,13
17516,4530,Game Packs,12,0,0.0,12
17517,4530,Kits,14,2,0.14285714285714285,12
17518,4530,Stuff Packs,13,0,0.0,13
17519,4531,Expansion Packs,2,0,0.0,2
17520,4531,Game Packs,1,1,1.0,0
17521,4531,Kits,2,2,1.0,0
17522,4531,Stuff Packs,4,4,1.0,0
17523,4532,Expansion Packs,5,0,0.0,5
17524,4532,Game Packs,3,0,0.0,3
17525,4532,Kits,2,2,1.0,0
17526,4532,Stuff Packs,3,2,0.6666666666666666,1
17527,4533,Expansion Packs,14,0,0.0,14
17528,4533,Game Packs,10,0,0.0,10
17529,4533,Kits,18,1,0.05555555555555555,17
17530,4533,Stuff Packs,20,0,0.0,20
17531,4534,Expansion Packs,14,1,0.07142857142857142,13
17532,4534,Game Packs,9,0,0.0,9
17533,4534,Kits,6,3,0.5,3
17534,4534,Stuff Packs,20,1,0.05,19
17535,4535,Expansion Packs,12,0,0.0,12
17536,4535,Game Packs,7,0,0.0,7
17537,4535,Stuff Packs,13,2,0.15384615384615385,11
17538,4536,Expansion Packs,9,0,0.0,9
17539,4536,Game Packs,3,0,0.0,3
17540,4536,Stuff Packs,2,0,0.0,2
17541,4537,Expansion Packs,16,0,0.0,16
17542,4537,Game Packs,7,0,0.0,7
17543,4537,Kits,8,1,0.125,7
17544,4537,Stuff Packs,10,1,0.1,9
17545,4538,Expansion Packs,2,0,0.0,2
17546,4538,Kits,1,1,1.0,0
17547,4538,Stuff Packs,2,2,1.0,0
17548,4539,Expansion Packs,16,0,0.0,16
17549,4539,Game Packs,12,0,0.0,12
17550,4539,Kits,33,0,0.0,33
17551,4539,Stuff Packs,20,0,0.0,20
17552,4540,Expansion Packs,14,0,0.0,14
17553,4540,Game Packs,6,0,0.0,6
17554,4540,Kits,15,1,0.06666666666666667,14
17555,4540,Stuff Packs,11,3,0.2727272727272727,8
17556,4541,Expansion Packs,4,0,0.0,4
17557,4541,Game Packs,2,0,0.0,2
17558,4541,Kits,6,1,0.16666666666666666,5
17559,4541,Stuff Packs,5,0,0.0,5
17560,4542,Expansion Packs,13,0,0.0,13
17561,4542,Game Packs,6,0,0.0,6
17562,4542,Kits,2,2,1.0,0
17563,4542,Stuff Packs,9,3,0.3333333333333333,6
17564,4543,Expansion Packs,10,7,0.7,3
17565,4543,Game Packs,4,2,0.5,2
17566,4543,Kits,2,2,1.0,0
17567,4543,Stuff Packs,3,3,1.0,0
17568,4544,Expansion Packs,16,0,0.0,16
17569,4544,Game Packs,12,0,0.0,12
17570,4544,Kits,33,1,0.030303030303030304,32
17571,4544,Stuff Packs,20,0,0.0,20
17572,4545,Expansion Packs,14,0,0.0,14
17573,4545,Game Packs,12,0,0.0,12
17574,4545,Kits,31,0,0.0,31
17575,4545,Stuff Packs,18,0,0.0,18
17576,4546,Expansion Packs,15,0,0.0,15
17577,4546,Game Packs,10,0,0.0,10
17578,4546,Kits,4,0,0.0,4
17579,4546,Stuff Packs,14,0,0.0,14
17580,4547,Expansion Packs,4,0,0.0,4
17581,4547,Game Packs,2,0,0.0,2
17582,4547,Kits,2,2,1.0,0
17583,4547,Stuff Packs,3,2,0.6666666666666666,1
17584,4548,Expansion Packs,16,0,0.0,16
17585,4548,Game Packs,12,0,0.0,12
17586,4548,Kits,26,0,0.0,26
17587,4548,Stuff Packs,19,1,0.05263157894736842,18
17588,4549,Expansion Packs,8,0,0.0,8
17589,4549,Game Packs,7,0,0.0,7
17590,4549,Kits,5,1,0.2,4
17591,4549,Stuff Packs,10,2,0.2,8
17592,4550,Expansion Packs,14,0,0.0,14
17593,4550,Game Packs,12,0,0.0,12
17594,4550,Kits,15,2,0.13333333333333333,13
17595,4550,Stuff Packs,17,1,0.058823529411764705,16
17596,4551,Expansion Packs,11,0,0.0,11
17597,4551,Game Packs,7,0,0.0,7
17598,4551,Kits,1,0,0.0,1
17599,4551,Stuff Packs,4,0,0.0,4
17600,4552,Expansion Packs,11,0,0.0,11
17601,4552,Game Packs,4,1,0.25,3
17602,4552,Kits,6,1,0.16666666666666666,5
17603,4552,Stuff Packs,9,4,0.4444444444444444,5
17604,4553,Expansion Packs,6,0,0.0,6
17605,4553,Game Packs,3,0,0.0,3
17606,4553,Kits,2,1,0.5,1
17607,4553,Stuff Packs,6,2,0.3333333333333333,4
17608,4554,Expansion Packs,5,0,0.0,5
17609,4554,Game Packs,6,0,0.0,6
17610,4554,Kits,1,0,0.0,1
17611,4554,Stuff Packs,7,0,0.0,7
17612,4555,Expansion Packs,12,1,0.08333333333333333,11
17613,4555,Game Packs,7,1,0.14285714285714285,6
17614,4555,Kits,4,2,0.5,2
17615,4555,Stuff Packs,11,4,0.36363636363636365,7
17616,4556,Expansion Packs,4,0,0.0,4
17617,4556,Game Packs,3,1,0.3333333333333333,2
17618,4556,Kits,5,3,0.6,2
17619,4556,Stuff Packs,4,3,0.75,1
17620,4557,Expansion Packs,14,0,0.0,14
17621,4557,Game Packs,10,0,0.0,10
17622,4557,Kits,7,1,0.14285714285714285,6
17623,4557,Stuff Packs,15,3,0.2,12
17624,4558,Expansion Packs,14,0,0.0,14
17625,4558,Game Packs,6,1,0.16666666666666666,5
17626,4558,Kits,16,1,0.0625,15
17627,4558,Stuff Packs,11,4,0.36363636363636365,7
17628,4559,Expansion Packs,16,1,0.0625,15
17629,4559,Game Packs,12,0,0.0,12
17630,4559,Kits,33,0,0.0,33
17631,4559,Stuff Packs,20,0,0.0,20
17632,4560,Expansion Packs,15,0,0.0,15
17633,4560,Game Packs,5,1,0.2,4
17634,4560,Kits,1,1,1.0,0
17635,4560,Stuff Packs,5,2,0.4,3
17636,4561,Expansion Packs,11,1,0.09090909090909091,10
17637,4561,Game Packs,6,0,0.0,6
17638,4561,Stuff Packs,6,0,0.0,6
17639,4562,Expansion Packs,15,0,0.0,15
17640,4562,Game Packs,5,0,0.0,5
17641,4562,Kits,5,1,0.2,4
17642,4562,Stuff Packs,8,3,0.375,5
17643,4563,Expansion Packs,16,0,0.0,16
17644,4563,Game Packs,12,0,0.0,12
17645,4563,Kits,33,1,0.030303030303030304,32
17646,4563,Stuff Packs,20,0,0.0,20
17647,4564,Expansion Packs,15,0,0.0,15
17648,4564,Game Packs,6,0,0.0,6
17649,4564,Kits,1,0,0.0,1
17650,4564,Stuff Packs,9,0,0.0,9
17651,4565,Expansion Packs,11,0,0.0,11
17652,4565,Game Packs,7,1,0.14285714285714285,6
17653,4565,Kits,4,2,0.5,2
17654,4565,Stuff Packs,12,1,0.08333333333333333,11
17655,4566,Expansion Packs,14,0,0.0,14
17656,4566,Game Packs,9,0,0.0,9
17657,4566,Kits,6,0,0.0,6
17658,4566,Stuff Packs,18,0,0.0,18
17659,4567,Expansion Packs,16,0,0.0,16
17660,4567,Game Packs,11,0,0.0,11
17661,4567,Kits,26,0,0.0,26
17662,4567,Stuff Packs,20,0,0.0,20
17663,4568,Expansion Packs,16,0,0.0,16
17664,4568,Game Packs,11,0,0.0,11
17665,4568,Kits,12,1,0.08333333333333333,11
17666,4568,Stuff Packs,20,1,0.05,19
17667,4569,Expansion Packs,13,0,0.0,13
17668,4569,Game Packs,8,0,0.0,8
17669,4569,Kits,7,2,0.2857142857142857,5
17670,4569,Stuff Packs,11,5,0.45454545454545453,6
17671,4570,Expansion Packs,12,0,0.0,12
17672,4570,Game Packs,6,1,0.16666666666666666,5
17673,4570,Kits,5,4,0.8,1
17674,4570,Stuff Packs,7,4,0.5714285714285714,3
17675,4571,Expansion Packs,6,0,0.0,6
17676,4571,Kits,3,1,0.3333333333333333,2
17677,4571,Stuff Packs,1,0,0.0,1
17678,4572,Expansion Packs,16,0,0.0,16
17679,4572,Game Packs,12,0,0.0,12
17680,4572,Kits,33,1,0.030303030303030304,32
17681,4572,Stuff Packs,20,0,0.0,20
17682,4573,Expansion Packs,16,0,0.0,16
17683,4573,Game Packs,12,0,0.0,12
17684,4573,Kits,33,0,0.0,33
17685,4573,Stuff Packs,20,0,0.0,20
17686,4574,Expansion Packs,16,0,0.0,16
17687,4574,Game Packs,11,0,0.0,11
17688,4574,Kits,31,1,0.03225806451612903,30
17689,4574,Stuff Packs,20,1,0.05,19
17690,4575,Expansion Packs,8,0,0.0,8
17691,4575,Game Packs,3,1,0.3333333333333333,2
17692,4575,Kits,2,1,0.5,1
17693,4575,Stuff Packs,6,3,0.5,3
17694,4576,Expansion Packs,12,0,0.0,12
17695,4576,Game Packs,5,0,0.0,5
17696,4576,Kits,1,0,0.0,1
17697,4576,Stuff Packs,8,1,0.125,7
17698,4577,Expansion Packs,15,0,0.0,15
17699,4577,Game Packs,10,0,0.0,10
17700,4577,Kits,10,0,0.0,10
17701,4577,Stuff Packs,14,0,0.0,14
17702,4578,Expansion Packs,16,0,0.0,16
17703,4578,Game Packs,12,0,0.0,12
17704,4578,Kits,29,1,0.034482758620689655,28
17705,4578,Stuff Packs,20,0,0.0,20
17706,4579,Expansion Packs,10,1,0.1,9
17707,4579,Game Packs,5,0,0.0,5
17708,4579,Kits,1,1,1.0,0
17709,4579,Stuff Packs,6,1,0.16666666666666666,5
17710,4580,Expansion Packs,15,0,0.0,15
17711,4580,Game Packs,12,0,0.0,12
17712,4580,Kits,14,0,0.0,14
17713,4580,Stuff Packs,18,0,0.0,18
17714,4581,Expansion Packs,16,0,0.0,16
17715,4581,Game Packs,12,1,0.08333333333333333,11
17716,4581,Kits,33,29,0.8787878787878788,4
17717,4581,Stuff Packs,20,4,0.2,16
17718,4582,Expansion Packs,10,0,0.0,10
17719,4582,Game Packs,2,0,0.0,2
17720,4582,Kits,2,1,0.5,1
17721,4582,Stuff Packs,4,0,0.0,4
17722,4583,Expansion Packs,14,0,0.0,14
17723,4583,Game Packs,12,0,0.0,12
17724,4583,Kits,10,1,0.1,9
17725,4583,Stuff Packs,18,0,0.0,18
17726,4584,Expansion Packs,16,0,0.0,16
17727,4584,Game Packs,11,0,0.0,11
17728,4584,Kits,17,2,0.11764705882352941,15
17729,4584,Stuff Packs,19,0,0.0,19
17730,4585,Expansion Packs,14,0,0.0,14
17731,4585,Game Packs,6,0,0.0,6
17732,4585,Kits,9,1,0.1111111111111111,8
17733,4585,Stuff Packs,11,5,0.45454545454545453,6
17734,4586,Expansion Packs,16,0,0.0,16
17735,4586,Game Packs,12,2,0.16666666666666666,10
17736,4586,Kits,33,1,0.030303030303030304,32
17737,4586,Stuff Packs,20,2,0.1,18
17738,4587,Expansion Packs,16,1,0.0625,15
17739,4587,Game Packs,10,0,0.0,10
17740,4587,Kits,14,0,0.0,14
17741,4587,Stuff Packs,15,0,0.0,15
17742,4588,Expansion Packs,16,0,0.0,16
17743,4588,Game Packs,9,0,0.0,9
17744,4588,Kits,10,1,0.1,9
17745,4588,Stuff Packs,15,2,0.13333333333333333,13
17746,4589,Expansion Packs,16,0,0.0,16
17747,4589,Game Packs,12,0,0.0,12
17748,4589,Kits,33,0,0.0,33
17749,4589,Stuff Packs,20,1,0.05,19
17750,4590,Expansion Packs,5,0,0.0,5
17751,4590,Game Packs,4,0,0.0,4
17752,4590,Kits,5,2,0.4,3
17753,4590,Stuff Packs,7,3,0.42857142857142855,4
17754,4591,Expansion Packs,16,0,0.0,16
17755,4591,Game Packs,11,0,0.0,11
17756,4591,Kits,8,3,0.375,5
17757,4591,Stuff Packs,20,0,0.0,20
17758,4592,Expansion Packs,15,1,0.06666666666666667,14
17759,4592,Game Packs,9,0,0.0,9
17760,4592,Kits,2,1,0.5,1
17761,4592,Stuff Packs,14,6,0.42857142857142855,8
17762,4593,Expansion Packs,8,0,0.0,8
17763,4593,Game Packs,4,0,0.0,4
17764,4593,Kits,6,0,0.0,6
17765,4593,Stuff Packs,5,2,0.4,3
17766,4594,Expansion Packs,15,0,0.0,15
17767,4594,Game Packs,5,0,0.0,5
17768,4594,Kits,5,0,0.0,5
17769,4594,Stuff Packs,8,0,0.0,8
17770,4595,Expansion Packs,10,0,0.0,10
17771,4595,Game Packs,6,0,0.0,6
17772,4595,Kits,3,1,0.3333333333333333,2
17773,4595,Stuff Packs,7,2,0.2857142857142857,5
17774,4596,Expansion Packs,7,0,0.0,7
17775,4596,Game Packs,6,0,0.0,6
17776,4596,Kits,6,2,0.3333333333333333,4
17777,4596,Stuff Packs,7,2,0.2857142857142857,5
17778,4597,Expansion Packs,5,0,0.0,5
17779,4597,Game Packs,4,1,0.25,3
17780,4597,Kits,6,3,0.5,3
17781,4597,Stuff Packs,7,3,0.42857142857142855,4
17782,4598,Expansion Packs,16,0,0.0,16
17783,4598,Game Packs,12,0,0.0,12
17784,4598,Kits,33,3,0.09090909090909091,30
17785,4598,Stuff Packs,20,2,0.1,18
17786,4599,Expansion Packs,16,0,0.0,16
17787,4599,Game Packs,12,0,0.0,12
17788,4599,Kits,33,0,0.0,33
17789,4599,Stuff Packs,20,0,0.0,20
17790,4600,Expansion Packs,6,0,0.0,6
17791,4600,Game Packs,3,0,0.0,3
17792,4600,Kits,6,2,0.3333333333333333,4
17793,4600,Stuff Packs,5,2,0.4,3
17794,4601,Expansion Packs,13,0,0.0,13
17795,4601,Game Packs,10,2,0.2,8
17796,4601,Kits,14,3,0.21428571428571427,11
17797,4601,Stuff Packs,15,4,0.26666666666666666,11
17798,4602,Expansion Packs,12,0,0.0,12
17799,4602,Game Packs,8,0,0.0,8
17800,4602,Kits,2,2,1.0,0
17801,4602,Stuff Packs,14,0,0.0,14
17802,4603,Expansion Packs,15,0,0.0,15
17803,4603,Game Packs,9,0,0.0,9
17804,4603,Kits,3,0,0.0,3
17805,4603,Stuff Packs,2,0,0.0,2
17806,4604,Expansion Packs,5,0,0.0,5
17807,4604,Game Packs,3,1,0.3333333333333333,2
17808,4604,Kits,5,1,0.2,4
17809,4604,Stuff Packs,7,2,0.2857142857142857,5
17810,4605,Expansion Packs,16,0,0.0,16
17811,4605,Game Packs,11,0,0.0,11
17812,4605,Kits,17,0,0.0,17
17813,4605,Stuff Packs,19,0,0.0,19
17814,4606,Expansion Packs,16,0,0.0,16
17815,4606,Game Packs,12,0,0.0,12
17816,4606,Kits,20,1,0.05,19
17817,4606,Stuff Packs,19,1,0.05263157894736842,18
17818,4607,Expansion Packs,16,0,0.0,16
17819,4607,Game Packs,12,0,0.0,12
17820,4607,Kits,33,0,0.0,33
17821,4607,Stuff Packs,20,0,0.0,20
17822,4608,Expansion Packs,16,0,0.0,16
17823,4608,Game Packs,12,0,0.0,12
17824,4608,Kits,26,1,0.038461538461538464,25
17825,4608,Stuff Packs,20,0,0.0,20
17826,4609,Expansion Packs,11,0,0.0,11
17827,4609,Game Packs,4,0,0.0,4
17828,4609,Stuff Packs,4,2,0.5,2
17829,4610,Expansion Packs,16,0,0.0,16
17830,4610,Game Packs,12,0,0.0,12
17831,4610,Kits,33,0,0.0,33
17832,4610,Stuff Packs,20,0,0.0,20
17833,4611,Expansion Packs,16,0,0.0,16
17834,4612,Expansion Packs,12,0,0.0,12
17835,4612,Game Packs,7,0,0.0,7
17836,4612,Kits,6,2,0.3333333333333333,4
17837,4612,Stuff Packs,10,3,0.3,7
17838,4613,Expansion Packs,9,0,0.0,9
17839,4613,Game Packs,3,0,0.0,3
17840,4613,Kits,1,1,1.0,0
17841,4613,Stuff Packs,8,3,0.375,5
17842,4614,Expansion Packs,15,0,0.0,15
17843,4614,Game Packs,12,0,0.0,12
17844,4614,Kits,4,0,0.0,4
17845,4614,Stuff Packs,18,0,0.0,18
17846,4615,Expansion Packs,16,0,0.0,16
17847,4615,Game Packs,11,1,0.09090909090909091,10
17848,4615,Kits,32,0,0.0,32
17849,4615,Stuff Packs,20,0,0.0,20
17850,4616,Expansion Packs,9,0,0.0,9
17851,4616,Game Packs,5,1,0.2,4
17852,4616,Kits,2,2,1.0,0
17853,4616,Stuff Packs,6,3,0.5,3
17854,4617,Expansion Packs,16,0,0.0,16
17855,4617,Game Packs,4,0,0.0,4
17856,4617,Kits,7,1,0.14285714285714285,6
17857,4617,Stuff Packs,10,3,0.3,7
17858,4618,Expansion Packs,16,0,0.0,16
17859,4618,Game Packs,12,0,0.0,12
17860,4618,Kits,33,0,0.0,33
17861,4618,Stuff Packs,20,0,0.0,20
17862,4619,Expansion Packs,9,0,0.0,9
17863,4619,Game Packs,6,0,0.0,6
17864,4619,Kits,1,0,0.0,1
17865,4619,Stuff Packs,6,2,0.3333333333333333,4
17866,4620,Expansion Packs,2,0,0.0,2
17867,4620,Game Packs,1,0,0.0,1
17868,4620,Stuff Packs,3,1,0.3333333333333333,2
17869,4621,Expansion Packs,16,0,0.0,16
17870,4621,Game Packs,12,0,0.0,12
17871,4621,Kits,31,0,0.0,31
17872,4621,Stuff Packs,20,0,0.0,20
17873,4622,Expansion Packs,7,0,0.0,7
17874,4622,Game Packs,4,0,0.0,4
17875,4622,Kits,3,1,0.3333333333333333,2
17876,4622,Stuff Packs,6,2,0.3333333333333333,4
17877,4623,Expansion Packs,16,0,0.0,16
17878,4623,Game Packs,12,0,0.0,12
17879,4623,Kits,4,3,0.75,1
17880,4623,Stuff Packs,15,1,0.06666666666666667,14
17881,4624,Expansion Packs,6,0,0.0,6
17882,4624,Game Packs,4,0,0.0,4
17883,4624,Kits,13,1,0.07692307692307693,12
17884,4624,Stuff Packs,10,3,0.3,7
17885,4625,Expansion Packs,2,0,0.0,2
17886,4625,Kits,3,1,0.3333333333333333,2
17887,4626,Expansion Packs,12,0,0.0,12
17888,4626,Game Packs,9,0,0.0,9
17889,4626,Kits,15,2,0.13333333333333333,13
17890,4626,Stuff Packs,15,4,0.26666666666666666,11
17891,4627,Expansion Packs,16,0,0.0,16
17892,4627,Game Packs,12,0,0.0,12
17893,4627,Kits,20,1,0.05,19
17894,4627,Stuff Packs,20,0,0.0,20
17895,4628,Expansion Packs,15,0,0.0,15
17896,4628,Game Packs,11,0,0.0,11
17897,4628,Kits,27,0,0.0,27
17898,4628,Stuff Packs,18,0,0.0,18
17899,4629,Expansion Packs,16,2,0.125,14
17900,4629,Game Packs,12,2,0.16666666666666666,10
17901,4629,Kits,33,3,0.09090909090909091,30
17902,4629,Stuff Packs,20,3,0.15,17
17903,4630,Expansion Packs,16,0,0.0,16
17904,4630,Game Packs,12,0,0.0,12
17905,4630,Kits,33,0,0.0,33
17906,4630,Stuff Packs,20,0,0.0,20
17907,4631,Expansion Packs,15,0,0.0,15
17908,4631,Game Packs,11,0,0.0,11
17909,4631,Kits,6,0,0.0,6
17910,4631,Stuff Packs,15,0,0.0,15
17911,4632,Expansion Packs,6,0,0.0,6
17912,4632,Game Packs,3,0,0.0,3
17913,4632,Kits,7,0,0.0,7
17914,4632,Stuff Packs,12,0,0.0,12
17915,4633,Expansion Packs,16,0,0.0,16
17916,4633,Game Packs,12,0,0.0,12
17917,4633,Kits,33,0,0.0,33
17918,4633,Stuff Packs,20,0,0.0,20
17919,4634,Expansion Packs,15,0,0.0,15
17920,4634,Game Packs,12,0,0.0,12
17921,4634,Kits,17,2,0.11764705882352941,15
17922,4634,Stuff Packs,18,3,0.16666666666666666,15
17923,4635,Expansion Packs,16,0,0.0,16
17924,4635,Game Packs,12,0,0.0,12
17925,4635,Kits,33,2,0.06060606060606061,31
17926,4635,Stuff Packs,20,2,0.1,18
17927,4636,Expansion Packs,9,0,0.0,9
17928,4636,Game Packs,5,0,0.0,5
17929,4636,Kits,2,0,0.0,2
17930,4636,Stuff Packs,6,0,0.0,6
17931,4637,Expansion Packs,9,0,0.0,9
17932,4637,Game Packs,4,1,0.25,3
17933,4637,Kits,3,1,0.3333333333333333,2
17934,4637,Stuff Packs,6,2,0.3333333333333333,4
17935,4638,Expansion Packs,15,0,0.0,15
17936,4638,Game Packs,11,0,0.0,11
17937,4638,Kits,9,1,0.1111111111111111,8
17938,4638,Stuff Packs,12,3,0.25,9
17939,4639,Expansion Packs,14,0,0.0,14
17940,4639,Game Packs,9,0,0.0,9
17941,4639,Kits,6,1,0.16666666666666666,5
17942,4639,Stuff Packs,8,2,0.25,6
17943,4640,Expansion Packs,16,0,0.0,16
17944,4640,Game Packs,12,0,0.0,12
17945,4640,Kits,20,0,0.0,20
17946,4640,Stuff Packs,20,0,0.0,20
17947,4641,Expansion Packs,6,0,0.0,6
17948,4641,Game Packs,3,1,0.3333333333333333,2
17949,4641,Kits,3,3,1.0,0
17950,4641,Stuff Packs,5,4,0.8,1
17951,4642,Expansion Packs,12,0,0.0,12
17952,4642,Game Packs,7,0,0.0,7
17953,4642,Kits,2,0,0.0,2
17954,4642,Stuff Packs,7,3,0.42857142857142855,4
17955,4643,Expansion Packs,13,0,0.0,13
17956,4643,Game Packs,8,0,0.0,8
17957,4643,Kits,8,1,0.125,7
17958,4643,Stuff Packs,18,2,0.1111111111111111,16
17959,4644,Expansion Packs,11,0,0.0,11
17960,4644,Game Packs,5,0,0.0,5
17961,4644,Kits,7,1,0.14285714285714285,6
17962,4644,Stuff Packs,12,2,0.16666666666666666,10
17963,4645,Expansion Packs,13,0,0.0,13
17964,4645,Game Packs,10,0,0.0,10
17965,4645,Kits,8,1,0.125,7
17966,4645,Stuff Packs,18,1,0.05555555555555555,17
17967,4646,Expansion Packs,16,0,0.0,16
17968,4646,Game Packs,12,0,0.0,12
17969,4646,Kits,33,1,0.030303030303030304,32
17970,4646,Stuff Packs,20,0,0.0,20
17971,4647,Expansion Packs,16,0,0.0,16
17972,4647,Game Packs,12,0,0.0,12
17973,4647,Kits,30,0,0.0,30
17974,4647,Stuff Packs,17,1,0.058823529411764705,16
17975,4648,Expansion Packs,13,0,0.0,13
17976,4648,Game Packs,9,0,0.0,9
17977,4648,Kits,3,1,0.3333333333333333,2
17978,4648,Stuff Packs,7,2,0.2857142857142857,5
17979,4649,Expansion Packs,16,0,0.0,16
17980,4649,Game Packs,12,0,0.0,12
17981,4649,Kits,33,1,0.030303030303030304,32
17982,4649,Stuff Packs,20,0,0.0,20
17983,4650,Expansion Packs,10,0,0.0,10
17984,4650,Game Packs,6,0,0.0,6
17985,4650,Kits,3,3,1.0,0
17986,4650,Stuff Packs,5,4,0.8,1
17987,4651,Expansion Packs,8,0,0.0,8
17988,4651,Game Packs,1,0,0.0,1
17989,4651,Kits,2,2,1.0,0
17990,4651,Stuff Packs,5,3,0.6,2
17991,4652,Expansion Packs,14,0,0.0,14
17992,4652,Game Packs,9,0,0.0,9
17993,4652,Stuff Packs,19,0,0.0,19
17994,4653,Expansion Packs,16,0,0.0,16
17995,4653,Game Packs,11,0,0.0,11
17996,4653,Kits,14,0,0.0,14
17997,4653,Stuff Packs,16,1,0.0625,15
17998,4654,Expansion Packs,16,0,0.0,16
17999,4654,Game Packs,10,0,0.0,10
18000,4654,Kits,5,2,0.4,3
18001,4654,Stuff Packs,15,0,0.0,15
18002,4655,Expansion Packs,15,0,0.0,15
18003,4655,Game Packs,8,0,0.0,8
18004,4655,Kits,5,0,0.0,5
18005,4655,Stuff Packs,6,0,0.0,6
18006,4656,Expansion Packs,16,0,0.0,16
18007,4656,Game Packs,11,0,0.0,11
18008,4656,Kits,32,1,0.03125,31
18009,4656,Stuff Packs,20,0,0.0,20
18010,4657,Expansion Packs,8,0,0.0,8
18011,4657,Game Packs,3,0,0.0,3
18012,4657,Kits,1,1,1.0,0
18013,4657,Stuff Packs,7,2,0.2857142857142857,5
18014,4658,Expansion Packs,13,0,0.0,13
18015,4658,Game Packs,7,0,0.0,7
18016,4658,Kits,1,0,0.0,1
18017,4658,Stuff Packs,6,2,0.3333333333333333,4
18018,4659,Expansion Packs,2,0,0.0,2
18019,4660,Expansion Packs,8,0,0.0,8
18020,4660,Game Packs,3,0,0.0,3
18021,4660,Kits,1,0,0.0,1
18022,4660,Stuff Packs,3,0,0.0,3
18023,4661,Expansion Packs,11,0,0.0,11
18024,4661,Game Packs,8,1,0.125,7
18025,4661,Kits,6,0,0.0,6
18026,4661,Stuff Packs,9,0,0.0,9
18027,4662,Expansion Packs,16,0,0.0,16
18028,4662,Game Packs,10,0,0.0,10
18029,4662,Kits,20,0,0.0,20
18030,4662,Stuff Packs,19,0,0.0,19
18031,4663,Expansion Packs,15,0,0.0,15
18032,4663,Game Packs,6,0,0.0,6
18033,4663,Kits,16,1,0.0625,15
18034,4663,Stuff Packs,8,4,0.5,4
18035,4664,Expansion Packs,14,0,0.0,14
18036,4664,Game Packs,3,0,0.0,3
18037,4664,Kits,7,1,0.14285714285714285,6
18038,4664,Stuff Packs,7,3,0.42857142857142855,4
18039,4665,Expansion Packs,12,0,0.0,12
18040,4665,Game Packs,9,0,0.0,9
18041,4665,Kits,2,0,0.0,2
18042,4665,Stuff Packs,18,1,0.05555555555555555,17
18043,4666,Expansion Packs,10,0,0.0,10
18044,4666,Game Packs,6,0,0.0,6
18045,4666,Kits,6,1,0.16666666666666666,5
18046,4666,Stuff Packs,5,2,0.4,3
18047,4667,Expansion Packs,10,0,0.0,10
18048,4667,Game Packs,6,0,0.0,6
18049,4667,Kits,2,0,0.0,2
18050,4667,Stuff Packs,10,0,0.0,10
18051,4668,Expansion Packs,16,0,0.0,16
18052,4668,Game Packs,11,0,0.0,11
18053,4668,Kits,32,1,0.03125,31
18054,4668,Stuff Packs,20,1,0.05,19
18055,4669,Expansion Packs,9,0,0.0,9
18056,4669,Game Packs,3,0,0.0,3
18057,4669,Kits,1,1,1.0,0
18058,4669,Stuff Packs,4,3,0.75,1
18059,4670,Expansion Packs,14,0,0.0,14
18060,4670,Game Packs,11,0,0.0,11
18061,4670,Kits,3,3,1.0,0
18062,4670,Stuff Packs,15,1,0.06666666666666667,14
18063,4671,Expansion Packs,4,0,0.0,4
18064,4671,Game Packs,4,0,0.0,4
18065,4671,Kits,4,2,0.5,2
18066,4671,Stuff Packs,6,3,0.5,3
18067,4672,Expansion Packs,16,0,0.0,16
18068,4672,Game Packs,12,0,0.0,12
18069,4672,Kits,33,0,0.0,33
18070,4672,Stuff Packs,20,0,0.0,20
18071,4673,Expansion Packs,16,0,0.0,16
18072,4673,Game Packs,12,0,0.0,12
18073,4673,Kits,19,0,0.0,19
18074,4673,Stuff Packs,20,0,0.0,20
18075,4674,Expansion Packs,16,0,0.0,16
18076,4674,Game Packs,12,0,0.0,12
18077,4674,Kits,31,0,0.0,31
18078,4674,Stuff Packs,20,0,0.0,20
18079,4675,Expansion Packs,15,0,0.0,15
18080,4675,Game Packs,11,0,0.0,11
18081,4675,Kits,13,1,0.07692307692307693,12
18082,4675,Stuff Packs,18,0,0.0,18
18083,4676,Expansion Packs,9,0,0.0,9
18084,4676,Game Packs,5,0,0.0,5
18085,4676,Kits,7,2,0.2857142857142857,5
18086,4676,Stuff Packs,12,3,0.25,9
18087,4677,Expansion Packs,16,0,0.0,16
18088,4677,Game Packs,12,0,0.0,12
18089,4677,Kits,22,1,0.045454545454545456,21
18090,4677,Stuff Packs,19,2,0.10526315789473684,17
18091,4678,Expansion Packs,15,0,0.0,15
18092,4678,Game Packs,11,0,0.0,11
18093,4678,Kits,12,1,0.08333333333333333,11
18094,4678,Stuff Packs,20,0,0.0,20
18095,4679,Expansion Packs,14,0,0.0,14
18096,4679,Game Packs,9,0,0.0,9
18097,4679,Kits,24,1,0.041666666666666664,23
18098,4679,Stuff Packs,20,0,0.0,20
18099,4680,Expansion Packs,16,0,0.0,16
18100,4680,Game Packs,12,0,0.0,12
18101,4680,Kits,33,0,0.0,33
18102,4680,Stuff Packs,20,0,0.0,20
18103,4681,Expansion Packs,16,0,0.0,16
18104,4681,Game Packs,12,1,0.08333333333333333,11
18105,4681,Kits,16,1,0.0625,15
18106,4681,Stuff Packs,19,2,0.10526315789473684,17
18107,4682,Expansion Packs,10,0,0.0,10
18108,4682,Game Packs,2,0,0.0,2
18109,4682,Kits,2,0,0.0,2
18110,4682,Stuff Packs,2,0,0.0,2
18111,4683,Expansion Packs,16,0,0.0,16
18112,4683,Game Packs,12,0,0.0,12
18113,4683,Kits,33,1,0.030303030303030304,32
18114,4683,Stuff Packs,20,0,0.0,20
18115,4684,Expansion Packs,14,0,0.0,14
18116,4684,Game Packs,10,0,0.0,10
18117,4684,Kits,12,0,0.0,12
18118,4684,Stuff Packs,20,1,0.05,19
18119,4685,Expansion Packs,6,0,0.0,6
18120,4685,Game Packs,2,0,0.0,2
18121,4685,Kits,2,2,1.0,0
18122,4685,Stuff Packs,4,3,0.75,1
18123,4686,Expansion Packs,16,0,0.0,16
18124,4686,Game Packs,11,0,0.0,11
18125,4686,Kits,22,0,0.0,22
18126,4686,Stuff Packs,18,0,0.0,18
18127,4687,Expansion Packs,16,0,0.0,16
18128,4687,Game Packs,12,0,0.0,12
18129,4687,Kits,33,0,0.0,33
18130,4687,Stuff Packs,20,0,0.0,20
18131,4688,Expansion Packs,14,0,0.0,14
18132,4688,Game Packs,11,0,0.0,11
18133,4688,Kits,12,0,0.0,12
18134,4688,Stuff Packs,18,0,0.0,18
18135,4689,Expansion Packs,16,0,0.0,16
18136,4689,Game Packs,12,0,0.0,12
18137,4689,Kits,33,0,0.0,33
18138,4689,Stuff Packs,20,0,0.0,20
18139,4690,Expansion Packs,13,0,0.0,13
18140,4690,Game Packs,7,1,0.14285714285714285,6
18141,4690,Kits,2,0,0.0,2
18142,4690,Stuff Packs,4,2,0.5,2
18143,4691,Expansion Packs,16,0,0.0,16
18144,4691,Game Packs,12,0,0.0,12
18145,4691,Kits,33,1,0.030303030303030304,32
18146,4691,Stuff Packs,20,0,0.0,20
18147,4692,Expansion Packs,2,0,0.0,2
18148,4692,Game Packs,3,1,0.3333333333333333,2
18149,4692,Kits,1,1,1.0,0
18150,4692,Stuff Packs,4,2,0.5,2
18151,4693,Expansion Packs,14,0,0.0,14
18152,4693,Game Packs,10,0,0.0,10
18153,4693,Kits,3,3,1.0,0
18154,4693,Stuff Packs,13,1,0.07692307692307693,12
18155,4694,Expansion Packs,16,0,0.0,16
18156,4694,Game Packs,7,0,0.0,7
18157,4694,Kits,10,2,0.2,8
18158,4694,Stuff Packs,14,2,0.14285714285714285,12
18159,4695,Expansion Packs,11,0,0.0,11
18160,4695,Game Packs,3,0,0.0,3
18161,4695,Stuff Packs,4,3,0.75,1
18162,4696,Expansion Packs,16,0,0.0,16
18163,4696,Game Packs,11,0,0.0,11
18164,4696,Kits,28,0,0.0,28
18165,4696,Stuff Packs,20,0,0.0,20
18166,4697,Expansion Packs,11,0,0.0,11
18167,4697,Game Packs,7,0,0.0,7
18168,4697,Kits,20,1,0.05,19
18169,4697,Stuff Packs,13,0,0.0,13
18170,4698,Expansion Packs,9,0,0.0,9
18171,4698,Game Packs,3,1,0.3333333333333333,2
18172,4698,Kits,1,1,1.0,0
18173,4698,Stuff Packs,6,4,0.6666666666666666,2
18174,4699,Expansion Packs,16,0,0.0,16
18175,4699,Game Packs,7,0,0.0,7
18176,4699,Kits,7,2,0.2857142857142857,5
18177,4699,Stuff Packs,9,3,0.3333333333333333,6
18178,4700,Expansion Packs,16,0,0.0,16
18179,4700,Game Packs,12,0,0.0,12
18180,4700,Kits,31,1,0.03225806451612903,30
18181,4700,Stuff Packs,20,0,0.0,20
18182,4701,Expansion Packs,9,0,0.0,9
18183,4701,Game Packs,7,1,0.14285714285714285,6
18184,4701,Kits,1,1,1.0,0
18185,4701,Stuff Packs,9,3,0.3333333333333333,6
18186,4702,Expansion Packs,13,0,0.0,13
18187,4702,Game Packs,12,0,0.0,12
18188,4702,Kits,8,2,0.25,6
18189,4702,Stuff Packs,17,1,0.058823529411764705,16
18190,4703,Expansion Packs,16,0,0.0,16
18191,4703,Game Packs,12,0,0.0,12
18192,4703,Kits,27,0,0.0,27
18193,4703,Stuff Packs,20,0,0.0,20
18194,4704,Expansion Packs,16,0,0.0,16
18195,4704,Game Packs,12,2,0.16666666666666666,10
18196,4704,Kits,31,0,0.0,31
18197,4704,Stuff Packs,20,0,0.0,20
18198,4705,Expansion Packs,16,0,0.0,16
18199,4705,Game Packs,12,0,0.0,12
18200,4705,Kits,21,1,0.047619047619047616,20
18201,4705,Stuff Packs,20,0,0.0,20
18202,4706,Expansion Packs,1,0,0.0,1
18203,4706,Game Packs,1,0,0.0,1
18204,4706,Stuff Packs,2,1,0.5,1
18205,4707,Expansion Packs,10,1,0.1,9
18206,4707,Game Packs,2,0,0.0,2
18207,4707,Kits,2,0,0.0,2
18208,4707,Stuff Packs,4,0,0.0,4
18209,4708,Expansion Packs,10,0,0.0,10
18210,4708,Game Packs,7,0,0.0,7
18211,4708,Kits,1,1,1.0,0
18212,4708,Stuff Packs,12,2,0.16666666666666666,10
18213,4709,Expansion Packs,10,0,0.0,10
18214,4709,Game Packs,10,1,0.1,9
18215,4709,Kits,7,1,0.14285714285714285,6
18216,4709,Stuff Packs,14,4,0.2857142857142857,10
18217,4710,Expansion Packs,11,0,0.0,11
18218,4710,Game Packs,2,0,0.0,2
18219,4710,Kits,3,2,0.6666666666666666,1
18220,4710,Stuff Packs,6,3,0.5,3
18221,4711,Expansion Packs,16,0,0.0,16
18222,4711,Game Packs,11,0,0.0,11
18223,4711,Kits,32,2,0.0625,30
18224,4711,Stuff Packs,20,0,0.0,20
18225,4712,Expansion Packs,11,0,0.0,11
18226,4712,Game Packs,10,0,0.0,10
18227,4712,Kits,4,2,0.5,2
18228,4712,Stuff Packs,14,1,0.07142857142857142,13
18229,4713,Expansion Packs,16,0,0.0,16
18230,4713,Game Packs,12,0,0.0,12
18231,4713,Kits,33,0,0.0,33
18232,4713,Stuff Packs,20,0,0.0,20
18233,4714,Expansion Packs,15,1,0.06666666666666667,14
18234,4714,Game Packs,5,0,0.0,5
18235,4714,Kits,3,1,0.3333333333333333,2
18236,4714,Stuff Packs,8,0,0.0,8
18237,4715,Expansion Packs,8,8,1.0,0
18238,4715,Game Packs,3,3,1.0,0
18239,4715,Kits,1,1,1.0,0
18240,4715,Stuff Packs,3,3,1.0,0
18241,4716,Expansion Packs,16,0,0.0,16
18242,4716,Game Packs,12,0,0.0,12
18243,4716,Kits,33,0,0.0,33
18244,4716,Stuff Packs,20,0,0.0,20
18245,4717,Expansion Packs,16,0,0.0,16
18246,4717,Game Packs,10,0,0.0,10
18247,4717,Kits,11,0,0.0,11
18248,4717,Stuff Packs,16,0,0.0,16
18249,4718,Expansion Packs,14,0,0.0,14
18250,4718,Game Packs,3,1,0.3333333333333333,2
18251,4718,Kits,3,1,0.3333333333333333,2
18252,4718,Stuff Packs,8,4,0.5,4
18253,4719,Expansion Packs,12,0,0.0,12
18254,4719,Game Packs,4,0,0.0,4
18255,4719,Kits,3,1,0.3333333333333333,2
18256,4719,Stuff Packs,13,2,0.15384615384615385,11
18257,4720,Expansion Packs,16,0,0.0,16
18258,4720,Game Packs,12,0,0.0,12
18259,4720,Kits,22,2,0.09090909090909091,20
18260,4720,Stuff Packs,20,0,0.0,20
18261,4721,Expansion Packs,4,0,0.0,4
18262,4721,Game Packs,2,1,0.5,1
18263,4721,Kits,2,2,1.0,0
18264,4721,Stuff Packs,5,4,0.8,1
18265,4722,Expansion Packs,15,0,0.0,15
18266,4722,Game Packs,12,0,0.0,12
18267,4722,Kits,9,1,0.1111111111111111,8
18268,4722,Stuff Packs,20,0,0.0,20
18269,4723,Expansion Packs,4,0,0.0,4
18270,4723,Game Packs,4,0,0.0,4
18271,4723,Kits,2,2,1.0,0
18272,4723,Stuff Packs,3,0,0.0,3
18273,4724,Expansion Packs,14,0,0.0,14
18274,4724,Game Packs,8,1,0.125,7
18275,4724,Kits,3,3,1.0,0
18276,4724,Stuff Packs,8,4,0.5,4
18277,4725,Expansion Packs,16,0,0.0,16
18278,4725,Game Packs,12,0,0.0,12
18279,4725,Kits,33,0,0.0,33
18280,4725,Stuff Packs,20,0,0.0,20
18281,4726,Expansion Packs,15,0,0.0,15
18282,4726,Game Packs,4,0,0.0,4
18283,4726,Kits,3,0,0.0,3
18284,4726,Stuff Packs,5,1,0.2,4
18285,4727,Expansion Packs,16,0,0.0,16
18286,4727,Game Packs,12,0,0.0,12
18287,4727,Kits,20,1,0.05,19
18288,4727,Stuff Packs,18,1,0.05555555555555555,17
18289,4728,Expansion Packs,16,0,0.0,16
18290,4728,Game Packs,11,0,0.0,11
18291,4728,Kits,17,1,0.058823529411764705,16
18292,4728,Stuff Packs,17,0,0.0,17
18293,4729,Expansion Packs,16,0,0.0,16
18294,4729,Game Packs,10,0,0.0,10
18295,4729,Stuff Packs,18,4,0.2222222222222222,14
18296,4730,Expansion Packs,9,0,0.0,9
18297,4730,Game Packs,5,0,0.0,5
18298,4730,Kits,1,1,1.0,0
18299,4730,Stuff Packs,4,2,0.5,2
18300,4731,Expansion Packs,12,0,0.0,12
18301,4731,Game Packs,10,0,0.0,10
18302,4731,Stuff Packs,1,0,0.0,1
18303,4732,Expansion Packs,16,0,0.0,16
18304,4732,Game Packs,12,0,0.0,12
18305,4732,Kits,33,0,0.0,33
18306,4732,Stuff Packs,20,0,0.0,20
18307,4733,Expansion Packs,14,0,0.0,14
18308,4733,Game Packs,11,0,0.0,11
18309,4733,Kits,3,3,1.0,0
18310,4733,Stuff Packs,15,1,0.06666666666666667,14
18311,4734,Expansion Packs,13,0,0.0,13
18312,4734,Game Packs,11,0,0.0,11
18313,4734,Kits,4,1,0.25,3
18314,4734,Stuff Packs,17,0,0.0,17
18315,4735,Expansion Packs,14,0,0.0,14
18316,4735,Game Packs,8,0,0.0,8
18317,4735,Kits,5,0,0.0,5
18318,4735,Stuff Packs,14,1,0.07142857142857142,13
18319,4736,Expansion Packs,14,0,0.0,14
18320,4736,Game Packs,10,0,0.0,10
18321,4736,Kits,2,0,0.0,2
18322,4736,Stuff Packs,18,0,0.0,18
18323,4737,Expansion Packs,16,1,0.0625,15
18324,4737,Game Packs,11,0,0.0,11
18325,4737,Kits,5,1,0.2,4
18326,4737,Stuff Packs,19,0,0.0,19
18327,4738,Expansion Packs,16,0,0.0,16
18328,4738,Game Packs,12,0,0.0,12
18329,4738,Kits,21,0,0.0,21
18330,4738,Stuff Packs,20,0,0.0,20
18331,4739,Expansion Packs,9,0,0.0,9
18332,4739,Game Packs,4,2,0.5,2
18333,4739,Kits,3,2,0.6666666666666666,1
18334,4739,Stuff Packs,14,3,0.21428571428571427,11
18335,4740,Expansion Packs,16,0,0.0,16
18336,4740,Game Packs,12,0,0.0,12
18337,4740,Kits,33,0,0.0,33
18338,4740,Stuff Packs,20,0,0.0,20
18339,4741,Expansion Packs,8,0,0.0,8
18340,4741,Game Packs,6,0,0.0,6
18341,4741,Kits,5,2,0.4,3
18342,4741,Stuff Packs,11,3,0.2727272727272727,8
18343,4742,Expansion Packs,11,0,0.0,11
18344,4742,Game Packs,3,0,0.0,3
18345,4742,Kits,6,1,0.16666666666666666,5
18346,4742,Stuff Packs,9,1,0.1111111111111111,8
18347,4743,Expansion Packs,1,1,1.0,0
18348,4743,Game Packs,1,0,0.0,1
18349,4744,Expansion Packs,6,0,0.0,6
18350,4744,Game Packs,4,0,0.0,4
18351,4744,Kits,2,2,1.0,0
18352,4744,Stuff Packs,5,1,0.2,4
18353,4745,Expansion Packs,15,0,0.0,15
18354,4745,Game Packs,12,0,0.0,12
18355,4745,Kits,26,0,0.0,26
18356,4745,Stuff Packs,20,0,0.0,20
18357,4746,Expansion Packs,7,0,0.0,7
18358,4746,Game Packs,7,0,0.0,7
18359,4746,Kits,10,1,0.1,9
18360,4746,Stuff Packs,11,0,0.0,11
18361,4747,Expansion Packs,2,0,0.0,2
18362,4747,Stuff Packs,1,0,0.0,1
18363,4748,Expansion Packs,16,0,0.0,16
18364,4748,Game Packs,11,0,0.0,11
18365,4748,Kits,26,2,0.07692307692307693,24
18366,4748,Stuff Packs,20,0,0.0,20
18367,4749,Expansion Packs,10,0,0.0,10
18368,4749,Game Packs,9,1,0.1111111111111111,8
18369,4749,Kits,2,2,1.0,0
18370,4749,Stuff Packs,12,2,0.16666666666666666,10
18371,4750,Expansion Packs,14,1,0.07142857142857142,13
18372,4750,Game Packs,7,0,0.0,7
18373,4750,Kits,5,1,0.2,4
18374,4750,Stuff Packs,14,2,0.14285714285714285,12
18375,4751,Expansion Packs,7,0,0.0,7
18376,4751,Game Packs,2,0,0.0,2
18377,4751,Kits,1,1,1.0,0
18378,4751,Stuff Packs,3,3,1.0,0
18379,4752,Expansion Packs,16,0,0.0,16
18380,4752,Game Packs,11,0,0.0,11
18381,4752,Kits,15,1,0.06666666666666667,14
18382,4752,Stuff Packs,20,2,0.1,18
18383,4753,Expansion Packs,13,0,0.0,13
18384,4753,Game Packs,11,0,0.0,11
18385,4753,Kits,22,2,0.09090909090909091,20
18386,4753,Stuff Packs,17,2,0.11764705882352941,15
18387,4754,Expansion Packs,13,1,0.07692307692307693,12
18388,4754,Game Packs,11,0,0.0,11
18389,4754,Kits,3,1,0.3333333333333333,2
18390,4754,Stuff Packs,17,2,0.11764705882352941,15
18391,4755,Expansion Packs,14,0,0.0,14
18392,4755,Game Packs,8,1,0.125,7
18393,4755,Kits,9,2,0.2222222222222222,7
18394,4755,Stuff Packs,11,2,0.18181818181818182,9
18395,4756,Expansion Packs,7,0,0.0,7
18396,4756,Game Packs,2,1,0.5,1
18397,4756,Kits,3,3,1.0,0
18398,4756,Stuff Packs,4,4,1.0,0
18399,4757,Expansion Packs,15,0,0.0,15
18400,4757,Game Packs,10,0,0.0,10
18401,4757,Kits,17,1,0.058823529411764705,16
18402,4757,Stuff Packs,18,0,0.0,18
18403,4758,Expansion Packs,15,1,0.06666666666666667,14
18404,4758,Game Packs,12,1,0.08333333333333333,11
18405,4758,Kits,18,1,0.05555555555555555,17
18406,4758,Stuff Packs,20,1,0.05,19
18407,4759,Expansion Packs,10,0,0.0,10
18408,4759,Game Packs,5,0,0.0,5
18409,4759,Kits,4,1,0.25,3
18410,4759,Stuff Packs,7,1,0.14285714285714285,6
18411,4760,Expansion Packs,12,0,0.0,12
18412,4760,Game Packs,9,0,0.0,9
18413,4760,Kits,2,1,0.5,1
18414,4760,Stuff Packs,11,3,0.2727272727272727,8
18415,4761,Expansion Packs,15,0,0.0,15
18416,4761,Game Packs,9,0,0.0,9
18417,4761,Kits,7,1,0.14285714285714285,6
18418,4761,Stuff Packs,9,0,0.0,9
18419,4762,Expansion Packs,16,0,0.0,16
18420,4762,Game Packs,12,0,0.0,12
18421,4762,Kits,33,0,0.0,33
18422,4762,Stuff Packs,20,0,0.0,20
18423,4763,Expansion Packs,6,0,0.0,6
18424,4763,Game Packs,2,0,0.0,2
18425,4763,Stuff Packs,3,1,0.3333333333333333,2
18426,4764,Expansion Packs,6,1,0.16666666666666666,5
18427,4764,Game Packs,1,0,0.0,1
18428,4764,Kits,2,1,0.5,1
18429,4764,Stuff Packs,6,2,0.3333333333333333,4
18430,4765,Expansion Packs,4,0,0.0,4
18431,4765,Game Packs,3,0,0.0,3
18432,4765,Kits,1,1,1.0,0
18433,4765,Stuff Packs,2,2,1.0,0
18434,4766,Expansion Packs,4,0,0.0,4
18435,4766,Game Packs,2,0,0.0,2
18436,4766,Kits,3,2,0.6666666666666666,1
18437,4766,Stuff Packs,4,4,1.0,0
18438,4767,Expansion Packs,8,0,0.0,8
18439,4767,Game Packs,7,0,0.0,7
18440,4767,Kits,1,0,0.0,1
18441,4767,Stuff Packs,16,0,0.0,16
18442,4768,Expansion Packs,6,0,0.0,6
18443,4768,Game Packs,1,0,0.0,1
18444,4768,Kits,2,2,1.0,0
18445,4768,Stuff Packs,3,3,1.0,0
18446,4769,Expansion Packs,16,0,0.0,16
18447,4769,Game Packs,7,0,0.0,7
18448,4769,Kits,2,1,0.5,1
18449,4769,Stuff Packs,7,1,0.14285714285714285,6
18450,4770,Expansion Packs,16,0,0.0,16
18451,4770,Game Packs,10,0,0.0,10
18452,4770,Kits,20,1,0.05,19
18453,4770,Stuff Packs,20,0,0.0,20
18454,4771,Expansion Packs,4,1,0.25,3
18455,4771,Game Packs,1,0,0.0,1
18456,4771,Kits,1,1,1.0,0
18457,4771,Stuff Packs,3,0,0.0,3
18458,4772,Expansion Packs,4,0,0.0,4
18459,4772,Game Packs,2,0,0.0,2
18460,4772,Stuff Packs,3,0,0.0,3
18461,4773,Expansion Packs,11,0,0.0,11
18462,4773,Game Packs,8,2,0.25,6
18463,4773,Kits,3,3,1.0,0
18464,4773,Stuff Packs,13,3,0.23076923076923078,10
18465,4774,Expansion Packs,12,0,0.0,12
18466,4774,Game Packs,5,0,0.0,5
18467,4774,Kits,4,1,0.25,3
18468,4774,Stuff Packs,15,1,0.06666666666666667,14
18469,4775,Expansion Packs,16,0,0.0,16
18470,4775,Game Packs,12,0,0.0,12
18471,4775,Kits,30,0,0.0,30
18472,4775,Stuff Packs,20,0,0.0,20
18473,4776,Expansion Packs,16,0,0.0,16
18474,4776,Game Packs,7,0,0.0,7
18475,4776,Kits,20,2,0.1,18
18476,4776,Stuff Packs,16,2,0.125,14
18477,4777,Expansion Packs,16,0,0.0,16
18478,4777,Game Packs,12,0,0.0,12
18479,4777,Kits,33,1,0.030303030303030304,32
18480,4777,Stuff Packs,20,0,0.0,20
18481,4778,Expansion Packs,16,1,0.0625,15
18482,4778,Game Packs,12,0,0.0,12
18483,4778,Kits,33,0,0.0,33
18484,4778,Stuff Packs,20,0,0.0,20
18485,4779,Expansion Packs,16,0,0.0,16
18486,4779,Game Packs,12,0,0.0,12
18487,4779,Kits,33,0,0.0,33
18488,4779,Stuff Packs,20,0,0.0,20
18489,4780,Expansion Packs,13,0,0.0,13
18490,4780,Game Packs,9,1,0.1111111111111111,8
18491,4780,Kits,3,3,1.0,0
18492,4780,Stuff Packs,9,3,0.3333333333333333,6
18493,4781,Expansion Packs,16,0,0.0,16
18494,4781,Game Packs,12,0,0.0,12
18495,4781,Kits,14,2,0.14285714285714285,12
18496,4781,Stuff Packs,11,3,0.2727272727272727,8
18497,4782,Expansion Packs,13,0,0.0,13
18498,4782,Game Packs,5,0,0.0,5
18499,4782,Kits,3,2,0.6666666666666666,1
18500,4782,Stuff Packs,9,2,0.2222222222222222,7
18501,4783,Expansion Packs,15,0,0.0,15
18502,4783,Game Packs,12,1,0.08333333333333333,11
18503,4783,Kits,32,1,0.03125,31
18504,4783,Stuff Packs,20,0,0.0,20
18505,4784,Expansion Packs,16,0,0.0,16
18506,4784,Game Packs,9,0,0.0,9
18507,4784,Kits,10,1,0.1,9
18508,4784,Stuff Packs,17,0,0.0,17
18509,4785,Expansion Packs,12,0,0.0,12
18510,4785,Game Packs,3,0,0.0,3
18511,4785,Kits,3,1,0.3333333333333333,2
18512,4785,Stuff Packs,6,0,0.0,6
18513,4786,Expansion Packs,10,0,0.0,10
18514,4786,Game Packs,4,0,0.0,4
18515,4786,Stuff Packs,6,2,0.3333333333333333,4
18516,4787,Expansion Packs,5,0,0.0,5
18517,4787,Game Packs,3,0,0.0,3
18518,4787,Stuff Packs,3,2,0.6666666666666666,1
18519,4788,Expansion Packs,16,0,0.0,16
18520,4788,Game Packs,12,0,0.0,12
18521,4788,Kits,33,1,0.030303030303030304,32
18522,4788,Stuff Packs,20,0,0.0,20
18523,4789,Expansion Packs,12,0,0.0,12
18524,4789,Game Packs,9,0,0.0,9
18525,4789,Kits,2,2,1.0,0
18526,4789,Stuff Packs,19,1,0.05263157894736842,18
18527,4790,Expansion Packs,16,0,0.0,16
18528,4790,Game Packs,12,0,0.0,12
18529,4790,Kits,32,1,0.03125,31
18530,4790,Stuff Packs,20,3,0.15,17
18531,4791,Expansion Packs,16,0,0.0,16
18532,4791,Game Packs,12,0,0.0,12
18533,4791,Kits,33,7,0.21212121212121213,26
18534,4791,Stuff Packs,20,2,0.1,18
18535,4792,Expansion Packs,13,0,0.0,13
18536,4792,Game Packs,3,0,0.0,3
18537,4792,Kits,1,0,0.0,1
18538,4792,Stuff Packs,5,2,0.4,3
18539,4793,Expansion Packs,16,0,0.0,16
18540,4793,Game Packs,12,0,0.0,12
18541,4793,Kits,29,0,0.0,29
18542,4793,Stuff Packs,20,0,0.0,20
18543,4794,Expansion Packs,3,0,0.0,3
18544,4794,Game Packs,1,0,0.0,1
18545,4794,Stuff Packs,1,0,0.0,1
18546,4795,Expansion Packs,16,0,0.0,16
18547,4795,Game Packs,12,0,0.0,12
18548,4795,Kits,33,0,0.0,33
18549,4795,Stuff Packs,20,0,0.0,20
18550,4796,Expansion Packs,8,0,0.0,8
18551,4796,Game Packs,2,0,0.0,2
18552,4796,Kits,3,0,0.0,3
18553,4796,Stuff Packs,6,0,0.0,6
18554,4797,Expansion Packs,11,0,0.0,11
18555,4797,Game Packs,8,0,0.0,8
18556,4797,Kits,3,1,0.3333333333333333,2
18557,4797,Stuff Packs,10,3,0.3,7
18558,4798,Expansion Packs,11,0,0.0,11
18559,4798,Game Packs,9,1,0.1111111111111111,8
18560,4798,Kits,3,3,1.0,0
18561,4798,Stuff Packs,11,4,0.36363636363636365,7
18562,4799,Expansion Packs,8,0,0.0,8
18563,4799,Game Packs,4,0,0.0,4
18564,4799,Kits,3,0,0.0,3
18565,4799,Stuff Packs,4,1,0.25,3
18566,4800,Expansion Packs,5,0,0.0,5
18567,4800,Game Packs,2,0,0.0,2
18568,4801,Expansion Packs,15,1,0.06666666666666667,14
18569,4801,Game Packs,12,0,0.0,12
18570,4801,Kits,33,1,0.030303030303030304,32
18571,4801,Stuff Packs,20,0,0.0,20
18572,4802,Expansion Packs,7,0,0.0,7
18573,4802,Game Packs,1,0,0.0,1
18574,4802,Kits,1,0,0.0,1
18575,4802,Stuff Packs,1,0,0.0,1
18576,4803,Expansion Packs,16,0,0.0,16
18577,4803,Game Packs,12,0,0.0,12
18578,4803,Kits,28,0,0.0,28
18579,4803,Stuff Packs,20,0,0.0,20
18580,4804,Expansion Packs,16,0,0.0,16
18581,4804,Game Packs,11,0,0.0,11
18582,4804,Kits,29,0,0.0,29
18583,4804,Stuff Packs,20,0,0.0,20
18584,4805,Expansion Packs,4,0,0.0,4
18585,4805,Game Packs,2,0,0.0,2
18586,4805,Kits,2,1,0.5,1
18587,4805,Stuff Packs,2,0,0.0,2
18588,4806,Expansion Packs,16,0,0.0,16
18589,4806,Game Packs,10,0,0.0,10
18590,4806,Kits,5,2,0.4,3
18591,4806,Stuff Packs,12,2,0.16666666666666666,10
18592,4807,Expansion Packs,16,0,0.0,16
18593,4807,Game Packs,12,0,0.0,12
18594,4807,Kits,33,0,0.0,33
18595,4807,Stuff Packs,20,0,0.0,20
18596,4808,Expansion Packs,16,0,0.0,16
18597,4808,Game Packs,12,0,0.0,12
18598,4808,Kits,33,0,0.0,33
18599,4808,Stuff Packs,20,0,0.0,20
18600,4809,Expansion Packs,6,0,0.0,6
18601,4809,Game Packs,3,0,0.0,3
18602,4809,Kits,2,2,1.0,0
18603,4809,Stuff Packs,5,2,0.4,3
18604,4810,Expansion Packs,16,0,0.0,16
18605,4810,Game Packs,12,0,0.0,12
18606,4810,Kits,33,0,0.0,33
18607,4810,Stuff Packs,20,0,0.0,20
18608,4811,Expansion Packs,16,0,0.0,16
18609,4811,Game Packs,12,0,0.0,12
18610,4811,Kits,33,0,0.0,33
18611,4811,Stuff Packs,20,0,0.0,20
18612,4812,Expansion Packs,12,0,0.0,12
18613,4812,Game Packs,6,0,0.0,6
18614,4812,Kits,4,1,0.25,3
18615,4812,Stuff Packs,8,2,0.25,6
18616,4813,Expansion Packs,15,0,0.0,15
18617,4813,Game Packs,9,0,0.0,9
18618,4813,Kits,9,0,0.0,9
18619,4813,Stuff Packs,19,0,0.0,19
18620,4814,Expansion Packs,16,0,0.0,16
18621,4814,Game Packs,11,0,0.0,11
18622,4814,Kits,27,0,0.0,27
18623,4814,Stuff Packs,20,0,0.0,20
18624,4815,Expansion Packs,7,0,0.0,7
18625,4816,Expansion Packs,16,0,0.0,16
18626,4816,Game Packs,12,0,0.0,12
18627,4816,Kits,18,3,0.16666666666666666,15
18628,4816,Stuff Packs,19,0,0.0,19
18629,4817,Expansion Packs,16,0,0.0,16
18630,4817,Game Packs,12,0,0.0,12
18631,4817,Kits,33,0,0.0,33
18632,4817,Stuff Packs,20,0,0.0,20
18633,4818,Expansion Packs,8,0,0.0,8
18634,4818,Game Packs,3,0,0.0,3
18635,4818,Kits,4,2,0.5,2
18636,4818,Stuff Packs,8,1,0.125,7
18637,4819,Expansion Packs,12,0,0.0,12
18638,4819,Game Packs,8,0,0.0,8
18639,4819,Kits,5,2,0.4,3
18640,4819,Stuff Packs,12,3,0.25,9
18641,4820,Expansion Packs,16,0,0.0,16
18642,4820,Game Packs,12,0,0.0,12
18643,4820,Kits,30,1,0.03333333333333333,29
18644,4820,Stuff Packs,20,0,0.0,20
18645,4821,Expansion Packs,15,0,0.0,15
18646,4821,Game Packs,8,0,0.0,8
18647,4821,Kits,7,0,0.0,7
18648,4821,Stuff Packs,9,0,0.0,9
18649,4822,Expansion Packs,13,0,0.0,13
18650,4822,Game Packs,9,0,0.0,9
18651,4822,Kits,1,1,1.0,0
18652,4822,Stuff Packs,5,2,0.4,3
18653,4823,Expansion Packs,16,0,0.0,16
18654,4823,Game Packs,12,0,0.0,12
18655,4823,Kits,33,0,0.0,33
18656,4823,Stuff Packs,20,0,0.0,20
18657,4824,Expansion Packs,14,0,0.0,14
18658,4824,Game Packs,7,0,0.0,7
18659,4824,Stuff Packs,8,0,0.0,8
18660,4825,Expansion Packs,13,0,0.0,13
18661,4825,Game Packs,9,0,0.0,9
18662,4825,Kits,9,1,0.1111111111111111,8
18663,4825,Stuff Packs,10,0,0.0,10
18664,4826,Expansion Packs,14,0,0.0,14
18665,4826,Game Packs,10,0,0.0,10
18666,4826,Kits,9,3,0.3333333333333333,6
18667,4826,Stuff Packs,15,1,0.06666666666666667,14
18668,4827,Expansion Packs,16,0,0.0,16
18669,4827,Game Packs,12,0,0.0,12
18670,4827,Kits,21,1,0.047619047619047616,20
18671,4827,Stuff Packs,20,0,0.0,20
18672,4828,Expansion Packs,16,0,0.0,16
18673,4828,Game Packs,12,0,0.0,12
18674,4828,Kits,24,0,0.0,24
18675,4828,Stuff Packs,20,0,0.0,20
18676,4829,Expansion Packs,12,0,0.0,12
18677,4829,Game Packs,4,0,0.0,4
18678,4829,Kits,4,1,0.25,3
18679,4829,Stuff Packs,3,0,0.0,3
18680,4830,Expansion Packs,12,1,0.08333333333333333,11
18681,4830,Game Packs,8,1,0.125,7
18682,4830,Kits,2,1,0.5,1
18683,4830,Stuff Packs,6,1,0.16666666666666666,5
18684,4831,Expansion Packs,15,0,0.0,15
18685,4831,Game Packs,10,0,0.0,10
18686,4831,Kits,26,0,0.0,26
18687,4831,Stuff Packs,17,4,0.23529411764705882,13
18688,4832,Expansion Packs,6,0,0.0,6
18689,4832,Game Packs,2,0,0.0,2
18690,4832,Kits,3,1,0.3333333333333333,2
18691,4832,Stuff Packs,5,3,0.6,2
18692,4833,Expansion Packs,16,0,0.0,16
18693,4833,Game Packs,12,0,0.0,12
18694,4833,Kits,33,0,0.0,33
18695,4833,Stuff Packs,20,0,0.0,20
18696,4834,Expansion Packs,15,0,0.0,15
18697,4834,Game Packs,6,0,0.0,6
18698,4834,Kits,3,0,0.0,3
18699,4834,Stuff Packs,9,3,0.3333333333333333,6
18700,4835,Expansion Packs,16,0,0.0,16
18701,4835,Game Packs,10,0,0.0,10
18702,4835,Kits,12,1,0.08333333333333333,11
18703,4835,Stuff Packs,18,2,0.1111111111111111,16
18704,4836,Expansion Packs,8,0,0.0,8
18705,4836,Game Packs,3,0,0.0,3
18706,4836,Stuff Packs,2,0,0.0,2
18707,4837,Expansion Packs,1,0,0.0,1
18708,4837,Stuff Packs,2,0,0.0,2
18709,4838,Expansion Packs,15,0,0.0,15
18710,4838,Game Packs,9,0,0.0,9
18711,4838,Kits,18,0,0.0,18
18712,4839,Expansion Packs,11,0,0.0,11
18713,4839,Game Packs,8,1,0.125,7
18714,4839,Kits,1,1,1.0,0
18715,4839,Stuff Packs,13,3,0.23076923076923078,10
18716,4840,Expansion Packs,7,0,0.0,7
18717,4840,Game Packs,6,0,0.0,6
18718,4840,Kits,2,2,1.0,0
18719,4840,Stuff Packs,10,1,0.1,9
18720,4841,Expansion Packs,16,0,0.0,16
18721,4841,Game Packs,7,0,0.0,7
18722,4841,Kits,21,3,0.14285714285714285,18
18723,4841,Stuff Packs,19,1,0.05263157894736842,18
18724,4842,Expansion Packs,12,0,0.0,12
18725,4842,Game Packs,6,0,0.0,6
18726,4842,Kits,1,1,1.0,0
18727,4842,Stuff Packs,8,2,0.25,6
18728,4843,Expansion Packs,16,0,0.0,16
18729,4843,Game Packs,11,0,0.0,11
18730,4843,Kits,31,0,0.0,31
18731,4843,Stuff Packs,18,2,0.1111111111111111,16
18732,4844,Expansion Packs,15,0,0.0,15
18733,4844,Game Packs,7,0,0.0,7
18734,4844,Kits,11,0,0.0,11
18735,4844,Stuff Packs,10,0,0.0,10
18736,4845,Expansion Packs,5,1,0.2,4
18737,4845,Game Packs,2,0,0.0,2
18738,4845,Stuff Packs,3,3,1.0,0
18739,4846,Expansion Packs,16,0,0.0,16
18740,4846,Game Packs,12,0,0.0,12
18741,4846,Kits,28,0,0.0,28
18742,4846,Stuff Packs,19,0,0.0,19
18743,4847,Expansion Packs,10,0,0.0,10
18744,4847,Game Packs,9,0,0.0,9
18745,4847,Stuff Packs,12,1,0.08333333333333333,11
18746,4848,Expansion Packs,16,0,0.0,16
18747,4848,Game Packs,12,0,0.0,12
18748,4848,Kits,25,1,0.04,24
18749,4848,Stuff Packs,20,0,0.0,20
18750,4849,Expansion Packs,6,0,0.0,6
18751,4849,Game Packs,3,0,0.0,3
18752,4849,Stuff Packs,3,0,0.0,3
18753,4850,Expansion Packs,7,4,0.5714285714285714,3
18754,4850,Game Packs,5,4,0.8,1
18755,4850,Stuff Packs,6,1,0.16666666666666666,5
18756,4851,Expansion Packs,16,0,0.0,16
18757,4851,Game Packs,12,0,0.0,12
18758,4851,Kits,33,0,0.0,33
18759,4851,Stuff Packs,20,0,0.0,20
18760,4852,Expansion Packs,15,0,0.0,15
18761,4852,Game Packs,12,0,0.0,12
18762,4852,Kits,10,0,0.0,10
18763,4852,Stuff Packs,18,0,0.0,18
18764,4853,Expansion Packs,16,0,0.0,16
18765,4853,Game Packs,12,0,0.0,12
18766,4853,Kits,33,0,0.0,33
18767,4853,Stuff Packs,20,0,0.0,20
18768,4854,Expansion Packs,4,0,0.0,4
18769,4854,Game Packs,1,0,0.0,1
18770,4854,Kits,1,0,0.0,1
18771,4854,Stuff Packs,3,2,0.6666666666666666,1
18772,4855,Expansion Packs,15,0,0.0,15
18773,4855,Game Packs,10,0,0.0,10
18774,4855,Stuff Packs,5,0,0.0,5
18775,4856,Expansion Packs,15,0,0.0,15
18776,4856,Game Packs,8,0,0.0,8
18777,4856,Kits,13,1,0.07692307692307693,12
18778,4856,Stuff Packs,16,0,0.0,16
18779,4857,Expansion Packs,13,0,0.0,13
18780,4857,Game Packs,5,0,0.0,5
18781,4857,Kits,5,1,0.2,4
18782,4857,Stuff Packs,5,2,0.4,3
18783,4858,Expansion Packs,15,0,0.0,15
18784,4858,Game Packs,7,0,0.0,7
18785,4858,Kits,4,0,0.0,4
18786,4858,Stuff Packs,11,0,0.0,11
18787,4859,Expansion Packs,16,0,0.0,16
18788,4859,Game Packs,12,0,0.0,12
18789,4859,Kits,21,0,0.0,21
18790,4859,Stuff Packs,20,0,0.0,20
18791,4860,Expansion Packs,15,0,0.0,15
18792,4860,Game Packs,7,0,0.0,7
18793,4860,Kits,2,1,0.5,1
18794,4860,Stuff Packs,10,2,0.2,8
18795,4861,Expansion Packs,13,0,0.0,13
18796,4861,Game Packs,10,0,0.0,10
18797,4861,Kits,6,3,0.5,3
18798,4861,Stuff Packs,11,5,0.45454545454545453,6
18799,4862,Expansion Packs,16,0,0.0,16
18800,4862,Game Packs,11,0,0.0,11
18801,4862,Kits,20,0,0.0,20
18802,4862,Stuff Packs,20,3,0.15,17
18803,4863,Expansion Packs,13,0,0.0,13
18804,4863,Game Packs,12,0,0.0,12
18805,4863,Kits,11,1,0.09090909090909091,10
18806,4863,Stuff Packs,17,2,0.11764705882352941,15
18807,4864,Expansion Packs,6,0,0.0,6
18808,4864,Game Packs,1,0,0.0,1
18809,4864,Stuff Packs,3,0,0.0,3
18810,4865,Expansion Packs,16,0,0.0,16
18811,4865,Game Packs,12,0,0.0,12
18812,4865,Kits,6,1,0.16666666666666666,5
18813,4865,Stuff Packs,19,2,0.10526315789473684,17
18814,4866,Expansion Packs,15,0,0.0,15
18815,4866,Game Packs,8,0,0.0,8
18816,4866,Kits,5,0,0.0,5
18817,4866,Stuff Packs,10,0,0.0,10
18818,4867,Expansion Packs,13,0,0.0,13
18819,4867,Game Packs,5,0,0.0,5
18820,4867,Kits,8,1,0.125,7
18821,4867,Stuff Packs,12,1,0.08333333333333333,11
18822,4868,Expansion Packs,14,0,0.0,14
18823,4868,Game Packs,10,0,0.0,10
18824,4868,Kits,15,1,0.06666666666666667,14
18825,4868,Stuff Packs,19,0,0.0,19
18826,4869,Expansion Packs,16,0,0.0,16
18827,4869,Game Packs,12,0,0.0,12
18828,4869,Kits,14,1,0.07142857142857142,13
18829,4869,Stuff Packs,20,0,0.0,20
18830,4870,Expansion Packs,15,0,0.0,15
18831,4870,Game Packs,11,0,0.0,11
18832,4870,Kits,11,1,0.09090909090909091,10
18833,4870,Stuff Packs,19,0,0.0,19
18834,4871,Expansion Packs,7,0,0.0,7
18835,4871,Game Packs,2,0,0.0,2
18836,4871,Kits,2,0,0.0,2
18837,4871,Stuff Packs,1,0,0.0,1
18838,4872,Expansion Packs,7,0,0.0,7
18839,4872,Game Packs,2,0,0.0,2
18840,4872,Kits,2,0,0.0,2
18841,4872,Stuff Packs,4,0,0.0,4
18842,4873,Expansion Packs,16,0,0.0,16
18843,4873,Game Packs,12,0,0.0,12
18844,4873,Kits,33,0,0.0,33
18845,4873,Stuff Packs,20,0,0.0,20
18846,4874,Expansion Packs,15,1,0.06666666666666667,14
18847,4874,Game Packs,9,1,0.1111111111111111,8
18848,4874,Stuff Packs,15,2,0.13333333333333333,13
18849,4875,Expansion Packs,16,0,0.0,16
18850,4875,Game Packs,12,0,0.0,12
18851,4875,Kits,33,1,0.030303030303030304,32
18852,4875,Stuff Packs,20,0,0.0,20
18853,4876,Expansion Packs,16,0,0.0,16
18854,4876,Game Packs,12,1,0.08333333333333333,11
18855,4876,Kits,33,0,0.0,33
18856,4876,Stuff Packs,20,0,0.0,20
18857,4877,Expansion Packs,15,0,0.0,15
18858,4877,Game Packs,10,0,0.0,10
18859,4877,Kits,13,1,0.07692307692307693,12
18860,4877,Stuff Packs,18,0,0.0,18
18861,4878,Expansion Packs,10,0,0.0,10
18862,4878,Game Packs,5,0,0.0,5
18863,4878,Kits,1,1,1.0,0
18864,4878,Stuff Packs,9,3,0.3333333333333333,6
18865,4879,Expansion Packs,12,0,0.0,12
18866,4879,Game Packs,7,2,0.2857142857142857,5
18867,4879,Kits,1,1,1.0,0
18868,4879,Stuff Packs,9,7,0.7777777777777778,2
18869,4880,Expansion Packs,16,0,0.0,16
18870,4880,Game Packs,4,0,0.0,4
18871,4880,Kits,8,1,0.125,7
18872,4880,Stuff Packs,10,3,0.3,7
18873,4881,Expansion Packs,16,0,0.0,16
18874,4881,Game Packs,12,0,0.0,12
18875,4881,Kits,33,0,0.0,33
18876,4881,Stuff Packs,20,0,0.0,20
18877,4882,Expansion Packs,4,0,0.0,4
18878,4882,Game Packs,3,2,0.6666666666666666,1
18879,4882,Kits,2,2,1.0,0
18880,4882,Stuff Packs,4,3,0.75,1
18881,4883,Expansion Packs,12,0,0.0,12
18882,4883,Game Packs,5,0,0.0,5
18883,4883,Kits,13,2,0.15384615384615385,11
18884,4883,Stuff Packs,11,3,0.2727272727272727,8
18885,4884,Expansion Packs,16,2,0.125,14
18886,4884,Game Packs,12,4,0.3333333333333333,8
18887,4884,Kits,33,11,0.3333333333333333,22
18888,4884,Stuff Packs,20,4,0.2,16
18889,4885,Expansion Packs,7,1,0.14285714285714285,6
18890,4885,Game Packs,3,0,0.0,3
18891,4885,Kits,9,1,0.1111111111111111,8
18892,4885,Stuff Packs,9,3,0.3333333333333333,6
18893,4886,Expansion Packs,12,0,0.0,12
18894,4886,Game Packs,7,2,0.2857142857142857,5
18895,4886,Kits,5,1,0.2,4
18896,4886,Stuff Packs,11,2,0.18181818181818182,9
18897,4887,Expansion Packs,11,0,0.0,11
18898,4887,Game Packs,9,0,0.0,9
18899,4887,Kits,10,1,0.1,9
18900,4887,Stuff Packs,18,1,0.05555555555555555,17
18901,4888,Expansion Packs,14,0,0.0,14
18902,4888,Game Packs,12,0,0.0,12
18903,4888,Kits,15,1,0.06666666666666667,14
18904,4888,Stuff Packs,20,0,0.0,20
18905,4889,Expansion Packs,9,0,0.0,9
18906,4889,Game Packs,6,0,0.0,6
18907,4889,Stuff Packs,8,1,0.125,7
18908,4890,Expansion Packs,16,0,0.0,16
18909,4890,Game Packs,11,0,0.0,11
18910,4890,Kits,6,2,0.3333333333333333,4
18911,4890,Stuff Packs,18,0,0.0,18
18912,4891,Expansion Packs,16,0,0.0,16
18913,4891,Game Packs,12,0,0.0,12
18914,4891,Kits,30,1,0.03333333333333333,29
18915,4891,Stuff Packs,20,0,0.0,20
18916,4892,Expansion Packs,13,0,0.0,13
18917,4892,Game Packs,5,0,0.0,5
18918,4892,Kits,8,0,0.0,8
18919,4892,Stuff Packs,11,0,0.0,11
18920,4893,Expansion Packs,16,0,0.0,16
18921,4893,Game Packs,11,0,0.0,11
18922,4893,Kits,19,0,0.0,19
18923,4893,Stuff Packs,20,0,0.0,20
18924,4894,Expansion Packs,2,0,0.0,2
18925,4894,Game Packs,4,0,0.0,4
18926,4894,Kits,1,0,0.0,1
18927,4894,Stuff Packs,6,0,0.0,6
18928,4895,Expansion Packs,12,0,0.0,12
18929,4895,Game Packs,5,0,0.0,5
18930,4895,Stuff Packs,8,0,0.0,8
18931,4896,Expansion Packs,10,0,0.0,10
18932,4896,Game Packs,3,1,0.3333333333333333,2
18933,4896,Kits,1,1,1.0,0
18934,4896,Stuff Packs,3,0,0.0,3
18935,4897,Expansion Packs,16,0,0.0,16
18936,4897,Game Packs,10,0,0.0,10
18937,4897,Kits,13,1,0.07692307692307693,12
18938,4897,Stuff Packs,14,0,0.0,14
18939,4898,Expansion Packs,13,0,0.0,13
18940,4898,Game Packs,9,0,0.0,9
18941,4898,Kits,6,2,0.3333333333333333,4
18942,4898,Stuff Packs,12,0,0.0,12
18943,4899,Expansion Packs,15,0,0.0,15
18944,4899,Game Packs,12,0,0.0,12
18945,4899,Kits,9,0,0.0,9
18946,4899,Stuff Packs,20,0,0.0,20
18947,4900,Expansion Packs,16,0,0.0,16
18948,4900,Game Packs,12,0,0.0,12
18949,4900,Kits,33,1,0.030303030303030304,32
18950,4900,Stuff Packs,20,0,0.0,20
18951,4901,Expansion Packs,16,9,0.5625,7
18952,4901,Game Packs,10,9,0.9,1
18953,4901,Kits,18,2,0.1111111111111111,16
18954,4901,Stuff Packs,17,12,0.7058823529411765,5
18955,4902,Expansion Packs,16,0,0.0,16
18956,4902,Game Packs,12,0,0.0,12
18957,4902,Kits,33,0,0.0,33
18958,4902,Stuff Packs,20,0,0.0,20
18959,4903,Expansion Packs,11,0,0.0,11
18960,4903,Game Packs,5,0,0.0,5
18961,4903,Stuff Packs,3,0,0.0,3
18962,4904,Expansion Packs,2,0,0.0,2
18963,4904,Game Packs,2,0,0.0,2
18964,4904,Kits,1,1,1.0,0
18965,4904,Stuff Packs,4,0,0.0,4
18966,4905,Expansion Packs,16,0,0.0,16
18967,4905,Game Packs,12,0,0.0,12
18968,4905,Kits,8,1,0.125,7
18969,4905,Stuff Packs,20,0,0.0,20
18970,4906,Expansion Packs,15,2,0.13333333333333333,13
18971,4906,Game Packs,8,0,0.0,8
18972,4906,Kits,5,0,0.0,5
18973,4906,Stuff Packs,19,1,0.05263157894736842,18
18974,4907,Expansion Packs,16,0,0.0,16
18975,4907,Game Packs,12,0,0.0,12
18976,4907,Kits,20,1,0.05,19
18977,4907,Stuff Packs,20,0,0.0,20
18978,4908,Expansion Packs,9,0,0.0,9
18979,4908,Game Packs,2,0,0.0,2
18980,4908,Kits,4,0,0.0,4
18981,4908,Stuff Packs,6,0,0.0,6
18982,4909,Expansion Packs,16,0,0.0,16
18983,4909,Game Packs,12,0,0.0,12
18984,4909,Kits,33,0,0.0,33
18985,4909,Stuff Packs,20,0,0.0,20
18986,4910,Expansion Packs,16,0,0.0,16
18987,4910,Game Packs,11,0,0.0,11
18988,4910,Kits,6,1,0.16666666666666666,5
18989,4910,Stuff Packs,9,0,0.0,9
18990,4911,Expansion Packs,14,0,0.0,14
18991,4911,Game Packs,12,0,0.0,12
18992,4911,Kits,6,1,0.16666666666666666,5
18993,4911,Stuff Packs,14,3,0.21428571428571427,11
18994,4912,Expansion Packs,8,0,0.0,8
18995,4912,Game Packs,4,0,0.0,4
18996,4912,Kits,1,1,1.0,0
18997,4912,Stuff Packs,2,0,0.0,2
18998,4913,Expansion Packs,14,0,0.0,14
18999,4913,Game Packs,11,0,0.0,11
19000,4913,Kits,18,1,0.05555555555555555,17
19001,4913,Stuff Packs,18,0,0.0,18
19002,4914,Expansion Packs,16,0,0.0,16
19003,4914,Game Packs,11,0,0.0,11
19004,4914,Kits,13,1,0.07692307692307693,12
19005,4914,Stuff Packs,18,3,0.16666666666666666,15
19006,4915,Expansion Packs,16,0,0.0,16
19007,4915,Game Packs,11,0,0.0,11
19008,4915,Kits,21,0,0.0,21
19009,4915,Stuff Packs,17,0,0.0,17
19010,4916,Expansion Packs,15,0,0.0,15
19011,4916,Game Packs,8,0,0.0,8
19012,4916,Kits,9,3,0.3333333333333333,6
19013,4916,Stuff Packs,13,3,0.23076923076923078,10
19014,4917,Expansion Packs,16,0,0.0,16
19015,4917,Game Packs,11,0,0.0,11
19016,4917,Kits,8,0,0.0,8
19017,4917,Stuff Packs,20,0,0.0,20
19018,4918,Expansion Packs,15,0,0.0,15
19019,4918,Game Packs,9,0,0.0,9
19020,4918,Kits,33,0,0.0,33
19021,4918,Stuff Packs,20,0,0.0,20
19022,4919,Expansion Packs,13,0,0.0,13
19023,4919,Game Packs,2,0,0.0,2
19024,4919,Kits,8,1,0.125,7
19025,4919,Stuff Packs,7,3,0.42857142857142855,4
19026,4920,Expansion Packs,10,0,0.0,10
19027,4920,Game Packs,9,0,0.0,9
19028,4920,Kits,8,0,0.0,8
19029,4920,Stuff Packs,16,0,0.0,16
19030,4921,Expansion Packs,16,0,0.0,16
19031,4921,Game Packs,11,0,0.0,11
19032,4921,Kits,21,0,0.0,21
19033,4921,Stuff Packs,20,0,0.0,20
19034,4922,Expansion Packs,16,0,0.0,16
19035,4922,Game Packs,10,0,0.0,10
19036,4922,Kits,3,3,1.0,0
19037,4922,Stuff Packs,19,0,0.0,19
19038,4923,Expansion Packs,15,0,0.0,15
19039,4923,Game Packs,9,0,0.0,9
19040,4923,Kits,9,1,0.1111111111111111,8
19041,4923,Stuff Packs,17,2,0.11764705882352941,15
19042,4924,Expansion Packs,9,0,0.0,9
19043,4924,Game Packs,9,0,0.0,9
19044,4924,Stuff Packs,15,0,0.0,15
19045,4925,Expansion Packs,13,0,0.0,13
19046,4925,Game Packs,7,0,0.0,7
19047,4925,Kits,5,0,0.0,5
19048,4925,Stuff Packs,10,3,0.3,7
19049,4926,Expansion Packs,13,0,0.0,13
19050,4926,Game Packs,5,1,0.2,4
19051,4926,Kits,8,1,0.125,7
19052,4926,Stuff Packs,5,3,0.6,2
19053,4927,Expansion Packs,16,0,0.0,16
19054,4927,Game Packs,7,0,0.0,7
19055,4927,Kits,2,2,1.0,0
19056,4927,Stuff Packs,10,3,0.3,7
19057,4928,Expansion Packs,3,1,0.3333333333333333,2
19058,4928,Game Packs,2,0,0.0,2
19059,4928,Kits,3,0,0.0,3
19060,4928,Stuff Packs,3,0,0.0,3
19061,4929,Expansion Packs,13,0,0.0,13
19062,4929,Game Packs,6,1,0.16666666666666666,5
19063,4929,Kits,6,2,0.3333333333333333,4
19064,4929,Stuff Packs,7,4,0.5714285714285714,3
19065,4930,Expansion Packs,9,0,0.0,9
19066,4930,Game Packs,4,0,0.0,4
19067,4930,Stuff Packs,4,0,0.0,4
19068,4931,Expansion Packs,16,0,0.0,16
19069,4931,Game Packs,9,1,0.1111111111111111,8
19070,4931,Kits,21,3,0.14285714285714285,18
19071,4931,Stuff Packs,16,4,0.25,12
19072,4932,Expansion Packs,13,1,0.07692307692307693,12
19073,4932,Game Packs,7,1,0.14285714285714285,6
19074,4932,Kits,9,2,0.2222222222222222,7
19075,4932,Stuff Packs,9,4,0.4444444444444444,5
19076,4933,Expansion Packs,16,0,0.0,16
19077,4933,Game Packs,12,0,0.0,12
19078,4933,Kits,33,4,0.12121212121212122,29
19079,4933,Stuff Packs,20,1,0.05,19
19080,4934,Expansion Packs,14,0,0.0,14
19081,4934,Game Packs,5,0,0.0,5
19082,4934,Kits,2,2,1.0,0
19083,4934,Stuff Packs,11,1,0.09090909090909091,10
19084,4935,Expansion Packs,15,0,0.0,15
19085,4935,Game Packs,10,0,0.0,10
19086,4935,Kits,3,0,0.0,3
19087,4935,Stuff Packs,11,1,0.09090909090909091,10
19088,4936,Expansion Packs,9,0,0.0,9
19089,4936,Game Packs,4,0,0.0,4
19090,4936,Kits,11,1,0.09090909090909091,10
19091,4936,Stuff Packs,8,3,0.375,5
19092,4937,Expansion Packs,15,0,0.0,15
19093,4937,Game Packs,12,0,0.0,12
19094,4937,Kits,31,1,0.03225806451612903,30
19095,4937,Stuff Packs,20,0,0.0,20
19096,4938,Expansion Packs,16,0,0.0,16
19097,4938,Game Packs,12,0,0.0,12
19098,4938,Kits,33,1,0.030303030303030304,32
19099,4938,Stuff Packs,20,0,0.0,20
19100,4939,Expansion Packs,11,0,0.0,11
19101,4939,Game Packs,7,1,0.14285714285714285,6
19102,4939,Kits,1,1,1.0,0
19103,4939,Stuff Packs,11,2,0.18181818181818182,9
19104,4940,Expansion Packs,16,0,0.0,16
19105,4940,Game Packs,11,0,0.0,11
19106,4940,Kits,14,2,0.14285714285714285,12
19107,4940,Stuff Packs,20,1,0.05,19
19108,4941,Expansion Packs,15,0,0.0,15
19109,4941,Game Packs,11,0,0.0,11
19110,4941,Kits,25,0,0.0,25
19111,4941,Stuff Packs,19,1,0.05263157894736842,18
19112,4942,Expansion Packs,7,0,0.0,7
19113,4942,Game Packs,4,0,0.0,4
19114,4942,Kits,2,2,1.0,0
19115,4942,Stuff Packs,5,0,0.0,5
19116,4943,Expansion Packs,16,0,0.0,16
19117,4943,Game Packs,12,0,0.0,12
19118,4943,Kits,17,0,0.0,17
19119,4943,Stuff Packs,20,0,0.0,20
19120,4944,Expansion Packs,7,0,0.0,7
19121,4944,Game Packs,3,0,0.0,3
19122,4944,Stuff Packs,1,0,0.0,1
19123,4945,Expansion Packs,16,0,0.0,16
19124,4945,Game Packs,6,0,0.0,6
19125,4945,Kits,2,2,1.0,0
19126,4945,Stuff Packs,6,2,0.3333333333333333,4
19127,4946,Expansion Packs,13,0,0.0,13
19128,4946,Game Packs,4,1,0.25,3
19129,4946,Kits,5,2,0.4,3
19130,4946,Stuff Packs,13,3,0.23076923076923078,10
19131,4947,Expansion Packs,9,0,0.0,9
19132,4947,Game Packs,7,0,0.0,7
19133,4947,Kits,1,1,1.0,0
19134,4947,Stuff Packs,9,1,0.1111111111111111,8
19135,4948,Expansion Packs,16,0,0.0,16
19136,4948,Game Packs,12,0,0.0,12
19137,4948,Kits,22,0,0.0,22
19138,4948,Stuff Packs,20,0,0.0,20
19139,4949,Expansion Packs,16,0,0.0,16
19140,4949,Game Packs,11,0,0.0,11
19141,4949,Kits,33,0,0.0,33
19142,4949,Stuff Packs,20,0,0.0,20
19143,4950,Expansion Packs,16,0,0.0,16
19144,4950,Game Packs,12,0,0.0,12
19145,4950,Kits,26,1,0.038461538461538464,25
19146,4950,Stuff Packs,19,0,0.0,19
19147,4951,Expansion Packs,16,0,0.0,16
19148,4951,Game Packs,12,0,0.0,12
19149,4951,Kits,28,0,0.0,28
19150,4951,Stuff Packs,20,0,0.0,20
19151,4952,Expansion Packs,7,0,0.0,7
19152,4952,Game Packs,5,0,0.0,5
19153,4952,Kits,14,1,0.07142857142857142,13
19154,4952,Stuff Packs,6,2,0.3333333333333333,4
19155,4953,Expansion Packs,15,0,0.0,15
19156,4953,Game Packs,11,0,0.0,11
19157,4953,Kits,33,1,0.030303030303030304,32
19158,4953,Stuff Packs,19,0,0.0,19
19159,4954,Expansion Packs,14,0,0.0,14
19160,4954,Game Packs,10,0,0.0,10
19161,4954,Kits,2,1,0.5,1
19162,4954,Stuff Packs,14,0,0.0,14
19163,4955,Expansion Packs,8,0,0.0,8
19164,4955,Game Packs,5,0,0.0,5
19165,4955,Kits,3,3,1.0,0
19166,4955,Stuff Packs,7,3,0.42857142857142855,4
19167,4956,Expansion Packs,13,0,0.0,13
19168,4956,Game Packs,11,0,0.0,11
19169,4956,Kits,4,3,0.75,1
19170,4956,Stuff Packs,20,0,0.0,20
19171,4957,Expansion Packs,13,0,0.0,13
19172,4957,Game Packs,9,0,0.0,9
19173,4957,Kits,2,1,0.5,1
19174,4957,Stuff Packs,7,1,0.14285714285714285,6
19175,4958,Expansion Packs,16,0,0.0,16
19176,4958,Game Packs,6,0,0.0,6
19177,4958,Kits,19,0,0.0,19
19178,4958,Stuff Packs,12,1,0.08333333333333333,11
19179,4959,Expansion Packs,16,0,0.0,16
19180,4959,Game Packs,11,0,0.0,11
19181,4959,Kits,22,2,0.09090909090909091,20
19182,4959,Stuff Packs,20,0,0.0,20
19183,4960,Expansion Packs,10,0,0.0,10
19184,4960,Game Packs,3,0,0.0,3
19185,4960,Kits,1,1,1.0,0
19186,4960,Stuff Packs,8,1,0.125,7
19187,4961,Expansion Packs,4,0,0.0,4
19188,4961,Kits,1,1,1.0,0
19189,4961,Stuff Packs,1,1,1.0,0
19190,4962,Expansion Packs,16,12,0.75,4
19191,4962,Game Packs,12,9,0.75,3
19192,4962,Kits,33,2,0.06060606060606061,31
19193,4962,Stuff Packs,20,16,0.8,4
19194,4963,Expansion Packs,13,0,0.0,13
19195,4963,Game Packs,10,0,0.0,10
19196,4963,Kits,2,2,1.0,0
19197,4963,Stuff Packs,13,1,0.07692307692307693,12
19198,4964,Expansion Packs,7,0,0.0,7
19199,4964,Kits,3,0,0.0,3
19200,4964,Stuff Packs,3,2,0.6666666666666666,1
19201,4965,Expansion Packs,10,0,0.0,10
19202,4965,Game Packs,5,0,0.0,5
19203,4965,Stuff Packs,10,1,0.1,9
19204,4966,Expansion Packs,7,0,0.0,7
19205,4966,Game Packs,8,0,0.0,8
19206,4966,Stuff Packs,10,0,0.0,10
19207,4967,Expansion Packs,8,0,0.0,8
19208,4967,Game Packs,5,0,0.0,5
19209,4967,Stuff Packs,5,1,0.2,4
19210,4968,Expansion Packs,14,0,0.0,14
19211,4968,Game Packs,5,0,0.0,5
19212,4968,Kits,7,1,0.14285714285714285,6
19213,4968,Stuff Packs,9,1,0.1111111111111111,8
19214,4969,Expansion Packs,16,0,0.0,16
19215,4969,Game Packs,11,0,0.0,11
19216,4969,Kits,30,1,0.03333333333333333,29
19217,4969,Stuff Packs,20,0,0.0,20
19218,4970,Expansion Packs,10,0,0.0,10
19219,4970,Game Packs,5,0,0.0,5
19220,4970,Kits,1,1,1.0,0
19221,4970,Stuff Packs,1,0,0.0,1
19222,4971,Expansion Packs,8,0,0.0,8
19223,4971,Game Packs,4,0,0.0,4
19224,4971,Kits,1,1,1.0,0
19225,4971,Stuff Packs,2,0,0.0,2
19226,4972,Expansion Packs,12,0,0.0,12
19227,4972,Game Packs,2,0,0.0,2
19228,4972,Kits,1,0,0.0,1
19229,4972,Stuff Packs,6,3,0.5,3
19230,4973,Expansion Packs,11,0,0.0,11
19231,4973,Game Packs,5,0,0.0,5
19232,4973,Kits,1,1,1.0,0
19233,4973,Stuff Packs,7,2,0.2857142857142857,5
19234,4974,Expansion Packs,4,0,0.0,4
19235,4974,Game Packs,3,0,0.0,3
19236,4974,Stuff Packs,4,2,0.5,2
19237,4975,Expansion Packs,7,0,0.0,7
19238,4975,Game Packs,1,0,0.0,1
19239,4975,Stuff Packs,2,2,1.0,0
19240,4976,Expansion Packs,16,0,0.0,16
19241,4976,Game Packs,12,3,0.25,9
19242,4976,Kits,33,1,0.030303030303030304,32
19243,4976,Stuff Packs,20,3,0.15,17
19244,4977,Expansion Packs,3,0,0.0,3
19245,4977,Game Packs,4,0,0.0,4
19246,4977,Stuff Packs,4,0,0.0,4
19247,4978,Stuff Packs,2,2,1.0,0
19248,4979,Expansion Packs,16,0,0.0,16
19249,4979,Game Packs,11,0,0.0,11
19250,4979,Kits,13,2,0.15384615384615385,11
19251,4979,Stuff Packs,14,2,0.14285714285714285,12
19252,4980,Expansion Packs,16,0,0.0,16
19253,4980,Game Packs,12,0,0.0,12
19254,4980,Kits,33,4,0.12121212121212122,29
19255,4980,Stuff Packs,20,9,0.45,11
19256,4981,Expansion Packs,16,1,0.0625,15
19257,4981,Game Packs,12,0,0.0,12
19258,4981,Kits,33,4,0.12121212121212122,29
19259,4981,Stuff Packs,20,0,0.0,20
19260,4982,Expansion Packs,16,1,0.0625,15
19261,4982,Game Packs,12,0,0.0,12
19262,4982,Kits,28,1,0.03571428571428571,27
19263,4982,Stuff Packs,20,0,0.0,20
19264,4983,Expansion Packs,16,0,0.0,16
19265,4983,Game Packs,10,0,0.0,10
19266,4983,Kits,23,0,0.0,23
19267,4983,Stuff Packs,9,0,0.0,9
19268,4984,Expansion Packs,16,0,0.0,16
19269,4984,Game Packs,12,0,0.0,12
19270,4984,Kits,7,1,0.14285714285714285,6
19271,4984,Stuff Packs,20,0,0.0,20
19272,4985,Expansion Packs,15,0,0.0,15
19273,4985,Game Packs,11,0,0.0,11
19274,4985,Kits,15,1,0.06666666666666667,14
19275,4985,Stuff Packs,17,1,0.058823529411764705,16
19276,4986,Expansion Packs,10,0,0.0,10
19277,4986,Game Packs,7,0,0.0,7
19278,4986,Kits,11,0,0.0,11
19279,4986,Stuff Packs,9,3,0.3333333333333333,6
19280,4987,Expansion Packs,15,0,0.0,15
19281,4987,Game Packs,8,0,0.0,8
19282,4987,Kits,7,1,0.14285714285714285,6
19283,4987,Stuff Packs,12,0,0.0,12
19284,4988,Expansion Packs,11,0,0.0,11
19285,4988,Game Packs,8,0,0.0,8
19286,4988,Stuff Packs,8,0,0.0,8
19287,4989,Expansion Packs,15,0,0.0,15
19288,4989,Game Packs,9,0,0.0,9
19289,4989,Kits,2,2,1.0,0
19290,4989,Stuff Packs,19,0,0.0,19
19291,4990,Expansion Packs,16,0,0.0,16
19292,4990,Game Packs,12,0,0.0,12
19293,4990,Kits,33,0,0.0,33
19294,4990,Stuff Packs,20,0,0.0,20
19295,4991,Expansion Packs,9,0,0.0,9
19296,4991,Game Packs,2,0,0.0,2
19297,4991,Kits,3,3,1.0,0
19298,4991,Stuff Packs,6,4,0.6666666666666666,2
19299,4992,Expansion Packs,16,0,0.0,16
19300,4992,Game Packs,12,0,0.0,12
19301,4992,Kits,32,1,0.03125,31
19302,4992,Stuff Packs,20,1,0.05,19
19303,4993,Expansion Packs,8,0,0.0,8
19304,4993,Game Packs,2,0,0.0,2
19305,4993,Kits,1,1,1.0,0
19306,4993,Stuff Packs,2,0,0.0,2
19307,4994,Expansion Packs,16,0,0.0,16
19308,4994,Game Packs,11,1,0.09090909090909091,10
19309,4994,Kits,6,2,0.3333333333333333,4
19310,4994,Stuff Packs,18,4,0.2222222222222222,14
19311,4995,Expansion Packs,15,0,0.0,15
19312,4995,Game Packs,10,0,0.0,10
19313,4995,Kits,27,0,0.0,27
19314,4995,Stuff Packs,13,0,0.0,13
19315,4996,Expansion Packs,15,0,0.0,15
19316,4996,Game Packs,3,1,0.3333333333333333,2
19317,4996,Kits,2,2,1.0,0
19318,4996,Stuff Packs,4,4,1.0,0
19319,4997,Expansion Packs,10,0,0.0,10
19320,4997,Game Packs,8,0,0.0,8
19321,4997,Kits,9,1,0.1111111111111111,8
19322,4997,Stuff Packs,13,2,0.15384615384615385,11
19323,4998,Expansion Packs,6,0,0.0,6
19324,4998,Stuff Packs,2,1,0.5,1
19325,4999,Expansion Packs,8,1,0.125,7
19326,4999,Game Packs,5,1,0.2,4
19327,4999,Kits,2,2,1.0,0
19328,4999,Stuff Packs,5,3,0.6,2
19329,5000,Expansion Packs,10,0,0.0,10
19330,5000,Game Packs,6,0,0.0,6
19331,5000,Kits,1,0,0.0,1
19332,5000,Stuff Packs,6,1,0.16666666666666666,5
19333,5001,Expansion Packs,13,0,0.0,13
19334,5001,Game Packs,6,0,0.0,6
19335,5001,Kits,2,1,0.5,1
19336,5001,Stuff Packs,8,2,0.25,6
19337,5002,Expansion Packs,15,0,0.0,15
19338,5002,Game Packs,9,0,0.0,9
19339,5002,Kits,4,1,0.25,3
19340,5002,Stuff Packs,10,1,0.1,9
19341,5003,Expansion Packs,2,0,0.0,2
19342,5003,Game Packs,2,0,0.0,2
19343,5003,Stuff Packs,1,0,0.0,1
19344,5004,Expansion Packs,15,0,0.0,15
19345,5004,Game Packs,10,0,0.0,10
19346,5004,Kits,10,1,0.1,9
19347,5004,Stuff Packs,19,2,0.10526315789473684,17
19348,5005,Expansion Packs,16,0,0.0,16
19349,5005,Game Packs,9,0,0.0,9
19350,5005,Kits,24,1,0.041666666666666664,23
19351,5005,Stuff Packs,20,0,0.0,20
19352,5006,Expansion Packs,9,0,0.0,9
19353,5006,Game Packs,1,0,0.0,1
19354,5006,Stuff Packs,2,0,0.0,2
19355,5007,Expansion Packs,15,0,0.0,15
19356,5007,Game Packs,11,0,0.0,11
19357,5007,Kits,12,1,0.08333333333333333,11
19358,5007,Stuff Packs,19,0,0.0,19
19359,5008,Expansion Packs,15,0,0.0,15
19360,5008,Game Packs,9,2,0.2222222222222222,7
19361,5008,Kits,14,2,0.14285714285714285,12
19362,5008,Stuff Packs,17,0,0.0,17
19363,5009,Expansion Packs,6,0,0.0,6
19364,5009,Game Packs,2,1,0.5,1
19365,5009,Kits,4,3,0.75,1
19366,5009,Stuff Packs,11,2,0.18181818181818182,9
19367,5010,Expansion Packs,16,0,0.0,16
19368,5010,Game Packs,12,0,0.0,12
19369,5010,Kits,33,0,0.0,33
19370,5010,Stuff Packs,20,0,0.0,20
19371,5011,Expansion Packs,7,2,0.2857142857142857,5
19372,5011,Game Packs,5,1,0.2,4
19373,5011,Kits,6,1,0.16666666666666666,5
19374,5011,Stuff Packs,11,4,0.36363636363636365,7
19375,5012,Expansion Packs,16,0,0.0,16
19376,5012,Game Packs,11,0,0.0,11
19377,5012,Kits,33,1,0.030303030303030304,32
19378,5012,Stuff Packs,19,1,0.05263157894736842,18
19379,5013,Expansion Packs,14,0,0.0,14
19380,5013,Game Packs,12,1,0.08333333333333333,11
19381,5013,Kits,18,3,0.16666666666666666,15
19382,5013,Stuff Packs,19,3,0.15789473684210525,16
19383,5014,Expansion Packs,15,0,0.0,15
19384,5014,Game Packs,8,1,0.125,7
19385,5014,Kits,13,2,0.15384615384615385,11
19386,5014,Stuff Packs,12,3,0.25,9
19387,5015,Expansion Packs,15,0,0.0,15
19388,5015,Game Packs,12,1,0.08333333333333333,11
19389,5015,Kits,19,0,0.0,19
19390,5015,Stuff Packs,20,0,0.0,20
19391,5016,Expansion Packs,11,0,0.0,11
19392,5016,Game Packs,2,0,0.0,2
19393,5016,Kits,6,1,0.16666666666666666,5
19394,5016,Stuff Packs,5,3,0.6,2
19395,5017,Expansion Packs,16,0,0.0,16
19396,5017,Game Packs,12,0,0.0,12
19397,5017,Kits,32,0,0.0,32
19398,5017,Stuff Packs,20,0,0.0,20
19399,5018,Expansion Packs,13,0,0.0,13
19400,5018,Game Packs,4,0,0.0,4
19401,5018,Kits,4,0,0.0,4
19402,5018,Stuff Packs,6,2,0.3333333333333333,4
19403,5019,Expansion Packs,3,0,0.0,3
19404,5019,Game Packs,3,0,0.0,3
19405,5019,Kits,2,0,0.0,2
19406,5019,Stuff Packs,4,0,0.0,4
19407,5020,Expansion Packs,15,0,0.0,15
19408,5020,Game Packs,12,0,0.0,12
19409,5020,Kits,9,0,0.0,9
19410,5020,Stuff Packs,20,0,0.0,20
19411,5021,Expansion Packs,15,0,0.0,15
19412,5021,Game Packs,9,0,0.0,9
19413,5021,Kits,6,0,0.0,6
19414,5021,Stuff Packs,10,4,0.4,6
19415,5022,Expansion Packs,7,0,0.0,7
19416,5022,Game Packs,1,0,0.0,1
19417,5022,Kits,2,2,1.0,0
19418,5022,Stuff Packs,3,2,0.6666666666666666,1
19419,5023,Expansion Packs,16,0,0.0,16
19420,5023,Game Packs,12,0,0.0,12
19421,5023,Kits,33,0,0.0,33
19422,5023,Stuff Packs,20,0,0.0,20
19423,5024,Expansion Packs,15,0,0.0,15
19424,5024,Game Packs,10,0,0.0,10
19425,5024,Kits,14,1,0.07142857142857142,13
19426,5024,Stuff Packs,14,0,0.0,14
19427,5025,Expansion Packs,14,0,0.0,14
19428,5025,Game Packs,12,0,0.0,12
19429,5025,Kits,18,0,0.0,18
19430,5025,Stuff Packs,19,0,0.0,19
19431,5026,Expansion Packs,16,0,0.0,16
19432,5026,Game Packs,11,0,0.0,11
19433,5026,Kits,33,1,0.030303030303030304,32
19434,5026,Stuff Packs,20,0,0.0,20
19435,5027,Expansion Packs,7,0,0.0,7
19436,5027,Stuff Packs,3,3,1.0,0
19437,5028,Expansion Packs,2,0,0.0,2
19438,5028,Game Packs,2,1,0.5,1
19439,5028,Stuff Packs,5,3,0.6,2
19440,5029,Expansion Packs,4,0,0.0,4
19441,5029,Kits,1,1,1.0,0
19442,5030,Expansion Packs,14,0,0.0,14
19443,5030,Game Packs,8,1,0.125,7
19444,5030,Kits,3,3,1.0,0
19445,5030,Stuff Packs,12,3,0.25,9
19446,5031,Expansion Packs,16,0,0.0,16
19447,5031,Game Packs,12,0,0.0,12
19448,5031,Kits,28,1,0.03571428571428571,27
19449,5031,Stuff Packs,20,0,0.0,20
19450,5032,Expansion Packs,9,0,0.0,9
19451,5032,Game Packs,3,0,0.0,3
19452,5032,Kits,1,1,1.0,0
19453,5032,Stuff Packs,2,0,0.0,2
19454,5033,Expansion Packs,13,0,0.0,13
19455,5033,Game Packs,10,0,0.0,10
19456,5033,Kits,1,0,0.0,1
19457,5033,Stuff Packs,19,0,0.0,19
19458,5034,Expansion Packs,13,0,0.0,13
19459,5034,Game Packs,11,0,0.0,11
19460,5034,Kits,12,1,0.08333333333333333,11
19461,5034,Stuff Packs,20,0,0.0,20
19462,5035,Expansion Packs,16,0,0.0,16
19463,5035,Game Packs,12,0,0.0,12
19464,5035,Kits,12,1,0.08333333333333333,11
19465,5035,Stuff Packs,20,0,0.0,20
19466,5036,Expansion Packs,13,0,0.0,13
19467,5036,Game Packs,7,0,0.0,7
19468,5036,Stuff Packs,9,1,0.1111111111111111,8
19469,5037,Expansion Packs,4,0,0.0,4
19470,5037,Game Packs,3,0,0.0,3
19471,5037,Kits,1,0,0.0,1
19472,5037,Stuff Packs,2,0,0.0,2
19473,5038,Expansion Packs,6,0,0.0,6
19474,5038,Game Packs,2,0,0.0,2
19475,5038,Kits,1,1,1.0,0
19476,5038,Stuff Packs,3,1,0.3333333333333333,2
19477,5039,Expansion Packs,7,0,0.0,7
19478,5039,Game Packs,2,0,0.0,2
19479,5039,Stuff Packs,2,0,0.0,2
19480,5040,Expansion Packs,15,0,0.0,15
19481,5040,Game Packs,10,0,0.0,10
19482,5040,Kits,16,3,0.1875,13
19483,5040,Stuff Packs,18,5,0.2777777777777778,13
19484,5041,Expansion Packs,14,1,0.07142857142857142,13
19485,5041,Game Packs,12,0,0.0,12
19486,5041,Kits,2,2,1.0,0
19487,5041,Stuff Packs,20,0,0.0,20
19488,5042,Expansion Packs,10,0,0.0,10
19489,5042,Game Packs,9,1,0.1111111111111111,8
19490,5042,Kits,4,2,0.5,2
19491,5042,Stuff Packs,14,4,0.2857142857142857,10
19492,5043,Expansion Packs,6,0,0.0,6
19493,5043,Game Packs,4,0,0.0,4
19494,5043,Kits,3,1,0.3333333333333333,2
19495,5043,Stuff Packs,7,2,0.2857142857142857,5
19496,5044,Expansion Packs,7,0,0.0,7
19497,5044,Game Packs,2,0,0.0,2
19498,5044,Kits,1,1,1.0,0
19499,5044,Stuff Packs,4,2,0.5,2
19500,5045,Expansion Packs,13,0,0.0,13
19501,5045,Game Packs,9,0,0.0,9
19502,5045,Kits,8,1,0.125,7
19503,5045,Stuff Packs,7,0,0.0,7
19504,5046,Expansion Packs,11,0,0.0,11
19505,5046,Game Packs,6,0,0.0,6
19506,5046,Kits,10,1,0.1,9
19507,5046,Stuff Packs,6,0,0.0,6
19508,5047,Expansion Packs,14,0,0.0,14
19509,5047,Game Packs,6,0,0.0,6
19510,5047,Kits,8,1,0.125,7
19511,5047,Stuff Packs,9,1,0.1111111111111111,8
19512,5048,Expansion Packs,16,0,0.0,16
19513,5048,Game Packs,12,0,0.0,12
19514,5048,Kits,23,1,0.043478260869565216,22
19515,5048,Stuff Packs,20,0,0.0,20
19516,5049,Expansion Packs,14,0,0.0,14
19517,5049,Game Packs,9,0,0.0,9
19518,5049,Kits,4,2,0.5,2
19519,5049,Stuff Packs,14,1,0.07142857142857142,13
19520,5050,Expansion Packs,16,0,0.0,16
19521,5050,Game Packs,12,0,0.0,12
19522,5050,Kits,33,0,0.0,33
19523,5050,Stuff Packs,20,0,0.0,20
19524,5051,Expansion Packs,14,0,0.0,14
19525,5051,Game Packs,11,0,0.0,11
19526,5051,Kits,27,2,0.07407407407407407,25
19527,5051,Stuff Packs,20,1,0.05,19
19528,5052,Expansion Packs,8,0,0.0,8
19529,5052,Game Packs,4,0,0.0,4
19530,5052,Stuff Packs,9,3,0.3333333333333333,6
19531,5053,Expansion Packs,16,0,0.0,16
19532,5053,Game Packs,10,0,0.0,10
19533,5053,Kits,15,1,0.06666666666666667,14
19534,5053,Stuff Packs,15,1,0.06666666666666667,14
19535,5054,Expansion Packs,16,0,0.0,16
19536,5054,Game Packs,11,0,0.0,11
19537,5054,Kits,13,1,0.07692307692307693,12
19538,5054,Stuff Packs,18,0,0.0,18
19539,5055,Expansion Packs,13,0,0.0,13
19540,5055,Game Packs,8,0,0.0,8
19541,5055,Kits,7,2,0.2857142857142857,5
19542,5055,Stuff Packs,14,4,0.2857142857142857,10
19543,5056,Expansion Packs,16,1,0.0625,15
19544,5056,Game Packs,5,0,0.0,5
19545,5056,Kits,11,0,0.0,11
19546,5056,Stuff Packs,14,3,0.21428571428571427,11
19547,5057,Expansion Packs,16,0,0.0,16
19548,5057,Game Packs,12,0,0.0,12
19549,5057,Kits,33,0,0.0,33
19550,5057,Stuff Packs,20,0,0.0,20
19551,5058,Expansion Packs,2,0,0.0,2
19552,5058,Kits,3,0,0.0,3
19553,5059,Expansion Packs,7,0,0.0,7
19554,5059,Game Packs,3,0,0.0,3
19555,5059,Kits,2,2,1.0,0
19556,5059,Stuff Packs,6,2,0.3333333333333333,4
19557,5060,Expansion Packs,16,0,0.0,16
19558,5060,Game Packs,11,0,0.0,11
19559,5060,Kits,14,1,0.07142857142857142,13
19560,5060,Stuff Packs,19,0,0.0,19
19561,5061,Expansion Packs,16,0,0.0,16
19562,5061,Game Packs,12,0,0.0,12
19563,5061,Kits,33,0,0.0,33
19564,5061,Stuff Packs,20,0,0.0,20
19565,5062,Expansion Packs,8,0,0.0,8
19566,5062,Game Packs,6,0,0.0,6
19567,5062,Kits,9,1,0.1111111111111111,8
19568,5062,Stuff Packs,10,0,0.0,10
19569,5063,Expansion Packs,6,0,0.0,6
19570,5063,Game Packs,2,0,0.0,2
19571,5063,Kits,2,2,1.0,0
19572,5063,Stuff Packs,4,3,0.75,1
19573,5064,Expansion Packs,16,0,0.0,16
19574,5064,Game Packs,11,0,0.0,11
19575,5064,Kits,32,1,0.03125,31
19576,5064,Stuff Packs,20,2,0.1,18
19577,5065,Expansion Packs,15,0,0.0,15
19578,5065,Game Packs,5,0,0.0,5
19579,5065,Kits,12,2,0.16666666666666666,10
19580,5065,Stuff Packs,10,4,0.4,6
19581,5066,Expansion Packs,4,0,0.0,4
19582,5066,Game Packs,2,1,0.5,1
19583,5066,Kits,2,2,1.0,0
19584,5066,Stuff Packs,5,3,0.6,2
19585,5067,Expansion Packs,16,0,0.0,16
19586,5067,Game Packs,11,0,0.0,11
19587,5067,Kits,33,1,0.030303030303030304,32
19588,5067,Stuff Packs,20,0,0.0,20
19589,5068,Expansion Packs,13,0,0.0,13
19590,5068,Game Packs,7,1,0.14285714285714285,6
19591,5068,Kits,2,2,1.0,0
19592,5068,Stuff Packs,11,5,0.45454545454545453,6
19593,5069,Expansion Packs,16,0,0.0,16
19594,5069,Game Packs,12,0,0.0,12
19595,5069,Kits,28,0,0.0,28
19596,5069,Stuff Packs,20,0,0.0,20
19597,5070,Expansion Packs,16,0,0.0,16
19598,5070,Game Packs,12,0,0.0,12
19599,5070,Kits,19,0,0.0,19
19600,5070,Stuff Packs,17,0,0.0,17
19601,5071,Expansion Packs,16,0,0.0,16
19602,5071,Game Packs,7,0,0.0,7
19603,5071,Kits,7,1,0.14285714285714285,6
19604,5071,Stuff Packs,10,0,0.0,10
19605,5072,Expansion Packs,7,0,0.0,7
19606,5072,Game Packs,5,0,0.0,5
19607,5072,Kits,4,1,0.25,3
19608,5072,Stuff Packs,5,4,0.8,1
19609,5073,Expansion Packs,16,0,0.0,16
19610,5073,Game Packs,12,1,0.08333333333333333,11
19611,5073,Kits,33,0,0.0,33
19612,5073,Stuff Packs,20,0,0.0,20
19613,5074,Expansion Packs,13,0,0.0,13
19614,5074,Game Packs,10,0,0.0,10
19615,5074,Kits,3,3,1.0,0
19616,5074,Stuff Packs,13,3,0.23076923076923078,10
19617,5075,Expansion Packs,14,0,0.0,14
19618,5075,Game Packs,11,0,0.0,11
19619,5075,Kits,9,1,0.1111111111111111,8
19620,5075,Stuff Packs,13,0,0.0,13
19621,5076,Expansion Packs,16,0,0.0,16
19622,5076,Game Packs,12,0,0.0,12
19623,5076,Kits,30,0,0.0,30
19624,5076,Stuff Packs,20,0,0.0,20
19625,5077,Expansion Packs,3,0,0.0,3
19626,5077,Game Packs,1,0,0.0,1
19627,5077,Kits,7,0,0.0,7
19628,5077,Stuff Packs,6,2,0.3333333333333333,4
19629,5078,Expansion Packs,16,1,0.0625,15
19630,5078,Game Packs,12,0,0.0,12
19631,5078,Kits,33,0,0.0,33
19632,5078,Stuff Packs,20,0,0.0,20
19633,5079,Expansion Packs,11,0,0.0,11
19634,5079,Game Packs,8,0,0.0,8
19635,5079,Kits,2,1,0.5,1
19636,5079,Stuff Packs,4,0,0.0,4
19637,5080,Expansion Packs,7,0,0.0,7
19638,5080,Game Packs,6,0,0.0,6
19639,5080,Kits,7,0,0.0,7
19640,5080,Stuff Packs,8,5,0.625,3
19641,5081,Expansion Packs,7,0,0.0,7
19642,5081,Game Packs,3,0,0.0,3
19643,5081,Kits,1,0,0.0,1
19644,5081,Stuff Packs,2,0,0.0,2
19645,5082,Expansion Packs,16,0,0.0,16
19646,5082,Game Packs,7,0,0.0,7
19647,5082,Kits,14,0,0.0,14
19648,5082,Stuff Packs,18,1,0.05555555555555555,17
19649,5083,Expansion Packs,15,0,0.0,15
19650,5083,Game Packs,10,0,0.0,10
19651,5083,Kits,7,3,0.42857142857142855,4
19652,5083,Stuff Packs,18,0,0.0,18
19653,5084,Expansion Packs,16,0,0.0,16
19654,5084,Game Packs,11,0,0.0,11
19655,5084,Kits,32,0,0.0,32
19656,5084,Stuff Packs,20,0,0.0,20
19657,5085,Expansion Packs,8,0,0.0,8
19658,5085,Game Packs,4,0,0.0,4
19659,5085,Kits,4,0,0.0,4
19660,5085,Stuff Packs,4,0,0.0,4
19661,5086,Expansion Packs,16,0,0.0,16
19662,5086,Game Packs,11,0,0.0,11
19663,5086,Kits,10,0,0.0,10
19664,5086,Stuff Packs,19,1,0.05263157894736842,18
19665,5087,Expansion Packs,16,0,0.0,16
19666,5087,Game Packs,11,0,0.0,11
19667,5087,Kits,20,1,0.05,19
19668,5087,Stuff Packs,20,0,0.0,20
19669,5088,Expansion Packs,14,0,0.0,14
19670,5088,Game Packs,12,0,0.0,12
19671,5088,Kits,11,0,0.0,11
19672,5088,Stuff Packs,20,0,0.0,20
19673,5089,Expansion Packs,16,0,0.0,16
19674,5089,Game Packs,12,0,0.0,12
19675,5089,Kits,33,1,0.030303030303030304,32
19676,5089,Stuff Packs,19,0,0.0,19
19677,5090,Expansion Packs,4,0,0.0,4
19678,5090,Game Packs,1,0,0.0,1
19679,5090,Kits,1,1,1.0,0
19680,5090,Stuff Packs,2,2,1.0,0
19681,5091,Expansion Packs,14,0,0.0,14
19682,5091,Game Packs,12,0,0.0,12
19683,5091,Kits,27,0,0.0,27
19684,5091,Stuff Packs,20,0,0.0,20
19685,5092,Expansion Packs,10,0,0.0,10
19686,5092,Game Packs,2,0,0.0,2
19687,5092,Kits,2,0,0.0,2
19688,5092,Stuff Packs,2,1,0.5,1
19689,5093,Expansion Packs,10,0,0.0,10
19690,5093,Game Packs,4,1,0.25,3
19691,5093,Kits,4,1,0.25,3
19692,5093,Stuff Packs,9,4,0.4444444444444444,5
19693,5094,Expansion Packs,12,0,0.0,12
19694,5094,Game Packs,10,0,0.0,10
19695,5094,Kits,1,1,1.0,0
19696,5094,Stuff Packs,18,1,0.05555555555555555,17
19697,5095,Expansion Packs,13,0,0.0,13
19698,5095,Game Packs,8,0,0.0,8
19699,5095,Kits,3,2,0.6666666666666666,1
19700,5095,Stuff Packs,9,3,0.3333333333333333,6
19701,5096,Expansion Packs,16,0,0.0,16
19702,5096,Game Packs,12,0,0.0,12
19703,5096,Kits,31,1,0.03225806451612903,30
19704,5096,Stuff Packs,20,0,0.0,20
19705,5097,Expansion Packs,14,0,0.0,14
19706,5097,Game Packs,4,0,0.0,4
19707,5097,Kits,11,0,0.0,11
19708,5097,Stuff Packs,10,2,0.2,8
19709,5098,Expansion Packs,12,1,0.08333333333333333,11
19710,5098,Game Packs,4,1,0.25,3
19711,5098,Kits,5,1,0.2,4
19712,5098,Stuff Packs,16,3,0.1875,13
19713,5099,Expansion Packs,7,0,0.0,7
19714,5099,Game Packs,3,0,0.0,3
19715,5099,Kits,2,1,0.5,1
19716,5099,Stuff Packs,7,2,0.2857142857142857,5
19717,5100,Expansion Packs,16,0,0.0,16
19718,5100,Game Packs,12,0,0.0,12
19719,5100,Kits,33,1,0.030303030303030304,32
19720,5100,Stuff Packs,20,0,0.0,20
19721,5101,Expansion Packs,16,0,0.0,16
19722,5101,Game Packs,8,0,0.0,8
19723,5101,Kits,15,1,0.06666666666666667,14
19724,5101,Stuff Packs,15,1,0.06666666666666667,14
19725,5102,Expansion Packs,16,0,0.0,16
19726,5102,Game Packs,12,0,0.0,12
19727,5102,Kits,4,1,0.25,3
19728,5102,Stuff Packs,18,1,0.05555555555555555,17
19729,5103,Expansion Packs,16,1,0.0625,15
19730,5103,Game Packs,11,0,0.0,11
19731,5103,Kits,2,0,0.0,2
19732,5103,Stuff Packs,13,1,0.07692307692307693,12
19733,5104,Expansion Packs,16,0,0.0,16
19734,5104,Game Packs,12,0,0.0,12
19735,5104,Kits,22,0,0.0,22
19736,5104,Stuff Packs,20,0,0.0,20
19737,5105,Expansion Packs,16,0,0.0,16
19738,5105,Game Packs,11,0,0.0,11
19739,5105,Kits,13,2,0.15384615384615385,11
19740,5105,Stuff Packs,13,2,0.15384615384615385,11
19741,5106,Expansion Packs,16,0,0.0,16
19742,5106,Game Packs,12,0,0.0,12
19743,5106,Kits,33,1,0.030303030303030304,32
19744,5106,Stuff Packs,20,0,0.0,20
19745,5107,Expansion Packs,11,0,0.0,11
19746,5107,Game Packs,8,0,0.0,8
19747,5107,Stuff Packs,17,0,0.0,17
19748,5108,Expansion Packs,15,0,0.0,15
19749,5108,Game Packs,6,0,0.0,6
19750,5108,Kits,8,0,0.0,8
19751,5108,Stuff Packs,8,1,0.125,7
19752,5109,Expansion Packs,14,0,0.0,14
19753,5109,Game Packs,12,0,0.0,12
19754,5109,Stuff Packs,17,0,0.0,17
19755,5110,Expansion Packs,16,0,0.0,16
19756,5110,Game Packs,11,0,0.0,11
19757,5110,Kits,22,1,0.045454545454545456,21
19758,5110,Stuff Packs,15,3,0.2,12
19759,5111,Expansion Packs,15,0,0.0,15
19760,5111,Game Packs,8,0,0.0,8
19761,5111,Kits,6,1,0.16666666666666666,5
19762,5111,Stuff Packs,18,1,0.05555555555555555,17
19763,5112,Expansion Packs,14,0,0.0,14
19764,5112,Game Packs,10,0,0.0,10
19765,5112,Kits,8,0,0.0,8
19766,5112,Stuff Packs,11,1,0.09090909090909091,10
19767,5113,Expansion Packs,8,0,0.0,8
19768,5113,Game Packs,4,1,0.25,3
19769,5113,Kits,6,2,0.3333333333333333,4
19770,5113,Stuff Packs,5,3,0.6,2
19771,5114,Expansion Packs,13,0,0.0,13
19772,5114,Game Packs,9,0,0.0,9
19773,5114,Kits,7,2,0.2857142857142857,5
19774,5114,Stuff Packs,8,4,0.5,4
19775,5115,Expansion Packs,16,0,0.0,16
19776,5115,Game Packs,12,0,0.0,12
19777,5115,Kits,23,0,0.0,23
19778,5115,Stuff Packs,20,0,0.0,20
19779,5116,Expansion Packs,16,0,0.0,16
19780,5116,Game Packs,12,0,0.0,12
19781,5116,Kits,33,0,0.0,33
19782,5116,Stuff Packs,20,0,0.0,20
19783,5117,Expansion Packs,16,0,0.0,16
19784,5117,Game Packs,12,0,0.0,12
19785,5117,Kits,22,0,0.0,22
19786,5117,Stuff Packs,17,0,0.0,17
19787,5118,Expansion Packs,15,0,0.0,15
19788,5118,Game Packs,11,0,0.0,11
19789,5118,Kits,21,0,0.0,21
19790,5118,Stuff Packs,20,0,0.0,20
19791,5119,Expansion Packs,8,0,0.0,8
19792,5119,Game Packs,2,0,0.0,2
19793,5119,Kits,3,2,0.6666666666666666,1
19794,5119,Stuff Packs,8,3,0.375,5
19795,5120,Expansion Packs,14,0,0.0,14
19796,5120,Game Packs,11,0,0.0,11
19797,5120,Kits,15,1,0.06666666666666667,14
19798,5120,Stuff Packs,19,0,0.0,19
19799,5121,Expansion Packs,16,0,0.0,16
19800,5121,Game Packs,12,0,0.0,12
19801,5121,Kits,29,0,0.0,29
19802,5121,Stuff Packs,20,0,0.0,20
19803,5122,Expansion Packs,16,0,0.0,16
19804,5122,Game Packs,11,0,0.0,11
19805,5122,Kits,33,1,0.030303030303030304,32
19806,5122,Stuff Packs,20,0,0.0,20
19807,5123,Expansion Packs,15,0,0.0,15
19808,5123,Game Packs,10,0,0.0,10
19809,5123,Kits,24,0,0.0,24
19810,5123,Stuff Packs,18,0,0.0,18
19811,5124,Expansion Packs,7,0,0.0,7
19812,5124,Game Packs,5,0,0.0,5
19813,5124,Kits,4,1,0.25,3
19814,5124,Stuff Packs,2,0,0.0,2
19815,5125,Expansion Packs,11,0,0.0,11
19816,5125,Game Packs,9,0,0.0,9
19817,5125,Kits,2,2,1.0,0
19818,5125,Stuff Packs,19,0,0.0,19
19819,5126,Expansion Packs,16,0,0.0,16
19820,5126,Game Packs,12,0,0.0,12
19821,5126,Kits,33,0,0.0,33
19822,5126,Stuff Packs,20,0,0.0,20
19823,5127,Expansion Packs,15,0,0.0,15
19824,5127,Game Packs,7,0,0.0,7
19825,5127,Kits,8,2,0.25,6
19826,5127,Stuff Packs,11,0,0.0,11
19827,5128,Expansion Packs,11,0,0.0,11
19828,5128,Game Packs,8,0,0.0,8
19829,5128,Kits,1,1,1.0,0
19830,5128,Stuff Packs,9,1,0.1111111111111111,8
19831,5129,Expansion Packs,16,0,0.0,16
19832,5129,Game Packs,12,0,0.0,12
19833,5129,Kits,32,0,0.0,32
19834,5129,Stuff Packs,20,0,0.0,20
19835,5130,Expansion Packs,11,0,0.0,11
19836,5130,Game Packs,9,0,0.0,9
19837,5130,Kits,14,2,0.14285714285714285,12
19838,5130,Stuff Packs,12,2,0.16666666666666666,10
19839,5131,Expansion Packs,16,0,0.0,16
19840,5131,Game Packs,12,1,0.08333333333333333,11
19841,5131,Kits,33,3,0.09090909090909091,30
19842,5131,Stuff Packs,20,4,0.2,16
19843,5132,Expansion Packs,15,0,0.0,15
19844,5132,Game Packs,10,0,0.0,10
19845,5132,Kits,7,2,0.2857142857142857,5
19846,5132,Stuff Packs,15,1,0.06666666666666667,14
19847,5133,Expansion Packs,11,0,0.0,11
19848,5133,Game Packs,6,0,0.0,6
19849,5133,Kits,3,0,0.0,3
19850,5133,Stuff Packs,12,1,0.08333333333333333,11
19851,5134,Expansion Packs,16,0,0.0,16
19852,5134,Game Packs,12,0,0.0,12
19853,5134,Kits,22,0,0.0,22
19854,5134,Stuff Packs,20,0,0.0,20
19855,5135,Expansion Packs,14,0,0.0,14
19856,5135,Game Packs,10,0,0.0,10
19857,5135,Stuff Packs,8,1,0.125,7
19858,5136,Expansion Packs,12,0,0.0,12
19859,5136,Game Packs,7,0,0.0,7
19860,5136,Kits,22,0,0.0,22
19861,5136,Stuff Packs,17,2,0.11764705882352941,15
19862,5137,Expansion Packs,16,0,0.0,16
19863,5137,Game Packs,12,0,0.0,12
19864,5137,Kits,33,0,0.0,33
19865,5137,Stuff Packs,19,0,0.0,19
19866,5138,Expansion Packs,15,0,0.0,15
19867,5138,Game Packs,11,0,0.0,11
19868,5138,Kits,19,1,0.05263157894736842,18
19869,5138,Stuff Packs,18,0,0.0,18
19870,5139,Expansion Packs,16,0,0.0,16
19871,5139,Game Packs,10,0,0.0,10
19872,5139,Kits,10,0,0.0,10
19873,5139,Stuff Packs,12,2,0.16666666666666666,10
19874,5140,Expansion Packs,10,0,0.0,10
19875,5140,Game Packs,5,0,0.0,5
19876,5140,Kits,2,1,0.5,1
19877,5140,Stuff Packs,5,2,0.4,3
19878,5141,Expansion Packs,6,0,0.0,6
19879,5141,Game Packs,3,0,0.0,3
19880,5141,Stuff Packs,2,2,1.0,0
19881,5142,Expansion Packs,9,0,0.0,9
19882,5142,Game Packs,2,0,0.0,2
19883,5142,Kits,2,2,1.0,0
19884,5142,Stuff Packs,4,3,0.75,1
19885,5143,Expansion Packs,16,0,0.0,16
19886,5143,Game Packs,12,0,0.0,12
19887,5143,Kits,33,0,0.0,33
19888,5143,Stuff Packs,20,0,0.0,20
19889,5144,Expansion Packs,14,0,0.0,14
19890,5144,Game Packs,10,0,0.0,10
19891,5144,Kits,8,2,0.25,6
19892,5144,Stuff Packs,20,0,0.0,20
19893,5145,Expansion Packs,13,0,0.0,13
19894,5145,Game Packs,9,0,0.0,9
19895,5145,Kits,12,2,0.16666666666666666,10
19896,5145,Stuff Packs,15,0,0.0,15
19897,5146,Expansion Packs,15,0,0.0,15
19898,5146,Game Packs,6,0,0.0,6
19899,5146,Kits,2,2,1.0,0
19900,5146,Stuff Packs,8,2,0.25,6
19901,5147,Expansion Packs,16,0,0.0,16
19902,5147,Game Packs,12,0,0.0,12
19903,5147,Kits,33,0,0.0,33
19904,5147,Stuff Packs,20,1,0.05,19
19905,5148,Expansion Packs,15,0,0.0,15
19906,5148,Game Packs,11,0,0.0,11
19907,5148,Kits,21,0,0.0,21
19908,5148,Stuff Packs,19,0,0.0,19
19909,5149,Expansion Packs,5,0,0.0,5
19910,5149,Game Packs,1,0,0.0,1
19911,5149,Stuff Packs,2,1,0.5,1
19912,5150,Expansion Packs,16,0,0.0,16
19913,5150,Game Packs,11,0,0.0,11
19914,5150,Kits,13,1,0.07692307692307693,12
19915,5150,Stuff Packs,20,0,0.0,20
19916,5151,Expansion Packs,16,0,0.0,16
19917,5151,Game Packs,12,0,0.0,12
19918,5151,Kits,11,1,0.09090909090909091,10
19919,5151,Stuff Packs,16,2,0.125,14
19920,5152,Expansion Packs,9,0,0.0,9
19921,5152,Game Packs,6,0,0.0,6
19922,5152,Kits,2,0,0.0,2
19923,5152,Stuff Packs,4,0,0.0,4
19924,5153,Expansion Packs,16,0,0.0,16
19925,5153,Game Packs,12,0,0.0,12
19926,5153,Kits,29,0,0.0,29
19927,5153,Stuff Packs,20,0,0.0,20
19928,5154,Expansion Packs,16,0,0.0,16
19929,5154,Game Packs,10,0,0.0,10
19930,5154,Kits,3,0,0.0,3
19931,5154,Stuff Packs,11,0,0.0,11
19932,5155,Expansion Packs,11,0,0.0,11
19933,5155,Game Packs,8,0,0.0,8
19934,5155,Kits,4,1,0.25,3
19935,5155,Stuff Packs,8,0,0.0,8
19936,5156,Expansion Packs,13,0,0.0,13
19937,5156,Game Packs,7,0,0.0,7
19938,5156,Kits,11,0,0.0,11
19939,5156,Stuff Packs,12,4,0.3333333333333333,8
19940,5157,Expansion Packs,7,1,0.14285714285714285,6
19941,5157,Game Packs,4,0,0.0,4
19942,5157,Kits,2,1,0.5,1
19943,5157,Stuff Packs,7,1,0.14285714285714285,6
19944,5158,Expansion Packs,6,0,0.0,6
19945,5158,Game Packs,2,0,0.0,2
19946,5158,Kits,4,1,0.25,3
19947,5158,Stuff Packs,4,0,0.0,4
19948,5159,Expansion Packs,16,0,0.0,16
19949,5159,Game Packs,12,0,0.0,12
19950,5159,Kits,26,1,0.038461538461538464,25
19951,5159,Stuff Packs,16,0,0.0,16
19952,5160,Expansion Packs,12,0,0.0,12
19953,5160,Game Packs,8,0,0.0,8
19954,5160,Kits,5,2,0.4,3
19955,5160,Stuff Packs,12,1,0.08333333333333333,11
19956,5161,Expansion Packs,9,0,0.0,9
19957,5161,Game Packs,3,0,0.0,3
19958,5161,Kits,4,1,0.25,3
19959,5161,Stuff Packs,8,3,0.375,5
19960,5162,Expansion Packs,16,0,0.0,16
19961,5162,Game Packs,12,0,0.0,12
19962,5162,Kits,22,1,0.045454545454545456,21
19963,5162,Stuff Packs,18,1,0.05555555555555555,17
19964,5163,Expansion Packs,16,0,0.0,16
19965,5163,Game Packs,12,0,0.0,12
19966,5163,Kits,33,0,0.0,33
19967,5163,Stuff Packs,15,1,0.06666666666666667,14
19968,5164,Expansion Packs,15,0,0.0,15
19969,5164,Game Packs,10,0,0.0,10
19970,5164,Kits,3,1,0.3333333333333333,2
19971,5164,Stuff Packs,15,0,0.0,15
19972,5165,Expansion Packs,12,0,0.0,12
19973,5165,Game Packs,9,0,0.0,9
19974,5165,Stuff Packs,10,0,0.0,10
19975,5166,Expansion Packs,16,0,0.0,16
19976,5166,Game Packs,12,0,0.0,12
19977,5166,Kits,33,0,0.0,33
19978,5166,Stuff Packs,20,0,0.0,20
19979,5167,Expansion Packs,1,0,0.0,1
19980,5167,Game Packs,1,1,1.0,0
19981,5167,Kits,5,3,0.6,2
19982,5167,Stuff Packs,6,3,0.5,3
19983,5168,Expansion Packs,15,0,0.0,15
19984,5168,Game Packs,11,0,0.0,11
19985,5168,Kits,5,1,0.2,4
19986,5168,Stuff Packs,20,0,0.0,20
19987,5169,Expansion Packs,16,0,0.0,16
19988,5169,Game Packs,12,0,0.0,12
19989,5169,Kits,21,0,0.0,21
19990,5169,Stuff Packs,20,0,0.0,20
19991,5170,Expansion Packs,12,0,0.0,12
19992,5170,Game Packs,5,0,0.0,5
19993,5170,Kits,6,1,0.16666666666666666,5
19994,5170,Stuff Packs,6,1,0.16666666666666666,5
19995,5171,Expansion Packs,12,0,0.0,12
19996,5171,Game Packs,10,0,0.0,10
19997,5171,Kits,8,2,0.25,6
19998,5171,Stuff Packs,14,1,0.07142857142857142,13
19999,5172,Expansion Packs,9,0,0.0,9
20000,5172,Game Packs,4,0,0.0,4
20001,5172,Kits,1,1,1.0,0
20002,5172,Stuff Packs,3,2,0.6666666666666666,1
20003,5173,Expansion Packs,16,0,0.0,16
20004,5173,Game Packs,8,0,0.0,8
20005,5173,Kits,8,0,0.0,8
20006,5173,Stuff Packs,19,0,0.0,19
20007,5174,Expansion Packs,16,0,0.0,16
20008,5174,Game Packs,12,0,0.0,12
20009,5174,Kits,33,0,0.0,33
20010,5174,Stuff Packs,20,0,0.0,20
20011,5175,Expansion Packs,8,1,0.125,7
20012,5175,Game Packs,4,0,0.0,4
20013,5175,Kits,4,0,0.0,4
20014,5175,Stuff Packs,9,0,0.0,9
20015,5176,Expansion Packs,2,0,0.0,2
20016,5176,Game Packs,2,1,0.5,1
20017,5176,Kits,3,3,1.0,0
20018,5176,Stuff Packs,5,4,0.8,1
20019,5177,Expansion Packs,13,0,0.0,13
20020,5177,Game Packs,7,0,0.0,7
20021,5177,Kits,6,1,0.16666666666666666,5
20022,5177,Stuff Packs,13,2,0.15384615384615385,11
20023,5178,Expansion Packs,11,0,0.0,11
20024,5178,Game Packs,4,0,0.0,4
20025,5178,Kits,1,1,1.0,0
20026,5178,Stuff Packs,11,1,0.09090909090909091,10
20027,5179,Expansion Packs,15,0,0.0,15
20028,5179,Game Packs,9,0,0.0,9
20029,5179,Kits,33,0,0.0,33
20030,5179,Stuff Packs,19,0,0.0,19
20031,5180,Expansion Packs,16,0,0.0,16
20032,5180,Game Packs,12,0,0.0,12
20033,5180,Kits,32,0,0.0,32
20034,5180,Stuff Packs,20,0,0.0,20
20035,5181,Expansion Packs,16,0,0.0,16
20036,5181,Game Packs,12,0,0.0,12
20037,5181,Kits,23,0,0.0,23
20038,5181,Stuff Packs,20,0,0.0,20
20039,5182,Expansion Packs,13,0,0.0,13
20040,5182,Game Packs,5,0,0.0,5
20041,5182,Kits,4,4,1.0,0
20042,5182,Stuff Packs,10,3,0.3,7
20043,5183,Expansion Packs,16,0,0.0,16
20044,5183,Game Packs,9,0,0.0,9
20045,5183,Kits,23,1,0.043478260869565216,22
20046,5183,Stuff Packs,14,3,0.21428571428571427,11
20047,5184,Expansion Packs,8,0,0.0,8
20048,5184,Game Packs,5,0,0.0,5
20049,5184,Kits,1,1,1.0,0
20050,5184,Stuff Packs,7,0,0.0,7
20051,5185,Expansion Packs,11,0,0.0,11
20052,5185,Game Packs,5,0,0.0,5
20053,5185,Kits,2,0,0.0,2
20054,5185,Stuff Packs,6,0,0.0,6
20055,5186,Expansion Packs,16,0,0.0,16
20056,5186,Game Packs,12,1,0.08333333333333333,11
20057,5186,Kits,33,0,0.0,33
20058,5186,Stuff Packs,20,0,0.0,20
20059,5187,Expansion Packs,14,0,0.0,14
20060,5187,Game Packs,7,0,0.0,7
20061,5187,Kits,3,2,0.6666666666666666,1
20062,5187,Stuff Packs,14,1,0.07142857142857142,13
20063,5188,Expansion Packs,16,0,0.0,16
20064,5188,Game Packs,11,0,0.0,11
20065,5188,Kits,26,2,0.07692307692307693,24
20066,5188,Stuff Packs,19,3,0.15789473684210525,16
20067,5189,Expansion Packs,11,0,0.0,11
20068,5189,Game Packs,7,0,0.0,7
20069,5189,Kits,9,1,0.1111111111111111,8
20070,5189,Stuff Packs,12,0,0.0,12
20071,5190,Expansion Packs,16,0,0.0,16
20072,5190,Game Packs,11,0,0.0,11
20073,5190,Kits,25,2,0.08,23
20074,5190,Stuff Packs,20,0,0.0,20
20075,5191,Expansion Packs,15,0,0.0,15
20076,5191,Game Packs,8,0,0.0,8
20077,5191,Kits,8,1,0.125,7
20078,5191,Stuff Packs,15,1,0.06666666666666667,14
20079,5192,Expansion Packs,14,0,0.0,14
20080,5192,Game Packs,3,0,0.0,3
20081,5192,Kits,12,0,0.0,12
20082,5192,Stuff Packs,10,2,0.2,8
20083,5193,Expansion Packs,16,0,0.0,16
20084,5193,Game Packs,12,1,0.08333333333333333,11
20085,5193,Kits,23,0,0.0,23
20086,5193,Stuff Packs,20,1,0.05,19
20087,5194,Expansion Packs,7,0,0.0,7
20088,5194,Game Packs,8,0,0.0,8
20089,5194,Kits,11,2,0.18181818181818182,9
20090,5194,Stuff Packs,11,1,0.09090909090909091,10
20091,5195,Expansion Packs,16,0,0.0,16
20092,5195,Game Packs,12,0,0.0,12
20093,5195,Kits,33,0,0.0,33
20094,5195,Stuff Packs,20,0,0.0,20
20095,5196,Expansion Packs,13,0,0.0,13
20096,5196,Game Packs,11,1,0.09090909090909091,10
20097,5196,Kits,3,3,1.0,0
20098,5196,Stuff Packs,19,0,0.0,19
20099,5197,Expansion Packs,14,0,0.0,14
20100,5197,Game Packs,12,0,0.0,12
20101,5197,Kits,9,0,0.0,9
20102,5197,Stuff Packs,20,0,0.0,20
20103,5198,Expansion Packs,10,0,0.0,10
20104,5198,Game Packs,3,0,0.0,3
20105,5198,Stuff Packs,10,2,0.2,8
20106,5199,Expansion Packs,16,0,0.0,16
20107,5199,Game Packs,11,0,0.0,11
20108,5199,Kits,24,2,0.08333333333333333,22
20109,5199,Stuff Packs,20,1,0.05,19
20110,5200,Expansion Packs,16,0,0.0,16
20111,5200,Game Packs,10,0,0.0,10
20112,5200,Kits,33,0,0.0,33
20113,5200,Stuff Packs,20,0,0.0,20
20114,5201,Expansion Packs,16,0,0.0,16
20115,5201,Game Packs,12,0,0.0,12
20116,5201,Kits,15,1,0.06666666666666667,14
20117,5201,Stuff Packs,19,0,0.0,19
20118,5202,Expansion Packs,15,0,0.0,15
20119,5202,Game Packs,12,0,0.0,12
20120,5202,Kits,4,0,0.0,4
20121,5202,Stuff Packs,20,0,0.0,20
20122,5203,Expansion Packs,14,0,0.0,14
20123,5203,Game Packs,10,1,0.1,9
20124,5203,Kits,5,3,0.6,2
20125,5203,Stuff Packs,14,0,0.0,14
20126,5204,Expansion Packs,15,0,0.0,15
20127,5204,Game Packs,10,0,0.0,10
20128,5204,Kits,6,1,0.16666666666666666,5
20129,5204,Stuff Packs,15,1,0.06666666666666667,14
20130,5205,Expansion Packs,12,0,0.0,12
20131,5205,Game Packs,6,0,0.0,6
20132,5205,Kits,6,0,0.0,6
20133,5205,Stuff Packs,19,1,0.05263157894736842,18
20134,5206,Expansion Packs,9,0,0.0,9
20135,5206,Game Packs,7,0,0.0,7
20136,5206,Stuff Packs,10,0,0.0,10
20137,5207,Expansion Packs,16,0,0.0,16
20138,5207,Game Packs,12,0,0.0,12
20139,5207,Kits,33,0,0.0,33
20140,5207,Stuff Packs,20,0,0.0,20
20141,5208,Expansion Packs,16,0,0.0,16
20142,5208,Game Packs,10,0,0.0,10
20143,5208,Kits,20,0,0.0,20
20144,5208,Stuff Packs,18,1,0.05555555555555555,17
20145,5209,Expansion Packs,7,0,0.0,7
20146,5209,Game Packs,3,0,0.0,3
20147,5209,Kits,2,2,1.0,0
20148,5209,Stuff Packs,7,3,0.42857142857142855,4
20149,5210,Expansion Packs,2,0,0.0,2
20150,5210,Game Packs,2,0,0.0,2
20151,5210,Kits,2,2,1.0,0
20152,5210,Stuff Packs,5,3,0.6,2
20153,5211,Expansion Packs,2,2,1.0,0
20154,5211,Game Packs,1,1,1.0,0
20155,5212,Expansion Packs,7,0,0.0,7
20156,5212,Game Packs,5,0,0.0,5
20157,5212,Kits,8,1,0.125,7
20158,5212,Stuff Packs,6,3,0.5,3
20159,5213,Expansion Packs,15,0,0.0,15
20160,5213,Game Packs,10,0,0.0,10
20161,5213,Kits,7,1,0.14285714285714285,6
20162,5213,Stuff Packs,18,1,0.05555555555555555,17
20163,5214,Expansion Packs,15,0,0.0,15
20164,5214,Game Packs,11,0,0.0,11
20165,5214,Kits,10,1,0.1,9
20166,5214,Stuff Packs,14,1,0.07142857142857142,13
20167,5215,Expansion Packs,16,0,0.0,16
20168,5215,Game Packs,11,0,0.0,11
20169,5215,Kits,7,0,0.0,7
20170,5215,Stuff Packs,20,0,0.0,20
20171,5216,Expansion Packs,16,0,0.0,16
20172,5216,Game Packs,12,0,0.0,12
20173,5216,Kits,33,0,0.0,33
20174,5216,Stuff Packs,20,0,0.0,20
20175,5217,Expansion Packs,16,0,0.0,16
20176,5217,Game Packs,12,0,0.0,12
20177,5217,Kits,33,0,0.0,33
20178,5217,Stuff Packs,20,0,0.0,20
20179,5218,Expansion Packs,3,0,0.0,3
20180,5218,Game Packs,2,0,0.0,2
20181,5218,Kits,1,1,1.0,0
20182,5218,Stuff Packs,3,1,0.3333333333333333,2
20183,5219,Expansion Packs,2,0,0.0,2
20184,5219,Game Packs,2,0,0.0,2
20185,5219,Kits,1,1,1.0,0
20186,5219,Stuff Packs,4,1,0.25,3
20187,5220,Expansion Packs,16,0,0.0,16
20188,5220,Game Packs,12,0,0.0,12
20189,5220,Kits,2,2,1.0,0
20190,5220,Stuff Packs,20,0,0.0,20
20191,5221,Expansion Packs,15,0,0.0,15
20192,5221,Game Packs,12,0,0.0,12
20193,5221,Kits,31,0,0.0,31
20194,5221,Stuff Packs,20,0,0.0,20
20195,5222,Expansion Packs,15,0,0.0,15
20196,5222,Game Packs,8,0,0.0,8
20197,5222,Stuff Packs,9,2,0.2222222222222222,7
20198,5223,Expansion Packs,5,0,0.0,5
20199,5223,Stuff Packs,2,0,0.0,2
20200,5224,Game Packs,1,0,0.0,1
20201,5225,Expansion Packs,1,0,0.0,1
20202,5225,Kits,2,0,0.0,2
20203,5225,Stuff Packs,3,0,0.0,3
20204,5226,Expansion Packs,13,0,0.0,13
20205,5226,Game Packs,9,0,0.0,9
20206,5226,Kits,2,0,0.0,2
20207,5226,Stuff Packs,11,5,0.45454545454545453,6
20208,5227,Expansion Packs,13,0,0.0,13
20209,5227,Game Packs,9,0,0.0,9
20210,5227,Kits,2,2,1.0,0
20211,5227,Stuff Packs,9,2,0.2222222222222222,7
20212,5228,Expansion Packs,16,0,0.0,16
20213,5228,Game Packs,12,0,0.0,12
20214,5228,Kits,33,2,0.06060606060606061,31
20215,5228,Stuff Packs,20,1,0.05,19
20216,5229,Expansion Packs,4,0,0.0,4
20217,5229,Game Packs,4,1,0.25,3
20218,5229,Stuff Packs,7,3,0.42857142857142855,4
20219,5230,Expansion Packs,9,0,0.0,9
20220,5230,Game Packs,5,0,0.0,5
20221,5230,Kits,19,1,0.05263157894736842,18
20222,5230,Stuff Packs,11,2,0.18181818181818182,9
20223,5231,Expansion Packs,16,0,0.0,16
20224,5231,Game Packs,12,0,0.0,12
20225,5231,Kits,4,0,0.0,4
20226,5231,Stuff Packs,20,0,0.0,20
20227,5232,Expansion Packs,11,0,0.0,11
20228,5232,Game Packs,7,0,0.0,7
20229,5232,Kits,2,2,1.0,0
20230,5232,Stuff Packs,13,4,0.3076923076923077,9
20231,5233,Expansion Packs,11,0,0.0,11
20232,5233,Game Packs,3,0,0.0,3
20233,5233,Kits,2,0,0.0,2
20234,5233,Stuff Packs,6,0,0.0,6
20235,5234,Expansion Packs,14,0,0.0,14
20236,5234,Game Packs,5,0,0.0,5
20237,5234,Kits,2,2,1.0,0
20238,5234,Stuff Packs,4,1,0.25,3
20239,5235,Expansion Packs,16,0,0.0,16
20240,5235,Game Packs,11,0,0.0,11
20241,5235,Kits,15,2,0.13333333333333333,13
20242,5235,Stuff Packs,19,0,0.0,19
20243,5236,Expansion Packs,16,0,0.0,16
20244,5236,Game Packs,11,0,0.0,11
20245,5236,Kits,24,1,0.041666666666666664,23
20246,5236,Stuff Packs,16,1,0.0625,15
20247,5237,Expansion Packs,14,0,0.0,14
20248,5237,Game Packs,9,0,0.0,9
20249,5237,Kits,5,1,0.2,4
20250,5237,Stuff Packs,15,1,0.06666666666666667,14
20251,5238,Expansion Packs,10,0,0.0,10
20252,5238,Game Packs,4,0,0.0,4
20253,5238,Kits,1,1,1.0,0
20254,5238,Stuff Packs,5,3,0.6,2
20255,5239,Expansion Packs,6,1,0.16666666666666666,5
20256,5239,Game Packs,2,1,0.5,1
20257,5239,Kits,2,2,1.0,0
20258,5239,Stuff Packs,3,2,0.6666666666666666,1
20259,5240,Expansion Packs,4,0,0.0,4
20260,5240,Game Packs,4,0,0.0,4
20261,5240,Kits,2,1,0.5,1
20262,5240,Stuff Packs,2,0,0.0,2
20263,5241,Expansion Packs,7,0,0.0,7
20264,5241,Game Packs,3,0,0.0,3
20265,5241,Kits,2,2,1.0,0
20266,5241,Stuff Packs,7,0,0.0,7
20267,5242,Expansion Packs,16,0,0.0,16
20268,5242,Game Packs,12,0,0.0,12
20269,5242,Kits,31,0,0.0,31
20270,5242,Stuff Packs,20,0,0.0,20
20271,5243,Expansion Packs,16,0,0.0,16
20272,5243,Game Packs,12,0,0.0,12
20273,5243,Kits,33,1,0.030303030303030304,32
20274,5243,Stuff Packs,20,0,0.0,20
20275,5244,Expansion Packs,15,0,0.0,15
20276,5244,Game Packs,8,0,0.0,8
20277,5244,Kits,5,0,0.0,5
20278,5244,Stuff Packs,11,1,0.09090909090909091,10
20279,5245,Expansion Packs,15,0,0.0,15
20280,5245,Game Packs,10,0,0.0,10
20281,5245,Kits,2,2,1.0,0
20282,5245,Stuff Packs,11,4,0.36363636363636365,7
20283,5246,Expansion Packs,1,0,0.0,1
20284,5246,Stuff Packs,1,0,0.0,1
20285,5247,Expansion Packs,3,0,0.0,3
20286,5247,Game Packs,5,1,0.2,4
20287,5247,Kits,2,2,1.0,0
20288,5247,Stuff Packs,6,4,0.6666666666666666,2
20289,5248,Expansion Packs,16,0,0.0,16
20290,5248,Game Packs,12,0,0.0,12
20291,5248,Kits,33,0,0.0,33
20292,5248,Stuff Packs,20,0,0.0,20
20293,5249,Expansion Packs,13,0,0.0,13
20294,5249,Game Packs,6,0,0.0,6
20295,5249,Kits,5,1,0.2,4
20296,5249,Stuff Packs,4,2,0.5,2
20297,5250,Expansion Packs,15,0,0.0,15
20298,5250,Game Packs,8,0,0.0,8
20299,5250,Kits,2,2,1.0,0
20300,5250,Stuff Packs,5,1,0.2,4
20301,5251,Expansion Packs,6,0,0.0,6
20302,5251,Game Packs,7,0,0.0,7
20303,5251,Kits,4,1,0.25,3
20304,5251,Stuff Packs,9,3,0.3333333333333333,6
20305,5252,Expansion Packs,12,0,0.0,12
20306,5252,Game Packs,5,2,0.4,3
20307,5252,Kits,4,2,0.5,2
20308,5252,Stuff Packs,10,4,0.4,6
20309,5253,Expansion Packs,16,0,0.0,16
20310,5253,Game Packs,12,0,0.0,12
20311,5253,Kits,33,0,0.0,33
20312,5253,Stuff Packs,20,0,0.0,20
20313,5254,Expansion Packs,16,0,0.0,16
20314,5254,Game Packs,12,0,0.0,12
20315,5254,Kits,20,0,0.0,20
20316,5254,Stuff Packs,20,0,0.0,20
20317,5255,Expansion Packs,3,0,0.0,3
20318,5255,Game Packs,2,0,0.0,2
20319,5255,Kits,1,1,1.0,0
20320,5255,Stuff Packs,4,1,0.25,3
20321,5256,Expansion Packs,6,0,0.0,6
20322,5256,Game Packs,3,0,0.0,3
20323,5256,Kits,2,2,1.0,0
20324,5256,Stuff Packs,8,0,0.0,8
20325,5257,Expansion Packs,16,1,0.0625,15
20326,5257,Game Packs,12,0,0.0,12
20327,5257,Kits,33,1,0.030303030303030304,32
20328,5257,Stuff Packs,20,0,0.0,20
20329,5258,Expansion Packs,16,0,0.0,16
20330,5258,Game Packs,12,1,0.08333333333333333,11
20331,5258,Kits,18,0,0.0,18
20332,5258,Stuff Packs,20,0,0.0,20
20333,5259,Expansion Packs,14,0,0.0,14
20334,5259,Game Packs,1,0,0.0,1
20335,5259,Kits,2,2,1.0,0
20336,5259,Stuff Packs,14,1,0.07142857142857142,13
20337,5260,Expansion Packs,16,0,0.0,16
20338,5260,Game Packs,12,0,0.0,12
20339,5260,Kits,29,0,0.0,29
20340,5260,Stuff Packs,20,1,0.05,19
20341,5261,Expansion Packs,15,0,0.0,15
20342,5261,Game Packs,11,0,0.0,11
20343,5261,Kits,1,0,0.0,1
20344,5261,Stuff Packs,8,2,0.25,6
20345,5262,Expansion Packs,13,0,0.0,13
20346,5262,Game Packs,8,0,0.0,8
20347,5262,Stuff Packs,13,2,0.15384615384615385,11
20348,5263,Expansion Packs,13,0,0.0,13
20349,5263,Game Packs,11,0,0.0,11
20350,5263,Kits,6,2,0.3333333333333333,4
20351,5263,Stuff Packs,12,3,0.25,9
20352,5264,Expansion Packs,15,0,0.0,15
20353,5264,Game Packs,12,0,0.0,12
20354,5264,Kits,30,1,0.03333333333333333,29
20355,5264,Stuff Packs,20,0,0.0,20
20356,5265,Expansion Packs,10,0,0.0,10
20357,5265,Game Packs,8,0,0.0,8
20358,5265,Kits,2,2,1.0,0
20359,5265,Stuff Packs,3,1,0.3333333333333333,2
20360,5266,Expansion Packs,15,0,0.0,15
20361,5266,Game Packs,12,0,0.0,12
20362,5266,Kits,3,3,1.0,0
20363,5266,Stuff Packs,20,3,0.15,17
20364,5267,Expansion Packs,2,0,0.0,2
20365,5267,Game Packs,2,1,0.5,1
20366,5267,Kits,2,2,1.0,0
20367,5267,Stuff Packs,4,4,1.0,0
20368,5268,Expansion Packs,16,2,0.125,14
20369,5268,Game Packs,11,0,0.0,11
20370,5268,Kits,7,0,0.0,7
20371,5268,Stuff Packs,7,0,0.0,7
20372,5269,Expansion Packs,16,0,0.0,16
20373,5269,Game Packs,8,0,0.0,8
20374,5269,Kits,2,0,0.0,2
20375,5269,Stuff Packs,3,1,0.3333333333333333,2
20376,5270,Expansion Packs,16,0,0.0,16
20377,5270,Game Packs,12,0,0.0,12
20378,5270,Kits,29,0,0.0,29
20379,5270,Stuff Packs,20,0,0.0,20
20380,5271,Expansion Packs,16,0,0.0,16
20381,5271,Game Packs,12,1,0.08333333333333333,11
20382,5271,Kits,12,0,0.0,12
20383,5271,Stuff Packs,20,1,0.05,19
20384,5272,Expansion Packs,16,0,0.0,16
20385,5272,Game Packs,12,0,0.0,12
20386,5272,Kits,29,1,0.034482758620689655,28
20387,5272,Stuff Packs,20,0,0.0,20
20388,5273,Expansion Packs,14,0,0.0,14
20389,5273,Game Packs,5,0,0.0,5
20390,5273,Kits,3,0,0.0,3
20391,5273,Stuff Packs,7,2,0.2857142857142857,5
20392,5274,Expansion Packs,16,0,0.0,16
20393,5274,Game Packs,12,0,0.0,12
20394,5274,Kits,16,1,0.0625,15
20395,5274,Stuff Packs,20,0,0.0,20
20396,5275,Expansion Packs,15,0,0.0,15
20397,5275,Game Packs,7,1,0.14285714285714285,6
20398,5275,Kits,3,2,0.6666666666666666,1
20399,5275,Stuff Packs,5,3,0.6,2
20400,5276,Expansion Packs,16,0,0.0,16
20401,5276,Game Packs,12,0,0.0,12
20402,5276,Kits,14,0,0.0,14
20403,5276,Stuff Packs,19,0,0.0,19
20404,5277,Expansion Packs,8,0,0.0,8
20405,5277,Game Packs,7,0,0.0,7
20406,5277,Stuff Packs,5,0,0.0,5
20407,5278,Expansion Packs,14,0,0.0,14
20408,5278,Game Packs,10,0,0.0,10
20409,5278,Kits,5,1,0.2,4
20410,5278,Stuff Packs,13,1,0.07692307692307693,12
20411,5279,Expansion Packs,13,0,0.0,13
20412,5279,Game Packs,7,0,0.0,7
20413,5279,Kits,7,1,0.14285714285714285,6
20414,5279,Stuff Packs,8,2,0.25,6
20415,5280,Expansion Packs,16,0,0.0,16
20416,5280,Game Packs,12,0,0.0,12
20417,5280,Kits,33,0,0.0,33
20418,5280,Stuff Packs,20,0,0.0,20
20419,5281,Expansion Packs,14,0,0.0,14
20420,5281,Game Packs,10,0,0.0,10
20421,5281,Kits,3,2,0.6666666666666666,1
20422,5281,Stuff Packs,17,0,0.0,17
20423,5282,Expansion Packs,13,0,0.0,13
20424,5282,Game Packs,9,2,0.2222222222222222,7
20425,5282,Kits,16,1,0.0625,15
20426,5282,Stuff Packs,12,4,0.3333333333333333,8
20427,5283,Expansion Packs,8,0,0.0,8
20428,5283,Game Packs,6,0,0.0,6
20429,5283,Kits,8,0,0.0,8
20430,5283,Stuff Packs,10,0,0.0,10
20431,5284,Expansion Packs,15,0,0.0,15
20432,5284,Game Packs,11,0,0.0,11
20433,5284,Kits,18,2,0.1111111111111111,16
20434,5284,Stuff Packs,20,2,0.1,18
20435,5285,Expansion Packs,16,1,0.0625,15
20436,5285,Game Packs,12,0,0.0,12
20437,5285,Kits,33,0,0.0,33
20438,5285,Stuff Packs,20,0,0.0,20
20439,5286,Expansion Packs,16,0,0.0,16
20440,5286,Game Packs,12,0,0.0,12
20441,5286,Kits,33,1,0.030303030303030304,32
20442,5286,Stuff Packs,20,0,0.0,20
20443,5287,Expansion Packs,7,0,0.0,7
20444,5287,Game Packs,5,0,0.0,5
20445,5287,Kits,10,0,0.0,10
20446,5287,Stuff Packs,7,0,0.0,7
20447,5288,Expansion Packs,6,0,0.0,6
20448,5288,Game Packs,2,0,0.0,2
20449,5288,Stuff Packs,1,0,0.0,1
20450,5289,Expansion Packs,8,0,0.0,8
20451,5289,Game Packs,3,0,0.0,3
20452,5289,Kits,11,1,0.09090909090909091,10
20453,5289,Stuff Packs,9,1,0.1111111111111111,8
20454,5290,Expansion Packs,14,0,0.0,14
20455,5290,Game Packs,11,0,0.0,11
20456,5290,Kits,3,1,0.3333333333333333,2
20457,5290,Stuff Packs,16,1,0.0625,15
20458,5291,Expansion Packs,15,0,0.0,15
20459,5291,Game Packs,11,0,0.0,11
20460,5291,Kits,6,2,0.3333333333333333,4
20461,5291,Stuff Packs,19,2,0.10526315789473684,17
20462,5292,Expansion Packs,15,0,0.0,15
20463,5292,Game Packs,9,0,0.0,9
20464,5292,Kits,5,2,0.4,3
20465,5292,Stuff Packs,14,2,0.14285714285714285,12
20466,5293,Expansion Packs,16,0,0.0,16
20467,5293,Game Packs,12,0,0.0,12
20468,5293,Kits,33,0,0.0,33
20469,5293,Stuff Packs,20,0,0.0,20
20470,5294,Expansion Packs,8,0,0.0,8
20471,5294,Game Packs,7,0,0.0,7
20472,5294,Kits,8,2,0.25,6
20473,5294,Stuff Packs,14,2,0.14285714285714285,12
20474,5295,Expansion Packs,16,0,0.0,16
20475,5295,Game Packs,12,0,0.0,12
20476,5295,Kits,33,0,0.0,33
20477,5295,Stuff Packs,20,0,0.0,20
20478,5296,Expansion Packs,16,0,0.0,16
20479,5296,Game Packs,12,0,0.0,12
20480,5296,Kits,14,1,0.07142857142857142,13
20481,5296,Stuff Packs,20,0,0.0,20
20482,5297,Expansion Packs,8,0,0.0,8
20483,5297,Game Packs,5,0,0.0,5
20484,5297,Stuff Packs,4,0,0.0,4
20485,5298,Expansion Packs,7,0,0.0,7
20486,5298,Game Packs,4,1,0.25,3
20487,5298,Kits,1,1,1.0,0
20488,5298,Stuff Packs,6,4,0.6666666666666666,2
20489,5299,Expansion Packs,16,0,0.0,16
20490,5299,Game Packs,12,0,0.0,12
20491,5299,Kits,33,0,0.0,33
20492,5299,Stuff Packs,20,0,0.0,20
20493,5300,Expansion Packs,16,0,0.0,16
20494,5300,Game Packs,7,0,0.0,7
20495,5300,Kits,1,1,1.0,0
20496,5300,Stuff Packs,4,1,0.25,3
20497,5301,Expansion Packs,14,0,0.0,14
20498,5301,Game Packs,8,0,0.0,8
20499,5301,Kits,3,0,0.0,3
20500,5301,Stuff Packs,13,3,0.23076923076923078,10
20501,5302,Expansion Packs,8,0,0.0,8
20502,5302,Stuff Packs,1,0,0.0,1
20503,5303,Expansion Packs,7,0,0.0,7
20504,5303,Game Packs,1,0,0.0,1
20505,5303,Kits,4,0,0.0,4
20506,5303,Stuff Packs,3,2,0.6666666666666666,1
20507,5304,Expansion Packs,16,0,0.0,16
20508,5304,Game Packs,9,0,0.0,9
20509,5304,Kits,16,0,0.0,16
20510,5304,Stuff Packs,18,0,0.0,18
20511,5305,Expansion Packs,16,0,0.0,16
20512,5305,Game Packs,12,0,0.0,12
20513,5305,Kits,25,1,0.04,24
20514,5305,Stuff Packs,20,0,0.0,20
20515,5306,Expansion Packs,16,0,0.0,16
20516,5306,Game Packs,11,0,0.0,11
20517,5306,Kits,4,2,0.5,2
20518,5306,Stuff Packs,17,5,0.29411764705882354,12
20519,5307,Expansion Packs,16,0,0.0,16
20520,5307,Game Packs,12,0,0.0,12
20521,5307,Kits,33,0,0.0,33
20522,5307,Stuff Packs,20,0,0.0,20
20523,5308,Expansion Packs,12,1,0.08333333333333333,11
20524,5308,Game Packs,11,0,0.0,11
20525,5308,Kits,3,0,0.0,3
20526,5308,Stuff Packs,18,0,0.0,18
20527,5309,Expansion Packs,16,0,0.0,16
20528,5309,Game Packs,12,0,0.0,12
20529,5309,Kits,11,1,0.09090909090909091,10
20530,5309,Stuff Packs,20,3,0.15,17
20531,5310,Expansion Packs,15,0,0.0,15
20532,5310,Game Packs,9,0,0.0,9
20533,5310,Kits,14,1,0.07142857142857142,13
20534,5310,Stuff Packs,11,0,0.0,11
20535,5311,Expansion Packs,14,0,0.0,14
20536,5311,Game Packs,10,0,0.0,10
20537,5311,Kits,4,1,0.25,3
20538,5311,Stuff Packs,19,0,0.0,19
20539,5312,Expansion Packs,16,0,0.0,16
20540,5312,Game Packs,12,0,0.0,12
20541,5312,Kits,8,3,0.375,5
20542,5312,Stuff Packs,13,2,0.15384615384615385,11
20543,5313,Expansion Packs,13,0,0.0,13
20544,5313,Kits,1,1,1.0,0
20545,5313,Stuff Packs,2,0,0.0,2
20546,5314,Expansion Packs,12,0,0.0,12
20547,5314,Game Packs,8,0,0.0,8
20548,5314,Kits,3,2,0.6666666666666666,1
20549,5314,Stuff Packs,18,1,0.05555555555555555,17
20550,5315,Expansion Packs,16,0,0.0,16
20551,5315,Game Packs,12,0,0.0,12
20552,5315,Kits,33,0,0.0,33
20553,5315,Stuff Packs,20,0,0.0,20
20554,5316,Expansion Packs,11,0,0.0,11
20555,5316,Game Packs,8,0,0.0,8
20556,5316,Kits,4,1,0.25,3
20557,5316,Stuff Packs,17,0,0.0,17
20558,5317,Expansion Packs,16,0,0.0,16
20559,5317,Game Packs,11,0,0.0,11
20560,5317,Kits,27,1,0.037037037037037035,26
20561,5317,Stuff Packs,20,0,0.0,20
20562,5318,Expansion Packs,7,0,0.0,7
20563,5318,Game Packs,3,0,0.0,3
20564,5318,Stuff Packs,1,0,0.0,1
20565,5319,Expansion Packs,16,0,0.0,16
20566,5319,Game Packs,12,0,0.0,12
20567,5319,Kits,33,2,0.06060606060606061,31
20568,5319,Stuff Packs,20,0,0.0,20
20569,5320,Expansion Packs,16,0,0.0,16
20570,5320,Game Packs,12,0,0.0,12
20571,5320,Kits,24,1,0.041666666666666664,23
20572,5320,Stuff Packs,20,0,0.0,20
20573,5321,Expansion Packs,16,0,0.0,16
20574,5321,Game Packs,12,0,0.0,12
20575,5321,Kits,33,0,0.0,33
20576,5321,Stuff Packs,20,0,0.0,20
20577,5322,Expansion Packs,5,0,0.0,5
20578,5322,Kits,2,0,0.0,2
20579,5322,Stuff Packs,2,0,0.0,2
20580,5323,Expansion Packs,15,0,0.0,15
20581,5323,Game Packs,12,0,0.0,12
20582,5323,Kits,25,0,0.0,25
20583,5323,Stuff Packs,20,0,0.0,20
20584,5324,Expansion Packs,12,0,0.0,12
20585,5324,Game Packs,5,0,0.0,5
20586,5324,Stuff Packs,14,0,0.0,14
20587,5325,Expansion Packs,16,0,0.0,16
20588,5325,Game Packs,11,0,0.0,11
20589,5325,Kits,17,2,0.11764705882352941,15
20590,5325,Stuff Packs,20,1,0.05,19
20591,5326,Expansion Packs,10,0,0.0,10
20592,5326,Game Packs,5,0,0.0,5
20593,5326,Kits,18,1,0.05555555555555555,17
20594,5326,Stuff Packs,13,0,0.0,13
20595,5327,Expansion Packs,6,0,0.0,6
20596,5327,Game Packs,4,0,0.0,4
20597,5327,Kits,4,0,0.0,4
20598,5327,Stuff Packs,5,3,0.6,2
20599,5328,Expansion Packs,15,0,0.0,15
20600,5328,Game Packs,11,1,0.09090909090909091,10
20601,5328,Kits,7,2,0.2857142857142857,5
20602,5328,Stuff Packs,17,1,0.058823529411764705,16
20603,5329,Expansion Packs,8,0,0.0,8
20604,5329,Game Packs,5,0,0.0,5
20605,5329,Kits,1,1,1.0,0
20606,5329,Stuff Packs,7,2,0.2857142857142857,5
20607,5330,Expansion Packs,16,0,0.0,16
20608,5330,Game Packs,12,0,0.0,12
20609,5330,Kits,33,0,0.0,33
20610,5330,Stuff Packs,20,0,0.0,20
20611,5331,Expansion Packs,14,0,0.0,14
20612,5331,Game Packs,9,0,0.0,9
20613,5331,Kits,4,1,0.25,3
20614,5331,Stuff Packs,14,5,0.35714285714285715,9
20615,5332,Expansion Packs,16,0,0.0,16
20616,5332,Game Packs,11,0,0.0,11
20617,5332,Kits,30,0,0.0,30
20618,5332,Stuff Packs,18,0,0.0,18
20619,5333,Expansion Packs,12,0,0.0,12
20620,5333,Game Packs,10,0,0.0,10
20621,5333,Kits,8,0,0.0,8
20622,5333,Stuff Packs,15,0,0.0,15
20623,5334,Expansion Packs,14,0,0.0,14
20624,5334,Game Packs,10,0,0.0,10
20625,5334,Kits,2,0,0.0,2
20626,5334,Stuff Packs,18,1,0.05555555555555555,17
20627,5335,Expansion Packs,13,0,0.0,13
20628,5335,Game Packs,5,0,0.0,5
20629,5335,Kits,5,1,0.2,4
20630,5335,Stuff Packs,7,1,0.14285714285714285,6
20631,5336,Expansion Packs,14,0,0.0,14
20632,5336,Game Packs,12,0,0.0,12
20633,5336,Kits,18,0,0.0,18
20634,5336,Stuff Packs,19,0,0.0,19
20635,5337,Expansion Packs,16,0,0.0,16
20636,5337,Game Packs,10,0,0.0,10
20637,5337,Kits,2,0,0.0,2
20638,5337,Stuff Packs,14,0,0.0,14
20639,5338,Expansion Packs,16,0,0.0,16
20640,5338,Game Packs,9,1,0.1111111111111111,8
20641,5338,Kits,2,1,0.5,1
20642,5338,Stuff Packs,9,2,0.2222222222222222,7
20643,5339,Expansion Packs,16,0,0.0,16
20644,5339,Game Packs,11,0,0.0,11
20645,5339,Kits,26,1,0.038461538461538464,25
20646,5339,Stuff Packs,18,0,0.0,18
20647,5340,Expansion Packs,11,0,0.0,11
20648,5340,Game Packs,4,0,0.0,4
20649,5340,Kits,6,0,0.0,6
20650,5340,Stuff Packs,6,2,0.3333333333333333,4
20651,5341,Expansion Packs,9,0,0.0,9
20652,5341,Game Packs,9,0,0.0,9
20653,5341,Kits,2,0,0.0,2
20654,5341,Stuff Packs,6,0,0.0,6
20655,5342,Expansion Packs,16,0,0.0,16
20656,5342,Game Packs,12,0,0.0,12
20657,5342,Kits,18,0,0.0,18
20658,5342,Stuff Packs,20,0,0.0,20
20659,5343,Expansion Packs,15,0,0.0,15
20660,5343,Game Packs,12,0,0.0,12
20661,5343,Kits,18,0,0.0,18
20662,5344,Expansion Packs,12,0,0.0,12
20663,5344,Game Packs,10,0,0.0,10
20664,5344,Kits,2,2,1.0,0
20665,5344,Stuff Packs,10,1,0.1,9
20666,5345,Expansion Packs,16,0,0.0,16
20667,5345,Game Packs,12,0,0.0,12
20668,5345,Kits,33,0,0.0,33
20669,5345,Stuff Packs,20,0,0.0,20
20670,5346,Expansion Packs,7,0,0.0,7
20671,5346,Game Packs,4,0,0.0,4
20672,5346,Kits,2,2,1.0,0
20673,5346,Stuff Packs,8,2,0.25,6
20674,5347,Expansion Packs,16,0,0.0,16
20675,5347,Game Packs,12,0,0.0,12
20676,5347,Kits,33,0,0.0,33
20677,5347,Stuff Packs,20,0,0.0,20
20678,5348,Expansion Packs,14,0,0.0,14
20679,5348,Game Packs,7,0,0.0,7
20680,5348,Kits,3,1,0.3333333333333333,2
20681,5348,Stuff Packs,9,2,0.2222222222222222,7
20682,5349,Expansion Packs,15,0,0.0,15
20683,5349,Game Packs,11,0,0.0,11
20684,5349,Kits,5,2,0.4,3
20685,5349,Stuff Packs,19,0,0.0,19
20686,5350,Expansion Packs,13,0,0.0,13
20687,5350,Game Packs,8,0,0.0,8
20688,5350,Kits,7,1,0.14285714285714285,6
20689,5350,Stuff Packs,8,3,0.375,5
20690,5351,Expansion Packs,15,0,0.0,15
20691,5351,Game Packs,10,0,0.0,10
20692,5351,Kits,5,1,0.2,4
20693,5351,Stuff Packs,17,0,0.0,17
20694,5352,Expansion Packs,12,0,0.0,12
20695,5352,Game Packs,12,2,0.16666666666666666,10
20696,5352,Kits,17,1,0.058823529411764705,16
20697,5352,Stuff Packs,19,2,0.10526315789473684,17
20698,5353,Expansion Packs,11,0,0.0,11
20699,5353,Stuff Packs,2,0,0.0,2
20700,5354,Expansion Packs,15,1,0.06666666666666667,14
20701,5354,Game Packs,9,0,0.0,9
20702,5354,Kits,9,0,0.0,9
20703,5354,Stuff Packs,20,0,0.0,20
20704,5355,Expansion Packs,3,0,0.0,3
20705,5355,Game Packs,2,0,0.0,2
20706,5355,Kits,2,2,1.0,0
20707,5355,Stuff Packs,2,0,0.0,2
20708,5356,Expansion Packs,10,0,0.0,10
20709,5356,Game Packs,12,0,0.0,12
20710,5356,Kits,19,1,0.05263157894736842,18
20711,5356,Stuff Packs,14,2,0.14285714285714285,12
20712,5357,Expansion Packs,16,0,0.0,16
20713,5357,Game Packs,12,0,0.0,12
20714,5357,Kits,21,0,0.0,21
20715,5357,Stuff Packs,20,0,0.0,20
20716,5358,Expansion Packs,14,0,0.0,14
20717,5358,Game Packs,12,0,0.0,12
20718,5358,Kits,3,3,1.0,0
20719,5358,Stuff Packs,18,0,0.0,18
20720,5359,Expansion Packs,14,0,0.0,14
20721,5359,Game Packs,11,0,0.0,11
20722,5359,Kits,16,2,0.125,14
20723,5359,Stuff Packs,19,0,0.0,19
20724,5360,Expansion Packs,16,0,0.0,16
20725,5360,Game Packs,12,0,0.0,12
20726,5360,Kits,32,1,0.03125,31
20727,5360,Stuff Packs,20,0,0.0,20
20728,5361,Expansion Packs,13,0,0.0,13
20729,5361,Game Packs,9,0,0.0,9
20730,5361,Kits,8,0,0.0,8
20731,5361,Stuff Packs,17,0,0.0,17
20732,5362,Expansion Packs,4,0,0.0,4
20733,5362,Game Packs,3,0,0.0,3
20734,5362,Kits,1,1,1.0,0
20735,5362,Stuff Packs,4,1,0.25,3
20736,5363,Expansion Packs,16,0,0.0,16
20737,5363,Game Packs,12,0,0.0,12
20738,5363,Kits,33,0,0.0,33
20739,5363,Stuff Packs,20,0,0.0,20
20740,5364,Expansion Packs,16,0,0.0,16
20741,5364,Game Packs,11,0,0.0,11
20742,5364,Kits,30,0,0.0,30
20743,5364,Stuff Packs,20,0,0.0,20
20744,5365,Expansion Packs,7,0,0.0,7
20745,5365,Game Packs,4,0,0.0,4
20746,5365,Stuff Packs,7,3,0.42857142857142855,4
20747,5366,Expansion Packs,16,0,0.0,16
20748,5366,Game Packs,9,1,0.1111111111111111,8
20749,5366,Kits,26,2,0.07692307692307693,24
20750,5366,Stuff Packs,16,3,0.1875,13
20751,5367,Expansion Packs,9,0,0.0,9
20752,5367,Game Packs,6,0,0.0,6
20753,5367,Kits,7,0,0.0,7
20754,5367,Stuff Packs,8,0,0.0,8
20755,5368,Expansion Packs,13,0,0.0,13
20756,5368,Game Packs,9,0,0.0,9
20757,5368,Kits,3,3,1.0,0
20758,5368,Stuff Packs,11,4,0.36363636363636365,7
20759,5369,Expansion Packs,15,0,0.0,15
20760,5369,Game Packs,12,0,0.0,12
20761,5369,Kits,3,0,0.0,3
20762,5369,Stuff Packs,9,0,0.0,9
20763,5370,Expansion Packs,12,0,0.0,12
20764,5370,Game Packs,9,0,0.0,9
20765,5370,Kits,3,3,1.0,0
20766,5370,Stuff Packs,14,2,0.14285714285714285,12
20767,5371,Expansion Packs,8,0,0.0,8
20768,5371,Game Packs,7,0,0.0,7
20769,5371,Kits,3,3,1.0,0
20770,5371,Stuff Packs,11,3,0.2727272727272727,8
20771,5372,Expansion Packs,16,0,0.0,16
20772,5372,Game Packs,12,0,0.0,12
20773,5372,Kits,33,0,0.0,33
20774,5372,Stuff Packs,20,0,0.0,20
20775,5373,Expansion Packs,13,0,0.0,13
20776,5373,Game Packs,9,0,0.0,9
20777,5373,Kits,6,0,0.0,6
20778,5373,Stuff Packs,8,0,0.0,8
20779,5374,Expansion Packs,10,0,0.0,10
20780,5374,Game Packs,7,0,0.0,7
20781,5374,Kits,3,2,0.6666666666666666,1
20782,5374,Stuff Packs,12,3,0.25,9
20783,5375,Expansion Packs,16,0,0.0,16
20784,5375,Game Packs,12,0,0.0,12
20785,5375,Kits,33,0,0.0,33
20786,5375,Stuff Packs,20,0,0.0,20
20787,5376,Expansion Packs,11,0,0.0,11
20788,5376,Game Packs,5,0,0.0,5
20789,5376,Kits,8,1,0.125,7
20790,5376,Stuff Packs,8,2,0.25,6
20791,5377,Expansion Packs,14,0,0.0,14
20792,5377,Game Packs,12,0,0.0,12
20793,5377,Kits,14,4,0.2857142857142857,10
20794,5377,Stuff Packs,20,0,0.0,20
20795,5378,Expansion Packs,15,0,0.0,15
20796,5378,Game Packs,10,0,0.0,10
20797,5378,Kits,23,1,0.043478260869565216,22
20798,5378,Stuff Packs,14,0,0.0,14
20799,5379,Expansion Packs,16,0,0.0,16
20800,5379,Game Packs,12,0,0.0,12
20801,5379,Kits,22,1,0.045454545454545456,21
20802,5379,Stuff Packs,20,0,0.0,20
20803,5380,Expansion Packs,16,0,0.0,16
20804,5380,Game Packs,10,0,0.0,10
20805,5380,Kits,2,1,0.5,1
20806,5380,Stuff Packs,20,0,0.0,20
20807,5381,Expansion Packs,14,0,0.0,14
20808,5381,Game Packs,10,0,0.0,10
20809,5381,Kits,3,2,0.6666666666666666,1
20810,5381,Stuff Packs,18,0,0.0,18
20811,5382,Expansion Packs,10,0,0.0,10
20812,5382,Game Packs,2,0,0.0,2
20813,5382,Kits,2,1,0.5,1
20814,5382,Stuff Packs,7,3,0.42857142857142855,4
20815,5383,Expansion Packs,16,0,0.0,16
20816,5383,Game Packs,12,0,0.0,12
20817,5383,Kits,33,0,0.0,33
20818,5383,Stuff Packs,20,0,0.0,20
20819,5384,Expansion Packs,10,0,0.0,10
20820,5384,Game Packs,6,0,0.0,6
20821,5384,Kits,2,2,1.0,0
20822,5384,Stuff Packs,6,1,0.16666666666666666,5
20823,5385,Expansion Packs,1,0,0.0,1
20824,5385,Kits,2,2,1.0,0
20825,5385,Stuff Packs,2,0,0.0,2
20826,5386,Expansion Packs,16,0,0.0,16
20827,5386,Game Packs,10,0,0.0,10
20828,5386,Kits,19,1,0.05263157894736842,18
20829,5386,Stuff Packs,15,2,0.13333333333333333,13
20830,5387,Expansion Packs,16,0,0.0,16
20831,5387,Game Packs,12,0,0.0,12
20832,5387,Kits,33,0,0.0,33
20833,5387,Stuff Packs,20,0,0.0,20
20834,5388,Expansion Packs,9,0,0.0,9
20835,5388,Game Packs,6,0,0.0,6
20836,5388,Kits,1,0,0.0,1
20837,5388,Stuff Packs,3,0,0.0,3
20838,5389,Expansion Packs,16,0,0.0,16
20839,5389,Game Packs,4,0,0.0,4
20840,5389,Kits,10,2,0.2,8
20841,5389,Stuff Packs,11,3,0.2727272727272727,8
20842,5390,Expansion Packs,2,1,0.5,1
20843,5390,Game Packs,2,0,0.0,2
20844,5390,Kits,1,0,0.0,1
20845,5390,Stuff Packs,2,1,0.5,1
20846,5391,Expansion Packs,14,0,0.0,14
20847,5391,Game Packs,10,0,0.0,10
20848,5391,Kits,10,0,0.0,10
20849,5391,Stuff Packs,18,1,0.05555555555555555,17
20850,5392,Expansion Packs,8,0,0.0,8
20851,5392,Game Packs,3,0,0.0,3
20852,5392,Stuff Packs,3,2,0.6666666666666666,1
20853,5393,Expansion Packs,16,0,0.0,16
20854,5393,Game Packs,12,0,0.0,12
20855,5393,Kits,33,0,0.0,33
20856,5393,Stuff Packs,20,0,0.0,20
20857,5394,Expansion Packs,16,0,0.0,16
20858,5394,Game Packs,11,0,0.0,11
20859,5394,Kits,24,1,0.041666666666666664,23
20860,5394,Stuff Packs,19,0,0.0,19
20861,5395,Expansion Packs,10,0,0.0,10
20862,5395,Game Packs,1,0,0.0,1
20863,5395,Kits,1,1,1.0,0
20864,5395,Stuff Packs,4,0,0.0,4
20865,5396,Expansion Packs,10,0,0.0,10
20866,5396,Game Packs,6,0,0.0,6
20867,5396,Kits,6,1,0.16666666666666666,5
20868,5396,Stuff Packs,3,1,0.3333333333333333,2
20869,5397,Expansion Packs,16,0,0.0,16
20870,5397,Game Packs,12,0,0.0,12
20871,5397,Kits,13,1,0.07692307692307693,12
20872,5397,Stuff Packs,20,0,0.0,20
20873,5398,Expansion Packs,15,0,0.0,15
20874,5398,Game Packs,7,0,0.0,7
20875,5398,Kits,17,0,0.0,17
20876,5398,Stuff Packs,18,2,0.1111111111111111,16
20877,5399,Expansion Packs,14,0,0.0,14
20878,5399,Game Packs,3,0,0.0,3
20879,5399,Kits,1,1,1.0,0
20880,5399,Stuff Packs,7,2,0.2857142857142857,5
20881,5400,Expansion Packs,7,0,0.0,7
20882,5400,Game Packs,5,0,0.0,5
20883,5400,Kits,8,1,0.125,7
20884,5400,Stuff Packs,8,2,0.25,6
20885,5401,Expansion Packs,10,0,0.0,10
20886,5401,Game Packs,6,0,0.0,6
20887,5401,Kits,4,3,0.75,1
20888,5401,Stuff Packs,13,4,0.3076923076923077,9
20889,5402,Expansion Packs,8,0,0.0,8
20890,5402,Game Packs,3,0,0.0,3
20891,5402,Kits,2,1,0.5,1
20892,5402,Stuff Packs,8,3,0.375,5
20893,5403,Expansion Packs,16,0,0.0,16
20894,5403,Game Packs,12,0,0.0,12
20895,5403,Kits,33,0,0.0,33
20896,5403,Stuff Packs,20,0,0.0,20
20897,5404,Expansion Packs,15,0,0.0,15
20898,5404,Game Packs,11,0,0.0,11
20899,5404,Kits,9,1,0.1111111111111111,8
20900,5404,Stuff Packs,16,1,0.0625,15
20901,5405,Expansion Packs,16,0,0.0,16
20902,5405,Game Packs,12,0,0.0,12
20903,5405,Kits,33,0,0.0,33
20904,5405,Stuff Packs,20,0,0.0,20
20905,5406,Expansion Packs,16,0,0.0,16
20906,5406,Game Packs,12,0,0.0,12
20907,5406,Kits,17,0,0.0,17
20908,5406,Stuff Packs,20,0,0.0,20
20909,5407,Expansion Packs,16,0,0.0,16
20910,5407,Game Packs,12,0,0.0,12
20911,5407,Kits,33,0,0.0,33
20912,5407,Stuff Packs,20,0,0.0,20
20913,5408,Expansion Packs,7,0,0.0,7
20914,5408,Game Packs,3,0,0.0,3
20915,5408,Stuff Packs,3,2,0.6666666666666666,1
20916,5409,Expansion Packs,8,0,0.0,8
20917,5409,Game Packs,3,0,0.0,3
20918,5409,Kits,4,0,0.0,4
20919,5409,Stuff Packs,11,0,0.0,11
20920,5410,Expansion Packs,11,0,0.0,11
20921,5410,Game Packs,8,0,0.0,8
20922,5410,Kits,2,2,1.0,0
20923,5410,Stuff Packs,17,1,0.058823529411764705,16
20924,5411,Expansion Packs,10,0,0.0,10
20925,5411,Game Packs,7,0,0.0,7
20926,5411,Kits,3,1,0.3333333333333333,2
20927,5411,Stuff Packs,5,0,0.0,5
20928,5412,Expansion Packs,12,0,0.0,12
20929,5412,Game Packs,7,0,0.0,7
20930,5412,Kits,4,3,0.75,1
20931,5412,Stuff Packs,14,2,0.14285714285714285,12
20932,5413,Expansion Packs,16,0,0.0,16
20933,5413,Game Packs,11,1,0.09090909090909091,10
20934,5413,Kits,9,0,0.0,9
20935,5413,Stuff Packs,18,1,0.05555555555555555,17
20936,5414,Expansion Packs,15,0,0.0,15
20937,5414,Game Packs,10,0,0.0,10
20938,5414,Kits,8,4,0.5,4
20939,5414,Stuff Packs,8,2,0.25,6
20940,5415,Expansion Packs,16,0,0.0,16
20941,5415,Game Packs,12,0,0.0,12
20942,5415,Kits,30,0,0.0,30
20943,5415,Stuff Packs,20,0,0.0,20
20944,5416,Expansion Packs,10,0,0.0,10
20945,5416,Game Packs,7,0,0.0,7
20946,5416,Kits,1,1,1.0,0
20947,5416,Stuff Packs,7,3,0.42857142857142855,4
20948,5417,Expansion Packs,16,0,0.0,16
20949,5417,Game Packs,11,0,0.0,11
20950,5417,Kits,5,1,0.2,4
20951,5417,Stuff Packs,20,1,0.05,19
20952,5418,Expansion Packs,15,0,0.0,15
20953,5418,Game Packs,12,0,0.0,12
20954,5418,Kits,16,1,0.0625,15
20955,5418,Stuff Packs,20,0,0.0,20
20956,5419,Expansion Packs,12,0,0.0,12
20957,5419,Game Packs,6,0,0.0,6
20958,5419,Kits,2,1,0.5,1
20959,5419,Stuff Packs,10,1,0.1,9
20960,5420,Expansion Packs,16,0,0.0,16
20961,5420,Game Packs,12,0,0.0,12
20962,5420,Kits,22,2,0.09090909090909091,20
20963,5420,Stuff Packs,19,0,0.0,19
20964,5421,Expansion Packs,13,0,0.0,13
20965,5421,Game Packs,3,0,0.0,3
20966,5421,Kits,6,0,0.0,6
20967,5421,Stuff Packs,6,2,0.3333333333333333,4
20968,5422,Expansion Packs,7,0,0.0,7
20969,5422,Game Packs,6,0,0.0,6
20970,5422,Kits,3,1,0.3333333333333333,2
20971,5422,Stuff Packs,7,2,0.2857142857142857,5
20972,5423,Expansion Packs,16,0,0.0,16
20973,5423,Game Packs,9,0,0.0,9
20974,5423,Kits,3,3,1.0,0
20975,5423,Stuff Packs,12,3,0.25,9
20976,5424,Expansion Packs,9,0,0.0,9
20977,5424,Game Packs,2,0,0.0,2
20978,5424,Stuff Packs,2,0,0.0,2
20979,5425,Expansion Packs,16,0,0.0,16
20980,5425,Game Packs,9,1,0.1111111111111111,8
20981,5425,Kits,26,1,0.038461538461538464,25
20982,5425,Stuff Packs,20,0,0.0,20
20983,5426,Expansion Packs,12,0,0.0,12
20984,5426,Game Packs,9,0,0.0,9
20985,5426,Kits,11,1,0.09090909090909091,10
20986,5426,Stuff Packs,15,2,0.13333333333333333,13
20987,5427,Expansion Packs,12,0,0.0,12
20988,5427,Game Packs,6,0,0.0,6
20989,5427,Stuff Packs,8,3,0.375,5
20990,5428,Expansion Packs,16,0,0.0,16
20991,5428,Game Packs,11,0,0.0,11
20992,5428,Kits,31,0,0.0,31
20993,5428,Stuff Packs,20,0,0.0,20
20994,5429,Expansion Packs,13,0,0.0,13
20995,5429,Game Packs,7,0,0.0,7
20996,5429,Kits,3,0,0.0,3
20997,5429,Stuff Packs,9,0,0.0,9
20998,5430,Expansion Packs,6,0,0.0,6
20999,5430,Game Packs,3,0,0.0,3
21000,5430,Stuff Packs,4,0,0.0,4
21001,5431,Expansion Packs,16,1,0.0625,15
21002,5431,Game Packs,12,0,0.0,12
21003,5431,Kits,33,1,0.030303030303030304,32
21004,5431,Stuff Packs,20,0,0.0,20
21005,5432,Expansion Packs,14,0,0.0,14
21006,5432,Game Packs,9,0,0.0,9
21007,5432,Kits,5,1,0.2,4
21008,5432,Stuff Packs,14,1,0.07142857142857142,13
21009,5433,Expansion Packs,12,0,0.0,12
21010,5433,Game Packs,5,0,0.0,5
21011,5433,Kits,2,0,0.0,2
21012,5433,Stuff Packs,7,0,0.0,7
21013,5434,Expansion Packs,15,0,0.0,15
21014,5434,Game Packs,11,0,0.0,11
21015,5434,Kits,6,1,0.16666666666666666,5
21016,5434,Stuff Packs,20,0,0.0,20
21017,5435,Expansion Packs,9,0,0.0,9
21018,5435,Game Packs,8,0,0.0,8
21019,5435,Stuff Packs,11,4,0.36363636363636365,7
21020,5436,Expansion Packs,16,0,0.0,16
21021,5436,Game Packs,12,0,0.0,12
21022,5436,Kits,20,1,0.05,19
21023,5436,Stuff Packs,20,0,0.0,20
21024,5437,Expansion Packs,7,0,0.0,7
21025,5437,Game Packs,6,0,0.0,6
21026,5437,Kits,1,1,1.0,0
21027,5437,Stuff Packs,9,0,0.0,9
21028,5438,Expansion Packs,14,0,0.0,14
21029,5438,Game Packs,11,0,0.0,11
21030,5438,Kits,14,1,0.07142857142857142,13
21031,5438,Stuff Packs,17,0,0.0,17
21032,5439,Expansion Packs,13,3,0.23076923076923078,10
21033,5439,Game Packs,12,3,0.25,9
21034,5439,Kits,11,4,0.36363636363636365,7
21035,5439,Stuff Packs,18,0,0.0,18
21036,5440,Expansion Packs,9,0,0.0,9
21037,5440,Game Packs,6,0,0.0,6
21038,5440,Kits,2,2,1.0,0
21039,5440,Stuff Packs,10,2,0.2,8
21040,5441,Expansion Packs,11,0,0.0,11
21041,5441,Game Packs,5,0,0.0,5
21042,5441,Stuff Packs,3,0,0.0,3
21043,5442,Expansion Packs,13,0,0.0,13
21044,5442,Game Packs,7,0,0.0,7
21045,5442,Kits,9,0,0.0,9
21046,5442,Stuff Packs,11,0,0.0,11
21047,5443,Game Packs,1,1,1.0,0
21048,5443,Kits,4,3,0.75,1
21049,5443,Stuff Packs,4,4,1.0,0
21050,5444,Expansion Packs,6,0,0.0,6
21051,5444,Game Packs,3,0,0.0,3
21052,5444,Kits,2,0,0.0,2
21053,5444,Stuff Packs,5,3,0.6,2
21054,5445,Expansion Packs,3,0,0.0,3
21055,5445,Kits,1,1,1.0,0
21056,5445,Stuff Packs,3,3,1.0,0
21057,5446,Expansion Packs,16,0,0.0,16
21058,5446,Game Packs,12,0,0.0,12
21059,5446,Kits,33,0,0.0,33
21060,5446,Stuff Packs,20,0,0.0,20
21061,5447,Expansion Packs,6,0,0.0,6
21062,5447,Game Packs,4,0,0.0,4
21063,5447,Kits,4,2,0.5,2
21064,5447,Stuff Packs,6,3,0.5,3
21065,5448,Expansion Packs,14,0,0.0,14
21066,5448,Game Packs,9,0,0.0,9
21067,5448,Kits,5,2,0.4,3
21068,5448,Stuff Packs,17,0,0.0,17
21069,5449,Expansion Packs,14,0,0.0,14
21070,5449,Game Packs,12,0,0.0,12
21071,5449,Kits,5,1,0.2,4
21072,5449,Stuff Packs,20,3,0.15,17
21073,5450,Expansion Packs,15,0,0.0,15
21074,5450,Game Packs,5,0,0.0,5
21075,5450,Kits,5,2,0.4,3
21076,5450,Stuff Packs,13,1,0.07692307692307693,12
21077,5451,Expansion Packs,12,0,0.0,12
21078,5451,Game Packs,8,0,0.0,8
21079,5451,Kits,7,0,0.0,7
21080,5451,Stuff Packs,13,2,0.15384615384615385,11
21081,5452,Expansion Packs,8,0,0.0,8
21082,5452,Game Packs,7,0,0.0,7
21083,5452,Kits,2,0,0.0,2
21084,5452,Stuff Packs,11,2,0.18181818181818182,9
21085,5453,Expansion Packs,16,0,0.0,16
21086,5453,Game Packs,12,0,0.0,12
21087,5453,Kits,33,6,0.18181818181818182,27
21088,5453,Stuff Packs,20,3,0.15,17
21089,5454,Expansion Packs,16,0,0.0,16
21090,5454,Game Packs,12,0,0.0,12
21091,5454,Kits,22,1,0.045454545454545456,21
21092,5454,Stuff Packs,19,0,0.0,19
21093,5455,Expansion Packs,13,0,0.0,13
21094,5455,Game Packs,9,0,0.0,9
21095,5455,Kits,13,1,0.07692307692307693,12
21096,5455,Stuff Packs,14,1,0.07142857142857142,13
21097,5456,Expansion Packs,16,0,0.0,16
21098,5456,Game Packs,11,0,0.0,11
21099,5456,Kits,19,0,0.0,19
21100,5456,Stuff Packs,20,0,0.0,20
21101,5457,Expansion Packs,16,0,0.0,16
21102,5457,Game Packs,12,0,0.0,12
21103,5457,Kits,30,1,0.03333333333333333,29
21104,5457,Stuff Packs,17,0,0.0,17
21105,5458,Expansion Packs,2,0,0.0,2
21106,5458,Kits,1,1,1.0,0
21107,5458,Stuff Packs,2,2,1.0,0
21108,5459,Expansion Packs,4,0,0.0,4
21109,5459,Kits,1,1,1.0,0
21110,5459,Stuff Packs,4,3,0.75,1
21111,5460,Expansion Packs,16,0,0.0,16
21112,5460,Game Packs,12,0,0.0,12
21113,5460,Kits,33,0,0.0,33
21114,5460,Stuff Packs,20,0,0.0,20
21115,5461,Expansion Packs,3,0,0.0,3
21116,5461,Game Packs,2,1,0.5,1
21117,5461,Kits,1,1,1.0,0
21118,5461,Stuff Packs,2,1,0.5,1
21119,5462,Expansion Packs,16,0,0.0,16
21120,5462,Game Packs,11,0,0.0,11
21121,5462,Kits,29,1,0.034482758620689655,28
21122,5462,Stuff Packs,19,4,0.21052631578947367,15
21123,5463,Expansion Packs,16,0,0.0,16
21124,5463,Game Packs,12,0,0.0,12
21125,5463,Kits,33,0,0.0,33
21126,5463,Stuff Packs,20,0,0.0,20
21127,5464,Expansion Packs,9,1,0.1111111111111111,8
21128,5464,Game Packs,6,0,0.0,6
21129,5464,Kits,4,2,0.5,2
21130,5464,Stuff Packs,14,9,0.6428571428571429,5
21131,5465,Expansion Packs,14,0,0.0,14
21132,5465,Game Packs,8,0,0.0,8
21133,5465,Kits,1,1,1.0,0
21134,5465,Stuff Packs,8,0,0.0,8
21135,5466,Expansion Packs,12,0,0.0,12
21136,5466,Game Packs,6,0,0.0,6
21137,5466,Kits,2,2,1.0,0
21138,5466,Stuff Packs,9,2,0.2222222222222222,7
21139,5467,Game Packs,12,5,0.4166666666666667,7
21140,5467,Kits,33,1,0.030303030303030304,32
21141,5467,Stuff Packs,20,11,0.55,9
21142,5468,Expansion Packs,7,0,0.0,7
21143,5468,Game Packs,2,0,0.0,2
21144,5468,Stuff Packs,1,0,0.0,1
21145,5469,Expansion Packs,16,0,0.0,16
21146,5469,Game Packs,12,0,0.0,12
21147,5469,Kits,33,0,0.0,33
21148,5469,Stuff Packs,20,0,0.0,20
21149,5470,Expansion Packs,16,0,0.0,16
21150,5470,Game Packs,12,0,0.0,12
21151,5470,Kits,33,0,0.0,33
21152,5470,Stuff Packs,20,0,0.0,20
21153,5471,Expansion Packs,14,0,0.0,14
21154,5471,Game Packs,11,0,0.0,11
21155,5471,Kits,9,2,0.2222222222222222,7
21156,5471,Stuff Packs,19,1,0.05263157894736842,18
21157,5472,Expansion Packs,16,0,0.0,16
21158,5472,Game Packs,11,0,0.0,11
21159,5472,Kits,28,1,0.03571428571428571,27
21160,5472,Stuff Packs,20,0,0.0,20
21161,5473,Expansion Packs,1,0,0.0,1
21162,5473,Game Packs,1,0,0.0,1
21163,5473,Kits,1,1,1.0,0
21164,5473,Stuff Packs,2,0,0.0,2
21165,5474,Expansion Packs,16,0,0.0,16
21166,5474,Game Packs,12,0,0.0,12
21167,5474,Kits,33,1,0.030303030303030304,32
21168,5474,Stuff Packs,20,0,0.0,20
21169,5475,Expansion Packs,7,0,0.0,7
21170,5475,Game Packs,4,1,0.25,3
21171,5475,Kits,6,2,0.3333333333333333,4
21172,5475,Stuff Packs,10,4,0.4,6
21173,5476,Expansion Packs,4,0,0.0,4
21174,5476,Game Packs,2,0,0.0,2
21175,5476,Stuff Packs,4,0,0.0,4
21176,5477,Expansion Packs,8,0,0.0,8
21177,5477,Game Packs,3,0,0.0,3
21178,5477,Stuff Packs,5,1,0.2,4
21179,5478,Expansion Packs,11,0,0.0,11
21180,5478,Game Packs,4,1,0.25,3
21181,5478,Kits,5,3,0.6,2
21182,5478,Stuff Packs,11,4,0.36363636363636365,7
21183,5479,Expansion Packs,6,0,0.0,6
21184,5479,Game Packs,4,1,0.25,3
21185,5479,Kits,3,3,1.0,0
21186,5479,Stuff Packs,12,3,0.25,9
21187,5480,Expansion Packs,10,0,0.0,10
21188,5480,Game Packs,6,0,0.0,6
21189,5480,Kits,12,0,0.0,12
21190,5480,Stuff Packs,12,0,0.0,12
21191,5481,Expansion Packs,9,0,0.0,9
21192,5481,Game Packs,5,0,0.0,5
21193,5481,Kits,2,2,1.0,0
21194,5481,Stuff Packs,4,2,0.5,2
21195,5482,Expansion Packs,16,0,0.0,16
21196,5482,Game Packs,12,0,0.0,12
21197,5482,Kits,31,0,0.0,31
21198,5482,Stuff Packs,20,0,0.0,20
21199,5483,Expansion Packs,16,0,0.0,16
21200,5483,Game Packs,12,0,0.0,12
21201,5483,Kits,33,0,0.0,33
21202,5483,Stuff Packs,20,0,0.0,20
21203,5484,Expansion Packs,12,0,0.0,12
21204,5484,Game Packs,6,0,0.0,6
21205,5484,Kits,2,0,0.0,2
21206,5484,Stuff Packs,8,2,0.25,6
21207,5485,Expansion Packs,16,0,0.0,16
21208,5485,Game Packs,12,0,0.0,12
21209,5485,Kits,33,0,0.0,33
21210,5485,Stuff Packs,20,0,0.0,20
21211,5486,Expansion Packs,1,0,0.0,1
21212,5486,Game Packs,1,0,0.0,1
21213,5486,Stuff Packs,1,0,0.0,1
21214,5487,Expansion Packs,16,0,0.0,16
21215,5487,Game Packs,12,0,0.0,12
21216,5487,Kits,33,1,0.030303030303030304,32
21217,5487,Stuff Packs,20,0,0.0,20
21218,5488,Expansion Packs,3,0,0.0,3
21219,5488,Game Packs,2,1,0.5,1
21220,5488,Kits,2,2,1.0,0
21221,5488,Stuff Packs,5,1,0.2,4
21222,5489,Expansion Packs,11,0,0.0,11
21223,5489,Game Packs,6,0,0.0,6
21224,5489,Kits,1,1,1.0,0
21225,5489,Stuff Packs,5,3,0.6,2
21226,5490,Expansion Packs,10,0,0.0,10
21227,5490,Game Packs,5,1,0.2,4
21228,5490,Kits,3,3,1.0,0
21229,5490,Stuff Packs,11,3,0.2727272727272727,8
21230,5491,Expansion Packs,16,0,0.0,16
21231,5491,Game Packs,12,0,0.0,12
21232,5491,Kits,33,0,0.0,33
21233,5491,Stuff Packs,20,0,0.0,20
21234,5492,Expansion Packs,12,0,0.0,12
21235,5492,Game Packs,12,0,0.0,12
21236,5492,Kits,13,0,0.0,13
21237,5492,Stuff Packs,18,0,0.0,18
21238,5493,Expansion Packs,8,0,0.0,8
21239,5493,Game Packs,4,0,0.0,4
21240,5493,Kits,4,0,0.0,4
21241,5493,Stuff Packs,8,3,0.375,5
21242,5494,Expansion Packs,15,0,0.0,15
21243,5494,Game Packs,11,0,0.0,11
21244,5494,Kits,6,1,0.16666666666666666,5
21245,5494,Stuff Packs,10,1,0.1,9
21246,5495,Expansion Packs,13,0,0.0,13
21247,5495,Game Packs,12,0,0.0,12
21248,5495,Kits,6,1,0.16666666666666666,5
21249,5495,Stuff Packs,14,3,0.21428571428571427,11
21250,5496,Expansion Packs,3,0,0.0,3
21251,5496,Game Packs,2,1,0.5,1
21252,5496,Stuff Packs,4,4,1.0,0
21253,5497,Expansion Packs,16,0,0.0,16
21254,5497,Game Packs,12,0,0.0,12
21255,5497,Kits,29,0,0.0,29
21256,5497,Stuff Packs,20,0,0.0,20
21257,5498,Expansion Packs,16,0,0.0,16
21258,5498,Game Packs,12,0,0.0,12
21259,5498,Kits,33,0,0.0,33
21260,5498,Stuff Packs,20,0,0.0,20
21261,5499,Expansion Packs,16,0,0.0,16
21262,5499,Game Packs,12,0,0.0,12
21263,5499,Kits,22,0,0.0,22
21264,5499,Stuff Packs,20,0,0.0,20
21265,5500,Expansion Packs,13,0,0.0,13
21266,5500,Game Packs,5,0,0.0,5
21267,5500,Stuff Packs,6,2,0.3333333333333333,4
21268,5501,Expansion Packs,8,0,0.0,8
21269,5501,Game Packs,4,0,0.0,4
21270,5501,Stuff Packs,5,0,0.0,5
21271,5502,Expansion Packs,2,0,0.0,2
21272,5502,Kits,1,1,1.0,0
21273,5503,Expansion Packs,16,0,0.0,16
21274,5503,Game Packs,11,0,0.0,11
21275,5503,Kits,33,2,0.06060606060606061,31
21276,5503,Stuff Packs,20,1,0.05,19
21277,5504,Expansion Packs,13,0,0.0,13
21278,5504,Game Packs,6,0,0.0,6
21279,5504,Kits,2,0,0.0,2
21280,5504,Stuff Packs,13,1,0.07692307692307693,12
21281,5505,Expansion Packs,16,0,0.0,16
21282,5505,Game Packs,12,0,0.0,12
21283,5505,Kits,18,1,0.05555555555555555,17
21284,5505,Stuff Packs,16,1,0.0625,15
21285,5506,Expansion Packs,15,0,0.0,15
21286,5506,Game Packs,9,0,0.0,9
21287,5506,Kits,5,0,0.0,5
21288,5506,Stuff Packs,7,0,0.0,7
21289,5507,Expansion Packs,5,0,0.0,5
21290,5507,Game Packs,3,1,0.3333333333333333,2
21291,5507,Kits,2,2,1.0,0
21292,5507,Stuff Packs,6,4,0.6666666666666666,2
21293,5508,Expansion Packs,5,0,0.0,5
21294,5508,Game Packs,2,0,0.0,2
21295,5508,Stuff Packs,3,0,0.0,3
21296,5509,Expansion Packs,4,0,0.0,4
21297,5509,Game Packs,2,1,0.5,1
21298,5509,Kits,4,3,0.75,1
21299,5509,Stuff Packs,5,3,0.6,2
21300,5510,Expansion Packs,14,0,0.0,14
21301,5510,Game Packs,12,0,0.0,12
21302,5510,Kits,17,0,0.0,17
21303,5510,Stuff Packs,13,0,0.0,13
21304,5511,Expansion Packs,14,0,0.0,14
21305,5511,Game Packs,9,0,0.0,9
21306,5511,Kits,2,1,0.5,1
21307,5511,Stuff Packs,10,1,0.1,9
21308,5512,Expansion Packs,12,0,0.0,12
21309,5512,Game Packs,7,0,0.0,7
21310,5512,Kits,4,1,0.25,3
21311,5512,Stuff Packs,7,2,0.2857142857142857,5
21312,5513,Expansion Packs,16,0,0.0,16
21313,5513,Game Packs,12,0,0.0,12
21314,5513,Kits,31,0,0.0,31
21315,5513,Stuff Packs,20,0,0.0,20
21316,5514,Expansion Packs,15,0,0.0,15
21317,5514,Game Packs,7,0,0.0,7
21318,5514,Kits,10,1,0.1,9
21319,5514,Stuff Packs,13,2,0.15384615384615385,11
21320,5515,Expansion Packs,5,0,0.0,5
21321,5515,Game Packs,3,1,0.3333333333333333,2
21322,5515,Kits,3,2,0.6666666666666666,1
21323,5515,Stuff Packs,5,4,0.8,1
21324,5516,Expansion Packs,15,0,0.0,15
21325,5516,Game Packs,7,0,0.0,7
21326,5516,Kits,5,3,0.6,2
21327,5516,Stuff Packs,8,4,0.5,4
21328,5517,Expansion Packs,3,0,0.0,3
21329,5517,Kits,4,2,0.5,2
21330,5517,Stuff Packs,4,3,0.75,1
21331,5518,Expansion Packs,8,0,0.0,8
21332,5518,Game Packs,2,0,0.0,2
21333,5518,Kits,8,1,0.125,7
21334,5518,Stuff Packs,8,3,0.375,5
21335,5519,Expansion Packs,15,0,0.0,15
21336,5519,Game Packs,12,0,0.0,12
21337,5519,Kits,31,1,0.03225806451612903,30
21338,5519,Stuff Packs,20,0,0.0,20
21339,5520,Expansion Packs,16,0,0.0,16
21340,5520,Game Packs,10,0,0.0,10
21341,5520,Kits,10,0,0.0,10
21342,5520,Stuff Packs,20,0,0.0,20
21343,5521,Expansion Packs,8,0,0.0,8
21344,5521,Game Packs,4,0,0.0,4
21345,5521,Kits,1,1,1.0,0
21346,5521,Stuff Packs,6,1,0.16666666666666666,5
21347,5522,Expansion Packs,16,0,0.0,16
21348,5522,Game Packs,12,0,0.0,12
21349,5522,Kits,26,1,0.038461538461538464,25
21350,5522,Stuff Packs,20,0,0.0,20
21351,5523,Expansion Packs,16,1,0.0625,15
21352,5523,Game Packs,12,0,0.0,12
21353,5523,Kits,33,3,0.09090909090909091,30
21354,5523,Stuff Packs,20,0,0.0,20
21355,5524,Expansion Packs,15,0,0.0,15
21356,5524,Game Packs,11,0,0.0,11
21357,5524,Kits,3,0,0.0,3
21358,5524,Stuff Packs,16,0,0.0,16
21359,5525,Expansion Packs,16,0,0.0,16
21360,5525,Game Packs,11,0,0.0,11
21361,5525,Kits,33,1,0.030303030303030304,32
21362,5525,Stuff Packs,20,0,0.0,20
21363,5526,Expansion Packs,9,1,0.1111111111111111,8
21364,5526,Game Packs,4,0,0.0,4
21365,5526,Kits,13,0,0.0,13
21366,5526,Stuff Packs,10,2,0.2,8
21367,5527,Expansion Packs,12,0,0.0,12
21368,5527,Game Packs,5,0,0.0,5
21369,5527,Kits,22,0,0.0,22
21370,5527,Stuff Packs,12,0,0.0,12
21371,5528,Expansion Packs,12,0,0.0,12
21372,5528,Game Packs,8,0,0.0,8
21373,5528,Kits,7,0,0.0,7
21374,5528,Stuff Packs,8,1,0.125,7
21375,5529,Expansion Packs,15,0,0.0,15
21376,5529,Game Packs,10,0,0.0,10
21377,5529,Kits,14,1,0.07142857142857142,13
21378,5529,Stuff Packs,18,2,0.1111111111111111,16
21379,5530,Expansion Packs,16,0,0.0,16
21380,5530,Game Packs,12,0,0.0,12
21381,5530,Kits,33,0,0.0,33
21382,5530,Stuff Packs,20,0,0.0,20
21383,5531,Expansion Packs,16,0,0.0,16
21384,5531,Game Packs,10,0,0.0,10
21385,5531,Kits,33,0,0.0,33
21386,5531,Stuff Packs,16,0,0.0,16
21387,5532,Expansion Packs,4,0,0.0,4
21388,5532,Game Packs,1,0,0.0,1
21389,5532,Kits,2,2,1.0,0
21390,5532,Stuff Packs,4,3,0.75,1
21391,5533,Expansion Packs,16,0,0.0,16
21392,5533,Game Packs,12,0,0.0,12
21393,5533,Kits,28,0,0.0,28
21394,5533,Stuff Packs,16,2,0.125,14
21395,5534,Expansion Packs,6,0,0.0,6
21396,5534,Game Packs,4,0,0.0,4
21397,5534,Stuff Packs,4,2,0.5,2
21398,5535,Expansion Packs,16,0,0.0,16
21399,5535,Game Packs,11,0,0.0,11
21400,5535,Kits,18,1,0.05555555555555555,17
21401,5535,Stuff Packs,20,0,0.0,20
21402,5536,Expansion Packs,12,0,0.0,12
21403,5536,Game Packs,10,0,0.0,10
21404,5536,Kits,1,1,1.0,0
21405,5536,Stuff Packs,11,2,0.18181818181818182,9
21406,5537,Expansion Packs,8,0,0.0,8
21407,5537,Game Packs,4,1,0.25,3
21408,5537,Kits,2,2,1.0,0
21409,5537,Stuff Packs,6,2,0.3333333333333333,4
21410,5538,Expansion Packs,5,0,0.0,5
21411,5538,Game Packs,4,0,0.0,4
21412,5538,Kits,2,2,1.0,0
21413,5538,Stuff Packs,4,3,0.75,1
21414,5539,Expansion Packs,13,0,0.0,13
21415,5539,Game Packs,7,0,0.0,7
21416,5539,Kits,16,0,0.0,16
21417,5539,Stuff Packs,14,0,0.0,14
21418,5540,Expansion Packs,7,0,0.0,7
21419,5540,Game Packs,4,0,0.0,4
21420,5540,Kits,2,0,0.0,2
21421,5540,Stuff Packs,5,3,0.6,2
21422,5541,Expansion Packs,11,0,0.0,11
21423,5541,Game Packs,6,0,0.0,6
21424,5541,Kits,2,2,1.0,0
21425,5541,Stuff Packs,7,0,0.0,7
21426,5542,Expansion Packs,16,0,0.0,16
21427,5542,Game Packs,12,0,0.0,12
21428,5542,Kits,32,2,0.0625,30
21429,5542,Stuff Packs,20,3,0.15,17
21430,5543,Expansion Packs,13,0,0.0,13
21431,5543,Game Packs,4,0,0.0,4
21432,5543,Stuff Packs,4,0,0.0,4
21433,5544,Expansion Packs,15,0,0.0,15
21434,5544,Game Packs,12,0,0.0,12
21435,5544,Kits,32,0,0.0,32
21436,5544,Stuff Packs,20,0,0.0,20
21437,5545,Expansion Packs,14,0,0.0,14
21438,5545,Game Packs,10,0,0.0,10
21439,5545,Stuff Packs,13,0,0.0,13
21440,5546,Expansion Packs,3,0,0.0,3
21441,5546,Game Packs,1,0,0.0,1
21442,5546,Kits,1,1,1.0,0
21443,5546,Stuff Packs,3,2,0.6666666666666666,1
21444,5547,Expansion Packs,16,0,0.0,16
21445,5547,Game Packs,11,0,0.0,11
21446,5547,Stuff Packs,20,0,0.0,20
21447,5548,Expansion Packs,12,0,0.0,12
21448,5548,Game Packs,11,0,0.0,11
21449,5548,Kits,3,3,1.0,0
21450,5548,Stuff Packs,18,0,0.0,18
21451,5549,Expansion Packs,14,0,0.0,14
21452,5549,Game Packs,12,0,0.0,12
21453,5549,Kits,9,2,0.2222222222222222,7
21454,5549,Stuff Packs,18,0,0.0,18
21455,5550,Expansion Packs,16,0,0.0,16
21456,5550,Game Packs,12,0,0.0,12
21457,5550,Kits,33,0,0.0,33
21458,5550,Stuff Packs,20,0,0.0,20
21459,5551,Expansion Packs,16,0,0.0,16
21460,5551,Game Packs,7,0,0.0,7
21461,5551,Kits,29,1,0.034482758620689655,28
21462,5551,Stuff Packs,19,0,0.0,19
21463,5552,Expansion Packs,5,0,0.0,5
21464,5552,Game Packs,1,0,0.0,1
21465,5552,Kits,2,2,1.0,0
21466,5552,Stuff Packs,4,3,0.75,1
21467,5553,Expansion Packs,14,0,0.0,14
21468,5553,Game Packs,11,0,0.0,11
21469,5553,Kits,7,1,0.14285714285714285,6
21470,5553,Stuff Packs,18,0,0.0,18
21471,5554,Expansion Packs,12,0,0.0,12
21472,5554,Game Packs,7,1,0.14285714285714285,6
21473,5554,Stuff Packs,9,2,0.2222222222222222,7
21474,5555,Expansion Packs,8,0,0.0,8
21475,5555,Game Packs,2,0,0.0,2
21476,5555,Kits,2,2,1.0,0
21477,5555,Stuff Packs,12,0,0.0,12
21478,5556,Expansion Packs,13,0,0.0,13
21479,5556,Game Packs,5,0,0.0,5
21480,5556,Stuff Packs,11,3,0.2727272727272727,8
21481,5557,Expansion Packs,15,1,0.06666666666666667,14
21482,5557,Game Packs,9,2,0.2222222222222222,7
21483,5557,Kits,2,0,0.0,2
21484,5557,Stuff Packs,15,2,0.13333333333333333,13
21485,5558,Expansion Packs,11,0,0.0,11
21486,5558,Game Packs,10,0,0.0,10
21487,5558,Stuff Packs,12,0,0.0,12
21488,5559,Expansion Packs,9,0,0.0,9
21489,5559,Game Packs,8,1,0.125,7
21490,5559,Kits,3,3,1.0,0
21491,5559,Stuff Packs,15,1,0.06666666666666667,14
21492,5560,Expansion Packs,16,0,0.0,16
21493,5560,Game Packs,12,0,0.0,12
21494,5560,Kits,26,0,0.0,26
21495,5560,Stuff Packs,20,0,0.0,20
21496,5561,Expansion Packs,13,0,0.0,13
21497,5561,Game Packs,7,0,0.0,7
21498,5561,Kits,4,1,0.25,3
21499,5561,Stuff Packs,10,2,0.2,8
21500,5562,Expansion Packs,16,0,0.0,16
21501,5562,Game Packs,12,0,0.0,12
21502,5562,Kits,33,0,0.0,33
21503,5562,Stuff Packs,20,0,0.0,20
21504,5563,Expansion Packs,14,0,0.0,14
21505,5563,Game Packs,10,0,0.0,10
21506,5563,Kits,4,1,0.25,3
21507,5563,Stuff Packs,14,0,0.0,14
21508,5564,Expansion Packs,14,0,0.0,14
21509,5564,Game Packs,6,1,0.16666666666666666,5
21510,5564,Kits,13,2,0.15384615384615385,11
21511,5564,Stuff Packs,9,2,0.2222222222222222,7
21512,5565,Expansion Packs,15,0,0.0,15
21513,5565,Game Packs,12,0,0.0,12
21514,5565,Kits,8,2,0.25,6
21515,5565,Stuff Packs,20,0,0.0,20
21516,5566,Expansion Packs,14,0,0.0,14
21517,5566,Game Packs,7,0,0.0,7
21518,5566,Kits,3,2,0.6666666666666666,1
21519,5566,Stuff Packs,10,3,0.3,7
21520,5567,Expansion Packs,14,0,0.0,14
21521,5567,Game Packs,9,0,0.0,9
21522,5567,Kits,4,0,0.0,4
21523,5567,Stuff Packs,11,0,0.0,11
21524,5568,Expansion Packs,12,0,0.0,12
21525,5568,Game Packs,6,0,0.0,6
21526,5568,Kits,3,1,0.3333333333333333,2
21527,5568,Stuff Packs,9,2,0.2222222222222222,7
21528,5569,Expansion Packs,16,0,0.0,16
21529,5569,Game Packs,12,0,0.0,12
21530,5569,Kits,33,0,0.0,33
21531,5569,Stuff Packs,20,2,0.1,18
21532,5570,Expansion Packs,14,0,0.0,14
21533,5570,Game Packs,9,0,0.0,9
21534,5570,Kits,3,3,1.0,0
21535,5570,Stuff Packs,15,2,0.13333333333333333,13
21536,5571,Expansion Packs,5,0,0.0,5
21537,5571,Game Packs,1,0,0.0,1
21538,5571,Kits,1,1,1.0,0
21539,5571,Stuff Packs,4,2,0.5,2
21540,5572,Expansion Packs,16,0,0.0,16
21541,5572,Game Packs,11,0,0.0,11
21542,5572,Kits,33,0,0.0,33
21543,5572,Stuff Packs,20,0,0.0,20
21544,5573,Expansion Packs,12,0,0.0,12
21545,5573,Game Packs,9,0,0.0,9
21546,5573,Kits,2,0,0.0,2
21547,5573,Stuff Packs,13,0,0.0,13
21548,5574,Expansion Packs,15,0,0.0,15
21549,5574,Game Packs,11,0,0.0,11
21550,5574,Kits,15,1,0.06666666666666667,14
21551,5574,Stuff Packs,17,0,0.0,17
21552,5575,Expansion Packs,16,0,0.0,16
21553,5575,Game Packs,12,0,0.0,12
21554,5575,Kits,23,1,0.043478260869565216,22
21555,5575,Stuff Packs,19,0,0.0,19
21556,5576,Expansion Packs,16,0,0.0,16
21557,5576,Game Packs,12,0,0.0,12
21558,5576,Kits,4,4,1.0,0
21559,5576,Stuff Packs,20,0,0.0,20
21560,5577,Expansion Packs,12,0,0.0,12
21561,5577,Game Packs,9,0,0.0,9
21562,5577,Kits,3,0,0.0,3
21563,5577,Stuff Packs,11,0,0.0,11
21564,5578,Expansion Packs,16,0,0.0,16
21565,5578,Game Packs,11,0,0.0,11
21566,5578,Kits,28,1,0.03571428571428571,27
21567,5578,Stuff Packs,20,0,0.0,20
21568,5579,Expansion Packs,12,0,0.0,12
21569,5579,Game Packs,6,2,0.3333333333333333,4
21570,5579,Kits,4,2,0.5,2
21571,5579,Stuff Packs,8,1,0.125,7
21572,5580,Expansion Packs,16,0,0.0,16
21573,5580,Game Packs,12,0,0.0,12
21574,5580,Kits,27,1,0.037037037037037035,26
21575,5580,Stuff Packs,20,3,0.15,17
21576,5581,Expansion Packs,12,0,0.0,12
21577,5581,Game Packs,9,0,0.0,9
21578,5581,Kits,3,2,0.6666666666666666,1
21579,5581,Stuff Packs,9,2,0.2222222222222222,7
21580,5582,Expansion Packs,12,0,0.0,12
21581,5582,Game Packs,6,0,0.0,6
21582,5582,Kits,4,4,1.0,0
21583,5582,Stuff Packs,10,0,0.0,10
21584,5583,Expansion Packs,1,0,0.0,1
21585,5583,Game Packs,1,0,0.0,1
21586,5583,Kits,3,0,0.0,3
21587,5583,Stuff Packs,5,0,0.0,5
21588,5584,Expansion Packs,16,0,0.0,16
21589,5584,Game Packs,9,0,0.0,9
21590,5584,Kits,12,0,0.0,12
21591,5584,Stuff Packs,15,0,0.0,15
21592,5585,Expansion Packs,16,0,0.0,16
21593,5585,Game Packs,12,0,0.0,12
21594,5585,Kits,21,1,0.047619047619047616,20
21595,5585,Stuff Packs,20,0,0.0,20
21596,5586,Expansion Packs,6,0,0.0,6
21597,5586,Game Packs,4,1,0.25,3
21598,5586,Kits,5,3,0.6,2
21599,5586,Stuff Packs,10,4,0.4,6
21600,5587,Expansion Packs,13,0,0.0,13
21601,5587,Game Packs,5,0,0.0,5
21602,5587,Kits,3,3,1.0,0
21603,5587,Stuff Packs,5,1,0.2,4
21604,5588,Expansion Packs,16,0,0.0,16
21605,5588,Game Packs,4,0,0.0,4
21606,5588,Stuff Packs,3,3,1.0,0
21607,5589,Expansion Packs,16,0,0.0,16
21608,5589,Game Packs,12,0,0.0,12
21609,5589,Kits,22,1,0.045454545454545456,21
21610,5589,Stuff Packs,20,0,0.0,20
21611,5590,Expansion Packs,16,0,0.0,16
21612,5590,Game Packs,9,0,0.0,9
21613,5590,Kits,4,0,0.0,4
21614,5590,Stuff Packs,18,0,0.0,18
21615,5591,Expansion Packs,12,0,0.0,12
21616,5591,Game Packs,11,0,0.0,11
21617,5591,Kits,15,1,0.06666666666666667,14
21618,5591,Stuff Packs,20,0,0.0,20
21619,5592,Expansion Packs,16,0,0.0,16
21620,5592,Game Packs,12,0,0.0,12
21621,5592,Kits,33,1,0.030303030303030304,32
21622,5592,Stuff Packs,20,2,0.1,18
21623,5593,Expansion Packs,9,0,0.0,9
21624,5593,Game Packs,3,0,0.0,3
21625,5593,Kits,7,2,0.2857142857142857,5
21626,5593,Stuff Packs,3,1,0.3333333333333333,2
21627,5594,Expansion Packs,12,0,0.0,12
21628,5594,Game Packs,7,0,0.0,7
21629,5594,Kits,3,3,1.0,0
21630,5594,Stuff Packs,9,4,0.4444444444444444,5
21631,5595,Expansion Packs,6,0,0.0,6
21632,5595,Game Packs,3,0,0.0,3
21633,5595,Kits,2,1,0.5,1
21634,5595,Stuff Packs,5,3,0.6,2
21635,5596,Expansion Packs,16,0,0.0,16
21636,5596,Game Packs,7,0,0.0,7
21637,5596,Kits,3,0,0.0,3
21638,5596,Stuff Packs,6,1,0.16666666666666666,5
21639,5597,Expansion Packs,12,0,0.0,12
21640,5597,Game Packs,10,0,0.0,10
21641,5597,Kits,5,2,0.4,3
21642,5597,Stuff Packs,15,2,0.13333333333333333,13
21643,5598,Expansion Packs,7,0,0.0,7
21644,5598,Game Packs,8,1,0.125,7
21645,5598,Kits,5,2,0.4,3
21646,5598,Stuff Packs,12,4,0.3333333333333333,8
21647,5599,Expansion Packs,13,0,0.0,13
21648,5599,Game Packs,4,0,0.0,4
21649,5599,Kits,2,0,0.0,2
21650,5599,Stuff Packs,8,1,0.125,7
21651,5600,Expansion Packs,15,1,0.06666666666666667,14
21652,5600,Game Packs,9,0,0.0,9
21653,5600,Kits,28,0,0.0,28
21654,5600,Stuff Packs,18,0,0.0,18
21655,5601,Expansion Packs,8,0,0.0,8
21656,5601,Game Packs,3,0,0.0,3
21657,5601,Kits,4,3,0.75,1
21658,5601,Stuff Packs,8,3,0.375,5
21659,5602,Expansion Packs,13,0,0.0,13
21660,5602,Game Packs,10,1,0.1,9
21661,5602,Kits,4,4,1.0,0
21662,5602,Stuff Packs,15,4,0.26666666666666666,11
21663,5603,Expansion Packs,6,0,0.0,6
21664,5603,Game Packs,1,0,0.0,1
21665,5603,Kits,3,3,1.0,0
21666,5603,Stuff Packs,6,4,0.6666666666666666,2
21667,5604,Expansion Packs,16,0,0.0,16
21668,5604,Game Packs,12,0,0.0,12
21669,5604,Kits,33,0,0.0,33
21670,5604,Stuff Packs,20,0,0.0,20
21671,5605,Expansion Packs,16,5,0.3125,11
21672,5605,Game Packs,10,5,0.5,5
21673,5605,Kits,18,3,0.16666666666666666,15
21674,5605,Stuff Packs,12,6,0.5,6
21675,5606,Expansion Packs,2,0,0.0,2
21676,5607,Expansion Packs,14,0,0.0,14
21677,5607,Game Packs,12,0,0.0,12
21678,5607,Kits,24,3,0.125,21
21679,5607,Stuff Packs,20,1,0.05,19
21680,5608,Expansion Packs,16,0,0.0,16
21681,5608,Game Packs,12,0,0.0,12
21682,5608,Kits,2,0,0.0,2
21683,5608,Stuff Packs,20,0,0.0,20
21684,5609,Expansion Packs,5,0,0.0,5
21685,5609,Game Packs,1,1,1.0,0
21686,5609,Kits,2,2,1.0,0
21687,5609,Stuff Packs,6,4,0.6666666666666666,2
21688,5610,Expansion Packs,15,0,0.0,15
21689,5610,Game Packs,12,0,0.0,12
21690,5610,Kits,25,2,0.08,23
21691,5610,Stuff Packs,20,1,0.05,19
21692,5611,Expansion Packs,11,0,0.0,11
21693,5611,Game Packs,1,0,0.0,1
21694,5611,Kits,2,0,0.0,2
21695,5611,Stuff Packs,2,0,0.0,2
21696,5612,Expansion Packs,16,0,0.0,16
21697,5612,Game Packs,12,0,0.0,12
21698,5612,Kits,33,1,0.030303030303030304,32
21699,5612,Stuff Packs,20,0,0.0,20
21700,5613,Expansion Packs,16,0,0.0,16
21701,5613,Game Packs,10,0,0.0,10
21702,5613,Kits,23,1,0.043478260869565216,22
21703,5613,Stuff Packs,20,0,0.0,20
21704,5614,Expansion Packs,16,0,0.0,16
21705,5614,Game Packs,12,0,0.0,12
21706,5614,Kits,33,0,0.0,33
21707,5614,Stuff Packs,20,0,0.0,20
21708,5615,Expansion Packs,15,0,0.0,15
21709,5615,Game Packs,12,0,0.0,12
21710,5615,Kits,2,2,1.0,0
21711,5615,Stuff Packs,20,1,0.05,19
21712,5616,Expansion Packs,16,0,0.0,16
21713,5616,Game Packs,5,0,0.0,5
21714,5616,Kits,6,1,0.16666666666666666,5
21715,5616,Stuff Packs,10,3,0.3,7
21716,5617,Expansion Packs,16,0,0.0,16
21717,5617,Game Packs,12,0,0.0,12
21718,5617,Kits,33,0,0.0,33
21719,5617,Stuff Packs,20,0,0.0,20
21720,5618,Expansion Packs,16,0,0.0,16
21721,5618,Game Packs,12,0,0.0,12
21722,5618,Kits,10,1,0.1,9
21723,5618,Stuff Packs,17,2,0.11764705882352941,15
21724,5619,Expansion Packs,16,0,0.0,16
21725,5619,Game Packs,12,0,0.0,12
21726,5619,Kits,26,1,0.038461538461538464,25
21727,5619,Stuff Packs,20,2,0.1,18
21728,5620,Expansion Packs,14,0,0.0,14
21729,5620,Game Packs,11,0,0.0,11
21730,5620,Kits,3,1,0.3333333333333333,2
21731,5620,Stuff Packs,12,2,0.16666666666666666,10
21732,5621,Expansion Packs,6,0,0.0,6
21733,5621,Game Packs,3,1,0.3333333333333333,2
21734,5621,Kits,2,2,1.0,0
21735,5621,Stuff Packs,4,3,0.75,1
21736,5622,Expansion Packs,16,0,0.0,16
21737,5622,Game Packs,12,0,0.0,12
21738,5622,Kits,20,1,0.05,19
21739,5622,Stuff Packs,20,0,0.0,20
21740,5623,Expansion Packs,9,0,0.0,9
21741,5623,Game Packs,6,0,0.0,6
21742,5623,Kits,2,1,0.5,1
21743,5623,Stuff Packs,7,3,0.42857142857142855,4
21744,5624,Expansion Packs,8,0,0.0,8
21745,5624,Game Packs,3,0,0.0,3
21746,5624,Kits,1,0,0.0,1
21747,5624,Stuff Packs,5,1,0.2,4
21748,5625,Expansion Packs,15,0,0.0,15
21749,5625,Game Packs,8,0,0.0,8
21750,5625,Kits,2,2,1.0,0
21751,5625,Stuff Packs,9,2,0.2222222222222222,7
21752,5626,Expansion Packs,5,0,0.0,5
21753,5626,Game Packs,2,0,0.0,2
21754,5626,Kits,2,0,0.0,2
21755,5626,Stuff Packs,4,0,0.0,4
21756,5627,Expansion Packs,12,0,0.0,12
21757,5627,Game Packs,9,0,0.0,9
21758,5627,Kits,2,2,1.0,0
21759,5627,Stuff Packs,9,3,0.3333333333333333,6
21760,5628,Expansion Packs,13,0,0.0,13
21761,5628,Game Packs,10,0,0.0,10
21762,5628,Kits,6,2,0.3333333333333333,4
21763,5628,Stuff Packs,18,0,0.0,18
21764,5629,Expansion Packs,15,1,0.06666666666666667,14
21765,5629,Game Packs,12,0,0.0,12
21766,5629,Kits,21,0,0.0,21
21767,5629,Stuff Packs,20,0,0.0,20
21768,5630,Expansion Packs,16,0,0.0,16
21769,5630,Game Packs,12,0,0.0,12
21770,5630,Kits,28,0,0.0,28
21771,5630,Stuff Packs,20,0,0.0,20
21772,5631,Expansion Packs,5,0,0.0,5
21773,5631,Game Packs,4,0,0.0,4
21774,5631,Kits,1,1,1.0,0
21775,5631,Stuff Packs,7,3,0.42857142857142855,4
21776,5632,Expansion Packs,16,0,0.0,16
21777,5632,Game Packs,11,0,0.0,11
21778,5632,Kits,5,1,0.2,4
21779,5632,Stuff Packs,14,2,0.14285714285714285,12
21780,5633,Expansion Packs,14,0,0.0,14
21781,5633,Game Packs,6,0,0.0,6
21782,5633,Kits,2,0,0.0,2
21783,5633,Stuff Packs,6,2,0.3333333333333333,4
21784,5634,Expansion Packs,16,16,1.0,0
21785,5634,Game Packs,12,12,1.0,0
21786,5634,Kits,33,33,1.0,0
21787,5634,Stuff Packs,20,20,1.0,0
21788,5635,Expansion Packs,16,0,0.0,16
21789,5635,Game Packs,10,0,0.0,10
21790,5635,Kits,11,0,0.0,11
21791,5635,Stuff Packs,17,0,0.0,17
21792,5636,Expansion Packs,16,0,0.0,16
21793,5636,Game Packs,12,0,0.0,12
21794,5636,Kits,33,0,0.0,33
21795,5636,Stuff Packs,20,0,0.0,20
21796,5637,Expansion Packs,10,0,0.0,10
21797,5637,Game Packs,8,1,0.125,7
21798,5637,Kits,5,3,0.6,2
21799,5637,Stuff Packs,11,4,0.36363636363636365,7
21800,5638,Expansion Packs,11,0,0.0,11
21801,5638,Game Packs,4,0,0.0,4
21802,5638,Kits,21,1,0.047619047619047616,20
21803,5638,Stuff Packs,12,2,0.16666666666666666,10
21804,5639,Expansion Packs,14,0,0.0,14
21805,5639,Game Packs,10,0,0.0,10
21806,5639,Kits,2,2,1.0,0
21807,5639,Stuff Packs,11,4,0.36363636363636365,7
21808,5640,Expansion Packs,16,4,0.25,12
21809,5640,Game Packs,12,0,0.0,12
21810,5640,Kits,33,0,0.0,33
21811,5640,Stuff Packs,20,0,0.0,20
21812,5641,Expansion Packs,1,0,0.0,1
21813,5642,Expansion Packs,11,0,0.0,11
21814,5642,Game Packs,6,0,0.0,6
21815,5642,Kits,12,3,0.25,9
21816,5642,Stuff Packs,9,3,0.3333333333333333,6
21817,5643,Expansion Packs,15,0,0.0,15
21818,5643,Game Packs,8,0,0.0,8
21819,5643,Kits,6,0,0.0,6
21820,5643,Stuff Packs,11,2,0.18181818181818182,9
21821,5644,Expansion Packs,14,0,0.0,14
21822,5644,Game Packs,9,0,0.0,9
21823,5644,Kits,4,1,0.25,3
21824,5644,Stuff Packs,13,2,0.15384615384615385,11
21825,5645,Expansion Packs,14,1,0.07142857142857142,13
21826,5645,Game Packs,7,0,0.0,7
21827,5645,Kits,11,1,0.09090909090909091,10
21828,5645,Stuff Packs,15,3,0.2,12
21829,5646,Expansion Packs,16,1,0.0625,15
21830,5646,Game Packs,11,2,0.18181818181818182,9
21831,5646,Kits,24,3,0.125,21
21832,5646,Stuff Packs,17,3,0.17647058823529413,14
21833,5647,Expansion Packs,16,0,0.0,16
21834,5647,Game Packs,12,0,0.0,12
21835,5647,Kits,33,0,0.0,33
21836,5647,Stuff Packs,20,0,0.0,20
21837,5648,Expansion Packs,16,0,0.0,16
21838,5648,Game Packs,10,0,0.0,10
21839,5648,Kits,18,1,0.05555555555555555,17
21840,5648,Stuff Packs,18,1,0.05555555555555555,17
21841,5649,Expansion Packs,14,0,0.0,14
21842,5649,Game Packs,10,0,0.0,10
21843,5649,Kits,10,0,0.0,10
21844,5649,Stuff Packs,15,0,0.0,15
21845,5650,Expansion Packs,16,0,0.0,16
21846,5650,Game Packs,12,0,0.0,12
21847,5650,Kits,27,0,0.0,27
21848,5650,Stuff Packs,20,0,0.0,20
21849,5651,Expansion Packs,16,0,0.0,16
21850,5651,Game Packs,12,0,0.0,12
21851,5651,Kits,33,0,0.0,33
21852,5651,Stuff Packs,20,0,0.0,20
21853,5652,Expansion Packs,16,0,0.0,16
21854,5652,Game Packs,12,0,0.0,12
21855,5652,Kits,33,1,0.030303030303030304,32
21856,5652,Stuff Packs,20,0,0.0,20
21857,5653,Expansion Packs,13,0,0.0,13
21858,5653,Game Packs,6,0,0.0,6
21859,5653,Kits,15,0,0.0,15
21860,5653,Stuff Packs,13,0,0.0,13
21861,5654,Game Packs,1,0,0.0,1
21862,5655,Expansion Packs,16,0,0.0,16
21863,5655,Game Packs,12,0,0.0,12
21864,5655,Kits,33,3,0.09090909090909091,30
21865,5655,Stuff Packs,20,0,0.0,20
21866,5656,Expansion Packs,14,0,0.0,14
21867,5656,Game Packs,7,1,0.14285714285714285,6
21868,5656,Kits,12,1,0.08333333333333333,11
21869,5656,Stuff Packs,15,2,0.13333333333333333,13
21870,5657,Expansion Packs,13,0,0.0,13
21871,5657,Game Packs,10,0,0.0,10
21872,5657,Kits,2,2,1.0,0
21873,5657,Stuff Packs,7,1,0.14285714285714285,6
21874,5658,Expansion Packs,3,0,0.0,3
21875,5658,Game Packs,2,0,0.0,2
21876,5658,Kits,3,0,0.0,3
21877,5658,Stuff Packs,1,0,0.0,1
21878,5659,Expansion Packs,16,0,0.0,16
21879,5659,Game Packs,12,0,0.0,12
21880,5659,Kits,33,0,0.0,33
21881,5659,Stuff Packs,20,1,0.05,19
21882,5660,Expansion Packs,14,0,0.0,14
21883,5660,Game Packs,11,0,0.0,11
21884,5660,Kits,13,0,0.0,13
21885,5660,Stuff Packs,18,0,0.0,18
21886,5661,Expansion Packs,16,0,0.0,16
21887,5661,Game Packs,11,0,0.0,11
21888,5661,Kits,16,1,0.0625,15
21889,5661,Stuff Packs,18,0,0.0,18
21890,5662,Expansion Packs,15,0,0.0,15
21891,5662,Game Packs,12,0,0.0,12
21892,5662,Kits,14,0,0.0,14
21893,5662,Stuff Packs,20,0,0.0,20
21894,5663,Expansion Packs,13,0,0.0,13
21895,5663,Game Packs,9,0,0.0,9
21896,5663,Kits,2,0,0.0,2
21897,5663,Stuff Packs,18,0,0.0,18
21898,5664,Expansion Packs,16,0,0.0,16
21899,5664,Game Packs,12,0,0.0,12
21900,5664,Kits,20,1,0.05,19
21901,5664,Stuff Packs,20,0,0.0,20
21902,5665,Expansion Packs,9,0,0.0,9
21903,5665,Game Packs,10,1,0.1,9
21904,5665,Kits,10,1,0.1,9
21905,5665,Stuff Packs,17,1,0.058823529411764705,16
21906,5666,Expansion Packs,5,1,0.2,4
21907,5666,Game Packs,4,0,0.0,4
21908,5666,Kits,1,1,1.0,0
21909,5666,Stuff Packs,7,1,0.14285714285714285,6
21910,5667,Expansion Packs,11,0,0.0,11
21911,5667,Game Packs,3,0,0.0,3
21912,5667,Kits,7,0,0.0,7
21913,5667,Stuff Packs,8,2,0.25,6
21914,5668,Expansion Packs,15,0,0.0,15
21915,5668,Game Packs,12,0,0.0,12
21916,5668,Kits,7,0,0.0,7
21917,5668,Stuff Packs,20,0,0.0,20
21918,5669,Expansion Packs,9,0,0.0,9
21919,5669,Game Packs,3,0,0.0,3
21920,5669,Kits,3,0,0.0,3
21921,5669,Stuff Packs,6,2,0.3333333333333333,4
21922,5670,Expansion Packs,16,0,0.0,16
21923,5670,Game Packs,12,0,0.0,12
21924,5670,Kits,33,1,0.030303030303030304,32
21925,5670,Stuff Packs,20,0,0.0,20
21926,5671,Expansion Packs,16,0,0.0,16
21927,5671,Game Packs,12,0,0.0,12
21928,5671,Kits,8,0,0.0,8
21929,5671,Stuff Packs,17,1,0.058823529411764705,16
21930,5672,Expansion Packs,16,0,0.0,16
21931,5672,Game Packs,12,0,0.0,12
21932,5672,Kits,29,0,0.0,29
21933,5672,Stuff Packs,20,0,0.0,20
21934,5673,Expansion Packs,16,0,0.0,16
21935,5673,Game Packs,9,0,0.0,9
21936,5673,Kits,10,1,0.1,9
21937,5673,Stuff Packs,13,3,0.23076923076923078,10
21938,5674,Expansion Packs,16,0,0.0,16
21939,5674,Game Packs,12,0,0.0,12
21940,5674,Kits,16,1,0.0625,15
21941,5674,Stuff Packs,20,1,0.05,19
21942,5675,Expansion Packs,12,0,0.0,12
21943,5675,Game Packs,9,0,0.0,9
21944,5675,Kits,6,0,0.0,6
21945,5675,Stuff Packs,15,0,0.0,15
21946,5676,Expansion Packs,2,0,0.0,2
21947,5676,Game Packs,1,0,0.0,1
21948,5677,Expansion Packs,16,0,0.0,16
21949,5677,Game Packs,12,0,0.0,12
21950,5677,Kits,33,0,0.0,33
21951,5677,Stuff Packs,20,2,0.1,18
21952,5678,Expansion Packs,13,1,0.07692307692307693,12
21953,5678,Game Packs,10,5,0.5,5
21954,5678,Kits,6,0,0.0,6
21955,5678,Stuff Packs,10,4,0.4,6
21956,5679,Expansion Packs,15,0,0.0,15
21957,5679,Game Packs,3,0,0.0,3
21958,5679,Kits,1,0,0.0,1
21959,5679,Stuff Packs,4,1,0.25,3
21960,5680,Expansion Packs,15,0,0.0,15
21961,5680,Game Packs,12,0,0.0,12
21962,5680,Kits,4,0,0.0,4
21963,5680,Stuff Packs,16,0,0.0,16
21964,5681,Expansion Packs,14,0,0.0,14
21965,5681,Game Packs,8,0,0.0,8
21966,5681,Kits,7,0,0.0,7
21967,5681,Stuff Packs,9,0,0.0,9
21968,5682,Expansion Packs,10,0,0.0,10
21969,5682,Game Packs,3,1,0.3333333333333333,2
21970,5682,Kits,4,3,0.75,1
21971,5682,Stuff Packs,7,4,0.5714285714285714,3
21972,5683,Expansion Packs,9,0,0.0,9
21973,5683,Game Packs,4,0,0.0,4
21974,5683,Kits,8,2,0.25,6
21975,5683,Stuff Packs,4,1,0.25,3
21976,5684,Expansion Packs,14,0,0.0,14
21977,5684,Game Packs,6,0,0.0,6
21978,5684,Kits,5,2,0.4,3
21979,5684,Stuff Packs,14,2,0.14285714285714285,12
21980,5685,Expansion Packs,16,0,0.0,16
21981,5685,Game Packs,12,0,0.0,12
21982,5685,Kits,33,0,0.0,33
21983,5685,Stuff Packs,20,0,0.0,20
21984,5686,Expansion Packs,16,0,0.0,16
21985,5686,Game Packs,11,0,0.0,11
21986,5686,Kits,18,0,0.0,18
21987,5686,Stuff Packs,20,0,0.0,20
21988,5687,Expansion Packs,16,0,0.0,16
21989,5687,Game Packs,12,0,0.0,12
21990,5687,Kits,7,1,0.14285714285714285,6
21991,5687,Stuff Packs,20,0,0.0,20
21992,5688,Expansion Packs,7,0,0.0,7
21993,5688,Game Packs,2,0,0.0,2
21994,5688,Kits,2,1,0.5,1
21995,5688,Stuff Packs,2,0,0.0,2
21996,5689,Expansion Packs,8,0,0.0,8
21997,5689,Game Packs,2,0,0.0,2
21998,5689,Kits,2,2,1.0,0
21999,5689,Stuff Packs,16,1,0.0625,15
22000,5690,Expansion Packs,16,0,0.0,16
22001,5690,Game Packs,12,0,0.0,12
22002,5690,Kits,33,0,0.0,33
22003,5690,Stuff Packs,20,0,0.0,20
22004,5691,Expansion Packs,15,0,0.0,15
22005,5691,Game Packs,11,0,0.0,11
22006,5691,Kits,15,1,0.06666666666666667,14
22007,5691,Stuff Packs,19,0,0.0,19
22008,5692,Expansion Packs,15,0,0.0,15
22009,5692,Game Packs,10,0,0.0,10
22010,5692,Kits,17,1,0.058823529411764705,16
22011,5692,Stuff Packs,15,0,0.0,15
22012,5693,Expansion Packs,6,0,0.0,6
22013,5693,Game Packs,5,0,0.0,5
22014,5693,Kits,2,2,1.0,0
22015,5693,Stuff Packs,9,4,0.4444444444444444,5
22016,5694,Expansion Packs,16,0,0.0,16
22017,5694,Game Packs,12,0,0.0,12
22018,5694,Kits,33,1,0.030303030303030304,32
22019,5694,Stuff Packs,20,1,0.05,19
22020,5695,Expansion Packs,16,0,0.0,16
22021,5695,Game Packs,12,0,0.0,12
22022,5695,Kits,26,0,0.0,26
22023,5695,Stuff Packs,20,0,0.0,20
22024,5696,Expansion Packs,16,0,0.0,16
22025,5696,Game Packs,12,0,0.0,12
22026,5696,Kits,31,0,0.0,31
22027,5696,Stuff Packs,20,0,0.0,20
22028,5697,Expansion Packs,15,0,0.0,15
22029,5697,Game Packs,8,0,0.0,8
22030,5697,Kits,11,1,0.09090909090909091,10
22031,5697,Stuff Packs,13,0,0.0,13
22032,5698,Expansion Packs,13,0,0.0,13
22033,5698,Game Packs,12,0,0.0,12
22034,5698,Kits,23,0,0.0,23
22035,5698,Stuff Packs,18,0,0.0,18
22036,5699,Expansion Packs,16,0,0.0,16
22037,5699,Game Packs,12,1,0.08333333333333333,11
22038,5699,Kits,19,3,0.15789473684210525,16
22039,5699,Stuff Packs,20,2,0.1,18
22040,5700,Expansion Packs,15,0,0.0,15
22041,5700,Game Packs,11,0,0.0,11
22042,5700,Kits,8,1,0.125,7
22043,5700,Stuff Packs,11,0,0.0,11
22044,5701,Expansion Packs,15,0,0.0,15
22045,5701,Game Packs,12,0,0.0,12
22046,5701,Kits,33,0,0.0,33
22047,5701,Stuff Packs,20,0,0.0,20
22048,5702,Expansion Packs,5,0,0.0,5
22049,5702,Game Packs,1,0,0.0,1
22050,5702,Stuff Packs,2,0,0.0,2
22051,5703,Expansion Packs,16,0,0.0,16
22052,5703,Game Packs,12,0,0.0,12
22053,5703,Kits,31,0,0.0,31
22054,5703,Stuff Packs,20,0,0.0,20
22055,5704,Expansion Packs,13,0,0.0,13
22056,5704,Game Packs,6,2,0.3333333333333333,4
22057,5704,Kits,4,3,0.75,1
22058,5704,Stuff Packs,10,7,0.7,3
22059,5705,Expansion Packs,16,0,0.0,16
22060,5705,Game Packs,12,0,0.0,12
22061,5705,Kits,22,1,0.045454545454545456,21
22062,5705,Stuff Packs,20,0,0.0,20
22063,5706,Expansion Packs,16,0,0.0,16
22064,5706,Game Packs,5,0,0.0,5
22065,5706,Kits,1,1,1.0,0
22066,5706,Stuff Packs,2,1,0.5,1
22067,5707,Expansion Packs,6,0,0.0,6
22068,5707,Game Packs,2,0,0.0,2
22069,5707,Kits,1,1,1.0,0
22070,5707,Stuff Packs,4,1,0.25,3
22071,5708,Expansion Packs,16,0,0.0,16
22072,5708,Game Packs,12,0,0.0,12
22073,5708,Kits,33,1,0.030303030303030304,32
22074,5708,Stuff Packs,20,0,0.0,20
22075,5709,Expansion Packs,16,0,0.0,16
22076,5709,Game Packs,11,0,0.0,11
22077,5709,Kits,19,1,0.05263157894736842,18
22078,5709,Stuff Packs,20,0,0.0,20
22079,5710,Expansion Packs,16,0,0.0,16
22080,5710,Game Packs,9,0,0.0,9
22081,5710,Kits,7,0,0.0,7
22082,5710,Stuff Packs,11,2,0.18181818181818182,9
22083,5711,Expansion Packs,16,0,0.0,16
22084,5711,Game Packs,12,0,0.0,12
22085,5711,Kits,28,0,0.0,28
22086,5711,Stuff Packs,20,0,0.0,20
22087,5712,Expansion Packs,4,0,0.0,4
22088,5712,Game Packs,4,0,0.0,4
22089,5712,Kits,4,2,0.5,2
22090,5712,Stuff Packs,6,3,0.5,3
22091,5713,Expansion Packs,16,0,0.0,16
22092,5713,Game Packs,12,0,0.0,12
22093,5713,Kits,33,0,0.0,33
22094,5713,Stuff Packs,20,0,0.0,20
22095,5714,Expansion Packs,15,0,0.0,15
22096,5714,Game Packs,12,0,0.0,12
22097,5714,Kits,24,1,0.041666666666666664,23
22098,5714,Stuff Packs,20,0,0.0,20
22099,5715,Expansion Packs,16,0,0.0,16
22100,5715,Game Packs,12,0,0.0,12
22101,5715,Kits,33,0,0.0,33
22102,5715,Stuff Packs,20,0,0.0,20
22103,5716,Expansion Packs,10,0,0.0,10
22104,5716,Game Packs,6,0,0.0,6
22105,5716,Kits,1,1,1.0,0
22106,5716,Stuff Packs,7,2,0.2857142857142857,5
22107,5717,Expansion Packs,2,0,0.0,2
22108,5717,Game Packs,1,0,0.0,1
22109,5717,Stuff Packs,4,0,0.0,4
22110,5718,Expansion Packs,16,0,0.0,16
22111,5718,Game Packs,12,0,0.0,12
22112,5718,Kits,33,0,0.0,33
22113,5718,Stuff Packs,20,0,0.0,20
22114,5719,Expansion Packs,15,0,0.0,15
22115,5719,Game Packs,7,0,0.0,7
22116,5719,Kits,17,0,0.0,17
22117,5719,Stuff Packs,10,0,0.0,10
22118,5720,Expansion Packs,16,0,0.0,16
22119,5720,Game Packs,12,0,0.0,12
22120,5720,Kits,33,0,0.0,33
22121,5720,Stuff Packs,20,0,0.0,20
22122,5721,Expansion Packs,16,0,0.0,16
22123,5721,Game Packs,12,0,0.0,12
22124,5721,Kits,22,1,0.045454545454545456,21
22125,5721,Stuff Packs,20,0,0.0,20
22126,5722,Expansion Packs,16,16,1.0,0
22127,5722,Game Packs,12,12,1.0,0
22128,5722,Kits,30,30,1.0,0
22129,5722,Stuff Packs,20,18,0.9,2
22130,5723,Expansion Packs,4,0,0.0,4
22131,5723,Game Packs,1,0,0.0,1
22132,5723,Kits,1,1,1.0,0
22133,5723,Stuff Packs,2,0,0.0,2
22134,5724,Expansion Packs,16,0,0.0,16
22135,5724,Game Packs,10,0,0.0,10
22136,5724,Kits,19,0,0.0,19
22137,5724,Stuff Packs,19,0,0.0,19
22138,5725,Expansion Packs,16,0,0.0,16
22139,5725,Game Packs,10,0,0.0,10
22140,5725,Kits,4,3,0.75,1
22141,5725,Stuff Packs,12,2,0.16666666666666666,10
22142,5726,Expansion Packs,14,0,0.0,14
22143,5726,Game Packs,12,0,0.0,12
22144,5726,Kits,7,1,0.14285714285714285,6
22145,5726,Stuff Packs,17,2,0.11764705882352941,15
22146,5727,Expansion Packs,16,0,0.0,16
22147,5727,Game Packs,12,0,0.0,12
22148,5727,Kits,17,1,0.058823529411764705,16
22149,5727,Stuff Packs,20,0,0.0,20
22150,5728,Expansion Packs,15,0,0.0,15
22151,5728,Game Packs,11,0,0.0,11
22152,5728,Kits,4,0,0.0,4
22153,5728,Stuff Packs,9,1,0.1111111111111111,8
22154,5729,Expansion Packs,15,0,0.0,15
22155,5729,Game Packs,9,0,0.0,9
22156,5729,Kits,4,2,0.5,2
22157,5729,Stuff Packs,8,3,0.375,5
22158,5730,Expansion Packs,15,0,0.0,15
22159,5730,Game Packs,12,0,0.0,12
22160,5730,Kits,21,0,0.0,21
22161,5730,Stuff Packs,20,0,0.0,20
22162,5731,Expansion Packs,9,0,0.0,9
22163,5731,Game Packs,8,0,0.0,8
22164,5731,Kits,4,2,0.5,2
22165,5731,Stuff Packs,11,3,0.2727272727272727,8
22166,5732,Expansion Packs,10,0,0.0,10
22167,5732,Game Packs,8,0,0.0,8
22168,5732,Kits,12,2,0.16666666666666666,10
22169,5732,Stuff Packs,11,2,0.18181818181818182,9
22170,5733,Expansion Packs,13,0,0.0,13
22171,5733,Game Packs,4,0,0.0,4
22172,5733,Kits,7,1,0.14285714285714285,6
22173,5733,Stuff Packs,7,0,0.0,7
22174,5734,Expansion Packs,15,0,0.0,15
22175,5734,Game Packs,9,1,0.1111111111111111,8
22176,5734,Kits,17,2,0.11764705882352941,15
22177,5734,Stuff Packs,19,1,0.05263157894736842,18
22178,5735,Expansion Packs,10,0,0.0,10
22179,5735,Game Packs,8,0,0.0,8
22180,5735,Kits,2,2,1.0,0
22181,5735,Stuff Packs,7,2,0.2857142857142857,5
22182,5736,Expansion Packs,16,0,0.0,16
22183,5736,Game Packs,12,0,0.0,12
22184,5736,Kits,33,0,0.0,33
22185,5736,Stuff Packs,20,1,0.05,19
22186,5737,Expansion Packs,10,2,0.2,8
22187,5737,Game Packs,2,1,0.5,1
22188,5737,Kits,6,1,0.16666666666666666,5
22189,5737,Stuff Packs,10,5,0.5,5
22190,5738,Expansion Packs,14,0,0.0,14
22191,5738,Game Packs,11,0,0.0,11
22192,5738,Kits,13,0,0.0,13
22193,5738,Stuff Packs,20,1,0.05,19
22194,5739,Expansion Packs,11,0,0.0,11
22195,5739,Game Packs,6,0,0.0,6
22196,5739,Kits,5,1,0.2,4
22197,5739,Stuff Packs,9,0,0.0,9
22198,5740,Expansion Packs,11,0,0.0,11
22199,5740,Game Packs,6,1,0.16666666666666666,5
22200,5740,Kits,11,1,0.09090909090909091,10
22201,5740,Stuff Packs,11,4,0.36363636363636365,7
22202,5741,Expansion Packs,16,0,0.0,16
22203,5741,Game Packs,11,0,0.0,11
22204,5741,Kits,8,2,0.25,6
22205,5741,Stuff Packs,11,2,0.18181818181818182,9
22206,5742,Expansion Packs,16,0,0.0,16
22207,5742,Game Packs,12,0,0.0,12
22208,5742,Kits,14,1,0.07142857142857142,13
22209,5742,Stuff Packs,20,0,0.0,20
22210,5743,Expansion Packs,16,0,0.0,16
22211,5743,Game Packs,11,0,0.0,11
22212,5743,Kits,10,2,0.2,8
22213,5743,Stuff Packs,20,0,0.0,20
22214,5744,Expansion Packs,16,0,0.0,16
22215,5744,Game Packs,6,1,0.16666666666666666,5
22216,5744,Kits,12,1,0.08333333333333333,11
22217,5744,Stuff Packs,11,4,0.36363636363636365,7
22218,5745,Expansion Packs,11,0,0.0,11
22219,5745,Game Packs,6,0,0.0,6
22220,5745,Stuff Packs,2,0,0.0,2
22221,5746,Expansion Packs,15,0,0.0,15
22222,5746,Game Packs,9,0,0.0,9
22223,5746,Kits,10,1,0.1,9
22224,5746,Stuff Packs,15,3,0.2,12
22225,5747,Expansion Packs,5,0,0.0,5
22226,5747,Game Packs,2,2,1.0,0
22227,5747,Stuff Packs,3,0,0.0,3
22228,5748,Expansion Packs,16,0,0.0,16
22229,5748,Game Packs,12,0,0.0,12
22230,5748,Kits,17,1,0.058823529411764705,16
22231,5748,Stuff Packs,20,0,0.0,20
22232,5749,Expansion Packs,16,0,0.0,16
22233,5749,Game Packs,11,0,0.0,11
22234,5749,Kits,27,1,0.037037037037037035,26
22235,5749,Stuff Packs,20,0,0.0,20
22236,5750,Expansion Packs,16,0,0.0,16
22237,5750,Game Packs,12,0,0.0,12
22238,5750,Kits,23,1,0.043478260869565216,22
22239,5750,Stuff Packs,20,0,0.0,20
22240,5751,Expansion Packs,14,0,0.0,14
22241,5751,Game Packs,9,1,0.1111111111111111,8
22242,5751,Kits,11,0,0.0,11
22243,5751,Stuff Packs,6,3,0.5,3
22244,5752,Expansion Packs,16,0,0.0,16
22245,5752,Game Packs,10,0,0.0,10
22246,5752,Kits,1,0,0.0,1
22247,5752,Stuff Packs,15,2,0.13333333333333333,13
22248,5753,Expansion Packs,15,0,0.0,15
22249,5753,Game Packs,11,0,0.0,11
22250,5753,Kits,30,0,0.0,30
22251,5753,Stuff Packs,18,0,0.0,18
22252,5754,Expansion Packs,13,0,0.0,13
22253,5754,Game Packs,9,0,0.0,9
22254,5754,Kits,2,2,1.0,0
22255,5754,Stuff Packs,12,2,0.16666666666666666,10
22256,5755,Expansion Packs,11,0,0.0,11
22257,5755,Game Packs,4,1,0.25,3
22258,5755,Kits,7,1,0.14285714285714285,6
22259,5755,Stuff Packs,8,3,0.375,5
22260,5756,Expansion Packs,14,0,0.0,14
22261,5756,Game Packs,6,0,0.0,6
22262,5756,Kits,8,2,0.25,6
22263,5756,Stuff Packs,9,4,0.4444444444444444,5
22264,5757,Expansion Packs,8,0,0.0,8
22265,5757,Game Packs,7,0,0.0,7
22266,5757,Kits,1,1,1.0,0
22267,5757,Stuff Packs,9,2,0.2222222222222222,7
22268,5758,Expansion Packs,15,0,0.0,15
22269,5758,Game Packs,10,0,0.0,10
22270,5758,Kits,6,0,0.0,6
22271,5758,Stuff Packs,11,1,0.09090909090909091,10
22272,5759,Expansion Packs,16,0,0.0,16
22273,5759,Game Packs,12,0,0.0,12
22274,5759,Kits,30,0,0.0,30
22275,5759,Stuff Packs,20,0,0.0,20
22276,5760,Expansion Packs,11,0,0.0,11
22277,5760,Game Packs,4,0,0.0,4
22278,5760,Stuff Packs,7,0,0.0,7
22279,5761,Expansion Packs,8,0,0.0,8
22280,5761,Game Packs,2,1,0.5,1
22281,5761,Kits,1,1,1.0,0
22282,5761,Stuff Packs,5,5,1.0,0
22283,5762,Expansion Packs,13,0,0.0,13
22284,5762,Game Packs,12,0,0.0,12
22285,5762,Kits,16,0,0.0,16
22286,5762,Stuff Packs,18,0,0.0,18
22287,5763,Expansion Packs,12,0,0.0,12
22288,5763,Game Packs,10,0,0.0,10
22289,5763,Kits,3,1,0.3333333333333333,2
22290,5763,Stuff Packs,11,1,0.09090909090909091,10
22291,5764,Expansion Packs,14,0,0.0,14
22292,5764,Game Packs,11,0,0.0,11
22293,5764,Kits,11,1,0.09090909090909091,10
22294,5764,Stuff Packs,15,0,0.0,15
22295,5765,Expansion Packs,4,0,0.0,4
22296,5765,Game Packs,2,0,0.0,2
22297,5765,Kits,2,2,1.0,0
22298,5765,Stuff Packs,4,2,0.5,2
22299,5766,Expansion Packs,5,0,0.0,5
22300,5766,Kits,2,2,1.0,0
22301,5766,Stuff Packs,4,2,0.5,2
22302,5767,Expansion Packs,12,0,0.0,12
22303,5767,Game Packs,9,0,0.0,9
22304,5767,Kits,8,2,0.25,6
22305,5767,Stuff Packs,12,1,0.08333333333333333,11
22306,5768,Expansion Packs,6,0,0.0,6
22307,5768,Game Packs,1,0,0.0,1
22308,5768,Stuff Packs,4,0,0.0,4
22309,5769,Expansion Packs,14,0,0.0,14
22310,5769,Game Packs,5,0,0.0,5
22311,5769,Kits,2,1,0.5,1
22312,5769,Stuff Packs,7,2,0.2857142857142857,5
22313,5770,Expansion Packs,7,0,0.0,7
22314,5770,Game Packs,2,0,0.0,2
22315,5771,Expansion Packs,14,0,0.0,14
22316,5771,Game Packs,10,0,0.0,10
22317,5771,Kits,23,0,0.0,23
22318,5771,Stuff Packs,17,0,0.0,17
22319,5772,Expansion Packs,4,0,0.0,4
22320,5772,Game Packs,4,0,0.0,4
22321,5772,Kits,1,1,1.0,0
22322,5772,Stuff Packs,5,3,0.6,2
22323,5773,Expansion Packs,16,0,0.0,16
22324,5773,Game Packs,12,0,0.0,12
22325,5773,Kits,28,0,0.0,28
22326,5773,Stuff Packs,20,0,0.0,20
22327,5774,Expansion Packs,14,0,0.0,14
22328,5774,Game Packs,9,0,0.0,9
22329,5774,Kits,4,0,0.0,4
22330,5774,Stuff Packs,16,1,0.0625,15
22331,5775,Expansion Packs,16,0,0.0,16
22332,5775,Game Packs,12,0,0.0,12
22333,5775,Kits,32,0,0.0,32
22334,5775,Stuff Packs,20,0,0.0,20
22335,5776,Expansion Packs,13,0,0.0,13
22336,5776,Game Packs,6,0,0.0,6
22337,5776,Kits,4,2,0.5,2
22338,5776,Stuff Packs,13,2,0.15384615384615385,11
22339,5777,Game Packs,1,1,1.0,0
22340,5777,Kits,1,1,1.0,0
22341,5777,Stuff Packs,1,1,1.0,0
22342,5778,Expansion Packs,15,0,0.0,15
22343,5778,Game Packs,4,0,0.0,4
22344,5778,Kits,14,1,0.07142857142857142,13
22345,5778,Stuff Packs,12,1,0.08333333333333333,11
22346,5779,Expansion Packs,4,0,0.0,4
22347,5779,Game Packs,5,0,0.0,5
22348,5779,Kits,2,2,1.0,0
22349,5779,Stuff Packs,5,3,0.6,2
22350,5780,Expansion Packs,16,0,0.0,16
22351,5780,Game Packs,11,0,0.0,11
22352,5780,Kits,21,1,0.047619047619047616,20
22353,5780,Stuff Packs,18,1,0.05555555555555555,17
22354,5781,Expansion Packs,15,0,0.0,15
22355,5781,Game Packs,8,0,0.0,8
22356,5781,Kits,15,1,0.06666666666666667,14
22357,5781,Stuff Packs,15,3,0.2,12
22358,5782,Expansion Packs,16,0,0.0,16
22359,5782,Game Packs,12,0,0.0,12
22360,5782,Kits,11,1,0.09090909090909091,10
22361,5782,Stuff Packs,20,1,0.05,19
22362,5783,Expansion Packs,16,0,0.0,16
22363,5783,Game Packs,9,0,0.0,9
22364,5783,Kits,8,1,0.125,7
22365,5783,Stuff Packs,14,1,0.07142857142857142,13
22366,5784,Expansion Packs,13,0,0.0,13
22367,5784,Game Packs,10,0,0.0,10
22368,5784,Kits,10,1,0.1,9
22369,5784,Stuff Packs,18,0,0.0,18
22370,5785,Expansion Packs,14,0,0.0,14
22371,5785,Game Packs,7,0,0.0,7
22372,5785,Kits,3,1,0.3333333333333333,2
22373,5785,Stuff Packs,10,0,0.0,10
22374,5786,Expansion Packs,15,0,0.0,15
22375,5786,Game Packs,7,0,0.0,7
22376,5786,Kits,5,1,0.2,4
22377,5786,Stuff Packs,9,1,0.1111111111111111,8
22378,5787,Expansion Packs,16,0,0.0,16
22379,5787,Game Packs,12,0,0.0,12
22380,5787,Kits,33,0,0.0,33
22381,5787,Stuff Packs,20,0,0.0,20
22382,5788,Expansion Packs,16,0,0.0,16
22383,5788,Game Packs,11,0,0.0,11
22384,5788,Kits,18,0,0.0,18
22385,5788,Stuff Packs,20,0,0.0,20
22386,5789,Expansion Packs,8,1,0.125,7
22387,5789,Game Packs,1,0,0.0,1
22388,5789,Kits,3,2,0.6666666666666666,1
22389,5789,Stuff Packs,3,2,0.6666666666666666,1
22390,5790,Expansion Packs,14,0,0.0,14
22391,5790,Game Packs,8,0,0.0,8
22392,5790,Kits,2,1,0.5,1
22393,5790,Stuff Packs,14,0,0.0,14
22394,5791,Expansion Packs,5,0,0.0,5
22395,5791,Kits,3,1,0.3333333333333333,2
22396,5791,Stuff Packs,4,3,0.75,1
22397,5792,Expansion Packs,10,0,0.0,10
22398,5792,Game Packs,6,0,0.0,6
22399,5792,Kits,22,0,0.0,22
22400,5792,Stuff Packs,11,3,0.2727272727272727,8
22401,5793,Expansion Packs,16,0,0.0,16
22402,5793,Game Packs,12,0,0.0,12
22403,5793,Kits,33,0,0.0,33
22404,5793,Stuff Packs,20,0,0.0,20
22405,5794,Expansion Packs,2,0,0.0,2
22406,5794,Game Packs,3,1,0.3333333333333333,2
22407,5794,Kits,2,2,1.0,0
22408,5794,Stuff Packs,6,4,0.6666666666666666,2
22409,5795,Expansion Packs,12,0,0.0,12
22410,5795,Game Packs,7,0,0.0,7
22411,5795,Kits,2,2,1.0,0
22412,5795,Stuff Packs,6,2,0.3333333333333333,4
22413,5796,Expansion Packs,16,1,0.0625,15
22414,5796,Game Packs,12,0,0.0,12
22415,5796,Kits,33,1,0.030303030303030304,32
22416,5796,Stuff Packs,20,0,0.0,20
22417,5797,Expansion Packs,9,0,0.0,9
22418,5797,Game Packs,4,0,0.0,4
22419,5797,Kits,5,0,0.0,5
22420,5797,Stuff Packs,9,4,0.4444444444444444,5
22421,5798,Expansion Packs,16,0,0.0,16
22422,5798,Game Packs,12,0,0.0,12
22423,5798,Kits,19,1,0.05263157894736842,18
22424,5798,Stuff Packs,20,0,0.0,20
22425,5799,Expansion Packs,14,0,0.0,14
22426,5799,Game Packs,7,0,0.0,7
22427,5799,Kits,6,2,0.3333333333333333,4
22428,5799,Stuff Packs,9,3,0.3333333333333333,6
22429,5800,Expansion Packs,14,0,0.0,14
22430,5800,Game Packs,12,1,0.08333333333333333,11
22431,5800,Kits,13,1,0.07692307692307693,12
22432,5800,Stuff Packs,14,0,0.0,14
22433,5801,Expansion Packs,16,1,0.0625,15
22434,5801,Game Packs,6,0,0.0,6
22435,5801,Kits,6,0,0.0,6
22436,5801,Stuff Packs,12,0,0.0,12
22437,5802,Expansion Packs,10,0,0.0,10
22438,5802,Game Packs,8,0,0.0,8
22439,5802,Kits,8,0,0.0,8
22440,5802,Stuff Packs,15,0,0.0,15
22441,5803,Expansion Packs,12,0,0.0,12
22442,5803,Game Packs,7,0,0.0,7
22443,5803,Kits,2,1,0.5,1
22444,5803,Stuff Packs,6,0,0.0,6
22445,5804,Expansion Packs,6,0,0.0,6
22446,5804,Game Packs,1,0,0.0,1
22447,5804,Kits,3,2,0.6666666666666666,1
22448,5804,Stuff Packs,3,1,0.3333333333333333,2
22449,5805,Expansion Packs,3,0,0.0,3
22450,5805,Game Packs,3,0,0.0,3
22451,5805,Stuff Packs,4,1,0.25,3
22452,5806,Expansion Packs,7,0,0.0,7
22453,5806,Game Packs,3,0,0.0,3
22454,5806,Kits,1,1,1.0,0
22455,5806,Stuff Packs,5,2,0.4,3
22456,5807,Expansion Packs,5,0,0.0,5
22457,5807,Game Packs,5,2,0.4,3
22458,5807,Kits,1,1,1.0,0
22459,5807,Stuff Packs,3,0,0.0,3
22460,5808,Expansion Packs,16,0,0.0,16
22461,5808,Game Packs,11,0,0.0,11
22462,5808,Kits,32,1,0.03125,31
22463,5808,Stuff Packs,20,0,0.0,20
22464,5809,Expansion Packs,9,1,0.1111111111111111,8
22465,5809,Game Packs,8,0,0.0,8
22466,5809,Kits,2,2,1.0,0
22467,5809,Stuff Packs,12,1,0.08333333333333333,11
22468,5810,Expansion Packs,6,0,0.0,6
22469,5810,Game Packs,2,0,0.0,2
22470,5810,Kits,1,1,1.0,0
22471,5810,Stuff Packs,3,3,1.0,0
22472,5811,Expansion Packs,7,0,0.0,7
22473,5811,Game Packs,6,0,0.0,6
22474,5811,Kits,3,0,0.0,3
22475,5811,Stuff Packs,8,0,0.0,8
22476,5812,Expansion Packs,6,0,0.0,6
22477,5812,Game Packs,2,0,0.0,2
22478,5812,Kits,3,1,0.3333333333333333,2
22479,5812,Stuff Packs,3,2,0.6666666666666666,1
22480,5813,Expansion Packs,16,0,0.0,16
22481,5813,Game Packs,12,0,0.0,12
22482,5813,Kits,33,0,0.0,33
22483,5813,Stuff Packs,20,0,0.0,20
22484,5814,Expansion Packs,16,0,0.0,16
22485,5814,Game Packs,12,0,0.0,12
22486,5814,Kits,33,1,0.030303030303030304,32
22487,5814,Stuff Packs,20,0,0.0,20
22488,5815,Expansion Packs,15,0,0.0,15
22489,5815,Game Packs,11,0,0.0,11
22490,5815,Kits,26,1,0.038461538461538464,25
22491,5815,Stuff Packs,20,0,0.0,20
22492,5816,Expansion Packs,8,0,0.0,8
22493,5816,Game Packs,3,0,0.0,3
22494,5816,Kits,2,2,1.0,0
22495,5816,Stuff Packs,6,3,0.5,3
22496,5817,Expansion Packs,11,0,0.0,11
22497,5817,Game Packs,8,0,0.0,8
22498,5817,Stuff Packs,7,2,0.2857142857142857,5
22499,5818,Expansion Packs,16,0,0.0,16
22500,5818,Game Packs,11,0,0.0,11
22501,5818,Kits,19,2,0.10526315789473684,17
22502,5818,Stuff Packs,19,0,0.0,19
22503,5819,Expansion Packs,15,0,0.0,15
22504,5819,Game Packs,12,0,0.0,12
22505,5819,Kits,21,2,0.09523809523809523,19
22506,5819,Stuff Packs,20,0,0.0,20
22507,5820,Expansion Packs,16,0,0.0,16
22508,5820,Game Packs,11,0,0.0,11
22509,5820,Kits,30,2,0.06666666666666667,28
22510,5820,Stuff Packs,19,2,0.10526315789473684,17
22511,5821,Expansion Packs,1,0,0.0,1
22512,5821,Game Packs,1,0,0.0,1
22513,5821,Stuff Packs,1,1,1.0,0
22514,5822,Expansion Packs,16,0,0.0,16
22515,5822,Game Packs,12,0,0.0,12
22516,5822,Kits,31,0,0.0,31
22517,5822,Stuff Packs,20,0,0.0,20
22518,5823,Expansion Packs,16,0,0.0,16
22519,5823,Game Packs,12,0,0.0,12
22520,5823,Kits,10,1,0.1,9
22521,5823,Stuff Packs,19,0,0.0,19
22522,5824,Expansion Packs,16,0,0.0,16
22523,5824,Game Packs,12,0,0.0,12
22524,5824,Kits,33,0,0.0,33
22525,5824,Stuff Packs,20,0,0.0,20
22526,5825,Expansion Packs,16,0,0.0,16
22527,5825,Game Packs,12,0,0.0,12
22528,5825,Kits,20,0,0.0,20
22529,5825,Stuff Packs,20,0,0.0,20
22530,5826,Expansion Packs,6,0,0.0,6
22531,5826,Game Packs,1,0,0.0,1
22532,5826,Kits,1,0,0.0,1
22533,5826,Stuff Packs,4,3,0.75,1
22534,5827,Expansion Packs,16,0,0.0,16
22535,5827,Game Packs,12,0,0.0,12
22536,5827,Kits,33,0,0.0,33
22537,5827,Stuff Packs,20,0,0.0,20
22538,5828,Expansion Packs,16,0,0.0,16
22539,5828,Game Packs,12,0,0.0,12
22540,5828,Kits,5,1,0.2,4
22541,5828,Stuff Packs,8,1,0.125,7
22542,5829,Expansion Packs,7,0,0.0,7
22543,5829,Game Packs,3,0,0.0,3
22544,5829,Kits,1,0,0.0,1
22545,5829,Stuff Packs,6,1,0.16666666666666666,5
22546,5830,Expansion Packs,13,4,0.3076923076923077,9
22547,5830,Game Packs,6,0,0.0,6
22548,5830,Kits,2,2,1.0,0
22549,5830,Stuff Packs,17,0,0.0,17
22550,5831,Expansion Packs,16,0,0.0,16
22551,5831,Game Packs,12,0,0.0,12
22552,5831,Kits,33,0,0.0,33
22553,5831,Stuff Packs,20,0,0.0,20
22554,5832,Expansion Packs,9,0,0.0,9
22555,5832,Game Packs,7,1,0.14285714285714285,6
22556,5832,Kits,15,3,0.2,12
22557,5832,Stuff Packs,11,3,0.2727272727272727,8
22558,5833,Expansion Packs,16,0,0.0,16
22559,5833,Game Packs,12,0,0.0,12
22560,5833,Kits,33,1,0.030303030303030304,32
22561,5833,Stuff Packs,20,1,0.05,19
22562,5834,Expansion Packs,16,0,0.0,16
22563,5834,Game Packs,12,0,0.0,12
22564,5834,Kits,26,0,0.0,26
22565,5834,Stuff Packs,20,0,0.0,20
22566,5835,Expansion Packs,12,0,0.0,12
22567,5835,Game Packs,10,0,0.0,10
22568,5835,Kits,4,0,0.0,4
22569,5835,Stuff Packs,17,0,0.0,17
22570,5836,Expansion Packs,16,0,0.0,16
22571,5836,Game Packs,12,0,0.0,12
22572,5836,Kits,13,0,0.0,13
22573,5836,Stuff Packs,20,0,0.0,20
22574,5837,Expansion Packs,14,0,0.0,14
22575,5837,Game Packs,12,0,0.0,12
22576,5837,Kits,4,1,0.25,3
22577,5837,Stuff Packs,10,2,0.2,8
22578,5838,Expansion Packs,15,0,0.0,15
22579,5838,Game Packs,11,0,0.0,11
22580,5838,Kits,12,1,0.08333333333333333,11
22581,5838,Stuff Packs,19,0,0.0,19
22582,5839,Expansion Packs,3,0,0.0,3
22583,5839,Game Packs,2,0,0.0,2
22584,5839,Kits,1,1,1.0,0
22585,5839,Stuff Packs,4,3,0.75,1
22586,5840,Expansion Packs,16,0,0.0,16
22587,5840,Game Packs,12,1,0.08333333333333333,11
22588,5840,Kits,26,2,0.07692307692307693,24
22589,5840,Stuff Packs,20,0,0.0,20
22590,5841,Expansion Packs,9,0,0.0,9
22591,5841,Game Packs,3,0,0.0,3
22592,5841,Kits,4,2,0.5,2
22593,5841,Stuff Packs,5,3,0.6,2
22594,5842,Expansion Packs,16,0,0.0,16
22595,5842,Game Packs,10,0,0.0,10
22596,5842,Kits,20,0,0.0,20
22597,5842,Stuff Packs,16,3,0.1875,13
22598,5843,Expansion Packs,6,0,0.0,6
22599,5843,Game Packs,3,0,0.0,3
22600,5843,Kits,1,1,1.0,0
22601,5843,Stuff Packs,5,3,0.6,2
22602,5844,Expansion Packs,7,0,0.0,7
22603,5844,Game Packs,5,1,0.2,4
22604,5844,Kits,1,1,1.0,0
22605,5844,Stuff Packs,10,2,0.2,8
22606,5845,Expansion Packs,16,0,0.0,16
22607,5845,Game Packs,12,0,0.0,12
22608,5845,Kits,33,0,0.0,33
22609,5845,Stuff Packs,20,0,0.0,20
22610,5846,Expansion Packs,16,0,0.0,16
22611,5846,Game Packs,12,0,0.0,12
22612,5846,Kits,28,0,0.0,28
22613,5846,Stuff Packs,20,0,0.0,20
22614,5847,Expansion Packs,16,0,0.0,16
22615,5847,Game Packs,11,0,0.0,11
22616,5847,Kits,24,1,0.041666666666666664,23
22617,5847,Stuff Packs,20,0,0.0,20
22618,5848,Expansion Packs,16,0,0.0,16
22619,5848,Game Packs,8,0,0.0,8
22620,5848,Kits,10,1,0.1,9
22621,5848,Stuff Packs,12,4,0.3333333333333333,8
22622,5849,Expansion Packs,15,0,0.0,15
22623,5849,Game Packs,12,0,0.0,12
22624,5849,Kits,32,1,0.03125,31
22625,5849,Stuff Packs,20,1,0.05,19
22626,5850,Expansion Packs,13,0,0.0,13
22627,5850,Game Packs,10,0,0.0,10
22628,5850,Kits,1,1,1.0,0
22629,5850,Stuff Packs,13,0,0.0,13
22630,5851,Expansion Packs,16,0,0.0,16
22631,5851,Game Packs,12,0,0.0,12
22632,5851,Kits,20,1,0.05,19
22633,5851,Stuff Packs,19,0,0.0,19
22634,5852,Expansion Packs,16,0,0.0,16
22635,5852,Game Packs,12,0,0.0,12
22636,5852,Kits,24,0,0.0,24
22637,5852,Stuff Packs,20,0,0.0,20
22638,5853,Expansion Packs,16,0,0.0,16
22639,5853,Game Packs,12,0,0.0,12
22640,5853,Kits,26,0,0.0,26
22641,5853,Stuff Packs,20,0,0.0,20
22642,5854,Expansion Packs,16,0,0.0,16
22643,5854,Game Packs,12,0,0.0,12
22644,5854,Kits,27,0,0.0,27
22645,5854,Stuff Packs,20,0,0.0,20
22646,5855,Expansion Packs,14,0,0.0,14
22647,5855,Game Packs,11,0,0.0,11
22648,5855,Kits,21,2,0.09523809523809523,19
22649,5855,Stuff Packs,17,0,0.0,17
22650,5856,Expansion Packs,14,0,0.0,14
22651,5856,Game Packs,11,0,0.0,11
22652,5856,Kits,6,2,0.3333333333333333,4
22653,5856,Stuff Packs,13,0,0.0,13
22654,5857,Expansion Packs,6,0,0.0,6
22655,5857,Game Packs,1,0,0.0,1
22656,5857,Stuff Packs,1,1,1.0,0
22657,5858,Expansion Packs,15,0,0.0,15
22658,5858,Game Packs,11,0,0.0,11
22659,5858,Kits,1,1,1.0,0
22660,5858,Stuff Packs,12,0,0.0,12
22661,5859,Expansion Packs,15,0,0.0,15
22662,5859,Game Packs,12,0,0.0,12
22663,5859,Kits,17,1,0.058823529411764705,16
22664,5859,Stuff Packs,20,0,0.0,20
22665,5860,Expansion Packs,16,0,0.0,16
22666,5860,Game Packs,7,0,0.0,7
22667,5860,Kits,22,0,0.0,22
22668,5860,Stuff Packs,9,1,0.1111111111111111,8
22669,5861,Expansion Packs,12,0,0.0,12
22670,5861,Game Packs,4,0,0.0,4
22671,5861,Kits,6,1,0.16666666666666666,5
22672,5861,Stuff Packs,12,3,0.25,9
22673,5862,Expansion Packs,11,0,0.0,11
22674,5862,Game Packs,8,0,0.0,8
22675,5862,Kits,6,1,0.16666666666666666,5
22676,5862,Stuff Packs,6,0,0.0,6
22677,5863,Expansion Packs,16,0,0.0,16
22678,5863,Game Packs,12,0,0.0,12
22679,5863,Kits,33,0,0.0,33
22680,5863,Stuff Packs,20,1,0.05,19
22681,5864,Expansion Packs,15,0,0.0,15
22682,5864,Game Packs,11,0,0.0,11
22683,5864,Kits,14,1,0.07142857142857142,13
22684,5864,Stuff Packs,20,0,0.0,20
22685,5865,Expansion Packs,12,0,0.0,12
22686,5865,Game Packs,7,0,0.0,7
22687,5865,Stuff Packs,5,0,0.0,5
22688,5866,Expansion Packs,6,0,0.0,6
22689,5866,Game Packs,4,0,0.0,4
22690,5866,Kits,2,1,0.5,1
22691,5866,Stuff Packs,6,2,0.3333333333333333,4
22692,5867,Expansion Packs,2,0,0.0,2
22693,5867,Game Packs,3,0,0.0,3
22694,5867,Stuff Packs,5,2,0.4,3
22695,5868,Expansion Packs,14,0,0.0,14
22696,5868,Game Packs,6,0,0.0,6
22697,5868,Kits,13,1,0.07692307692307693,12
22698,5868,Stuff Packs,11,3,0.2727272727272727,8
22699,5869,Expansion Packs,15,0,0.0,15
22700,5869,Game Packs,9,0,0.0,9
22701,5869,Kits,16,4,0.25,12
22702,5869,Stuff Packs,14,4,0.2857142857142857,10
22703,5870,Expansion Packs,5,0,0.0,5
22704,5870,Game Packs,4,0,0.0,4
22705,5870,Kits,2,2,1.0,0
22706,5870,Stuff Packs,7,2,0.2857142857142857,5
22707,5871,Expansion Packs,2,0,0.0,2
22708,5871,Game Packs,1,1,1.0,0
22709,5871,Kits,3,3,1.0,0
22710,5871,Stuff Packs,3,3,1.0,0
22711,5872,Expansion Packs,16,0,0.0,16
22712,5872,Game Packs,12,0,0.0,12
22713,5872,Kits,33,0,0.0,33
22714,5872,Stuff Packs,20,0,0.0,20
22715,5873,Expansion Packs,16,0,0.0,16
22716,5873,Game Packs,11,0,0.0,11
22717,5873,Kits,32,1,0.03125,31
22718,5873,Stuff Packs,20,0,0.0,20
22719,5874,Expansion Packs,16,0,0.0,16
22720,5874,Game Packs,12,0,0.0,12
22721,5874,Kits,33,0,0.0,33
22722,5874,Stuff Packs,20,0,0.0,20
22723,5875,Expansion Packs,16,0,0.0,16
22724,5875,Game Packs,12,0,0.0,12
22725,5875,Kits,31,1,0.03225806451612903,30
22726,5875,Stuff Packs,20,0,0.0,20
22727,5876,Expansion Packs,11,0,0.0,11
22728,5876,Game Packs,3,0,0.0,3
22729,5876,Kits,3,0,0.0,3
22730,5876,Stuff Packs,6,1,0.16666666666666666,5
22731,5877,Expansion Packs,16,0,0.0,16
22732,5877,Game Packs,12,0,0.0,12
22733,5877,Kits,33,0,0.0,33
22734,5877,Stuff Packs,20,0,0.0,20
22735,5878,Expansion Packs,13,0,0.0,13
22736,5878,Game Packs,7,0,0.0,7
22737,5878,Kits,12,0,0.0,12
22738,5878,Stuff Packs,12,2,0.16666666666666666,10
22739,5879,Expansion Packs,15,0,0.0,15
22740,5879,Game Packs,11,0,0.0,11
22741,5879,Kits,16,1,0.0625,15
22742,5879,Stuff Packs,19,0,0.0,19
22743,5880,Expansion Packs,14,0,0.0,14
22744,5880,Game Packs,11,0,0.0,11
22745,5880,Kits,25,0,0.0,25
22746,5880,Stuff Packs,17,0,0.0,17
22747,5881,Expansion Packs,16,0,0.0,16
22748,5881,Game Packs,12,1,0.08333333333333333,11
22749,5881,Kits,33,6,0.18181818181818182,27
22750,5881,Stuff Packs,20,6,0.3,14
22751,5882,Expansion Packs,12,0,0.0,12
22752,5882,Game Packs,4,1,0.25,3
22753,5882,Kits,10,1,0.1,9
22754,5882,Stuff Packs,12,2,0.16666666666666666,10
22755,5883,Expansion Packs,15,0,0.0,15
22756,5883,Game Packs,7,0,0.0,7
22757,5883,Kits,2,2,1.0,0
22758,5883,Stuff Packs,18,0,0.0,18
22759,5884,Expansion Packs,6,0,0.0,6
22760,5884,Game Packs,2,1,0.5,1
22761,5884,Kits,1,1,1.0,0
22762,5884,Stuff Packs,4,2,0.5,2
22763,5885,Expansion Packs,3,0,0.0,3
22764,5885,Game Packs,1,0,0.0,1
22765,5885,Kits,2,2,1.0,0
22766,5885,Stuff Packs,4,4,1.0,0
22767,5886,Expansion Packs,5,0,0.0,5
22768,5886,Game Packs,3,0,0.0,3
22769,5886,Kits,2,2,1.0,0
22770,5886,Stuff Packs,6,0,0.0,6
22771,5887,Expansion Packs,11,0,0.0,11
22772,5887,Game Packs,7,0,0.0,7
22773,5887,Kits,8,0,0.0,8
22774,5887,Stuff Packs,14,1,0.07142857142857142,13
22775,5888,Expansion Packs,9,0,0.0,9
22776,5888,Game Packs,4,0,0.0,4
22777,5888,Stuff Packs,3,0,0.0,3
22778,5889,Expansion Packs,16,0,0.0,16
22779,5889,Game Packs,12,0,0.0,12
22780,5889,Kits,33,0,0.0,33
22781,5889,Stuff Packs,20,0,0.0,20
22782,5890,Expansion Packs,16,0,0.0,16
22783,5890,Game Packs,11,0,0.0,11
22784,5890,Kits,20,1,0.05,19
22785,5890,Stuff Packs,20,0,0.0,20
22786,5891,Expansion Packs,3,0,0.0,3
22787,5891,Game Packs,2,1,0.5,1
22788,5891,Kits,3,1,0.3333333333333333,2
22789,5891,Stuff Packs,6,4,0.6666666666666666,2
22790,5892,Expansion Packs,4,0,0.0,4
22791,5892,Game Packs,3,0,0.0,3
22792,5892,Stuff Packs,4,1,0.25,3
22793,5893,Expansion Packs,16,0,0.0,16
22794,5893,Game Packs,12,1,0.08333333333333333,11
22795,5893,Kits,33,0,0.0,33
22796,5893,Stuff Packs,20,0,0.0,20
22797,5894,Expansion Packs,11,0,0.0,11
22798,5894,Game Packs,6,0,0.0,6
22799,5894,Kits,6,1,0.16666666666666666,5
22800,5894,Stuff Packs,6,0,0.0,6
22801,5895,Expansion Packs,16,0,0.0,16
22802,5895,Game Packs,11,0,0.0,11
22803,5895,Kits,30,0,0.0,30
22804,5895,Stuff Packs,20,0,0.0,20
22805,5896,Expansion Packs,11,0,0.0,11
22806,5896,Game Packs,7,0,0.0,7
22807,5896,Kits,2,2,1.0,0
22808,5896,Stuff Packs,9,0,0.0,9
22809,5897,Expansion Packs,12,0,0.0,12
22810,5897,Game Packs,9,0,0.0,9
22811,5897,Kits,2,2,1.0,0
22812,5897,Stuff Packs,13,0,0.0,13
22813,5898,Expansion Packs,9,0,0.0,9
22814,5898,Game Packs,7,0,0.0,7
22815,5898,Kits,4,2,0.5,2
22816,5898,Stuff Packs,6,1,0.16666666666666666,5
22817,5899,Expansion Packs,9,0,0.0,9
22818,5899,Game Packs,4,0,0.0,4
22819,5899,Kits,11,2,0.18181818181818182,9
22820,5899,Stuff Packs,9,2,0.2222222222222222,7
22821,5900,Expansion Packs,3,0,0.0,3
22822,5900,Game Packs,1,0,0.0,1
22823,5901,Expansion Packs,15,0,0.0,15
22824,5901,Game Packs,10,0,0.0,10
22825,5901,Kits,2,0,0.0,2
22826,5901,Stuff Packs,8,2,0.25,6
22827,5902,Expansion Packs,4,0,0.0,4
22828,5902,Game Packs,2,1,0.5,1
22829,5902,Kits,1,1,1.0,0
22830,5902,Stuff Packs,6,3,0.5,3
22831,5903,Expansion Packs,12,0,0.0,12
22832,5903,Game Packs,10,0,0.0,10
22833,5903,Kits,13,1,0.07692307692307693,12
22834,5903,Stuff Packs,13,1,0.07692307692307693,12
22835,5904,Expansion Packs,15,0,0.0,15
22836,5904,Game Packs,12,0,0.0,12
22837,5904,Kits,29,0,0.0,29
22838,5904,Stuff Packs,20,0,0.0,20
22839,5905,Expansion Packs,16,0,0.0,16
22840,5905,Game Packs,9,0,0.0,9
22841,5905,Kits,3,1,0.3333333333333333,2
22842,5905,Stuff Packs,18,2,0.1111111111111111,16
22843,5906,Expansion Packs,15,0,0.0,15
22844,5906,Game Packs,8,0,0.0,8
22845,5906,Kits,11,1,0.09090909090909091,10
22846,5906,Stuff Packs,6,1,0.16666666666666666,5
22847,5907,Expansion Packs,6,0,0.0,6
22848,5907,Game Packs,3,0,0.0,3
22849,5907,Kits,2,0,0.0,2
22850,5907,Stuff Packs,5,3,0.6,2
22851,5908,Kits,1,0,0.0,1
22852,5909,Expansion Packs,8,0,0.0,8
22853,5909,Game Packs,5,0,0.0,5
22854,5909,Kits,7,0,0.0,7
22855,5909,Stuff Packs,10,0,0.0,10
22856,5910,Expansion Packs,12,0,0.0,12
22857,5910,Game Packs,3,0,0.0,3
22858,5910,Stuff Packs,7,0,0.0,7
22859,5911,Expansion Packs,2,0,0.0,2
22860,5911,Game Packs,1,0,0.0,1
22861,5911,Kits,2,2,1.0,0
22862,5911,Stuff Packs,3,1,0.3333333333333333,2
22863,5912,Expansion Packs,16,0,0.0,16
22864,5912,Game Packs,12,0,0.0,12
22865,5912,Kits,2,0,0.0,2
22866,5912,Stuff Packs,17,0,0.0,17
22867,5913,Expansion Packs,16,0,0.0,16
22868,5913,Game Packs,12,0,0.0,12
22869,5913,Kits,25,0,0.0,25
22870,5913,Stuff Packs,20,1,0.05,19
22871,5914,Expansion Packs,5,0,0.0,5
22872,5914,Game Packs,5,0,0.0,5
22873,5914,Kits,4,3,0.75,1
22874,5914,Stuff Packs,10,4,0.4,6
22875,5915,Expansion Packs,4,0,0.0,4
22876,5915,Game Packs,3,0,0.0,3
22877,5915,Kits,1,1,1.0,0
22878,5915,Stuff Packs,3,0,0.0,3
22879,5916,Expansion Packs,16,0,0.0,16
22880,5916,Game Packs,9,0,0.0,9
22881,5916,Kits,1,0,0.0,1
22882,5916,Stuff Packs,7,2,0.2857142857142857,5
22883,5917,Expansion Packs,7,0,0.0,7
22884,5917,Game Packs,2,0,0.0,2
22885,5917,Kits,3,0,0.0,3
22886,5917,Stuff Packs,13,2,0.15384615384615385,11
22887,5918,Expansion Packs,16,0,0.0,16
22888,5918,Game Packs,12,0,0.0,12
22889,5918,Kits,33,1,0.030303030303030304,32
22890,5918,Stuff Packs,20,0,0.0,20
22891,5919,Expansion Packs,16,0,0.0,16
22892,5919,Game Packs,11,0,0.0,11
22893,5919,Kits,22,0,0.0,22
22894,5919,Stuff Packs,20,0,0.0,20
22895,5920,Expansion Packs,16,0,0.0,16
22896,5920,Game Packs,12,0,0.0,12
22897,5920,Kits,33,0,0.0,33
22898,5920,Stuff Packs,20,0,0.0,20
22899,5921,Expansion Packs,13,7,0.5384615384615384,6
22900,5921,Game Packs,10,5,0.5,5
22901,5921,Kits,2,1,0.5,1
22902,5921,Stuff Packs,10,9,0.9,1
22903,5922,Expansion Packs,1,0,0.0,1
22904,5922,Game Packs,1,0,0.0,1
22905,5922,Stuff Packs,2,1,0.5,1
22906,5923,Expansion Packs,16,0,0.0,16
22907,5923,Game Packs,12,0,0.0,12
22908,5923,Kits,31,0,0.0,31
22909,5923,Stuff Packs,20,0,0.0,20
22910,5924,Expansion Packs,4,0,0.0,4
22911,5924,Game Packs,6,0,0.0,6
22912,5924,Kits,2,1,0.5,1
22913,5924,Stuff Packs,7,2,0.2857142857142857,5
22914,5925,Expansion Packs,16,0,0.0,16
22915,5925,Game Packs,12,0,0.0,12
22916,5925,Kits,32,1,0.03125,31
22917,5925,Stuff Packs,20,0,0.0,20
22918,5926,Expansion Packs,16,0,0.0,16
22919,5926,Game Packs,12,0,0.0,12
22920,5926,Kits,33,0,0.0,33
22921,5926,Stuff Packs,20,0,0.0,20
22922,5927,Expansion Packs,12,0,0.0,12
22923,5927,Game Packs,7,0,0.0,7
22924,5927,Kits,5,3,0.6,2
22925,5927,Stuff Packs,11,4,0.36363636363636365,7
22926,5928,Expansion Packs,8,0,0.0,8
22927,5928,Game Packs,8,0,0.0,8
22928,5928,Kits,4,2,0.5,2
22929,5928,Stuff Packs,11,1,0.09090909090909091,10
22930,5929,Expansion Packs,16,0,0.0,16
22931,5929,Game Packs,12,0,0.0,12
22932,5929,Kits,33,1,0.030303030303030304,32
22933,5929,Stuff Packs,20,0,0.0,20
22934,5930,Expansion Packs,12,0,0.0,12
22935,5930,Game Packs,8,0,0.0,8
22936,5930,Kits,4,1,0.25,3
22937,5930,Stuff Packs,7,1,0.14285714285714285,6
22938,5931,Expansion Packs,8,0,0.0,8
22939,5931,Game Packs,3,0,0.0,3
22940,5931,Stuff Packs,10,2,0.2,8
22941,5932,Expansion Packs,16,0,0.0,16
22942,5932,Game Packs,12,0,0.0,12
22943,5932,Kits,33,1,0.030303030303030304,32
22944,5932,Stuff Packs,20,3,0.15,17
22945,5933,Kits,2,2,1.0,0
22946,5933,Stuff Packs,3,3,1.0,0
22947,5934,Expansion Packs,16,0,0.0,16
22948,5934,Game Packs,12,0,0.0,12
22949,5934,Kits,33,0,0.0,33
22950,5934,Stuff Packs,20,0,0.0,20
22951,5935,Expansion Packs,6,0,0.0,6
22952,5935,Game Packs,4,1,0.25,3
22953,5935,Kits,2,1,0.5,1
22954,5935,Stuff Packs,5,2,0.4,3
22955,5936,Expansion Packs,14,0,0.0,14
22956,5936,Game Packs,8,1,0.125,7
22957,5936,Kits,8,2,0.25,6
22958,5936,Stuff Packs,15,4,0.26666666666666666,11
22959,5937,Expansion Packs,10,0,0.0,10
22960,5937,Game Packs,4,0,0.0,4
22961,5937,Kits,5,1,0.2,4
22962,5937,Stuff Packs,4,2,0.5,2
22963,5938,Expansion Packs,2,0,0.0,2
22964,5938,Game Packs,4,0,0.0,4
22965,5938,Kits,2,0,0.0,2
22966,5938,Stuff Packs,1,0,0.0,1
22967,5939,Expansion Packs,8,0,0.0,8
22968,5939,Game Packs,3,0,0.0,3
22969,5939,Kits,4,0,0.0,4
22970,5939,Stuff Packs,3,0,0.0,3
22971,5940,Expansion Packs,5,0,0.0,5
22972,5940,Game Packs,4,0,0.0,4
22973,5940,Kits,3,2,0.6666666666666666,1
22974,5940,Stuff Packs,6,2,0.3333333333333333,4
22975,5941,Expansion Packs,9,0,0.0,9
22976,5941,Game Packs,6,0,0.0,6
22977,5941,Stuff Packs,3,1,0.3333333333333333,2
22978,5942,Expansion Packs,8,0,0.0,8
22979,5942,Kits,1,1,1.0,0
22980,5942,Stuff Packs,1,0,0.0,1
22981,5943,Expansion Packs,9,0,0.0,9
22982,5943,Game Packs,6,0,0.0,6
22983,5943,Kits,2,2,1.0,0
22984,5943,Stuff Packs,10,2,0.2,8
22985,5944,Expansion Packs,7,0,0.0,7
22986,5944,Game Packs,4,0,0.0,4
22987,5944,Kits,2,2,1.0,0
22988,5944,Stuff Packs,11,0,0.0,11
22989,5945,Expansion Packs,10,0,0.0,10
22990,5945,Game Packs,2,0,0.0,2
22991,5945,Kits,3,1,0.3333333333333333,2
22992,5945,Stuff Packs,7,3,0.42857142857142855,4
22993,5946,Expansion Packs,14,0,0.0,14
22994,5946,Game Packs,9,0,0.0,9
22995,5946,Kits,8,0,0.0,8
22996,5946,Stuff Packs,9,0,0.0,9
22997,5947,Expansion Packs,16,1,0.0625,15
22998,5947,Game Packs,12,0,0.0,12
22999,5947,Kits,33,0,0.0,33
23000,5947,Stuff Packs,20,0,0.0,20
23001,5948,Expansion Packs,16,0,0.0,16
23002,5948,Game Packs,12,0,0.0,12
23003,5948,Kits,33,1,0.030303030303030304,32
23004,5948,Stuff Packs,20,0,0.0,20
23005,5949,Expansion Packs,9,0,0.0,9
23006,5949,Game Packs,7,0,0.0,7
23007,5949,Kits,7,2,0.2857142857142857,5
23008,5949,Stuff Packs,13,4,0.3076923076923077,9
23009,5950,Expansion Packs,16,13,0.8125,3
23010,5950,Game Packs,12,12,1.0,0
23011,5950,Kits,33,33,1.0,0
23012,5950,Stuff Packs,20,20,1.0,0
23013,5951,Expansion Packs,10,0,0.0,10
23014,5951,Game Packs,4,0,0.0,4
23015,5951,Kits,1,1,1.0,0
23016,5951,Stuff Packs,3,0,0.0,3
23017,5952,Expansion Packs,9,0,0.0,9
23018,5952,Game Packs,5,0,0.0,5
23019,5952,Kits,2,2,1.0,0
23020,5952,Stuff Packs,13,2,0.15384615384615385,11
23021,5953,Expansion Packs,16,0,0.0,16
23022,5953,Game Packs,11,0,0.0,11
23023,5953,Kits,10,1,0.1,9
23024,5953,Stuff Packs,15,5,0.3333333333333333,10
23025,5954,Expansion Packs,16,0,0.0,16
23026,5954,Game Packs,10,0,0.0,10
23027,5954,Kits,7,2,0.2857142857142857,5
23028,5954,Stuff Packs,12,2,0.16666666666666666,10
23029,5955,Expansion Packs,5,0,0.0,5
23030,5955,Game Packs,2,0,0.0,2
23031,5955,Kits,3,1,0.3333333333333333,2
23032,5955,Stuff Packs,7,3,0.42857142857142855,4
23033,5956,Expansion Packs,15,0,0.0,15
23034,5956,Game Packs,8,0,0.0,8
23035,5956,Kits,7,1,0.14285714285714285,6
23036,5956,Stuff Packs,8,3,0.375,5
23037,5957,Expansion Packs,16,0,0.0,16
23038,5957,Game Packs,12,0,0.0,12
23039,5957,Kits,33,0,0.0,33
23040,5957,Stuff Packs,20,0,0.0,20
23041,5958,Expansion Packs,16,0,0.0,16
23042,5958,Game Packs,11,0,0.0,11
23043,5958,Kits,5,3,0.6,2
23044,5958,Stuff Packs,17,2,0.11764705882352941,15
23045,5959,Expansion Packs,16,0,0.0,16
23046,5959,Game Packs,9,0,0.0,9
23047,5959,Kits,3,0,0.0,3
23048,5959,Stuff Packs,10,0,0.0,10
23049,5960,Expansion Packs,16,0,0.0,16
23050,5960,Game Packs,10,0,0.0,10
23051,5960,Kits,25,0,0.0,25
23052,5960,Stuff Packs,18,0,0.0,18
23053,5961,Expansion Packs,4,1,0.25,3
23054,5961,Game Packs,4,0,0.0,4
23055,5961,Kits,1,1,1.0,0
23056,5961,Stuff Packs,7,1,0.14285714285714285,6
23057,5962,Expansion Packs,3,0,0.0,3
23058,5962,Game Packs,3,1,0.3333333333333333,2
23059,5962,Kits,7,2,0.2857142857142857,5
23060,5962,Stuff Packs,4,1,0.25,3
23061,5963,Expansion Packs,5,0,0.0,5
23062,5963,Game Packs,5,0,0.0,5
23063,5963,Kits,6,0,0.0,6
23064,5963,Stuff Packs,3,0,0.0,3
23065,5964,Expansion Packs,15,0,0.0,15
23066,5964,Game Packs,12,0,0.0,12
23067,5964,Kits,15,1,0.06666666666666667,14
23068,5964,Stuff Packs,20,0,0.0,20
23069,5965,Expansion Packs,16,0,0.0,16
23070,5965,Game Packs,12,0,0.0,12
23071,5965,Kits,23,0,0.0,23
23072,5965,Stuff Packs,19,0,0.0,19
23073,5966,Expansion Packs,6,0,0.0,6
23074,5966,Game Packs,2,0,0.0,2
23075,5966,Kits,3,1,0.3333333333333333,2
23076,5966,Stuff Packs,5,2,0.4,3
23077,5967,Expansion Packs,7,0,0.0,7
23078,5967,Game Packs,3,1,0.3333333333333333,2
23079,5967,Kits,1,1,1.0,0
23080,5967,Stuff Packs,6,4,0.6666666666666666,2
23081,5968,Expansion Packs,15,0,0.0,15
23082,5968,Game Packs,11,0,0.0,11
23083,5968,Kits,14,1,0.07142857142857142,13
23084,5968,Stuff Packs,19,0,0.0,19
23085,5969,Expansion Packs,15,0,0.0,15
23086,5969,Game Packs,10,0,0.0,10
23087,5969,Kits,12,1,0.08333333333333333,11
23088,5969,Stuff Packs,11,3,0.2727272727272727,8
23089,5970,Expansion Packs,16,0,0.0,16
23090,5970,Game Packs,12,0,0.0,12
23091,5970,Kits,20,2,0.1,18
23092,5970,Stuff Packs,20,0,0.0,20
23093,5971,Expansion Packs,12,0,0.0,12
23094,5971,Game Packs,7,0,0.0,7
23095,5971,Kits,2,2,1.0,0
23096,5971,Stuff Packs,10,1,0.1,9
23097,5972,Expansion Packs,7,0,0.0,7
23098,5972,Game Packs,4,0,0.0,4
23099,5972,Kits,2,2,1.0,0
23100,5972,Stuff Packs,4,2,0.5,2
23101,5973,Expansion Packs,14,0,0.0,14
23102,5973,Game Packs,12,0,0.0,12
23103,5973,Kits,19,0,0.0,19
23104,5973,Stuff Packs,19,0,0.0,19
23105,5974,Expansion Packs,12,0,0.0,12
23106,5974,Game Packs,8,0,0.0,8
23107,5974,Kits,3,0,0.0,3
23108,5974,Stuff Packs,13,0,0.0,13
23109,5975,Expansion Packs,16,0,0.0,16
23110,5975,Game Packs,12,0,0.0,12
23111,5975,Kits,15,1,0.06666666666666667,14
23112,5975,Stuff Packs,20,0,0.0,20
23113,5976,Expansion Packs,16,0,0.0,16
23114,5976,Game Packs,11,0,0.0,11
23115,5976,Kits,20,1,0.05,19
23116,5976,Stuff Packs,20,0,0.0,20
23117,5977,Expansion Packs,8,0,0.0,8
23118,5977,Game Packs,8,0,0.0,8
23119,5977,Kits,12,1,0.08333333333333333,11
23120,5977,Stuff Packs,13,2,0.15384615384615385,11
23121,5978,Expansion Packs,15,0,0.0,15
23122,5978,Game Packs,7,0,0.0,7
23123,5978,Kits,4,0,0.0,4
23124,5978,Stuff Packs,7,0,0.0,7
23125,5979,Expansion Packs,9,0,0.0,9
23126,5979,Game Packs,9,0,0.0,9
23127,5979,Stuff Packs,16,0,0.0,16
23128,5980,Expansion Packs,16,0,0.0,16
23129,5980,Game Packs,11,0,0.0,11
23130,5980,Kits,31,0,0.0,31
23131,5980,Stuff Packs,20,0,0.0,20
23132,5981,Expansion Packs,16,0,0.0,16
23133,5981,Game Packs,12,0,0.0,12
23134,5981,Kits,2,2,1.0,0
23135,5981,Stuff Packs,20,0,0.0,20
23136,5982,Expansion Packs,13,0,0.0,13
23137,5982,Game Packs,6,1,0.16666666666666666,5
23138,5982,Kits,1,0,0.0,1
23139,5982,Stuff Packs,6,2,0.3333333333333333,4
23140,5983,Expansion Packs,13,0,0.0,13
23141,5983,Game Packs,10,1,0.1,9
23142,5983,Kits,6,1,0.16666666666666666,5
23143,5983,Stuff Packs,13,4,0.3076923076923077,9
23144,5984,Expansion Packs,1,1,1.0,0
23145,5984,Game Packs,1,0,0.0,1
23146,5985,Expansion Packs,16,0,0.0,16
23147,5985,Game Packs,9,0,0.0,9
23148,5985,Kits,26,2,0.07692307692307693,24
23149,5985,Stuff Packs,19,0,0.0,19
23150,5986,Expansion Packs,15,0,0.0,15
23151,5986,Game Packs,9,0,0.0,9
23152,5986,Kits,2,0,0.0,2
23153,5986,Stuff Packs,11,0,0.0,11
23154,5987,Expansion Packs,9,0,0.0,9
23155,5987,Game Packs,9,0,0.0,9
23156,5987,Kits,1,1,1.0,0
23157,5987,Stuff Packs,14,0,0.0,14
23158,5988,Expansion Packs,16,0,0.0,16
23159,5988,Game Packs,12,0,0.0,12
23160,5988,Kits,33,0,0.0,33
23161,5988,Stuff Packs,20,0,0.0,20
23162,5989,Expansion Packs,10,0,0.0,10
23163,5989,Game Packs,2,1,0.5,1
23164,5989,Kits,5,4,0.8,1
23165,5989,Stuff Packs,7,1,0.14285714285714285,6
23166,5990,Expansion Packs,16,0,0.0,16
23167,5990,Game Packs,12,2,0.16666666666666666,10
23168,5990,Kits,33,2,0.06060606060606061,31
23169,5990,Stuff Packs,20,0,0.0,20
23170,5991,Expansion Packs,11,0,0.0,11
23171,5991,Game Packs,6,1,0.16666666666666666,5
23172,5991,Kits,2,1,0.5,1
23173,5991,Stuff Packs,12,3,0.25,9
23174,5992,Expansion Packs,7,0,0.0,7
23175,5992,Game Packs,8,0,0.0,8
23176,5992,Kits,2,1,0.5,1
23177,5992,Stuff Packs,7,0,0.0,7
23178,5993,Expansion Packs,15,0,0.0,15
23179,5993,Game Packs,11,0,0.0,11
23180,5993,Kits,1,0,0.0,1
23181,5993,Stuff Packs,19,0,0.0,19
23182,5994,Expansion Packs,16,0,0.0,16
23183,5994,Game Packs,11,0,0.0,11
23184,5994,Kits,5,0,0.0,5
23185,5994,Stuff Packs,6,0,0.0,6
23186,5995,Expansion Packs,13,0,0.0,13
23187,5995,Game Packs,8,0,0.0,8
23188,5995,Kits,5,1,0.2,4
23189,5995,Stuff Packs,10,0,0.0,10
23190,5996,Expansion Packs,16,0,0.0,16
23191,5996,Game Packs,12,0,0.0,12
23192,5996,Kits,31,1,0.03225806451612903,30
23193,5996,Stuff Packs,20,0,0.0,20
23194,5997,Expansion Packs,16,0,0.0,16
23195,5997,Game Packs,12,0,0.0,12
23196,5997,Kits,33,0,0.0,33
23197,5997,Stuff Packs,20,0,0.0,20
23198,5998,Expansion Packs,4,0,0.0,4
23199,5998,Game Packs,2,0,0.0,2
23200,5998,Kits,5,0,0.0,5
23201,5998,Stuff Packs,4,0,0.0,4
23202,5999,Expansion Packs,9,0,0.0,9
23203,5999,Game Packs,4,0,0.0,4
23204,5999,Kits,6,1,0.16666666666666666,5
23205,5999,Stuff Packs,8,4,0.5,4
23206,6000,Expansion Packs,16,0,0.0,16
23207,6000,Game Packs,11,0,0.0,11
23208,6000,Kits,33,0,0.0,33
23209,6000,Stuff Packs,20,0,0.0,20
23210,6001,Expansion Packs,16,5,0.3125,11
23211,6001,Game Packs,12,5,0.4166666666666667,7
23212,6001,Kits,33,4,0.12121212121212122,29
23213,6001,Stuff Packs,20,4,0.2,16
23214,6002,Expansion Packs,8,0,0.0,8
23215,6002,Game Packs,3,1,0.3333333333333333,2
23216,6002,Kits,2,2,1.0,0
23217,6002,Stuff Packs,3,1,0.3333333333333333,2
23218,6003,Expansion Packs,9,0,0.0,9
23219,6003,Game Packs,6,0,0.0,6
23220,6003,Kits,5,2,0.4,3
23221,6003,Stuff Packs,15,1,0.06666666666666667,14
23222,6004,Expansion Packs,16,0,0.0,16
23223,6004,Game Packs,11,0,0.0,11
23224,6004,Kits,13,2,0.15384615384615385,11
23225,6004,Stuff Packs,20,1,0.05,19
23226,6005,Expansion Packs,16,0,0.0,16
23227,6005,Game Packs,12,0,0.0,12
23228,6005,Kits,19,0,0.0,19
23229,6005,Stuff Packs,20,0,0.0,20
23230,6006,Expansion Packs,8,0,0.0,8
23231,6006,Game Packs,7,0,0.0,7
23232,6006,Stuff Packs,7,0,0.0,7
23233,6007,Expansion Packs,13,0,0.0,13
23234,6007,Game Packs,9,0,0.0,9
23235,6007,Kits,3,1,0.3333333333333333,2
23236,6007,Stuff Packs,16,0,0.0,16
23237,6008,Expansion Packs,16,0,0.0,16
23238,6008,Game Packs,12,0,0.0,12
23239,6008,Kits,33,1,0.030303030303030304,32
23240,6008,Stuff Packs,20,1,0.05,19
23241,6009,Expansion Packs,11,0,0.0,11
23242,6009,Game Packs,5,0,0.0,5
23243,6009,Kits,2,0,0.0,2
23244,6009,Stuff Packs,5,3,0.6,2
23245,6010,Expansion Packs,16,0,0.0,16
23246,6010,Game Packs,11,0,0.0,11
23247,6010,Kits,28,0,0.0,28
23248,6010,Stuff Packs,20,0,0.0,20
23249,6011,Expansion Packs,5,0,0.0,5
23250,6011,Stuff Packs,5,0,0.0,5
23251,6012,Expansion Packs,13,0,0.0,13
23252,6012,Game Packs,3,0,0.0,3
23253,6012,Kits,2,2,1.0,0
23254,6012,Stuff Packs,7,3,0.42857142857142855,4
23255,6013,Expansion Packs,16,16,1.0,0
23256,6013,Game Packs,12,12,1.0,0
23257,6013,Kits,33,33,1.0,0
23258,6013,Stuff Packs,20,20,1.0,0
23259,6014,Expansion Packs,12,0,0.0,12
23260,6014,Game Packs,7,0,0.0,7
23261,6014,Kits,4,0,0.0,4
23262,6014,Stuff Packs,8,0,0.0,8
23263,6015,Expansion Packs,10,0,0.0,10
23264,6015,Game Packs,7,1,0.14285714285714285,6
23265,6015,Kits,9,0,0.0,9
23266,6015,Stuff Packs,16,0,0.0,16
23267,6016,Expansion Packs,13,0,0.0,13
23268,6016,Game Packs,10,0,0.0,10
23269,6016,Kits,14,0,0.0,14
23270,6016,Stuff Packs,17,0,0.0,17
23271,6017,Expansion Packs,16,0,0.0,16
23272,6017,Game Packs,11,0,0.0,11
23273,6017,Kits,29,0,0.0,29
23274,6017,Stuff Packs,20,0,0.0,20
23275,6018,Expansion Packs,15,0,0.0,15
23276,6018,Game Packs,6,0,0.0,6
23277,6018,Kits,31,2,0.06451612903225806,29
23278,6018,Stuff Packs,15,0,0.0,15
23279,6019,Expansion Packs,16,0,0.0,16
23280,6019,Game Packs,11,0,0.0,11
23281,6019,Kits,31,0,0.0,31
23282,6019,Stuff Packs,20,0,0.0,20
23283,6020,Expansion Packs,10,0,0.0,10
23284,6020,Game Packs,3,0,0.0,3
23285,6020,Kits,2,0,0.0,2
23286,6020,Stuff Packs,4,0,0.0,4
23287,6021,Expansion Packs,1,0,0.0,1
23288,6021,Kits,1,1,1.0,0
23289,6021,Stuff Packs,3,3,1.0,0
23290,6022,Expansion Packs,13,0,0.0,13
23291,6022,Game Packs,12,0,0.0,12
23292,6022,Kits,4,1,0.25,3
23293,6022,Stuff Packs,20,1,0.05,19
23294,6023,Expansion Packs,2,0,0.0,2
23295,6023,Game Packs,2,0,0.0,2
23296,6023,Stuff Packs,2,0,0.0,2
23297,6024,Expansion Packs,14,0,0.0,14
23298,6024,Game Packs,12,0,0.0,12
23299,6024,Kits,15,0,0.0,15
23300,6024,Stuff Packs,18,0,0.0,18
23301,6025,Expansion Packs,2,0,0.0,2
23302,6025,Game Packs,2,0,0.0,2
23303,6025,Kits,4,1,0.25,3
23304,6025,Stuff Packs,1,0,0.0,1
23305,6026,Expansion Packs,16,0,0.0,16
23306,6026,Game Packs,3,0,0.0,3
23307,6026,Kits,9,1,0.1111111111111111,8
23308,6026,Stuff Packs,12,3,0.25,9
23309,6027,Expansion Packs,16,0,0.0,16
23310,6027,Game Packs,12,0,0.0,12
23311,6027,Kits,29,1,0.034482758620689655,28
23312,6027,Stuff Packs,20,0,0.0,20
23313,6028,Expansion Packs,3,1,0.3333333333333333,2
23314,6028,Game Packs,2,0,0.0,2
23315,6028,Stuff Packs,1,0,0.0,1
23316,6029,Expansion Packs,9,0,0.0,9
23317,6029,Game Packs,2,0,0.0,2
23318,6029,Kits,1,0,0.0,1
23319,6029,Stuff Packs,3,2,0.6666666666666666,1
23320,6030,Expansion Packs,10,1,0.1,9
23321,6030,Game Packs,6,0,0.0,6
23322,6030,Stuff Packs,4,2,0.5,2
23323,6031,Expansion Packs,10,0,0.0,10
23324,6031,Game Packs,5,0,0.0,5
23325,6031,Kits,1,0,0.0,1
23326,6031,Stuff Packs,6,1,0.16666666666666666,5
23327,6032,Expansion Packs,10,0,0.0,10
23328,6032,Game Packs,4,0,0.0,4
23329,6032,Kits,1,1,1.0,0
23330,6032,Stuff Packs,10,0,0.0,10
23331,6033,Expansion Packs,16,0,0.0,16
23332,6033,Game Packs,11,0,0.0,11
23333,6033,Kits,11,1,0.09090909090909091,10
23334,6033,Stuff Packs,17,0,0.0,17
23335,6034,Expansion Packs,16,0,0.0,16
23336,6034,Game Packs,12,2,0.16666666666666666,10
23337,6034,Kits,33,0,0.0,33
23338,6034,Stuff Packs,20,0,0.0,20
23339,6035,Expansion Packs,15,0,0.0,15
23340,6035,Game Packs,12,0,0.0,12
23341,6035,Kits,30,2,0.06666666666666667,28
23342,6035,Stuff Packs,19,1,0.05263157894736842,18
23343,6036,Expansion Packs,6,0,0.0,6
23344,6036,Game Packs,4,0,0.0,4
23345,6036,Kits,2,0,0.0,2
23346,6036,Stuff Packs,7,2,0.2857142857142857,5
23347,6037,Expansion Packs,5,0,0.0,5
23348,6037,Game Packs,2,0,0.0,2
23349,6037,Stuff Packs,2,0,0.0,2
23350,6038,Expansion Packs,5,0,0.0,5
23351,6038,Game Packs,3,0,0.0,3
23352,6038,Kits,2,2,1.0,0
23353,6038,Stuff Packs,5,3,0.6,2
23354,6039,Expansion Packs,10,0,0.0,10
23355,6039,Game Packs,8,0,0.0,8
23356,6039,Kits,9,0,0.0,9
23357,6039,Stuff Packs,10,0,0.0,10
23358,6040,Expansion Packs,14,0,0.0,14
23359,6040,Game Packs,11,0,0.0,11
23360,6040,Kits,3,3,1.0,0
23361,6040,Stuff Packs,13,3,0.23076923076923078,10
23362,6041,Expansion Packs,13,0,0.0,13
23363,6041,Game Packs,6,0,0.0,6
23364,6041,Kits,9,0,0.0,9
23365,6041,Stuff Packs,10,0,0.0,10
23366,6042,Expansion Packs,15,0,0.0,15
23367,6042,Game Packs,10,1,0.1,9
23368,6042,Kits,11,2,0.18181818181818182,9
23369,6042,Stuff Packs,15,0,0.0,15
23370,6043,Expansion Packs,15,0,0.0,15
23371,6043,Game Packs,12,0,0.0,12
23372,6043,Kits,12,0,0.0,12
23373,6043,Stuff Packs,20,0,0.0,20
23374,6044,Expansion Packs,16,0,0.0,16
23375,6044,Game Packs,12,0,0.0,12
23376,6044,Kits,20,1,0.05,19
23377,6044,Stuff Packs,20,0,0.0,20
23378,6045,Expansion Packs,8,0,0.0,8
23379,6045,Game Packs,8,0,0.0,8
23380,6045,Kits,3,2,0.6666666666666666,1
23381,6045,Stuff Packs,8,3,0.375,5
23382,6046,Expansion Packs,15,0,0.0,15
23383,6046,Game Packs,12,0,0.0,12
23384,6046,Kits,19,1,0.05263157894736842,18
23385,6046,Stuff Packs,20,0,0.0,20
23386,6047,Expansion Packs,16,0,0.0,16
23387,6047,Game Packs,12,0,0.0,12
23388,6047,Kits,33,0,0.0,33
23389,6047,Stuff Packs,20,0,0.0,20
23390,6048,Expansion Packs,16,0,0.0,16
23391,6048,Game Packs,12,0,0.0,12
23392,6048,Kits,33,1,0.030303030303030304,32
23393,6048,Stuff Packs,20,0,0.0,20
23394,6049,Expansion Packs,16,0,0.0,16
23395,6049,Game Packs,12,0,0.0,12
23396,6049,Kits,22,0,0.0,22
23397,6049,Stuff Packs,20,0,0.0,20
23398,6050,Expansion Packs,16,0,0.0,16
23399,6050,Game Packs,10,0,0.0,10
23400,6050,Kits,5,1,0.2,4
23401,6050,Stuff Packs,15,1,0.06666666666666667,14
23402,6051,Expansion Packs,16,0,0.0,16
23403,6051,Game Packs,12,0,0.0,12
23404,6051,Kits,33,0,0.0,33
23405,6051,Stuff Packs,20,0,0.0,20
23406,6052,Expansion Packs,16,0,0.0,16
23407,6052,Game Packs,12,0,0.0,12
23408,6052,Kits,24,1,0.041666666666666664,23
23409,6052,Stuff Packs,20,0,0.0,20
23410,6053,Expansion Packs,16,0,0.0,16
23411,6053,Game Packs,11,0,0.0,11
23412,6053,Kits,17,1,0.058823529411764705,16
23413,6053,Stuff Packs,20,0,0.0,20
23414,6054,Expansion Packs,16,0,0.0,16
23415,6054,Game Packs,12,0,0.0,12
23416,6054,Kits,32,1,0.03125,31
23417,6054,Stuff Packs,20,0,0.0,20
23418,6055,Expansion Packs,12,0,0.0,12
23419,6055,Game Packs,9,0,0.0,9
23420,6055,Stuff Packs,15,0,0.0,15
23421,6056,Expansion Packs,11,0,0.0,11
23422,6056,Game Packs,3,0,0.0,3
23423,6056,Kits,1,1,1.0,0
23424,6056,Stuff Packs,7,2,0.2857142857142857,5
23425,6057,Expansion Packs,16,0,0.0,16
23426,6057,Game Packs,12,1,0.08333333333333333,11
23427,6057,Kits,33,0,0.0,33
23428,6057,Stuff Packs,20,0,0.0,20
23429,6058,Expansion Packs,16,0,0.0,16
23430,6058,Game Packs,12,0,0.0,12
23431,6058,Kits,31,0,0.0,31
23432,6058,Stuff Packs,20,0,0.0,20
23433,6059,Expansion Packs,15,0,0.0,15
23434,6059,Game Packs,12,0,0.0,12
23435,6059,Kits,7,1,0.14285714285714285,6
23436,6059,Stuff Packs,19,0,0.0,19
23437,6060,Expansion Packs,16,0,0.0,16
23438,6060,Game Packs,12,0,0.0,12
23439,6060,Kits,33,0,0.0,33
23440,6060,Stuff Packs,20,0,0.0,20
23441,6061,Expansion Packs,3,0,0.0,3
23442,6061,Game Packs,2,0,0.0,2
23443,6061,Stuff Packs,2,0,0.0,2
23444,6062,Expansion Packs,13,0,0.0,13
23445,6062,Game Packs,8,0,0.0,8
23446,6062,Kits,3,0,0.0,3
23447,6062,Stuff Packs,16,0,0.0,16
23448,6063,Expansion Packs,14,0,0.0,14
23449,6063,Game Packs,12,0,0.0,12
23450,6063,Kits,11,0,0.0,11
23451,6063,Stuff Packs,9,0,0.0,9
23452,6064,Expansion Packs,5,1,0.2,4
23453,6064,Game Packs,2,0,0.0,2
23454,6064,Kits,10,1,0.1,9
23455,6064,Stuff Packs,6,3,0.5,3
23456,6065,Expansion Packs,16,0,0.0,16
23457,6065,Game Packs,11,0,0.0,11
23458,6065,Kits,23,2,0.08695652173913043,21
23459,6065,Stuff Packs,20,2,0.1,18
23460,6066,Expansion Packs,16,0,0.0,16
23461,6066,Game Packs,12,0,0.0,12
23462,6066,Kits,24,1,0.041666666666666664,23
23463,6066,Stuff Packs,20,0,0.0,20
23464,6067,Expansion Packs,11,0,0.0,11
23465,6067,Game Packs,6,0,0.0,6
23466,6067,Kits,8,0,0.0,8
23467,6067,Stuff Packs,11,0,0.0,11
23468,6068,Expansion Packs,3,0,0.0,3
23469,6068,Game Packs,1,0,0.0,1
23470,6068,Kits,6,5,0.8333333333333334,1
23471,6068,Stuff Packs,5,3,0.6,2
23472,6069,Expansion Packs,15,0,0.0,15
23473,6069,Game Packs,11,0,0.0,11
23474,6069,Kits,11,0,0.0,11
23475,6069,Stuff Packs,20,0,0.0,20
23476,6070,Expansion Packs,12,0,0.0,12
23477,6070,Game Packs,5,0,0.0,5
23478,6070,Kits,2,1,0.5,1
23479,6070,Stuff Packs,7,2,0.2857142857142857,5
23480,6071,Expansion Packs,16,0,0.0,16
23481,6071,Game Packs,12,0,0.0,12
23482,6071,Kits,33,0,0.0,33
23483,6071,Stuff Packs,20,0,0.0,20
23484,6072,Expansion Packs,16,0,0.0,16
23485,6072,Game Packs,12,0,0.0,12
23486,6072,Kits,33,0,0.0,33
23487,6072,Stuff Packs,20,0,0.0,20
23488,6073,Expansion Packs,15,0,0.0,15
23489,6073,Game Packs,11,0,0.0,11
23490,6073,Kits,10,1,0.1,9
23491,6073,Stuff Packs,12,1,0.08333333333333333,11
23492,6074,Expansion Packs,15,0,0.0,15
23493,6074,Game Packs,12,0,0.0,12
23494,6074,Kits,17,0,0.0,17
23495,6074,Stuff Packs,20,0,0.0,20
23496,6075,Expansion Packs,7,0,0.0,7
23497,6075,Game Packs,2,0,0.0,2
23498,6075,Stuff Packs,3,0,0.0,3
23499,6076,Expansion Packs,10,0,0.0,10
23500,6076,Game Packs,4,0,0.0,4
23501,6076,Kits,15,0,0.0,15
23502,6076,Stuff Packs,10,2,0.2,8
23503,6077,Expansion Packs,15,7,0.4666666666666667,8
23504,6077,Game Packs,10,7,0.7,3
23505,6077,Kits,3,2,0.6666666666666666,1
23506,6077,Stuff Packs,17,6,0.35294117647058826,11
23507,6078,Expansion Packs,16,0,0.0,16
23508,6078,Game Packs,10,0,0.0,10
23509,6078,Kits,13,0,0.0,13
23510,6078,Stuff Packs,19,1,0.05263157894736842,18
23511,6079,Expansion Packs,13,0,0.0,13
23512,6079,Game Packs,10,0,0.0,10
23513,6079,Kits,4,2,0.5,2
23514,6079,Stuff Packs,13,3,0.23076923076923078,10
23515,6080,Expansion Packs,16,0,0.0,16
23516,6080,Game Packs,11,0,0.0,11
23517,6080,Kits,12,1,0.08333333333333333,11
23518,6080,Stuff Packs,20,0,0.0,20
23519,6081,Expansion Packs,16,0,0.0,16
23520,6081,Game Packs,9,0,0.0,9
23521,6081,Kits,27,1,0.037037037037037035,26
23522,6081,Stuff Packs,16,1,0.0625,15
23523,6082,Expansion Packs,16,0,0.0,16
23524,6082,Game Packs,12,0,0.0,12
23525,6082,Kits,33,2,0.06060606060606061,31
23526,6082,Stuff Packs,20,1,0.05,19
23527,6083,Expansion Packs,16,0,0.0,16
23528,6083,Game Packs,12,0,0.0,12
23529,6083,Kits,33,1,0.030303030303030304,32
23530,6083,Stuff Packs,20,0,0.0,20
23531,6084,Expansion Packs,4,0,0.0,4
23532,6084,Game Packs,3,1,0.3333333333333333,2
23533,6084,Kits,1,1,1.0,0
23534,6084,Stuff Packs,3,3,1.0,0
23535,6085,Expansion Packs,15,0,0.0,15
23536,6085,Game Packs,8,1,0.125,7
23537,6085,Kits,8,2,0.25,6
23538,6085,Stuff Packs,12,3,0.25,9
23539,6086,Expansion Packs,16,0,0.0,16
23540,6086,Game Packs,10,0,0.0,10
23541,6086,Kits,16,1,0.0625,15
23542,6086,Stuff Packs,20,0,0.0,20
23543,6087,Expansion Packs,16,0,0.0,16
23544,6087,Game Packs,12,0,0.0,12
23545,6087,Kits,33,0,0.0,33
23546,6087,Stuff Packs,20,0,0.0,20
23547,6088,Expansion Packs,10,0,0.0,10
23548,6088,Game Packs,7,0,0.0,7
23549,6088,Kits,1,0,0.0,1
23550,6088,Stuff Packs,14,1,0.07142857142857142,13
23551,6089,Expansion Packs,6,0,0.0,6
23552,6089,Game Packs,5,1,0.2,4
23553,6089,Kits,10,0,0.0,10
23554,6089,Stuff Packs,11,3,0.2727272727272727,8
23555,6090,Expansion Packs,3,0,0.0,3
23556,6090,Game Packs,3,0,0.0,3
23557,6090,Kits,2,2,1.0,0
23558,6090,Stuff Packs,6,3,0.5,3
23559,6091,Expansion Packs,5,0,0.0,5
23560,6091,Game Packs,3,1,0.3333333333333333,2
23561,6091,Kits,2,1,0.5,1
23562,6091,Stuff Packs,4,4,1.0,0
23563,6092,Expansion Packs,15,0,0.0,15
23564,6092,Game Packs,12,0,0.0,12
23565,6092,Kits,30,0,0.0,30
23566,6092,Stuff Packs,20,0,0.0,20
23567,6093,Expansion Packs,7,0,0.0,7
23568,6093,Game Packs,1,0,0.0,1
23569,6093,Kits,4,2,0.5,2
23570,6093,Stuff Packs,6,3,0.5,3
23571,6094,Expansion Packs,10,0,0.0,10
23572,6094,Game Packs,2,0,0.0,2
23573,6094,Kits,8,1,0.125,7
23574,6094,Stuff Packs,6,0,0.0,6
23575,6095,Expansion Packs,10,0,0.0,10
23576,6095,Game Packs,2,1,0.5,1
23577,6095,Kits,3,1,0.3333333333333333,2
23578,6095,Stuff Packs,4,2,0.5,2
23579,6096,Expansion Packs,15,0,0.0,15
23580,6096,Game Packs,9,0,0.0,9
23581,6096,Kits,9,2,0.2222222222222222,7
23582,6096,Stuff Packs,15,4,0.26666666666666666,11
23583,6097,Expansion Packs,3,0,0.0,3
23584,6097,Game Packs,4,0,0.0,4
23585,6097,Kits,1,0,0.0,1
23586,6097,Stuff Packs,4,0,0.0,4
23587,6098,Expansion Packs,15,0,0.0,15
23588,6098,Game Packs,10,0,0.0,10
23589,6098,Kits,11,1,0.09090909090909091,10
23590,6098,Stuff Packs,13,1,0.07692307692307693,12
23591,6099,Expansion Packs,3,0,0.0,3
23592,6099,Game Packs,2,1,0.5,1
23593,6099,Kits,4,3,0.75,1
23594,6099,Stuff Packs,6,4,0.6666666666666666,2
23595,6100,Expansion Packs,13,0,0.0,13
23596,6100,Game Packs,6,0,0.0,6
23597,6100,Kits,2,2,1.0,0
23598,6100,Stuff Packs,8,2,0.25,6
23599,6101,Expansion Packs,13,0,0.0,13
23600,6101,Game Packs,6,0,0.0,6
23601,6101,Kits,13,1,0.07692307692307693,12
23602,6101,Stuff Packs,11,1,0.09090909090909091,10
23603,6102,Expansion Packs,2,0,0.0,2
23604,6102,Game Packs,1,1,1.0,0
23605,6102,Kits,2,2,1.0,0
23606,6102,Stuff Packs,4,3,0.75,1
23607,6103,Expansion Packs,16,0,0.0,16
23608,6103,Game Packs,12,0,0.0,12
23609,6103,Kits,20,1,0.05,19
23610,6103,Stuff Packs,20,2,0.1,18
23611,6104,Expansion Packs,16,0,0.0,16
23612,6104,Game Packs,11,0,0.0,11
23613,6104,Kits,33,0,0.0,33
23614,6104,Stuff Packs,20,0,0.0,20
23615,6105,Expansion Packs,4,0,0.0,4
23616,6105,Kits,1,0,0.0,1
23617,6105,Stuff Packs,2,2,1.0,0
23618,6106,Expansion Packs,16,0,0.0,16
23619,6106,Game Packs,12,0,0.0,12
23620,6106,Kits,21,1,0.047619047619047616,20
23621,6106,Stuff Packs,20,1,0.05,19
23622,6107,Expansion Packs,2,0,0.0,2
23623,6108,Expansion Packs,11,0,0.0,11
23624,6108,Game Packs,3,0,0.0,3
23625,6108,Kits,1,1,1.0,0
23626,6108,Stuff Packs,5,1,0.2,4
23627,6109,Expansion Packs,11,1,0.09090909090909091,10
23628,6109,Game Packs,4,1,0.25,3
23629,6109,Kits,4,1,0.25,3
23630,6109,Stuff Packs,6,5,0.8333333333333334,1
23631,6110,Expansion Packs,13,0,0.0,13
23632,6110,Game Packs,3,0,0.0,3
23633,6110,Kits,6,0,0.0,6
23634,6110,Stuff Packs,4,0,0.0,4
23635,6111,Expansion Packs,9,0,0.0,9
23636,6111,Game Packs,3,0,0.0,3
23637,6111,Kits,4,1,0.25,3
23638,6111,Stuff Packs,6,0,0.0,6
23639,6112,Expansion Packs,16,0,0.0,16
23640,6112,Game Packs,12,0,0.0,12
23641,6112,Kits,21,1,0.047619047619047616,20
23642,6112,Stuff Packs,20,1,0.05,19
23643,6113,Expansion Packs,3,0,0.0,3
23644,6113,Game Packs,2,0,0.0,2
23645,6113,Kits,1,0,0.0,1
23646,6113,Stuff Packs,3,1,0.3333333333333333,2
23647,6114,Expansion Packs,16,1,0.0625,15
23648,6114,Game Packs,12,1,0.08333333333333333,11
23649,6114,Kits,33,2,0.06060606060606061,31
23650,6114,Stuff Packs,20,4,0.2,16
23651,6115,Expansion Packs,16,0,0.0,16
23652,6115,Game Packs,12,0,0.0,12
23653,6115,Kits,20,0,0.0,20
23654,6115,Stuff Packs,20,0,0.0,20
23655,6116,Expansion Packs,11,0,0.0,11
23656,6116,Game Packs,9,0,0.0,9
23657,6116,Kits,7,2,0.2857142857142857,5
23658,6116,Stuff Packs,13,1,0.07692307692307693,12
23659,6117,Expansion Packs,16,0,0.0,16
23660,6117,Game Packs,12,0,0.0,12
23661,6117,Kits,33,0,0.0,33
23662,6117,Stuff Packs,20,0,0.0,20
23663,6118,Expansion Packs,16,0,0.0,16
23664,6118,Game Packs,11,0,0.0,11
23665,6118,Kits,33,0,0.0,33
23666,6118,Stuff Packs,20,0,0.0,20
23667,6119,Expansion Packs,11,0,0.0,11
23668,6119,Game Packs,6,0,0.0,6
23669,6119,Stuff Packs,5,2,0.4,3
23670,6120,Expansion Packs,10,0,0.0,10
23671,6120,Game Packs,8,0,0.0,8
23672,6120,Kits,7,2,0.2857142857142857,5
23673,6120,Stuff Packs,12,3,0.25,9
23674,6121,Expansion Packs,16,0,0.0,16
23675,6121,Game Packs,12,0,0.0,12
23676,6121,Kits,24,1,0.041666666666666664,23
23677,6121,Stuff Packs,20,0,0.0,20
23678,6122,Expansion Packs,15,0,0.0,15
23679,6122,Game Packs,9,0,0.0,9
23680,6122,Kits,11,1,0.09090909090909091,10
23681,6122,Stuff Packs,13,3,0.23076923076923078,10
23682,6123,Expansion Packs,16,0,0.0,16
23683,6123,Game Packs,10,0,0.0,10
23684,6123,Kits,12,0,0.0,12
23685,6123,Stuff Packs,16,0,0.0,16
23686,6124,Expansion Packs,15,0,0.0,15
23687,6124,Game Packs,7,0,0.0,7
23688,6124,Kits,6,2,0.3333333333333333,4
23689,6124,Stuff Packs,9,3,0.3333333333333333,6
23690,6125,Expansion Packs,7,0,0.0,7
23691,6125,Game Packs,4,0,0.0,4
23692,6125,Kits,3,2,0.6666666666666666,1
23693,6125,Stuff Packs,9,2,0.2222222222222222,7
23694,6126,Expansion Packs,16,0,0.0,16
23695,6126,Game Packs,12,0,0.0,12
23696,6126,Kits,33,0,0.0,33
23697,6126,Stuff Packs,20,0,0.0,20
23698,6127,Expansion Packs,16,0,0.0,16
23699,6127,Game Packs,11,0,0.0,11
23700,6127,Kits,4,3,0.75,1
23701,6127,Stuff Packs,16,1,0.0625,15
23702,6128,Expansion Packs,14,0,0.0,14
23703,6128,Game Packs,8,0,0.0,8
23704,6128,Kits,2,2,1.0,0
23705,6128,Stuff Packs,15,0,0.0,15
23706,6129,Expansion Packs,14,0,0.0,14
23707,6129,Game Packs,10,0,0.0,10
23708,6129,Kits,9,1,0.1111111111111111,8
23709,6129,Stuff Packs,15,2,0.13333333333333333,13
23710,6130,Expansion Packs,7,0,0.0,7
23711,6130,Game Packs,5,0,0.0,5
23712,6130,Kits,11,2,0.18181818181818182,9
23713,6130,Stuff Packs,6,3,0.5,3
23714,6131,Expansion Packs,14,0,0.0,14
23715,6131,Game Packs,4,0,0.0,4
23716,6131,Kits,3,1,0.3333333333333333,2
23717,6131,Stuff Packs,5,1,0.2,4
23718,6132,Expansion Packs,4,0,0.0,4
23719,6132,Game Packs,1,0,0.0,1
23720,6132,Kits,2,2,1.0,0
23721,6132,Stuff Packs,2,1,0.5,1
23722,6133,Expansion Packs,13,0,0.0,13
23723,6133,Game Packs,7,1,0.14285714285714285,6
23724,6133,Kits,9,3,0.3333333333333333,6
23725,6133,Stuff Packs,10,4,0.4,6
23726,6134,Expansion Packs,13,0,0.0,13
23727,6134,Game Packs,8,0,0.0,8
23728,6134,Kits,8,2,0.25,6
23729,6134,Stuff Packs,10,3,0.3,7
23730,6135,Expansion Packs,16,0,0.0,16
23731,6135,Game Packs,12,0,0.0,12
23732,6135,Kits,17,1,0.058823529411764705,16
23733,6135,Stuff Packs,20,3,0.15,17
23734,6136,Expansion Packs,4,0,0.0,4
23735,6136,Kits,6,1,0.16666666666666666,5
23736,6136,Stuff Packs,8,2,0.25,6
23737,6137,Expansion Packs,14,0,0.0,14
23738,6137,Game Packs,9,0,0.0,9
23739,6137,Kits,19,1,0.05263157894736842,18
23740,6137,Stuff Packs,17,0,0.0,17
23741,6138,Expansion Packs,15,0,0.0,15
23742,6138,Game Packs,10,0,0.0,10
23743,6138,Kits,8,1,0.125,7
23744,6138,Stuff Packs,13,2,0.15384615384615385,11
23745,6139,Expansion Packs,16,14,0.875,2
23746,6139,Game Packs,12,12,1.0,0
23747,6139,Kits,33,1,0.030303030303030304,32
23748,6139,Stuff Packs,20,20,1.0,0
23749,6140,Expansion Packs,14,0,0.0,14
23750,6140,Game Packs,11,0,0.0,11
23751,6140,Kits,8,0,0.0,8
23752,6140,Stuff Packs,14,0,0.0,14
23753,6141,Expansion Packs,16,0,0.0,16
23754,6141,Game Packs,11,0,0.0,11
23755,6141,Kits,33,0,0.0,33
23756,6141,Stuff Packs,20,0,0.0,20
23757,6142,Expansion Packs,11,0,0.0,11
23758,6142,Game Packs,7,0,0.0,7
23759,6142,Kits,5,1,0.2,4
23760,6142,Stuff Packs,9,2,0.2222222222222222,7
23761,6143,Expansion Packs,16,0,0.0,16
23762,6143,Game Packs,12,0,0.0,12
23763,6143,Kits,23,1,0.043478260869565216,22
23764,6143,Stuff Packs,20,0,0.0,20
23765,6144,Expansion Packs,16,0,0.0,16
23766,6144,Game Packs,12,0,0.0,12
23767,6144,Kits,16,1,0.0625,15
23768,6144,Stuff Packs,20,1,0.05,19
23769,6145,Expansion Packs,11,0,0.0,11
23770,6145,Game Packs,2,1,0.5,1
23771,6145,Stuff Packs,4,4,1.0,0
23772,6146,Expansion Packs,14,0,0.0,14
23773,6146,Game Packs,10,0,0.0,10
23774,6146,Kits,2,2,1.0,0
23775,6146,Stuff Packs,9,3,0.3333333333333333,6
23776,6147,Expansion Packs,15,0,0.0,15
23777,6147,Game Packs,9,1,0.1111111111111111,8
23778,6147,Kits,6,3,0.5,3
23779,6147,Stuff Packs,17,3,0.17647058823529413,14
23780,6148,Expansion Packs,12,0,0.0,12
23781,6148,Game Packs,8,0,0.0,8
23782,6148,Kits,2,2,1.0,0
23783,6148,Stuff Packs,6,2,0.3333333333333333,4
23784,6149,Expansion Packs,12,0,0.0,12
23785,6149,Game Packs,3,0,0.0,3
23786,6149,Kits,3,2,0.6666666666666666,1
23787,6149,Stuff Packs,5,0,0.0,5
23788,6150,Expansion Packs,15,1,0.06666666666666667,14
23789,6150,Game Packs,10,0,0.0,10
23790,6150,Kits,12,0,0.0,12
23791,6150,Stuff Packs,20,0,0.0,20
23792,6151,Expansion Packs,14,0,0.0,14
23793,6151,Game Packs,12,0,0.0,12
23794,6151,Kits,25,0,0.0,25
23795,6151,Stuff Packs,20,0,0.0,20
23796,6152,Expansion Packs,7,0,0.0,7
23797,6152,Game Packs,3,0,0.0,3
23798,6152,Kits,7,0,0.0,7
23799,6152,Stuff Packs,7,2,0.2857142857142857,5
23800,6153,Expansion Packs,4,0,0.0,4
23801,6153,Game Packs,2,0,0.0,2
23802,6153,Kits,1,0,0.0,1
23803,6153,Stuff Packs,4,0,0.0,4
23804,6154,Expansion Packs,16,0,0.0,16
23805,6154,Game Packs,12,0,0.0,12
23806,6154,Kits,33,0,0.0,33
23807,6154,Stuff Packs,20,0,0.0,20
23808,6155,Expansion Packs,16,0,0.0,16
23809,6155,Game Packs,12,0,0.0,12
23810,6155,Kits,33,0,0.0,33
23811,6155,Stuff Packs,18,0,0.0,18
23812,6156,Game Packs,2,2,1.0,0
23813,6156,Kits,2,2,1.0,0
23814,6156,Stuff Packs,5,5,1.0,0
23815,6157,Expansion Packs,12,0,0.0,12
23816,6157,Game Packs,6,0,0.0,6
23817,6157,Kits,2,2,1.0,0
23818,6157,Stuff Packs,12,1,0.08333333333333333,11
23819,6158,Expansion Packs,16,0,0.0,16
23820,6158,Game Packs,12,0,0.0,12
23821,6158,Kits,33,1,0.030303030303030304,32
23822,6158,Stuff Packs,20,0,0.0,20
23823,6159,Expansion Packs,11,0,0.0,11
23824,6159,Game Packs,8,1,0.125,7
23825,6159,Kits,3,2,0.6666666666666666,1
23826,6159,Stuff Packs,11,3,0.2727272727272727,8
23827,6160,Expansion Packs,16,0,0.0,16
23828,6160,Game Packs,12,0,0.0,12
23829,6160,Kits,31,0,0.0,31
23830,6160,Stuff Packs,20,0,0.0,20
23831,6161,Expansion Packs,16,0,0.0,16
23832,6161,Game Packs,12,0,0.0,12
23833,6161,Kits,27,0,0.0,27
23834,6161,Stuff Packs,20,0,0.0,20
23835,6162,Expansion Packs,16,0,0.0,16
23836,6162,Game Packs,12,0,0.0,12
23837,6162,Kits,14,0,0.0,14
23838,6162,Stuff Packs,17,1,0.058823529411764705,16
23839,6163,Expansion Packs,13,0,0.0,13
23840,6163,Game Packs,10,0,0.0,10
23841,6163,Kits,2,2,1.0,0
23842,6163,Stuff Packs,16,1,0.0625,15
23843,6164,Expansion Packs,16,0,0.0,16
23844,6164,Game Packs,12,0,0.0,12
23845,6164,Kits,30,1,0.03333333333333333,29
23846,6164,Stuff Packs,20,0,0.0,20
23847,6165,Expansion Packs,16,0,0.0,16
23848,6165,Game Packs,12,0,0.0,12
23849,6165,Kits,33,0,0.0,33
23850,6165,Stuff Packs,20,0,0.0,20
23851,6166,Expansion Packs,16,0,0.0,16
23852,6166,Game Packs,11,0,0.0,11
23853,6166,Kits,24,0,0.0,24
23854,6166,Stuff Packs,20,0,0.0,20
23855,6167,Expansion Packs,15,0,0.0,15
23856,6167,Game Packs,9,0,0.0,9
23857,6167,Kits,11,0,0.0,11
23858,6167,Stuff Packs,19,0,0.0,19
23859,6168,Expansion Packs,16,0,0.0,16
23860,6168,Game Packs,12,0,0.0,12
23861,6168,Kits,21,0,0.0,21
23862,6168,Stuff Packs,20,0,0.0,20
23863,6169,Expansion Packs,7,0,0.0,7
23864,6169,Game Packs,7,0,0.0,7
23865,6169,Kits,1,1,1.0,0
23866,6169,Stuff Packs,7,1,0.14285714285714285,6
23867,6170,Expansion Packs,11,0,0.0,11
23868,6170,Game Packs,6,1,0.16666666666666666,5
23869,6170,Kits,4,0,0.0,4
23870,6170,Stuff Packs,11,5,0.45454545454545453,6
23871,6171,Expansion Packs,16,0,0.0,16
23872,6171,Game Packs,11,0,0.0,11
23873,6171,Kits,20,1,0.05,19
23874,6171,Stuff Packs,20,0,0.0,20
23875,6172,Expansion Packs,13,0,0.0,13
23876,6172,Game Packs,7,0,0.0,7
23877,6172,Kits,1,0,0.0,1
23878,6172,Stuff Packs,4,0,0.0,4
23879,6173,Expansion Packs,16,0,0.0,16
23880,6173,Game Packs,12,0,0.0,12
23881,6173,Kits,33,1,0.030303030303030304,32
23882,6173,Stuff Packs,20,0,0.0,20
23883,6174,Expansion Packs,7,0,0.0,7
23884,6174,Game Packs,4,0,0.0,4
23885,6174,Kits,2,2,1.0,0
23886,6174,Stuff Packs,4,0,0.0,4
23887,6175,Expansion Packs,6,0,0.0,6
23888,6175,Game Packs,2,0,0.0,2
23889,6175,Kits,1,1,1.0,0
23890,6175,Stuff Packs,4,2,0.5,2
23891,6176,Expansion Packs,14,0,0.0,14
23892,6176,Game Packs,10,0,0.0,10
23893,6176,Kits,15,2,0.13333333333333333,13
23894,6176,Stuff Packs,17,1,0.058823529411764705,16
23895,6177,Expansion Packs,16,0,0.0,16
23896,6177,Game Packs,11,0,0.0,11
23897,6177,Kits,32,0,0.0,32
23898,6177,Stuff Packs,20,0,0.0,20
23899,6178,Expansion Packs,11,0,0.0,11
23900,6178,Game Packs,4,0,0.0,4
23901,6178,Kits,1,0,0.0,1
23902,6178,Stuff Packs,1,0,0.0,1
23903,6179,Expansion Packs,16,0,0.0,16
23904,6179,Game Packs,12,0,0.0,12
23905,6179,Kits,33,1,0.030303030303030304,32
23906,6179,Stuff Packs,20,0,0.0,20
23907,6180,Expansion Packs,6,0,0.0,6
23908,6180,Game Packs,1,0,0.0,1
23909,6180,Kits,1,1,1.0,0
23910,6180,Stuff Packs,4,0,0.0,4
23911,6181,Expansion Packs,15,1,0.06666666666666667,14
23912,6181,Game Packs,6,0,0.0,6
23913,6181,Kits,12,0,0.0,12
23914,6181,Stuff Packs,7,1,0.14285714285714285,6
23915,6182,Expansion Packs,16,0,0.0,16
23916,6182,Game Packs,12,0,0.0,12
23917,6182,Kits,33,1,0.030303030303030304,32
23918,6182,Stuff Packs,20,0,0.0,20
23919,6183,Expansion Packs,15,0,0.0,15
23920,6183,Game Packs,8,0,0.0,8
23921,6183,Kits,16,1,0.0625,15
23922,6183,Stuff Packs,18,1,0.05555555555555555,17
23923,6184,Expansion Packs,16,0,0.0,16
23924,6184,Game Packs,11,0,0.0,11
23925,6184,Kits,18,1,0.05555555555555555,17
23926,6184,Stuff Packs,20,0,0.0,20
23927,6185,Expansion Packs,10,1,0.1,9
23928,6185,Game Packs,3,0,0.0,3
23929,6185,Kits,10,0,0.0,10
23930,6185,Stuff Packs,10,1,0.1,9
23931,6186,Expansion Packs,8,0,0.0,8
23932,6186,Game Packs,5,0,0.0,5
23933,6186,Kits,9,0,0.0,9
23934,6186,Stuff Packs,6,0,0.0,6
23935,6187,Expansion Packs,16,0,0.0,16
23936,6187,Game Packs,11,0,0.0,11
23937,6187,Kits,33,0,0.0,33
23938,6187,Stuff Packs,20,1,0.05,19
23939,6188,Expansion Packs,9,0,0.0,9
23940,6188,Game Packs,7,0,0.0,7
23941,6188,Stuff Packs,2,1,0.5,1
23942,6189,Expansion Packs,13,0,0.0,13
23943,6189,Game Packs,3,0,0.0,3
23944,6189,Kits,4,0,0.0,4
23945,6189,Stuff Packs,6,1,0.16666666666666666,5
23946,6190,Expansion Packs,10,0,0.0,10
23947,6190,Game Packs,5,0,0.0,5
23948,6190,Kits,3,0,0.0,3
23949,6190,Stuff Packs,8,2,0.25,6
23950,6191,Expansion Packs,11,0,0.0,11
23951,6191,Game Packs,10,0,0.0,10
23952,6191,Kits,8,1,0.125,7
23953,6191,Stuff Packs,18,0,0.0,18
23954,6192,Expansion Packs,16,0,0.0,16
23955,6192,Game Packs,12,0,0.0,12
23956,6192,Kits,31,0,0.0,31
23957,6192,Stuff Packs,20,1,0.05,19
23958,6193,Expansion Packs,16,0,0.0,16
23959,6193,Game Packs,12,0,0.0,12
23960,6193,Kits,33,0,0.0,33
23961,6193,Stuff Packs,20,0,0.0,20
23962,6194,Expansion Packs,16,0,0.0,16
23963,6194,Game Packs,12,0,0.0,12
23964,6194,Kits,33,3,0.09090909090909091,30
23965,6194,Stuff Packs,20,4,0.2,16
23966,6195,Expansion Packs,8,0,0.0,8
23967,6195,Game Packs,7,1,0.14285714285714285,6
23968,6195,Kits,22,3,0.13636363636363635,19
23969,6195,Stuff Packs,17,2,0.11764705882352941,15
23970,6196,Expansion Packs,16,0,0.0,16
23971,6196,Game Packs,12,0,0.0,12
23972,6196,Kits,33,0,0.0,33
23973,6196,Stuff Packs,20,0,0.0,20
23974,6197,Expansion Packs,16,3,0.1875,13
23975,6197,Game Packs,12,0,0.0,12
23976,6197,Kits,33,0,0.0,33
23977,6197,Stuff Packs,20,0,0.0,20
23978,6198,Expansion Packs,5,0,0.0,5
23979,6198,Game Packs,4,0,0.0,4
23980,6198,Stuff Packs,2,0,0.0,2
23981,6199,Expansion Packs,2,0,0.0,2
23982,6199,Game Packs,4,0,0.0,4
23983,6199,Kits,10,0,0.0,10
23984,6199,Stuff Packs,4,0,0.0,4
23985,6200,Expansion Packs,8,0,0.0,8
23986,6200,Game Packs,5,0,0.0,5
23987,6200,Kits,2,2,1.0,0
23988,6200,Stuff Packs,8,3,0.375,5
23989,6201,Expansion Packs,16,0,0.0,16
23990,6201,Game Packs,11,0,0.0,11
23991,6201,Kits,29,1,0.034482758620689655,28
23992,6201,Stuff Packs,20,3,0.15,17
23993,6202,Expansion Packs,16,0,0.0,16
23994,6202,Game Packs,12,0,0.0,12
23995,6202,Kits,33,0,0.0,33
23996,6202,Stuff Packs,20,1,0.05,19
23997,6203,Expansion Packs,5,0,0.0,5
23998,6203,Game Packs,1,0,0.0,1
23999,6203,Kits,2,2,1.0,0
24000,6203,Stuff Packs,3,2,0.6666666666666666,1
24001,6204,Expansion Packs,2,0,0.0,2
24002,6204,Kits,1,1,1.0,0
24003,6204,Stuff Packs,3,3,1.0,0
24004,6205,Expansion Packs,16,0,0.0,16
24005,6205,Game Packs,12,1,0.08333333333333333,11
24006,6205,Kits,4,2,0.5,2
24007,6205,Stuff Packs,20,0,0.0,20
24008,6206,Expansion Packs,16,0,0.0,16
24009,6206,Game Packs,12,0,0.0,12
24010,6206,Kits,21,0,0.0,21
24011,6206,Stuff Packs,20,0,0.0,20
24012,6207,Expansion Packs,8,0,0.0,8
24013,6207,Game Packs,1,0,0.0,1
24014,6207,Kits,2,2,1.0,0
24015,6207,Stuff Packs,6,3,0.5,3
24016,6208,Expansion Packs,7,0,0.0,7
24017,6208,Game Packs,4,0,0.0,4
24018,6208,Kits,3,1,0.3333333333333333,2
24019,6208,Stuff Packs,5,3,0.6,2
24020,6209,Expansion Packs,15,0,0.0,15
24021,6209,Game Packs,12,0,0.0,12
24022,6209,Kits,10,1,0.1,9
24023,6209,Stuff Packs,20,2,0.1,18
24024,6210,Expansion Packs,11,0,0.0,11
24025,6210,Game Packs,4,0,0.0,4
24026,6210,Kits,2,0,0.0,2
24027,6210,Stuff Packs,10,2,0.2,8
24028,6211,Expansion Packs,16,14,0.875,2
24029,6211,Game Packs,6,5,0.8333333333333334,1
24030,6211,Kits,22,22,1.0,0
24031,6211,Stuff Packs,17,15,0.8823529411764706,2
24032,6212,Expansion Packs,13,0,0.0,13
24033,6212,Game Packs,5,1,0.2,4
24034,6212,Kits,4,3,0.75,1
24035,6212,Stuff Packs,8,4,0.5,4
24036,6213,Expansion Packs,15,0,0.0,15
24037,6213,Game Packs,12,0,0.0,12
24038,6213,Kits,9,1,0.1111111111111111,8
24039,6213,Stuff Packs,18,0,0.0,18
24040,6214,Expansion Packs,16,0,0.0,16
24041,6214,Game Packs,12,1,0.08333333333333333,11
24042,6214,Kits,9,0,0.0,9
24043,6214,Stuff Packs,10,0,0.0,10
24044,6215,Expansion Packs,12,0,0.0,12
24045,6215,Game Packs,3,0,0.0,3
24046,6215,Stuff Packs,8,2,0.25,6
24047,6216,Expansion Packs,14,0,0.0,14
24048,6216,Game Packs,9,0,0.0,9
24049,6216,Kits,5,2,0.4,3
24050,6216,Stuff Packs,10,2,0.2,8
24051,6217,Expansion Packs,16,0,0.0,16
24052,6217,Game Packs,12,0,0.0,12
24053,6217,Kits,15,1,0.06666666666666667,14
24054,6217,Stuff Packs,20,0,0.0,20
24055,6218,Expansion Packs,10,0,0.0,10
24056,6218,Game Packs,6,1,0.16666666666666666,5
24057,6218,Kits,3,1,0.3333333333333333,2
24058,6218,Stuff Packs,6,0,0.0,6
24059,6219,Expansion Packs,15,0,0.0,15
24060,6219,Game Packs,10,0,0.0,10
24061,6219,Kits,2,0,0.0,2
24062,6219,Stuff Packs,9,2,0.2222222222222222,7
24063,6220,Expansion Packs,15,0,0.0,15
24064,6220,Game Packs,12,0,0.0,12
24065,6220,Kits,21,1,0.047619047619047616,20
24066,6220,Stuff Packs,17,0,0.0,17
24067,6221,Expansion Packs,16,0,0.0,16
24068,6221,Game Packs,12,0,0.0,12
24069,6221,Kits,33,1,0.030303030303030304,32
24070,6221,Stuff Packs,20,0,0.0,20
24071,6222,Expansion Packs,16,0,0.0,16
24072,6222,Game Packs,12,0,0.0,12
24073,6222,Kits,33,0,0.0,33
24074,6222,Stuff Packs,20,0,0.0,20
24075,6223,Expansion Packs,16,1,0.0625,15
24076,6223,Game Packs,12,0,0.0,12
24077,6223,Kits,21,0,0.0,21
24078,6223,Stuff Packs,20,0,0.0,20
24079,6224,Expansion Packs,15,0,0.0,15
24080,6224,Game Packs,12,0,0.0,12
24081,6224,Kits,10,1,0.1,9
24082,6224,Stuff Packs,11,0,0.0,11
24083,6225,Expansion Packs,16,0,0.0,16
24084,6225,Game Packs,12,0,0.0,12
24085,6225,Kits,33,0,0.0,33
24086,6225,Stuff Packs,20,0,0.0,20
24087,6226,Expansion Packs,16,0,0.0,16
24088,6226,Game Packs,12,0,0.0,12
24089,6226,Kits,25,0,0.0,25
24090,6226,Stuff Packs,20,0,0.0,20
24091,6227,Expansion Packs,11,0,0.0,11
24092,6227,Game Packs,6,0,0.0,6
24093,6227,Kits,2,2,1.0,0
24094,6227,Stuff Packs,10,2,0.2,8
24095,6228,Expansion Packs,16,0,0.0,16
24096,6228,Game Packs,12,0,0.0,12
24097,6228,Kits,33,1,0.030303030303030304,32
24098,6228,Stuff Packs,20,0,0.0,20
24099,6229,Expansion Packs,16,0,0.0,16
24100,6229,Game Packs,11,0,0.0,11
24101,6229,Kits,21,0,0.0,21
24102,6229,Stuff Packs,19,0,0.0,19
24103,6230,Expansion Packs,16,1,0.0625,15
24104,6230,Game Packs,12,0,0.0,12
24105,6230,Kits,33,2,0.06060606060606061,31
24106,6230,Stuff Packs,20,0,0.0,20
24107,6231,Expansion Packs,16,0,0.0,16
24108,6231,Game Packs,12,0,0.0,12
24109,6231,Kits,11,2,0.18181818181818182,9
24110,6231,Stuff Packs,20,0,0.0,20
24111,6232,Expansion Packs,8,0,0.0,8
24112,6232,Game Packs,3,0,0.0,3
24113,6232,Kits,3,1,0.3333333333333333,2
24114,6232,Stuff Packs,5,1,0.2,4
24115,6233,Expansion Packs,5,0,0.0,5
24116,6233,Stuff Packs,1,0,0.0,1
24117,6234,Expansion Packs,16,0,0.0,16
24118,6234,Game Packs,11,0,0.0,11
24119,6234,Kits,25,1,0.04,24
24120,6234,Stuff Packs,20,0,0.0,20
24121,6235,Expansion Packs,16,0,0.0,16
24122,6235,Game Packs,12,0,0.0,12
24123,6235,Kits,33,1,0.030303030303030304,32
24124,6235,Stuff Packs,20,0,0.0,20
24125,6236,Expansion Packs,10,0,0.0,10
24126,6236,Game Packs,8,0,0.0,8
24127,6236,Stuff Packs,13,0,0.0,13
24128,6237,Expansion Packs,14,0,0.0,14
24129,6237,Game Packs,9,0,0.0,9
24130,6237,Kits,25,2,0.08,23
24131,6237,Stuff Packs,16,1,0.0625,15
24132,6238,Expansion Packs,5,0,0.0,5
24133,6238,Game Packs,2,0,0.0,2
24134,6238,Stuff Packs,3,1,0.3333333333333333,2
24135,6239,Expansion Packs,16,0,0.0,16
24136,6239,Game Packs,12,1,0.08333333333333333,11
24137,6239,Kits,33,0,0.0,33
24138,6239,Stuff Packs,20,1,0.05,19
24139,6240,Expansion Packs,3,0,0.0,3
24140,6240,Kits,2,2,1.0,0
24141,6240,Stuff Packs,2,2,1.0,0
24142,6241,Expansion Packs,15,0,0.0,15
24143,6241,Game Packs,10,0,0.0,10
24144,6241,Kits,11,0,0.0,11
24145,6241,Stuff Packs,16,0,0.0,16
24146,6242,Expansion Packs,13,0,0.0,13
24147,6242,Game Packs,9,0,0.0,9
24148,6242,Kits,7,1,0.14285714285714285,6
24149,6242,Stuff Packs,11,1,0.09090909090909091,10
24150,6243,Expansion Packs,11,0,0.0,11
24151,6243,Game Packs,7,0,0.0,7
24152,6243,Kits,3,1,0.3333333333333333,2
24153,6243,Stuff Packs,9,0,0.0,9
24154,6244,Expansion Packs,7,0,0.0,7
24155,6244,Game Packs,7,0,0.0,7
24156,6244,Kits,2,2,1.0,0
24157,6244,Stuff Packs,10,3,0.3,7
24158,6245,Expansion Packs,15,0,0.0,15
24159,6245,Game Packs,8,0,0.0,8
24160,6245,Kits,6,2,0.3333333333333333,4
24161,6245,Stuff Packs,17,0,0.0,17
24162,6246,Expansion Packs,6,0,0.0,6
24163,6246,Game Packs,2,0,0.0,2
24164,6246,Kits,6,1,0.16666666666666666,5
24165,6246,Stuff Packs,3,0,0.0,3
24166,6247,Expansion Packs,16,0,0.0,16
24167,6247,Game Packs,9,0,0.0,9
24168,6247,Kits,15,1,0.06666666666666667,14
24169,6247,Stuff Packs,13,0,0.0,13
24170,6248,Expansion Packs,13,0,0.0,13
24171,6248,Game Packs,5,1,0.2,4
24172,6248,Kits,4,2,0.5,2
24173,6248,Stuff Packs,9,3,0.3333333333333333,6
24174,6249,Expansion Packs,14,1,0.07142857142857142,13
24175,6249,Game Packs,2,0,0.0,2
24176,6249,Stuff Packs,2,0,0.0,2
24177,6250,Expansion Packs,16,0,0.0,16
24178,6250,Game Packs,8,0,0.0,8
24179,6250,Kits,10,0,0.0,10
24180,6250,Stuff Packs,6,0,0.0,6
24181,6251,Expansion Packs,13,0,0.0,13
24182,6251,Game Packs,5,0,0.0,5
24183,6251,Kits,1,0,0.0,1
24184,6251,Stuff Packs,5,0,0.0,5
24185,6252,Expansion Packs,15,0,0.0,15
24186,6252,Game Packs,10,0,0.0,10
24187,6252,Kits,13,1,0.07692307692307693,12
24188,6252,Stuff Packs,13,0,0.0,13
24189,6253,Expansion Packs,11,0,0.0,11
24190,6253,Game Packs,6,0,0.0,6
24191,6253,Stuff Packs,8,0,0.0,8
24192,6254,Expansion Packs,16,0,0.0,16
24193,6254,Game Packs,12,0,0.0,12
24194,6254,Kits,33,3,0.09090909090909091,30
24195,6254,Stuff Packs,20,0,0.0,20
24196,6255,Expansion Packs,7,0,0.0,7
24197,6255,Game Packs,7,0,0.0,7
24198,6255,Kits,3,3,1.0,0
24199,6255,Stuff Packs,11,2,0.18181818181818182,9
24200,6256,Expansion Packs,11,0,0.0,11
24201,6256,Game Packs,5,0,0.0,5
24202,6256,Kits,10,0,0.0,10
24203,6256,Stuff Packs,7,0,0.0,7
24204,6257,Expansion Packs,16,0,0.0,16
24205,6257,Game Packs,11,0,0.0,11
24206,6257,Kits,30,0,0.0,30
24207,6257,Stuff Packs,20,0,0.0,20
24208,6258,Expansion Packs,13,0,0.0,13
24209,6258,Game Packs,8,0,0.0,8
24210,6258,Kits,3,1,0.3333333333333333,2
24211,6258,Stuff Packs,14,1,0.07142857142857142,13
24212,6259,Expansion Packs,16,0,0.0,16
24213,6259,Game Packs,12,0,0.0,12
24214,6259,Kits,33,0,0.0,33
24215,6259,Stuff Packs,20,0,0.0,20
24216,6260,Expansion Packs,16,0,0.0,16
24217,6260,Game Packs,12,0,0.0,12
24218,6260,Kits,33,1,0.030303030303030304,32
24219,6260,Stuff Packs,20,0,0.0,20
24220,6261,Expansion Packs,5,1,0.2,4
24221,6261,Game Packs,2,1,0.5,1
24222,6261,Kits,2,2,1.0,0
24223,6261,Stuff Packs,3,2,0.6666666666666666,1
24224,6262,Expansion Packs,9,0,0.0,9
24225,6262,Game Packs,1,0,0.0,1
24226,6262,Kits,1,1,1.0,0
24227,6262,Stuff Packs,3,3,1.0,0
24228,6263,Expansion Packs,16,0,0.0,16
24229,6263,Game Packs,12,0,0.0,12
24230,6263,Kits,33,1,0.030303030303030304,32
24231,6263,Stuff Packs,20,0,0.0,20
24232,6264,Expansion Packs,8,0,0.0,8
24233,6264,Game Packs,2,1,0.5,1
24234,6264,Kits,3,3,1.0,0
24235,6264,Stuff Packs,6,3,0.5,3
24236,6265,Expansion Packs,11,0,0.0,11
24237,6265,Game Packs,4,0,0.0,4
24238,6265,Stuff Packs,8,2,0.25,6
24239,6266,Expansion Packs,5,0,0.0,5
24240,6266,Stuff Packs,5,1,0.2,4
24241,6267,Expansion Packs,15,0,0.0,15
24242,6267,Game Packs,5,0,0.0,5
24243,6267,Kits,6,1,0.16666666666666666,5
24244,6267,Stuff Packs,5,0,0.0,5
24245,6268,Expansion Packs,16,0,0.0,16
24246,6268,Game Packs,12,0,0.0,12
24247,6268,Kits,27,0,0.0,27
24248,6268,Stuff Packs,20,0,0.0,20
24249,6269,Expansion Packs,9,0,0.0,9
24250,6269,Game Packs,6,0,0.0,6
24251,6269,Kits,2,1,0.5,1
24252,6269,Stuff Packs,11,1,0.09090909090909091,10
24253,6270,Expansion Packs,4,0,0.0,4
24254,6270,Game Packs,6,0,0.0,6
24255,6270,Kits,2,2,1.0,0
24256,6270,Stuff Packs,5,2,0.4,3
24257,6271,Expansion Packs,16,0,0.0,16
24258,6271,Game Packs,12,0,0.0,12
24259,6271,Kits,31,0,0.0,31
24260,6271,Stuff Packs,20,0,0.0,20
24261,6272,Expansion Packs,3,0,0.0,3
24262,6272,Game Packs,2,1,0.5,1
24263,6272,Kits,2,2,1.0,0
24264,6272,Stuff Packs,5,3,0.6,2
24265,6273,Expansion Packs,4,0,0.0,4
24266,6273,Game Packs,6,0,0.0,6
24267,6273,Kits,7,1,0.14285714285714285,6
24268,6273,Stuff Packs,9,0,0.0,9
24269,6274,Expansion Packs,16,0,0.0,16
24270,6274,Game Packs,11,0,0.0,11
24271,6274,Kits,19,1,0.05263157894736842,18
24272,6274,Stuff Packs,20,0,0.0,20
24273,6275,Game Packs,1,0,0.0,1
24274,6275,Kits,1,1,1.0,0
24275,6275,Stuff Packs,3,2,0.6666666666666666,1
24276,6276,Expansion Packs,8,0,0.0,8
24277,6276,Game Packs,6,1,0.16666666666666666,5
24278,6276,Stuff Packs,11,1,0.09090909090909091,10
24279,6277,Expansion Packs,16,0,0.0,16
24280,6277,Game Packs,12,0,0.0,12
24281,6277,Kits,33,0,0.0,33
24282,6277,Stuff Packs,20,1,0.05,19
24283,6278,Expansion Packs,16,0,0.0,16
24284,6278,Game Packs,12,0,0.0,12
24285,6278,Kits,33,1,0.030303030303030304,32
24286,6278,Stuff Packs,20,0,0.0,20
24287,6279,Expansion Packs,16,0,0.0,16
24288,6279,Game Packs,12,0,0.0,12
24289,6279,Kits,33,1,0.030303030303030304,32
24290,6279,Stuff Packs,20,0,0.0,20
24291,6280,Expansion Packs,16,0,0.0,16
24292,6280,Game Packs,11,0,0.0,11
24293,6280,Kits,23,0,0.0,23
24294,6280,Stuff Packs,20,0,0.0,20
24295,6281,Expansion Packs,12,0,0.0,12
24296,6281,Game Packs,9,0,0.0,9
24297,6281,Kits,1,0,0.0,1
24298,6281,Stuff Packs,15,0,0.0,15
24299,6282,Expansion Packs,16,0,0.0,16
24300,6282,Game Packs,12,0,0.0,12
24301,6282,Kits,33,1,0.030303030303030304,32
24302,6282,Stuff Packs,20,0,0.0,20
24303,6283,Expansion Packs,16,0,0.0,16
24304,6283,Game Packs,9,0,0.0,9
24305,6283,Kits,30,1,0.03333333333333333,29
24306,6283,Stuff Packs,19,0,0.0,19
24307,6284,Expansion Packs,16,0,0.0,16
24308,6284,Game Packs,12,0,0.0,12
24309,6284,Kits,33,0,0.0,33
24310,6284,Stuff Packs,20,0,0.0,20
24311,6285,Expansion Packs,15,0,0.0,15
24312,6285,Game Packs,9,0,0.0,9
24313,6285,Kits,12,0,0.0,12
24314,6285,Stuff Packs,13,1,0.07692307692307693,12
24315,6286,Expansion Packs,11,0,0.0,11
24316,6286,Game Packs,6,0,0.0,6
24317,6286,Kits,1,0,0.0,1
24318,6286,Stuff Packs,13,1,0.07692307692307693,12
24319,6287,Expansion Packs,15,0,0.0,15
24320,6287,Game Packs,11,0,0.0,11
24321,6287,Kits,29,0,0.0,29
24322,6287,Stuff Packs,20,0,0.0,20
24323,6288,Expansion Packs,9,0,0.0,9
24324,6288,Game Packs,3,0,0.0,3
24325,6288,Kits,1,1,1.0,0
24326,6288,Stuff Packs,4,2,0.5,2
24327,6289,Expansion Packs,14,1,0.07142857142857142,13
24328,6289,Game Packs,10,0,0.0,10
24329,6289,Kits,12,0,0.0,12
24330,6289,Stuff Packs,19,1,0.05263157894736842,18
24331,6290,Expansion Packs,7,0,0.0,7
24332,6290,Game Packs,4,0,0.0,4
24333,6290,Kits,3,2,0.6666666666666666,1
24334,6290,Stuff Packs,5,0,0.0,5
24335,6291,Expansion Packs,15,0,0.0,15
24336,6291,Game Packs,10,0,0.0,10
24337,6291,Kits,9,1,0.1111111111111111,8
24338,6291,Stuff Packs,14,1,0.07142857142857142,13
24339,6292,Expansion Packs,16,0,0.0,16
24340,6292,Game Packs,12,0,0.0,12
24341,6292,Kits,25,1,0.04,24
24342,6292,Stuff Packs,20,0,0.0,20
24343,6293,Expansion Packs,15,1,0.06666666666666667,14
24344,6293,Game Packs,9,2,0.2222222222222222,7
24345,6293,Kits,14,0,0.0,14
24346,6293,Stuff Packs,11,1,0.09090909090909091,10
24347,6294,Expansion Packs,16,0,0.0,16
24348,6294,Game Packs,11,0,0.0,11
24349,6294,Kits,9,2,0.2222222222222222,7
24350,6294,Stuff Packs,11,3,0.2727272727272727,8
24351,6295,Expansion Packs,14,0,0.0,14
24352,6295,Game Packs,11,0,0.0,11
24353,6295,Kits,9,1,0.1111111111111111,8
24354,6295,Stuff Packs,20,0,0.0,20
24355,6296,Expansion Packs,12,0,0.0,12
24356,6296,Game Packs,7,0,0.0,7
24357,6296,Kits,20,2,0.1,18
24358,6296,Stuff Packs,13,2,0.15384615384615385,11
24359,6297,Expansion Packs,14,0,0.0,14
24360,6297,Game Packs,7,0,0.0,7
24361,6297,Kits,11,1,0.09090909090909091,10
24362,6297,Stuff Packs,11,1,0.09090909090909091,10
24363,6298,Expansion Packs,15,0,0.0,15
24364,6298,Game Packs,8,0,0.0,8
24365,6298,Kits,6,0,0.0,6
24366,6298,Stuff Packs,8,2,0.25,6
24367,6299,Expansion Packs,8,0,0.0,8
24368,6299,Game Packs,4,1,0.25,3
24369,6299,Kits,3,1,0.3333333333333333,2
24370,6299,Stuff Packs,6,4,0.6666666666666666,2
24371,6300,Expansion Packs,16,0,0.0,16
24372,6300,Game Packs,12,0,0.0,12
24373,6300,Kits,33,0,0.0,33
24374,6300,Stuff Packs,20,0,0.0,20
24375,6301,Expansion Packs,6,0,0.0,6
24376,6301,Game Packs,3,0,0.0,3
24377,6301,Kits,6,2,0.3333333333333333,4
24378,6301,Stuff Packs,5,3,0.6,2
24379,6302,Expansion Packs,8,0,0.0,8
24380,6302,Game Packs,4,0,0.0,4
24381,6302,Kits,6,1,0.16666666666666666,5
24382,6302,Stuff Packs,4,0,0.0,4
24383,6303,Expansion Packs,4,0,0.0,4
24384,6303,Game Packs,1,0,0.0,1
24385,6303,Kits,2,2,1.0,0
24386,6303,Stuff Packs,4,3,0.75,1
24387,6304,Expansion Packs,5,0,0.0,5
24388,6304,Game Packs,1,0,0.0,1
24389,6304,Kits,2,2,1.0,0
24390,6304,Stuff Packs,3,2,0.6666666666666666,1
24391,6305,Expansion Packs,4,0,0.0,4
24392,6305,Stuff Packs,2,1,0.5,1
24393,6306,Expansion Packs,15,0,0.0,15
24394,6306,Game Packs,11,1,0.09090909090909091,10
24395,6306,Kits,8,1,0.125,7
24396,6306,Stuff Packs,9,0,0.0,9
24397,6307,Expansion Packs,7,0,0.0,7
24398,6307,Game Packs,1,1,1.0,0
24399,6307,Kits,3,0,0.0,3
24400,6307,Stuff Packs,6,4,0.6666666666666666,2
24401,6308,Expansion Packs,13,0,0.0,13
24402,6308,Game Packs,9,0,0.0,9
24403,6308,Kits,8,2,0.25,6
24404,6308,Stuff Packs,13,2,0.15384615384615385,11
24405,6309,Expansion Packs,11,0,0.0,11
24406,6309,Game Packs,10,0,0.0,10
24407,6309,Kits,1,1,1.0,0
24408,6309,Stuff Packs,16,2,0.125,14
24409,6310,Expansion Packs,16,1,0.0625,15
24410,6310,Game Packs,12,0,0.0,12
24411,6310,Kits,11,2,0.18181818181818182,9
24412,6310,Stuff Packs,16,0,0.0,16
24413,6311,Expansion Packs,16,0,0.0,16
24414,6311,Game Packs,12,1,0.08333333333333333,11
24415,6311,Kits,17,0,0.0,17
24416,6311,Stuff Packs,10,0,0.0,10
24417,6312,Expansion Packs,15,0,0.0,15
24418,6312,Game Packs,10,0,0.0,10
24419,6312,Stuff Packs,19,0,0.0,19
24420,6313,Expansion Packs,6,0,0.0,6
24421,6313,Game Packs,7,0,0.0,7
24422,6313,Stuff Packs,13,0,0.0,13
24423,6314,Expansion Packs,16,0,0.0,16
24424,6314,Game Packs,11,0,0.0,11
24425,6314,Kits,2,1,0.5,1
24426,6314,Stuff Packs,16,2,0.125,14
24427,6315,Expansion Packs,14,0,0.0,14
24428,6315,Game Packs,8,1,0.125,7
24429,6315,Kits,7,1,0.14285714285714285,6
24430,6315,Stuff Packs,11,1,0.09090909090909091,10
24431,6316,Expansion Packs,12,0,0.0,12
24432,6316,Game Packs,12,0,0.0,12
24433,6316,Kits,6,0,0.0,6
24434,6316,Stuff Packs,18,0,0.0,18
24435,6317,Expansion Packs,12,0,0.0,12
24436,6317,Game Packs,4,0,0.0,4
24437,6317,Kits,33,2,0.06060606060606061,31
24438,6317,Stuff Packs,20,0,0.0,20
24439,6318,Expansion Packs,16,0,0.0,16
24440,6318,Game Packs,11,0,0.0,11
24441,6318,Kits,24,0,0.0,24
24442,6318,Stuff Packs,20,0,0.0,20
24443,6319,Expansion Packs,15,0,0.0,15
24444,6319,Game Packs,11,0,0.0,11
24445,6319,Kits,14,1,0.07142857142857142,13
24446,6319,Stuff Packs,19,0,0.0,19
24447,6320,Expansion Packs,15,0,0.0,15
24448,6320,Game Packs,10,2,0.2,8
24449,6320,Kits,7,2,0.2857142857142857,5
24450,6320,Stuff Packs,18,4,0.2222222222222222,14
24451,6321,Expansion Packs,15,15,1.0,0
24452,6321,Game Packs,12,12,1.0,0
24453,6321,Kits,29,29,1.0,0
24454,6321,Stuff Packs,20,20,1.0,0
24455,6322,Expansion Packs,12,0,0.0,12
24456,6322,Game Packs,4,0,0.0,4
24457,6322,Kits,8,1,0.125,7
24458,6322,Stuff Packs,10,3,0.3,7
24459,6323,Expansion Packs,15,0,0.0,15
24460,6323,Game Packs,10,0,0.0,10
24461,6323,Kits,19,1,0.05263157894736842,18
24462,6323,Stuff Packs,18,0,0.0,18
24463,6324,Expansion Packs,13,0,0.0,13
24464,6324,Game Packs,4,0,0.0,4
24465,6324,Kits,10,0,0.0,10
24466,6324,Stuff Packs,7,0,0.0,7
24467,6325,Expansion Packs,16,0,0.0,16
24468,6325,Game Packs,11,0,0.0,11
24469,6325,Kits,12,2,0.16666666666666666,10
24470,6325,Stuff Packs,20,0,0.0,20
24471,6326,Expansion Packs,15,0,0.0,15
24472,6326,Game Packs,11,0,0.0,11
24473,6326,Kits,9,1,0.1111111111111111,8
24474,6326,Stuff Packs,12,1,0.08333333333333333,11
24475,6327,Expansion Packs,13,0,0.0,13
24476,6327,Game Packs,7,0,0.0,7
24477,6327,Kits,2,0,0.0,2
24478,6327,Stuff Packs,6,0,0.0,6
24479,6328,Expansion Packs,8,0,0.0,8
24480,6328,Game Packs,3,0,0.0,3
24481,6328,Kits,3,1,0.3333333333333333,2
24482,6328,Stuff Packs,3,0,0.0,3
24483,6329,Expansion Packs,16,0,0.0,16
24484,6329,Game Packs,12,0,0.0,12
24485,6329,Kits,33,0,0.0,33
24486,6329,Stuff Packs,20,0,0.0,20
24487,6330,Expansion Packs,16,0,0.0,16
24488,6330,Game Packs,8,0,0.0,8
24489,6330,Kits,11,1,0.09090909090909091,10
24490,6330,Stuff Packs,16,1,0.0625,15
24491,6331,Expansion Packs,14,0,0.0,14
24492,6331,Game Packs,10,0,0.0,10
24493,6331,Kits,2,2,1.0,0
24494,6331,Stuff Packs,18,1,0.05555555555555555,17
24495,6332,Expansion Packs,9,0,0.0,9
24496,6332,Game Packs,2,0,0.0,2
24497,6332,Kits,1,0,0.0,1
24498,6332,Stuff Packs,2,1,0.5,1
24499,6333,Expansion Packs,7,0,0.0,7
24500,6333,Game Packs,1,0,0.0,1
24501,6333,Kits,6,0,0.0,6
24502,6333,Stuff Packs,9,0,0.0,9
24503,6334,Expansion Packs,12,0,0.0,12
24504,6334,Game Packs,7,0,0.0,7
24505,6334,Kits,1,1,1.0,0
24506,6334,Stuff Packs,10,1,0.1,9
24507,6335,Expansion Packs,8,0,0.0,8
24508,6335,Game Packs,6,0,0.0,6
24509,6335,Kits,4,1,0.25,3
24510,6335,Stuff Packs,5,2,0.4,3
24511,6336,Expansion Packs,16,0,0.0,16
24512,6336,Game Packs,12,0,0.0,12
24513,6336,Kits,33,0,0.0,33
24514,6336,Stuff Packs,20,0,0.0,20
24515,6337,Expansion Packs,15,0,0.0,15
24516,6337,Game Packs,10,0,0.0,10
24517,6337,Kits,2,1,0.5,1
24518,6337,Stuff Packs,9,3,0.3333333333333333,6
24519,6338,Expansion Packs,16,0,0.0,16
24520,6338,Game Packs,12,0,0.0,12
24521,6338,Kits,23,2,0.08695652173913043,21
24522,6338,Stuff Packs,20,0,0.0,20
24523,6339,Expansion Packs,16,0,0.0,16
24524,6339,Game Packs,11,0,0.0,11
24525,6339,Kits,24,1,0.041666666666666664,23
24526,6339,Stuff Packs,18,0,0.0,18
24527,6340,Expansion Packs,8,0,0.0,8
24528,6340,Game Packs,3,2,0.6666666666666666,1
24529,6340,Kits,3,3,1.0,0
24530,6340,Stuff Packs,5,4,0.8,1
24531,6341,Expansion Packs,15,0,0.0,15
24532,6341,Game Packs,12,0,0.0,12
24533,6341,Kits,26,0,0.0,26
24534,6341,Stuff Packs,20,0,0.0,20
24535,6342,Expansion Packs,15,0,0.0,15
24536,6342,Game Packs,10,0,0.0,10
24537,6342,Kits,8,0,0.0,8
24538,6342,Stuff Packs,18,0,0.0,18
24539,6343,Expansion Packs,8,1,0.125,7
24540,6343,Game Packs,1,1,1.0,0
24541,6343,Kits,2,2,1.0,0
24542,6343,Stuff Packs,4,4,1.0,0
24543,6344,Expansion Packs,16,0,0.0,16
24544,6344,Game Packs,9,0,0.0,9
24545,6344,Kits,17,0,0.0,17
24546,6344,Stuff Packs,19,2,0.10526315789473684,17
24547,6345,Expansion Packs,3,0,0.0,3
24548,6345,Game Packs,1,0,0.0,1
24549,6345,Stuff Packs,3,3,1.0,0
24550,6346,Expansion Packs,11,0,0.0,11
24551,6346,Game Packs,8,0,0.0,8
24552,6346,Stuff Packs,16,0,0.0,16
24553,6347,Expansion Packs,10,1,0.1,9
24554,6347,Game Packs,6,0,0.0,6
24555,6347,Kits,5,1,0.2,4
24556,6347,Stuff Packs,6,0,0.0,6
24557,6348,Expansion Packs,6,0,0.0,6
24558,6348,Game Packs,1,0,0.0,1
24559,6348,Stuff Packs,2,0,0.0,2
24560,6349,Expansion Packs,14,0,0.0,14
24561,6349,Game Packs,11,0,0.0,11
24562,6349,Kits,2,2,1.0,0
24563,6349,Stuff Packs,19,0,0.0,19
24564,6350,Expansion Packs,16,0,0.0,16
24565,6350,Game Packs,8,0,0.0,8
24566,6350,Kits,5,1,0.2,4
24567,6350,Stuff Packs,15,0,0.0,15
24568,6351,Expansion Packs,13,0,0.0,13
24569,6351,Game Packs,5,0,0.0,5
24570,6351,Kits,2,0,0.0,2
24571,6351,Stuff Packs,8,0,0.0,8
24572,6352,Expansion Packs,16,0,0.0,16
24573,6352,Game Packs,12,0,0.0,12
24574,6352,Kits,33,0,0.0,33
24575,6352,Stuff Packs,20,0,0.0,20
24576,6353,Expansion Packs,15,0,0.0,15
24577,6353,Game Packs,11,0,0.0,11
24578,6353,Kits,16,1,0.0625,15
24579,6353,Stuff Packs,19,0,0.0,19
24580,6354,Expansion Packs,6,0,0.0,6
24581,6354,Game Packs,5,1,0.2,4
24582,6354,Kits,5,3,0.6,2
24583,6354,Stuff Packs,6,2,0.3333333333333333,4
24584,6355,Expansion Packs,15,0,0.0,15
24585,6355,Game Packs,9,0,0.0,9
24586,6355,Kits,4,3,0.75,1
24587,6355,Stuff Packs,11,3,0.2727272727272727,8
24588,6356,Expansion Packs,16,0,0.0,16
24589,6356,Game Packs,12,0,0.0,12
24590,6356,Kits,14,1,0.07142857142857142,13
24591,6356,Stuff Packs,20,1,0.05,19
24592,6357,Expansion Packs,5,0,0.0,5
24593,6357,Game Packs,2,0,0.0,2
24594,6357,Stuff Packs,2,0,0.0,2
24595,6358,Expansion Packs,13,0,0.0,13
24596,6358,Game Packs,6,0,0.0,6
24597,6358,Kits,5,0,0.0,5
24598,6358,Stuff Packs,10,3,0.3,7
24599,6359,Expansion Packs,14,0,0.0,14
24600,6359,Game Packs,10,0,0.0,10
24601,6359,Kits,2,1,0.5,1
24602,6359,Stuff Packs,16,0,0.0,16
24603,6360,Expansion Packs,13,0,0.0,13
24604,6360,Game Packs,7,0,0.0,7
24605,6360,Kits,5,0,0.0,5
24606,6360,Stuff Packs,10,0,0.0,10
24607,6361,Expansion Packs,13,0,0.0,13
24608,6361,Game Packs,12,0,0.0,12
24609,6361,Kits,14,0,0.0,14
24610,6361,Stuff Packs,18,0,0.0,18
24611,6362,Expansion Packs,14,0,0.0,14
24612,6362,Game Packs,11,0,0.0,11
24613,6362,Kits,8,1,0.125,7
24614,6362,Stuff Packs,18,0,0.0,18
24615,6363,Expansion Packs,16,0,0.0,16
24616,6363,Game Packs,11,0,0.0,11
24617,6363,Kits,23,1,0.043478260869565216,22
24618,6363,Stuff Packs,20,1,0.05,19
24619,6364,Expansion Packs,13,0,0.0,13
24620,6364,Game Packs,9,0,0.0,9
24621,6364,Kits,2,1,0.5,1
24622,6364,Stuff Packs,7,1,0.14285714285714285,6
24623,6365,Expansion Packs,11,0,0.0,11
24624,6365,Game Packs,6,0,0.0,6
24625,6365,Kits,4,1,0.25,3
24626,6365,Stuff Packs,9,1,0.1111111111111111,8
24627,6366,Expansion Packs,15,1,0.06666666666666667,14
24628,6366,Game Packs,11,0,0.0,11
24629,6366,Kits,31,3,0.0967741935483871,28
24630,6366,Stuff Packs,12,1,0.08333333333333333,11
24631,6367,Expansion Packs,6,0,0.0,6
24632,6367,Game Packs,1,1,1.0,0
24633,6367,Kits,3,3,1.0,0
24634,6367,Stuff Packs,4,4,1.0,0
24635,6368,Expansion Packs,2,0,0.0,2
24636,6368,Game Packs,1,0,0.0,1
24637,6368,Stuff Packs,2,1,0.5,1
24638,6369,Expansion Packs,16,0,0.0,16
24639,6369,Game Packs,12,0,0.0,12
24640,6369,Kits,33,0,0.0,33
24641,6369,Stuff Packs,20,0,0.0,20
24642,6370,Expansion Packs,14,0,0.0,14
24643,6370,Game Packs,7,0,0.0,7
24644,6370,Kits,9,0,0.0,9
24645,6370,Stuff Packs,8,0,0.0,8
24646,6371,Expansion Packs,15,0,0.0,15
24647,6371,Game Packs,12,0,0.0,12
24648,6371,Kits,33,1,0.030303030303030304,32
24649,6371,Stuff Packs,20,1,0.05,19
24650,6372,Expansion Packs,15,0,0.0,15
24651,6372,Game Packs,12,1,0.08333333333333333,11
24652,6372,Kits,31,1,0.03225806451612903,30
24653,6372,Stuff Packs,20,0,0.0,20
24654,6373,Expansion Packs,13,0,0.0,13
24655,6373,Game Packs,5,0,0.0,5
24656,6373,Kits,1,1,1.0,0
24657,6373,Stuff Packs,10,1,0.1,9
24658,6374,Expansion Packs,14,0,0.0,14
24659,6374,Game Packs,9,0,0.0,9
24660,6374,Kits,3,1,0.3333333333333333,2
24661,6374,Stuff Packs,17,4,0.23529411764705882,13
24662,6375,Expansion Packs,15,0,0.0,15
24663,6375,Game Packs,9,0,0.0,9
24664,6375,Kits,5,2,0.4,3
24665,6375,Stuff Packs,14,2,0.14285714285714285,12
24666,6376,Expansion Packs,16,0,0.0,16
24667,6376,Game Packs,12,0,0.0,12
24668,6376,Kits,33,0,0.0,33
24669,6376,Stuff Packs,20,0,0.0,20
24670,6377,Expansion Packs,16,0,0.0,16
24671,6377,Game Packs,12,0,0.0,12
24672,6377,Kits,33,0,0.0,33
24673,6377,Stuff Packs,20,0,0.0,20
24674,6378,Expansion Packs,15,0,0.0,15
24675,6378,Game Packs,10,0,0.0,10
24676,6378,Kits,13,1,0.07692307692307693,12
24677,6378,Stuff Packs,20,0,0.0,20
24678,6379,Expansion Packs,16,0,0.0,16
24679,6379,Game Packs,9,0,0.0,9
24680,6379,Kits,5,2,0.4,3
24681,6379,Stuff Packs,13,2,0.15384615384615385,11
24682,6380,Expansion Packs,15,1,0.06666666666666667,14
24683,6380,Game Packs,10,0,0.0,10
24684,6380,Kits,3,0,0.0,3
24685,6380,Stuff Packs,20,0,0.0,20
24686,6381,Expansion Packs,10,0,0.0,10
24687,6381,Game Packs,3,0,0.0,3
24688,6381,Stuff Packs,7,2,0.2857142857142857,5
24689,6382,Expansion Packs,16,0,0.0,16
24690,6382,Game Packs,12,0,0.0,12
24691,6382,Kits,26,0,0.0,26
24692,6382,Stuff Packs,20,0,0.0,20
24693,6383,Expansion Packs,13,0,0.0,13
24694,6383,Game Packs,12,0,0.0,12
24695,6383,Kits,11,0,0.0,11
24696,6383,Stuff Packs,16,0,0.0,16
24697,6384,Expansion Packs,6,0,0.0,6
24698,6384,Game Packs,5,1,0.2,4
24699,6384,Stuff Packs,4,0,0.0,4
24700,6385,Expansion Packs,4,0,0.0,4
24701,6385,Game Packs,3,0,0.0,3
24702,6385,Kits,7,1,0.14285714285714285,6
24703,6385,Stuff Packs,5,3,0.6,2
24704,6386,Expansion Packs,6,0,0.0,6
24705,6386,Game Packs,3,0,0.0,3
24706,6386,Kits,2,2,1.0,0
24707,6386,Stuff Packs,9,3,0.3333333333333333,6
24708,6387,Expansion Packs,16,0,0.0,16
24709,6387,Game Packs,12,0,0.0,12
24710,6387,Kits,33,0,0.0,33
24711,6387,Stuff Packs,20,0,0.0,20
24712,6388,Expansion Packs,16,0,0.0,16
24713,6388,Game Packs,4,0,0.0,4
24714,6388,Kits,1,0,0.0,1
24715,6388,Stuff Packs,1,0,0.0,1
24716,6389,Expansion Packs,16,4,0.25,12
24717,6389,Game Packs,12,5,0.4166666666666667,7
24718,6389,Kits,33,12,0.36363636363636365,21
24719,6389,Stuff Packs,20,9,0.45,11
24720,6390,Expansion Packs,16,0,0.0,16
24721,6390,Game Packs,12,0,0.0,12
24722,6390,Kits,33,0,0.0,33
24723,6390,Stuff Packs,20,0,0.0,20
24724,6391,Expansion Packs,16,0,0.0,16
24725,6391,Game Packs,12,0,0.0,12
24726,6391,Kits,33,0,0.0,33
24727,6391,Stuff Packs,20,0,0.0,20
24728,6392,Expansion Packs,12,0,0.0,12
24729,6392,Game Packs,7,1,0.14285714285714285,6
24730,6392,Kits,9,2,0.2222222222222222,7
24731,6392,Stuff Packs,16,1,0.0625,15
24732,6393,Expansion Packs,8,0,0.0,8
24733,6393,Game Packs,3,1,0.3333333333333333,2
24734,6393,Kits,8,3,0.375,5
24735,6393,Stuff Packs,9,4,0.4444444444444444,5
24736,6394,Expansion Packs,10,0,0.0,10
24737,6394,Game Packs,9,0,0.0,9
24738,6394,Stuff Packs,14,0,0.0,14
24739,6395,Expansion Packs,16,0,0.0,16
24740,6395,Game Packs,12,0,0.0,12
24741,6395,Kits,33,0,0.0,33
24742,6395,Stuff Packs,20,0,0.0,20
24743,6396,Expansion Packs,13,0,0.0,13
24744,6396,Game Packs,11,0,0.0,11
24745,6396,Kits,12,0,0.0,12
24746,6396,Stuff Packs,16,0,0.0,16
24747,6397,Expansion Packs,16,16,1.0,0
24748,6397,Game Packs,12,12,1.0,0
24749,6397,Kits,33,33,1.0,0
24750,6397,Stuff Packs,20,20,1.0,0
24751,6398,Expansion Packs,1,0,0.0,1
24752,6398,Game Packs,1,1,1.0,0
24753,6398,Kits,3,3,1.0,0
24754,6398,Stuff Packs,6,2,0.3333333333333333,4
24755,6399,Expansion Packs,15,0,0.0,15
24756,6399,Game Packs,8,0,0.0,8
24757,6399,Kits,15,1,0.06666666666666667,14
24758,6399,Stuff Packs,16,0,0.0,16
24759,6400,Expansion Packs,4,0,0.0,4
24760,6400,Game Packs,1,0,0.0,1
24761,6400,Kits,3,0,0.0,3
24762,6400,Stuff Packs,4,0,0.0,4
24763,6401,Expansion Packs,16,2,0.125,14
24764,6401,Game Packs,12,0,0.0,12
24765,6401,Kits,32,1,0.03125,31
24766,6401,Stuff Packs,20,0,0.0,20
24767,6402,Expansion Packs,16,0,0.0,16
24768,6402,Game Packs,12,0,0.0,12
24769,6402,Kits,24,0,0.0,24
24770,6402,Stuff Packs,20,0,0.0,20
24771,6403,Expansion Packs,4,0,0.0,4
24772,6403,Game Packs,5,0,0.0,5
24773,6403,Kits,2,0,0.0,2
24774,6403,Stuff Packs,4,2,0.5,2
24775,6404,Game Packs,1,1,1.0,0
24776,6404,Kits,3,3,1.0,0
24777,6404,Stuff Packs,4,4,1.0,0
24778,6405,Expansion Packs,5,0,0.0,5
24779,6405,Game Packs,4,0,0.0,4
24780,6405,Kits,3,0,0.0,3
24781,6405,Stuff Packs,6,3,0.5,3
24782,6406,Expansion Packs,15,0,0.0,15
24783,6406,Game Packs,5,0,0.0,5
24784,6406,Kits,9,1,0.1111111111111111,8
24785,6406,Stuff Packs,8,0,0.0,8
24786,6407,Expansion Packs,11,0,0.0,11
24787,6407,Game Packs,7,1,0.14285714285714285,6
24788,6407,Kits,5,3,0.6,2
24789,6407,Stuff Packs,8,2,0.25,6
24790,6408,Expansion Packs,6,0,0.0,6
24791,6408,Game Packs,2,1,0.5,1
24792,6408,Kits,3,3,1.0,0
24793,6408,Stuff Packs,3,3,1.0,0
24794,6409,Expansion Packs,4,0,0.0,4
24795,6409,Game Packs,2,1,0.5,1
24796,6409,Kits,1,1,1.0,0
24797,6409,Stuff Packs,2,1,0.5,1
24798,6410,Expansion Packs,10,0,0.0,10
24799,6410,Game Packs,6,0,0.0,6
24800,6410,Stuff Packs,12,0,0.0,12
24801,6411,Expansion Packs,15,0,0.0,15
24802,6411,Game Packs,11,0,0.0,11
24803,6411,Kits,8,0,0.0,8
24804,6411,Stuff Packs,13,1,0.07692307692307693,12
24805,6412,Expansion Packs,15,0,0.0,15
24806,6412,Game Packs,12,0,0.0,12
24807,6412,Kits,6,2,0.3333333333333333,4
24808,6412,Stuff Packs,20,0,0.0,20
24809,6413,Expansion Packs,14,0,0.0,14
24810,6413,Game Packs,9,0,0.0,9
24811,6413,Kits,2,1,0.5,1
24812,6413,Stuff Packs,18,0,0.0,18
24813,6414,Expansion Packs,16,16,1.0,0
24814,6414,Game Packs,10,10,1.0,0
24815,6414,Stuff Packs,18,17,0.9444444444444444,1
24816,6415,Expansion Packs,3,0,0.0,3
24817,6415,Game Packs,1,0,0.0,1
24818,6415,Kits,1,1,1.0,0
24819,6415,Stuff Packs,3,1,0.3333333333333333,2
24820,6416,Expansion Packs,15,0,0.0,15
24821,6416,Game Packs,11,0,0.0,11
24822,6416,Kits,2,0,0.0,2
24823,6416,Stuff Packs,13,0,0.0,13
24824,6417,Expansion Packs,15,0,0.0,15
24825,6417,Game Packs,8,1,0.125,7
24826,6417,Kits,5,1,0.2,4
24827,6417,Stuff Packs,9,1,0.1111111111111111,8
24828,6418,Expansion Packs,13,0,0.0,13
24829,6418,Game Packs,4,0,0.0,4
24830,6418,Stuff Packs,7,1,0.14285714285714285,6
24831,6419,Expansion Packs,3,0,0.0,3
24832,6419,Game Packs,4,0,0.0,4
24833,6419,Kits,2,0,0.0,2
24834,6419,Stuff Packs,3,0,0.0,3
24835,6420,Expansion Packs,13,0,0.0,13
24836,6420,Game Packs,11,0,0.0,11
24837,6420,Kits,3,2,0.6666666666666666,1
24838,6420,Stuff Packs,19,1,0.05263157894736842,18
24839,6421,Expansion Packs,13,0,0.0,13
24840,6421,Game Packs,10,0,0.0,10
24841,6421,Kits,3,0,0.0,3
24842,6421,Stuff Packs,6,1,0.16666666666666666,5
24843,6422,Expansion Packs,15,0,0.0,15
24844,6422,Game Packs,12,0,0.0,12
24845,6422,Kits,3,1,0.3333333333333333,2
24846,6422,Stuff Packs,20,0,0.0,20
24847,6423,Expansion Packs,10,0,0.0,10
24848,6423,Game Packs,3,0,0.0,3
24849,6423,Kits,11,1,0.09090909090909091,10
24850,6423,Stuff Packs,8,1,0.125,7
24851,6424,Expansion Packs,8,0,0.0,8
24852,6424,Game Packs,8,1,0.125,7
24853,6424,Stuff Packs,9,4,0.4444444444444444,5
24854,6425,Expansion Packs,16,0,0.0,16
24855,6425,Game Packs,12,1,0.08333333333333333,11
24856,6425,Kits,33,8,0.24242424242424243,25
24857,6425,Stuff Packs,20,11,0.55,9
24858,6426,Expansion Packs,16,0,0.0,16
24859,6426,Game Packs,11,0,0.0,11
24860,6426,Kits,22,1,0.045454545454545456,21
24861,6426,Stuff Packs,20,0,0.0,20
24862,6427,Expansion Packs,13,0,0.0,13
24863,6427,Game Packs,5,0,0.0,5
24864,6427,Kits,2,2,1.0,0
24865,6427,Stuff Packs,8,1,0.125,7
24866,6428,Expansion Packs,16,0,0.0,16
24867,6428,Game Packs,12,0,0.0,12
24868,6428,Kits,24,1,0.041666666666666664,23
24869,6428,Stuff Packs,18,0,0.0,18
24870,6429,Expansion Packs,13,0,0.0,13
24871,6429,Game Packs,7,0,0.0,7
24872,6429,Kits,1,0,0.0,1
24873,6429,Stuff Packs,7,0,0.0,7
24874,6430,Expansion Packs,14,0,0.0,14
24875,6430,Game Packs,7,0,0.0,7
24876,6430,Kits,3,2,0.6666666666666666,1
24877,6430,Stuff Packs,13,0,0.0,13
24878,6431,Expansion Packs,16,0,0.0,16
24879,6431,Game Packs,12,0,0.0,12
24880,6431,Kits,33,0,0.0,33
24881,6431,Stuff Packs,20,0,0.0,20
24882,6432,Expansion Packs,16,0,0.0,16
24883,6432,Game Packs,12,0,0.0,12
24884,6432,Kits,33,1,0.030303030303030304,32
24885,6432,Stuff Packs,20,0,0.0,20
24886,6433,Expansion Packs,13,0,0.0,13
24887,6433,Game Packs,5,0,0.0,5
24888,6433,Kits,2,0,0.0,2
24889,6433,Stuff Packs,10,1,0.1,9
24890,6434,Expansion Packs,6,0,0.0,6
24891,6434,Game Packs,2,1,0.5,1
24892,6434,Kits,3,2,0.6666666666666666,1
24893,6434,Stuff Packs,6,4,0.6666666666666666,2
24894,6435,Expansion Packs,9,0,0.0,9
24895,6435,Game Packs,6,1,0.16666666666666666,5
24896,6435,Kits,3,3,1.0,0
24897,6435,Stuff Packs,6,2,0.3333333333333333,4
24898,6436,Expansion Packs,16,0,0.0,16
24899,6436,Game Packs,10,0,0.0,10
24900,6436,Kits,4,0,0.0,4
24901,6436,Stuff Packs,20,1,0.05,19
24902,6437,Expansion Packs,16,0,0.0,16
24903,6437,Game Packs,12,0,0.0,12
24904,6437,Kits,27,1,0.037037037037037035,26
24905,6437,Stuff Packs,20,0,0.0,20
24906,6438,Expansion Packs,16,0,0.0,16
24907,6438,Game Packs,7,1,0.14285714285714285,6
24908,6438,Kits,4,2,0.5,2
24909,6438,Stuff Packs,9,1,0.1111111111111111,8
24910,6439,Expansion Packs,9,0,0.0,9
24911,6439,Game Packs,3,0,0.0,3
24912,6439,Kits,3,2,0.6666666666666666,1
24913,6439,Stuff Packs,3,0,0.0,3
24914,6440,Expansion Packs,15,0,0.0,15
24915,6440,Game Packs,11,0,0.0,11
24916,6440,Kits,13,1,0.07692307692307693,12
24917,6440,Stuff Packs,20,1,0.05,19
24918,6441,Expansion Packs,8,0,0.0,8
24919,6441,Game Packs,9,0,0.0,9
24920,6441,Kits,5,1,0.2,4
24921,6441,Stuff Packs,10,0,0.0,10
24922,6442,Expansion Packs,16,0,0.0,16
24923,6442,Game Packs,9,0,0.0,9
24924,6442,Kits,31,0,0.0,31
24925,6442,Stuff Packs,17,2,0.11764705882352941,15
24926,6443,Expansion Packs,9,0,0.0,9
24927,6443,Game Packs,5,1,0.2,4
24928,6443,Kits,4,2,0.5,2
24929,6443,Stuff Packs,5,3,0.6,2
24930,6444,Expansion Packs,16,0,0.0,16
24931,6444,Game Packs,12,1,0.08333333333333333,11
24932,6444,Kits,33,0,0.0,33
24933,6444,Stuff Packs,20,0,0.0,20
24934,6445,Expansion Packs,15,0,0.0,15
24935,6445,Game Packs,8,0,0.0,8
24936,6445,Kits,7,1,0.14285714285714285,6
24937,6445,Stuff Packs,12,0,0.0,12
24938,6446,Expansion Packs,7,0,0.0,7
24939,6446,Game Packs,1,0,0.0,1
24940,6446,Kits,2,2,1.0,0
24941,6446,Stuff Packs,4,3,0.75,1
24942,6447,Expansion Packs,12,0,0.0,12
24943,6447,Game Packs,5,0,0.0,5
24944,6447,Kits,1,0,0.0,1
24945,6447,Stuff Packs,5,0,0.0,5
24946,6448,Expansion Packs,16,0,0.0,16
24947,6448,Game Packs,12,0,0.0,12
24948,6448,Kits,1,1,1.0,0
24949,6448,Stuff Packs,19,0,0.0,19
24950,6449,Expansion Packs,16,0,0.0,16
24951,6449,Game Packs,12,0,0.0,12
24952,6449,Kits,20,1,0.05,19
24953,6449,Stuff Packs,20,1,0.05,19
24954,6450,Expansion Packs,15,0,0.0,15
24955,6450,Game Packs,10,0,0.0,10
24956,6450,Kits,29,0,0.0,29
24957,6450,Stuff Packs,18,0,0.0,18
24958,6451,Expansion Packs,9,0,0.0,9
24959,6451,Game Packs,4,0,0.0,4
24960,6451,Kits,13,0,0.0,13
24961,6451,Stuff Packs,14,0,0.0,14
24962,6452,Expansion Packs,16,0,0.0,16
24963,6452,Game Packs,12,0,0.0,12
24964,6452,Kits,33,0,0.0,33
24965,6452,Stuff Packs,20,0,0.0,20
24966,6453,Expansion Packs,2,1,0.5,1
24967,6453,Stuff Packs,5,5,1.0,0
24968,6454,Expansion Packs,14,0,0.0,14
24969,6454,Game Packs,10,0,0.0,10
24970,6454,Kits,14,0,0.0,14
24971,6454,Stuff Packs,18,0,0.0,18
24972,6455,Expansion Packs,8,0,0.0,8
24973,6455,Game Packs,5,1,0.2,4
24974,6455,Kits,5,2,0.4,3
24975,6455,Stuff Packs,13,3,0.23076923076923078,10
24976,6456,Kits,3,0,0.0,3
24977,6456,Stuff Packs,4,3,0.75,1
24978,6457,Expansion Packs,14,1,0.07142857142857142,13
24979,6457,Game Packs,5,0,0.0,5
24980,6457,Stuff Packs,3,0,0.0,3
24981,6458,Expansion Packs,15,0,0.0,15
24982,6458,Game Packs,5,1,0.2,4
24983,6458,Kits,3,2,0.6666666666666666,1
24984,6458,Stuff Packs,15,2,0.13333333333333333,13
24985,6459,Expansion Packs,16,0,0.0,16
24986,6459,Game Packs,12,0,0.0,12
24987,6459,Kits,33,1,0.030303030303030304,32
24988,6459,Stuff Packs,20,0,0.0,20
24989,6460,Expansion Packs,16,0,0.0,16
24990,6460,Game Packs,12,0,0.0,12
24991,6460,Kits,33,0,0.0,33
24992,6460,Stuff Packs,20,0,0.0,20
24993,6461,Expansion Packs,4,0,0.0,4
24994,6461,Game Packs,4,0,0.0,4
24995,6461,Kits,3,2,0.6666666666666666,1
24996,6461,Stuff Packs,6,3,0.5,3
24997,6462,Expansion Packs,16,0,0.0,16
24998,6462,Game Packs,12,0,0.0,12
24999,6462,Kits,33,0,0.0,33
25000,6462,Stuff Packs,20,0,0.0,20
25001,6463,Expansion Packs,3,0,0.0,3
25002,6463,Game Packs,1,1,1.0,0
25003,6463,Kits,2,2,1.0,0
25004,6463,Stuff Packs,4,4,1.0,0
25005,6464,Expansion Packs,1,0,0.0,1
25006,6464,Game Packs,1,0,0.0,1
25007,6464,Kits,2,2,1.0,0
25008,6464,Stuff Packs,1,0,0.0,1
25009,6465,Expansion Packs,2,0,0.0,2
25010,6465,Game Packs,2,0,0.0,2
25011,6465,Kits,10,0,0.0,10
25012,6465,Stuff Packs,4,1,0.25,3
25013,6466,Expansion Packs,9,0,0.0,9
25014,6466,Game Packs,6,0,0.0,6
25015,6466,Kits,2,0,0.0,2
25016,6466,Stuff Packs,6,0,0.0,6
25017,6467,Expansion Packs,16,0,0.0,16
25018,6467,Game Packs,12,0,0.0,12
25019,6467,Kits,33,0,0.0,33
25020,6467,Stuff Packs,20,0,0.0,20
25021,6468,Game Packs,1,1,1.0,0
25022,6468,Kits,3,3,1.0,0
25023,6468,Stuff Packs,3,3,1.0,0
25024,6469,Expansion Packs,16,0,0.0,16
25025,6469,Game Packs,12,1,0.08333333333333333,11
25026,6469,Kits,31,1,0.03225806451612903,30
25027,6469,Stuff Packs,20,1,0.05,19
25028,6470,Expansion Packs,10,0,0.0,10
25029,6470,Game Packs,4,1,0.25,3
25030,6470,Kits,4,3,0.75,1
25031,6470,Stuff Packs,6,4,0.6666666666666666,2
25032,6471,Expansion Packs,12,1,0.08333333333333333,11
25033,6471,Game Packs,8,0,0.0,8
25034,6471,Kits,3,1,0.3333333333333333,2
25035,6471,Stuff Packs,19,0,0.0,19
25036,6472,Expansion Packs,8,0,0.0,8
25037,6472,Game Packs,7,0,0.0,7
25038,6472,Kits,1,0,0.0,1
25039,6472,Stuff Packs,11,1,0.09090909090909091,10
25040,6473,Expansion Packs,16,0,0.0,16
25041,6473,Game Packs,11,0,0.0,11
25042,6473,Kits,28,0,0.0,28
25043,6473,Stuff Packs,20,0,0.0,20
25044,6474,Expansion Packs,15,0,0.0,15
25045,6474,Game Packs,9,0,0.0,9
25046,6474,Kits,2,0,0.0,2
25047,6474,Stuff Packs,17,0,0.0,17
25048,6475,Expansion Packs,15,0,0.0,15
25049,6475,Game Packs,11,0,0.0,11
25050,6475,Kits,10,2,0.2,8
25051,6475,Stuff Packs,20,0,0.0,20
25052,6476,Expansion Packs,16,0,0.0,16
25053,6476,Game Packs,12,0,0.0,12
25054,6476,Kits,33,0,0.0,33
25055,6476,Stuff Packs,20,0,0.0,20
25056,6477,Expansion Packs,7,0,0.0,7
25057,6477,Game Packs,1,0,0.0,1
25058,6477,Kits,1,1,1.0,0
25059,6477,Stuff Packs,4,3,0.75,1
25060,6478,Expansion Packs,8,0,0.0,8
25061,6478,Game Packs,6,0,0.0,6
25062,6478,Kits,1,1,1.0,0
25063,6478,Stuff Packs,8,3,0.375,5
25064,6479,Expansion Packs,1,0,0.0,1
25065,6479,Game Packs,3,0,0.0,3
25066,6479,Kits,1,1,1.0,0
25067,6479,Stuff Packs,4,2,0.5,2
25068,6480,Expansion Packs,15,0,0.0,15
25069,6480,Game Packs,9,0,0.0,9
25070,6480,Kits,1,1,1.0,0
25071,6480,Stuff Packs,13,0,0.0,13
25072,6481,Expansion Packs,6,0,0.0,6
25073,6481,Game Packs,3,1,0.3333333333333333,2
25074,6481,Kits,3,3,1.0,0
25075,6481,Stuff Packs,7,4,0.5714285714285714,3
25076,6482,Expansion Packs,16,0,0.0,16
25077,6482,Game Packs,12,0,0.0,12
25078,6482,Kits,28,1,0.03571428571428571,27
25079,6482,Stuff Packs,20,0,0.0,20
25080,6483,Expansion Packs,10,0,0.0,10
25081,6483,Game Packs,6,0,0.0,6
25082,6483,Stuff Packs,6,1,0.16666666666666666,5
25083,6484,Expansion Packs,16,0,0.0,16
25084,6484,Game Packs,12,0,0.0,12
25085,6484,Kits,29,1,0.034482758620689655,28
25086,6484,Stuff Packs,17,0,0.0,17
25087,6485,Expansion Packs,16,0,0.0,16
25088,6485,Game Packs,11,0,0.0,11
25089,6485,Kits,25,0,0.0,25
25090,6485,Stuff Packs,19,0,0.0,19
25091,6486,Expansion Packs,12,0,0.0,12
25092,6486,Game Packs,7,0,0.0,7
25093,6486,Kits,14,1,0.07142857142857142,13
25094,6486,Stuff Packs,15,3,0.2,12
25095,6487,Expansion Packs,15,0,0.0,15
25096,6487,Game Packs,11,0,0.0,11
25097,6487,Kits,3,1,0.3333333333333333,2
25098,6487,Stuff Packs,10,0,0.0,10
25099,6488,Expansion Packs,16,0,0.0,16
25100,6488,Game Packs,12,0,0.0,12
25101,6488,Kits,9,1,0.1111111111111111,8
25102,6488,Stuff Packs,15,3,0.2,12
25103,6489,Expansion Packs,13,0,0.0,13
25104,6489,Kits,1,1,1.0,0
25105,6489,Stuff Packs,4,3,0.75,1
25106,6490,Expansion Packs,10,0,0.0,10
25107,6490,Game Packs,5,0,0.0,5
25108,6490,Kits,3,0,0.0,3
25109,6490,Stuff Packs,4,0,0.0,4
25110,6491,Expansion Packs,11,0,0.0,11
25111,6491,Game Packs,6,0,0.0,6
25112,6491,Kits,5,1,0.2,4
25113,6491,Stuff Packs,8,1,0.125,7
25114,6492,Expansion Packs,12,0,0.0,12
25115,6492,Game Packs,11,0,0.0,11
25116,6492,Stuff Packs,13,0,0.0,13
25117,6493,Expansion Packs,16,0,0.0,16
25118,6493,Game Packs,12,0,0.0,12
25119,6493,Kits,33,1,0.030303030303030304,32
25120,6493,Stuff Packs,20,0,0.0,20
25121,6494,Expansion Packs,5,0,0.0,5
25122,6494,Game Packs,5,0,0.0,5
25123,6494,Kits,2,0,0.0,2
25124,6494,Stuff Packs,7,0,0.0,7
25125,6495,Expansion Packs,16,0,0.0,16
25126,6495,Game Packs,12,0,0.0,12
25127,6495,Kits,33,0,0.0,33
25128,6495,Stuff Packs,20,0,0.0,20
25129,6496,Expansion Packs,16,0,0.0,16
25130,6496,Game Packs,12,0,0.0,12
25131,6496,Kits,31,0,0.0,31
25132,6496,Stuff Packs,20,0,0.0,20
25133,6497,Expansion Packs,16,0,0.0,16
25134,6497,Game Packs,9,0,0.0,9
25135,6497,Kits,18,0,0.0,18
25136,6497,Stuff Packs,15,2,0.13333333333333333,13
25137,6498,Expansion Packs,5,0,0.0,5
25138,6498,Game Packs,3,1,0.3333333333333333,2
25139,6498,Kits,3,2,0.6666666666666666,1
25140,6498,Stuff Packs,6,4,0.6666666666666666,2
25141,6499,Expansion Packs,10,0,0.0,10
25142,6499,Game Packs,9,0,0.0,9
25143,6499,Stuff Packs,14,0,0.0,14
25144,6500,Expansion Packs,13,0,0.0,13
25145,6500,Game Packs,7,0,0.0,7
25146,6500,Kits,3,2,0.6666666666666666,1
25147,6500,Stuff Packs,8,1,0.125,7
25148,6501,Expansion Packs,16,0,0.0,16
25149,6501,Game Packs,12,0,0.0,12
25150,6501,Kits,33,0,0.0,33
25151,6501,Stuff Packs,20,0,0.0,20
25152,6502,Expansion Packs,14,0,0.0,14
25153,6502,Game Packs,6,0,0.0,6
25154,6502,Kits,5,2,0.4,3
25155,6502,Stuff Packs,9,2,0.2222222222222222,7
25156,6503,Expansion Packs,15,0,0.0,15
25157,6503,Game Packs,11,0,0.0,11
25158,6503,Kits,7,0,0.0,7
25159,6503,Stuff Packs,16,0,0.0,16
25160,6504,Expansion Packs,10,0,0.0,10
25161,6504,Game Packs,3,0,0.0,3
25162,6504,Kits,5,2,0.4,3
25163,6504,Stuff Packs,3,2,0.6666666666666666,1
25164,6505,Expansion Packs,10,0,0.0,10
25165,6505,Game Packs,3,0,0.0,3
25166,6505,Kits,1,1,1.0,0
25167,6505,Stuff Packs,3,2,0.6666666666666666,1
25168,6506,Expansion Packs,3,0,0.0,3
25169,6506,Stuff Packs,1,1,1.0,0
25170,6507,Expansion Packs,16,0,0.0,16
25171,6507,Game Packs,12,0,0.0,12
25172,6507,Kits,15,1,0.06666666666666667,14
25173,6507,Stuff Packs,20,0,0.0,20
25174,6508,Expansion Packs,16,0,0.0,16
25175,6508,Game Packs,12,0,0.0,12
25176,6508,Kits,15,2,0.13333333333333333,13
25177,6508,Stuff Packs,20,2,0.1,18
25178,6509,Expansion Packs,15,0,0.0,15
25179,6509,Game Packs,12,0,0.0,12
25180,6509,Kits,9,3,0.3333333333333333,6
25181,6509,Stuff Packs,15,2,0.13333333333333333,13
25182,6510,Expansion Packs,13,0,0.0,13
25183,6510,Game Packs,7,1,0.14285714285714285,6
25184,6510,Kits,14,1,0.07142857142857142,13
25185,6510,Stuff Packs,14,2,0.14285714285714285,12
25186,6511,Expansion Packs,6,0,0.0,6
25187,6511,Game Packs,2,0,0.0,2
25188,6512,Expansion Packs,16,0,0.0,16
25189,6512,Game Packs,12,0,0.0,12
25190,6512,Kits,16,1,0.0625,15
25191,6512,Stuff Packs,20,0,0.0,20
25192,6513,Expansion Packs,12,0,0.0,12
25193,6513,Game Packs,8,0,0.0,8
25194,6513,Kits,2,2,1.0,0
25195,6513,Stuff Packs,6,1,0.16666666666666666,5
25196,6514,Expansion Packs,16,0,0.0,16
25197,6514,Game Packs,11,0,0.0,11
25198,6514,Kits,14,1,0.07142857142857142,13
25199,6514,Stuff Packs,14,1,0.07142857142857142,13
25200,6515,Expansion Packs,11,0,0.0,11
25201,6515,Game Packs,5,0,0.0,5
25202,6515,Kits,3,1,0.3333333333333333,2
25203,6515,Stuff Packs,12,0,0.0,12
25204,6516,Game Packs,1,1,1.0,0
25205,6516,Kits,3,3,1.0,0
25206,6516,Stuff Packs,4,4,1.0,0
25207,6517,Expansion Packs,16,0,0.0,16
25208,6517,Game Packs,12,0,0.0,12
25209,6517,Kits,31,1,0.03225806451612903,30
25210,6517,Stuff Packs,19,0,0.0,19
25211,6518,Expansion Packs,16,0,0.0,16
25212,6518,Game Packs,10,0,0.0,10
25213,6518,Kits,2,0,0.0,2
25214,6518,Stuff Packs,15,0,0.0,15
25215,6519,Expansion Packs,16,0,0.0,16
25216,6519,Game Packs,12,0,0.0,12
25217,6519,Kits,33,0,0.0,33
25218,6519,Stuff Packs,20,0,0.0,20
25219,6520,Expansion Packs,11,0,0.0,11
25220,6520,Game Packs,5,0,0.0,5
25221,6520,Kits,16,3,0.1875,13
25222,6520,Stuff Packs,8,3,0.375,5
25223,6521,Expansion Packs,2,0,0.0,2
25224,6521,Stuff Packs,2,0,0.0,2
25225,6522,Expansion Packs,15,0,0.0,15
25226,6522,Game Packs,7,0,0.0,7
25227,6522,Kits,3,3,1.0,0
25228,6522,Stuff Packs,16,2,0.125,14
25229,6523,Expansion Packs,14,0,0.0,14
25230,6523,Game Packs,11,0,0.0,11
25231,6523,Kits,2,0,0.0,2
25232,6523,Stuff Packs,17,0,0.0,17
25233,6524,Expansion Packs,15,0,0.0,15
25234,6524,Game Packs,12,0,0.0,12
25235,6524,Kits,23,1,0.043478260869565216,22
25236,6524,Stuff Packs,19,0,0.0,19
25237,6525,Expansion Packs,12,0,0.0,12
25238,6525,Game Packs,8,0,0.0,8
25239,6525,Kits,11,1,0.09090909090909091,10
25240,6525,Stuff Packs,10,2,0.2,8
25241,6526,Expansion Packs,16,1,0.0625,15
25242,6526,Game Packs,12,0,0.0,12
25243,6526,Kits,23,1,0.043478260869565216,22
25244,6526,Stuff Packs,18,0,0.0,18
25245,6527,Expansion Packs,3,0,0.0,3
25246,6527,Game Packs,2,0,0.0,2
25247,6527,Kits,2,0,0.0,2
25248,6527,Stuff Packs,4,2,0.5,2
25249,6528,Expansion Packs,15,0,0.0,15
25250,6528,Game Packs,12,0,0.0,12
25251,6528,Kits,4,2,0.5,2
25252,6528,Stuff Packs,20,1,0.05,19
25253,6529,Expansion Packs,16,1,0.0625,15
25254,6529,Game Packs,12,0,0.0,12
25255,6529,Kits,18,0,0.0,18
25256,6529,Stuff Packs,20,0,0.0,20
25257,6530,Expansion Packs,6,0,0.0,6
25258,6530,Game Packs,4,0,0.0,4
25259,6530,Kits,7,2,0.2857142857142857,5
25260,6530,Stuff Packs,8,4,0.5,4
25261,6531,Expansion Packs,11,0,0.0,11
25262,6531,Game Packs,9,0,0.0,9
25263,6531,Kits,4,3,0.75,1
25264,6531,Stuff Packs,13,2,0.15384615384615385,11
25265,6532,Expansion Packs,14,0,0.0,14
25266,6532,Game Packs,11,0,0.0,11
25267,6532,Kits,13,1,0.07692307692307693,12
25268,6532,Stuff Packs,12,0,0.0,12
25269,6533,Expansion Packs,15,0,0.0,15
25270,6533,Game Packs,12,0,0.0,12
25271,6533,Kits,27,1,0.037037037037037035,26
25272,6533,Stuff Packs,20,0,0.0,20
25273,6534,Expansion Packs,11,0,0.0,11
25274,6534,Game Packs,7,0,0.0,7
25275,6534,Kits,8,0,0.0,8
25276,6534,Stuff Packs,10,0,0.0,10
25277,6535,Expansion Packs,11,0,0.0,11
25278,6535,Game Packs,5,0,0.0,5
25279,6535,Kits,1,1,1.0,0
25280,6535,Stuff Packs,8,3,0.375,5
25281,6536,Expansion Packs,13,0,0.0,13
25282,6536,Game Packs,10,0,0.0,10
25283,6536,Kits,2,2,1.0,0
25284,6536,Stuff Packs,16,3,0.1875,13
25285,6537,Expansion Packs,12,0,0.0,12
25286,6537,Game Packs,7,0,0.0,7
25287,6537,Kits,2,2,1.0,0
25288,6537,Stuff Packs,8,2,0.25,6
25289,6538,Expansion Packs,6,0,0.0,6
25290,6538,Game Packs,1,0,0.0,1
25291,6538,Kits,2,0,0.0,2
25292,6538,Stuff Packs,4,0,0.0,4
25293,6539,Expansion Packs,4,0,0.0,4
25294,6539,Game Packs,2,0,0.0,2
25295,6539,Kits,8,0,0.0,8
25296,6539,Stuff Packs,8,3,0.375,5
25297,6540,Expansion Packs,16,0,0.0,16
25298,6540,Game Packs,12,0,0.0,12
25299,6540,Kits,33,0,0.0,33
25300,6540,Stuff Packs,20,0,0.0,20
25301,6541,Expansion Packs,13,0,0.0,13
25302,6541,Game Packs,6,0,0.0,6
25303,6541,Kits,3,0,0.0,3
25304,6541,Stuff Packs,12,0,0.0,12
25305,6542,Expansion Packs,7,0,0.0,7
25306,6542,Game Packs,3,0,0.0,3
25307,6542,Kits,9,0,0.0,9
25308,6542,Stuff Packs,9,1,0.1111111111111111,8
25309,6543,Expansion Packs,14,0,0.0,14
25310,6543,Game Packs,7,0,0.0,7
25311,6543,Kits,2,2,1.0,0
25312,6543,Stuff Packs,17,2,0.11764705882352941,15
25313,6544,Expansion Packs,15,0,0.0,15
25314,6544,Game Packs,3,0,0.0,3
25315,6544,Kits,5,0,0.0,5
25316,6544,Stuff Packs,7,2,0.2857142857142857,5
25317,6545,Expansion Packs,6,0,0.0,6
25318,6545,Game Packs,1,0,0.0,1
25319,6545,Kits,1,0,0.0,1
25320,6545,Stuff Packs,1,0,0.0,1
25321,6546,Expansion Packs,15,0,0.0,15
25322,6546,Game Packs,8,1,0.125,7
25323,6546,Kits,7,3,0.42857142857142855,4
25324,6546,Stuff Packs,13,3,0.23076923076923078,10
25325,6547,Expansion Packs,10,0,0.0,10
25326,6547,Game Packs,9,0,0.0,9
25327,6547,Kits,2,2,1.0,0
25328,6547,Stuff Packs,15,0,0.0,15
25329,6548,Expansion Packs,15,0,0.0,15
25330,6548,Game Packs,8,0,0.0,8
25331,6548,Kits,2,1,0.5,1
25332,6548,Stuff Packs,13,0,0.0,13
25333,6549,Expansion Packs,9,0,0.0,9
25334,6549,Game Packs,7,0,0.0,7
25335,6549,Kits,4,2,0.5,2
25336,6549,Stuff Packs,9,2,0.2222222222222222,7
25337,6550,Expansion Packs,16,1,0.0625,15
25338,6550,Game Packs,12,0,0.0,12
25339,6550,Kits,33,2,0.06060606060606061,31
25340,6550,Stuff Packs,20,0,0.0,20
25341,6551,Expansion Packs,16,0,0.0,16
25342,6551,Game Packs,7,0,0.0,7
25343,6551,Kits,2,2,1.0,0
25344,6551,Stuff Packs,13,1,0.07692307692307693,12
25345,6552,Expansion Packs,7,0,0.0,7
25346,6552,Game Packs,4,1,0.25,3
25347,6552,Kits,1,1,1.0,0
25348,6552,Stuff Packs,3,0,0.0,3
25349,6553,Expansion Packs,16,0,0.0,16
25350,6553,Game Packs,12,0,0.0,12
25351,6553,Kits,2,0,0.0,2
25352,6553,Stuff Packs,6,0,0.0,6
25353,6554,Expansion Packs,15,0,0.0,15
25354,6554,Game Packs,12,0,0.0,12
25355,6554,Kits,33,0,0.0,33
25356,6554,Stuff Packs,20,0,0.0,20
25357,6555,Expansion Packs,16,0,0.0,16
25358,6555,Game Packs,12,0,0.0,12
25359,6555,Kits,26,1,0.038461538461538464,25
25360,6555,Stuff Packs,20,0,0.0,20
25361,6556,Expansion Packs,16,0,0.0,16
25362,6556,Game Packs,11,0,0.0,11
25363,6556,Kits,13,1,0.07692307692307693,12
25364,6556,Stuff Packs,14,1,0.07142857142857142,13
25365,6557,Expansion Packs,16,0,0.0,16
25366,6557,Game Packs,11,0,0.0,11
25367,6557,Kits,10,1,0.1,9
25368,6557,Stuff Packs,20,0,0.0,20
25369,6558,Expansion Packs,6,0,0.0,6
25370,6558,Game Packs,2,0,0.0,2
25371,6558,Kits,18,1,0.05555555555555555,17
25372,6558,Stuff Packs,15,0,0.0,15
25373,6559,Expansion Packs,16,0,0.0,16
25374,6559,Game Packs,12,0,0.0,12
25375,6559,Kits,31,0,0.0,31
25376,6559,Stuff Packs,20,0,0.0,20
25377,6560,Expansion Packs,11,0,0.0,11
25378,6560,Game Packs,6,0,0.0,6
25379,6560,Kits,6,2,0.3333333333333333,4
25380,6560,Stuff Packs,8,2,0.25,6
25381,6561,Expansion Packs,16,0,0.0,16
25382,6561,Game Packs,11,0,0.0,11
25383,6561,Kits,21,0,0.0,21
25384,6561,Stuff Packs,20,0,0.0,20
25385,6562,Expansion Packs,12,0,0.0,12
25386,6562,Game Packs,7,0,0.0,7
25387,6562,Kits,2,1,0.5,1
25388,6562,Stuff Packs,4,0,0.0,4
25389,6563,Expansion Packs,16,0,0.0,16
25390,6563,Game Packs,12,0,0.0,12
25391,6563,Kits,6,0,0.0,6
25392,6563,Stuff Packs,20,0,0.0,20
25393,6564,Expansion Packs,15,0,0.0,15
25394,6564,Game Packs,11,0,0.0,11
25395,6564,Kits,2,1,0.5,1
25396,6564,Stuff Packs,11,0,0.0,11
25397,6565,Expansion Packs,14,0,0.0,14
25398,6565,Game Packs,10,0,0.0,10
25399,6565,Kits,20,0,0.0,20
25400,6565,Stuff Packs,16,0,0.0,16
25401,6566,Expansion Packs,14,0,0.0,14
25402,6566,Game Packs,10,0,0.0,10
25403,6566,Stuff Packs,12,0,0.0,12
25404,6567,Expansion Packs,12,0,0.0,12
25405,6567,Game Packs,8,0,0.0,8
25406,6567,Kits,11,1,0.09090909090909091,10
25407,6567,Stuff Packs,6,3,0.5,3
25408,6568,Expansion Packs,5,0,0.0,5
25409,6568,Game Packs,4,0,0.0,4
25410,6568,Kits,2,2,1.0,0
25411,6568,Stuff Packs,5,1,0.2,4
25412,6569,Expansion Packs,15,0,0.0,15
25413,6569,Game Packs,11,0,0.0,11
25414,6569,Kits,9,3,0.3333333333333333,6
25415,6569,Stuff Packs,19,1,0.05263157894736842,18
25416,6570,Expansion Packs,4,0,0.0,4
25417,6570,Game Packs,1,0,0.0,1
25418,6570,Stuff Packs,3,2,0.6666666666666666,1
25419,6571,Expansion Packs,16,0,0.0,16
25420,6571,Game Packs,12,0,0.0,12
25421,6571,Kits,33,1,0.030303030303030304,32
25422,6571,Stuff Packs,20,0,0.0,20
25423,6572,Expansion Packs,6,0,0.0,6
25424,6572,Game Packs,4,1,0.25,3
25425,6572,Kits,2,2,1.0,0
25426,6572,Stuff Packs,7,4,0.5714285714285714,3
25427,6573,Expansion Packs,15,0,0.0,15
25428,6573,Game Packs,6,0,0.0,6
25429,6573,Kits,5,1,0.2,4
25430,6573,Stuff Packs,8,2,0.25,6
25431,6574,Expansion Packs,16,0,0.0,16
25432,6574,Game Packs,12,0,0.0,12
25433,6574,Kits,4,2,0.5,2
25434,6574,Stuff Packs,20,0,0.0,20
25435,6575,Expansion Packs,16,0,0.0,16
25436,6575,Game Packs,12,0,0.0,12
25437,6575,Kits,31,1,0.03225806451612903,30
25438,6575,Stuff Packs,20,0,0.0,20
25439,6576,Expansion Packs,15,0,0.0,15
25440,6576,Game Packs,12,0,0.0,12
25441,6576,Kits,12,2,0.16666666666666666,10
25442,6576,Stuff Packs,18,1,0.05555555555555555,17
25443,6577,Expansion Packs,9,0,0.0,9
25444,6577,Game Packs,5,0,0.0,5
25445,6577,Kits,11,0,0.0,11
25446,6577,Stuff Packs,9,0,0.0,9
25447,6578,Expansion Packs,8,0,0.0,8
25448,6578,Game Packs,5,0,0.0,5
25449,6578,Kits,16,0,0.0,16
25450,6578,Stuff Packs,8,0,0.0,8
25451,6579,Expansion Packs,7,0,0.0,7
25452,6579,Game Packs,4,0,0.0,4
25453,6579,Kits,2,2,1.0,0
25454,6579,Stuff Packs,4,3,0.75,1
25455,6580,Expansion Packs,16,0,0.0,16
25456,6580,Game Packs,11,0,0.0,11
25457,6580,Kits,32,0,0.0,32
25458,6580,Stuff Packs,20,0,0.0,20
25459,6581,Expansion Packs,16,0,0.0,16
25460,6581,Game Packs,12,0,0.0,12
25461,6581,Kits,32,1,0.03125,31
25462,6581,Stuff Packs,20,0,0.0,20
25463,6582,Expansion Packs,16,0,0.0,16
25464,6582,Game Packs,12,0,0.0,12
25465,6582,Kits,29,0,0.0,29
25466,6582,Stuff Packs,20,0,0.0,20
25467,6583,Expansion Packs,16,0,0.0,16
25468,6583,Game Packs,12,0,0.0,12
25469,6583,Kits,23,0,0.0,23
25470,6583,Stuff Packs,20,0,0.0,20
25471,6584,Expansion Packs,16,0,0.0,16
25472,6584,Game Packs,11,0,0.0,11
25473,6584,Kits,14,1,0.07142857142857142,13
25474,6584,Stuff Packs,20,0,0.0,20
25475,6585,Expansion Packs,16,0,0.0,16
25476,6585,Game Packs,11,0,0.0,11
25477,6585,Kits,27,1,0.037037037037037035,26
25478,6585,Stuff Packs,20,0,0.0,20
25479,6586,Expansion Packs,7,0,0.0,7
25480,6586,Game Packs,3,1,0.3333333333333333,2
25481,6586,Kits,5,1,0.2,4
25482,6586,Stuff Packs,11,4,0.36363636363636365,7
25483,6587,Expansion Packs,16,0,0.0,16
25484,6587,Game Packs,10,1,0.1,9
25485,6587,Kits,9,1,0.1111111111111111,8
25486,6587,Stuff Packs,12,3,0.25,9
25487,6588,Expansion Packs,16,0,0.0,16
25488,6588,Game Packs,11,2,0.18181818181818182,9
25489,6588,Kits,33,6,0.18181818181818182,27
25490,6588,Stuff Packs,20,7,0.35,13
25491,6589,Expansion Packs,16,0,0.0,16
25492,6589,Game Packs,5,0,0.0,5
25493,6589,Kits,4,1,0.25,3
25494,6589,Stuff Packs,7,3,0.42857142857142855,4
25495,6590,Expansion Packs,2,0,0.0,2
25496,6590,Game Packs,2,0,0.0,2
25497,6590,Stuff Packs,3,1,0.3333333333333333,2
25498,6591,Expansion Packs,16,0,0.0,16
25499,6591,Game Packs,11,0,0.0,11
25500,6591,Kits,7,1,0.14285714285714285,6
25501,6591,Stuff Packs,13,1,0.07692307692307693,12
25502,6592,Expansion Packs,15,0,0.0,15
25503,6592,Game Packs,7,1,0.14285714285714285,6
25504,6592,Kits,2,2,1.0,0
25505,6592,Stuff Packs,18,0,0.0,18
25506,6593,Expansion Packs,16,0,0.0,16
25507,6593,Game Packs,11,0,0.0,11
25508,6593,Kits,4,2,0.5,2
25509,6593,Stuff Packs,8,4,0.5,4
25510,6594,Expansion Packs,13,0,0.0,13
25511,6594,Game Packs,4,0,0.0,4
25512,6594,Kits,6,1,0.16666666666666666,5
25513,6594,Stuff Packs,7,1,0.14285714285714285,6
25514,6595,Expansion Packs,16,0,0.0,16
25515,6595,Game Packs,11,0,0.0,11
25516,6595,Kits,16,1,0.0625,15
25517,6595,Stuff Packs,20,0,0.0,20
25518,6596,Expansion Packs,9,0,0.0,9
25519,6596,Game Packs,2,0,0.0,2
25520,6596,Kits,1,0,0.0,1
25521,6596,Stuff Packs,7,3,0.42857142857142855,4
25522,6597,Expansion Packs,11,0,0.0,11
25523,6597,Game Packs,10,0,0.0,10
25524,6597,Kits,3,2,0.6666666666666666,1
25525,6597,Stuff Packs,14,1,0.07142857142857142,13
25526,6598,Expansion Packs,12,0,0.0,12
25527,6598,Game Packs,10,0,0.0,10
25528,6598,Kits,1,1,1.0,0
25529,6598,Stuff Packs,7,1,0.14285714285714285,6
25530,6599,Expansion Packs,11,0,0.0,11
25531,6599,Game Packs,3,0,0.0,3
25532,6599,Kits,10,1,0.1,9
25533,6599,Stuff Packs,8,0,0.0,8
25534,6600,Expansion Packs,16,0,0.0,16
25535,6600,Game Packs,12,0,0.0,12
25536,6600,Kits,33,0,0.0,33
25537,6600,Stuff Packs,20,0,0.0,20
25538,6601,Expansion Packs,16,0,0.0,16
25539,6601,Game Packs,12,0,0.0,12
25540,6601,Kits,4,2,0.5,2
25541,6601,Stuff Packs,20,0,0.0,20
25542,6602,Expansion Packs,6,0,0.0,6
25543,6602,Game Packs,3,0,0.0,3
25544,6602,Kits,4,0,0.0,4
25545,6602,Stuff Packs,9,2,0.2222222222222222,7
25546,6603,Expansion Packs,16,0,0.0,16
25547,6603,Game Packs,11,0,0.0,11
25548,6603,Kits,18,1,0.05555555555555555,17
25549,6603,Stuff Packs,19,1,0.05263157894736842,18
25550,6604,Expansion Packs,15,0,0.0,15
25551,6604,Game Packs,10,0,0.0,10
25552,6604,Kits,6,1,0.16666666666666666,5
25553,6604,Stuff Packs,15,2,0.13333333333333333,13
25554,6605,Expansion Packs,6,0,0.0,6
25555,6605,Game Packs,5,0,0.0,5
25556,6605,Kits,2,2,1.0,0
25557,6605,Stuff Packs,9,1,0.1111111111111111,8
25558,6606,Expansion Packs,8,0,0.0,8
25559,6606,Game Packs,7,0,0.0,7
25560,6606,Kits,8,0,0.0,8
25561,6606,Stuff Packs,12,3,0.25,9
25562,6607,Expansion Packs,10,0,0.0,10
25563,6607,Game Packs,6,1,0.16666666666666666,5
25564,6607,Kits,2,1,0.5,1
25565,6607,Stuff Packs,9,3,0.3333333333333333,6
25566,6608,Expansion Packs,16,0,0.0,16
25567,6608,Game Packs,12,0,0.0,12
25568,6608,Kits,33,0,0.0,33
25569,6608,Stuff Packs,20,0,0.0,20
25570,6609,Expansion Packs,16,0,0.0,16
25571,6609,Game Packs,11,0,0.0,11
25572,6609,Kits,6,1,0.16666666666666666,5
25573,6609,Stuff Packs,6,0,0.0,6
25574,6610,Expansion Packs,16,0,0.0,16
25575,6610,Game Packs,12,0,0.0,12
25576,6610,Kits,30,0,0.0,30
25577,6610,Stuff Packs,16,0,0.0,16
25578,6611,Expansion Packs,11,0,0.0,11
25579,6611,Game Packs,4,0,0.0,4
25580,6611,Kits,4,0,0.0,4
25581,6611,Stuff Packs,9,3,0.3333333333333333,6
25582,6612,Expansion Packs,9,0,0.0,9
25583,6612,Game Packs,7,0,0.0,7
25584,6612,Kits,8,1,0.125,7
25585,6612,Stuff Packs,13,2,0.15384615384615385,11
25586,6613,Expansion Packs,16,0,0.0,16
25587,6613,Game Packs,11,0,0.0,11
25588,6613,Kits,9,0,0.0,9
25589,6613,Stuff Packs,20,1,0.05,19
25590,6614,Expansion Packs,14,0,0.0,14
25591,6614,Game Packs,11,0,0.0,11
25592,6614,Kits,8,2,0.25,6
25593,6614,Stuff Packs,11,1,0.09090909090909091,10
25594,6615,Expansion Packs,7,0,0.0,7
25595,6616,Expansion Packs,16,0,0.0,16
25596,6616,Game Packs,12,0,0.0,12
25597,6616,Kits,29,1,0.034482758620689655,28
25598,6616,Stuff Packs,20,0,0.0,20
25599,6617,Expansion Packs,8,0,0.0,8
25600,6617,Game Packs,2,0,0.0,2
25601,6617,Stuff Packs,2,0,0.0,2
25602,6618,Expansion Packs,16,0,0.0,16
25603,6618,Game Packs,11,0,0.0,11
25604,6618,Kits,7,1,0.14285714285714285,6
25605,6618,Stuff Packs,20,0,0.0,20
25606,6619,Expansion Packs,16,0,0.0,16
25607,6619,Game Packs,11,0,0.0,11
25608,6619,Kits,20,3,0.15,17
25609,6619,Stuff Packs,20,1,0.05,19
25610,6620,Expansion Packs,13,0,0.0,13
25611,6620,Game Packs,6,1,0.16666666666666666,5
25612,6620,Kits,13,1,0.07692307692307693,12
25613,6620,Stuff Packs,10,3,0.3,7
25614,6621,Expansion Packs,16,0,0.0,16
25615,6621,Game Packs,12,0,0.0,12
25616,6621,Kits,22,0,0.0,22
25617,6621,Stuff Packs,20,0,0.0,20
25618,6622,Expansion Packs,9,0,0.0,9
25619,6622,Game Packs,6,0,0.0,6
25620,6622,Kits,1,1,1.0,0
25621,6622,Stuff Packs,11,1,0.09090909090909091,10
25622,6623,Expansion Packs,16,0,0.0,16
25623,6623,Game Packs,12,1,0.08333333333333333,11
25624,6623,Kits,33,1,0.030303030303030304,32
25625,6623,Stuff Packs,20,1,0.05,19
25626,6624,Expansion Packs,15,0,0.0,15
25627,6624,Game Packs,11,0,0.0,11
25628,6624,Kits,11,1,0.09090909090909091,10
25629,6624,Stuff Packs,19,1,0.05263157894736842,18
25630,6625,Expansion Packs,16,0,0.0,16
25631,6625,Game Packs,10,0,0.0,10
25632,6625,Kits,12,3,0.25,9
25633,6625,Stuff Packs,20,0,0.0,20
25634,6626,Expansion Packs,8,0,0.0,8
25635,6626,Game Packs,5,0,0.0,5
25636,6626,Kits,3,2,0.6666666666666666,1
25637,6626,Stuff Packs,11,0,0.0,11
25638,6627,Expansion Packs,14,0,0.0,14
25639,6627,Game Packs,6,0,0.0,6
25640,6627,Kits,5,3,0.6,2
25641,6627,Stuff Packs,15,5,0.3333333333333333,10
25642,6628,Expansion Packs,16,0,0.0,16
25643,6628,Game Packs,10,0,0.0,10
25644,6628,Kits,12,0,0.0,12
25645,6628,Stuff Packs,18,2,0.1111111111111111,16
25646,6629,Expansion Packs,14,0,0.0,14
25647,6629,Game Packs,12,0,0.0,12
25648,6629,Kits,14,2,0.14285714285714285,12
25649,6629,Stuff Packs,19,1,0.05263157894736842,18
25650,6630,Expansion Packs,14,0,0.0,14
25651,6630,Game Packs,11,1,0.09090909090909091,10
25652,6630,Kits,4,2,0.5,2
25653,6630,Stuff Packs,14,4,0.2857142857142857,10
25654,6631,Expansion Packs,14,0,0.0,14
25655,6631,Game Packs,11,0,0.0,11
25656,6631,Kits,3,3,1.0,0
25657,6631,Stuff Packs,18,0,0.0,18
25658,6632,Expansion Packs,15,0,0.0,15
25659,6632,Game Packs,6,0,0.0,6
25660,6632,Kits,7,2,0.2857142857142857,5
25661,6632,Stuff Packs,9,1,0.1111111111111111,8
25662,6633,Expansion Packs,16,0,0.0,16
25663,6633,Game Packs,7,0,0.0,7
25664,6633,Kits,8,1,0.125,7
25665,6633,Stuff Packs,11,1,0.09090909090909091,10
25666,6634,Game Packs,1,0,0.0,1
25667,6634,Kits,1,1,1.0,0
25668,6634,Stuff Packs,1,0,0.0,1
25669,6635,Expansion Packs,1,0,0.0,1
25670,6635,Game Packs,1,1,1.0,0
25671,6635,Kits,2,2,1.0,0
25672,6635,Stuff Packs,4,4,1.0,0
25673,6636,Expansion Packs,14,0,0.0,14
25674,6636,Game Packs,11,0,0.0,11
25675,6636,Kits,4,1,0.25,3
25676,6636,Stuff Packs,18,0,0.0,18
25677,6637,Expansion Packs,14,0,0.0,14
25678,6637,Game Packs,6,0,0.0,6
25679,6637,Kits,15,3,0.2,12
25680,6637,Stuff Packs,12,3,0.25,9
25681,6638,Expansion Packs,15,0,0.0,15
25682,6638,Game Packs,10,0,0.0,10
25683,6638,Kits,3,0,0.0,3
25684,6638,Stuff Packs,9,0,0.0,9
25685,6639,Expansion Packs,4,0,0.0,4
25686,6639,Kits,5,2,0.4,3
25687,6639,Stuff Packs,3,1,0.3333333333333333,2
25688,6640,Expansion Packs,11,0,0.0,11
25689,6640,Game Packs,8,0,0.0,8
25690,6640,Kits,9,2,0.2222222222222222,7
25691,6640,Stuff Packs,8,0,0.0,8
25692,6641,Expansion Packs,16,0,0.0,16
25693,6641,Game Packs,10,0,0.0,10
25694,6641,Kits,16,1,0.0625,15
25695,6641,Stuff Packs,13,2,0.15384615384615385,11
25696,6642,Expansion Packs,12,0,0.0,12
25697,6642,Game Packs,9,0,0.0,9
25698,6642,Kits,5,1,0.2,4
25699,6642,Stuff Packs,9,2,0.2222222222222222,7
25700,6643,Expansion Packs,9,0,0.0,9
25701,6643,Game Packs,6,0,0.0,6
25702,6643,Kits,8,1,0.125,7
25703,6643,Stuff Packs,10,3,0.3,7
25704,6644,Expansion Packs,16,0,0.0,16
25705,6644,Game Packs,11,0,0.0,11
25706,6644,Kits,17,1,0.058823529411764705,16
25707,6644,Stuff Packs,16,0,0.0,16
25708,6645,Expansion Packs,16,0,0.0,16
25709,6645,Game Packs,12,0,0.0,12
25710,6645,Kits,33,1,0.030303030303030304,32
25711,6645,Stuff Packs,20,1,0.05,19
25712,6646,Expansion Packs,6,0,0.0,6
25713,6646,Game Packs,4,1,0.25,3
25714,6646,Stuff Packs,4,3,0.75,1
25715,6647,Expansion Packs,16,0,0.0,16
25716,6647,Game Packs,7,0,0.0,7
25717,6647,Kits,8,1,0.125,7
25718,6647,Stuff Packs,15,2,0.13333333333333333,13
25719,6648,Expansion Packs,15,0,0.0,15
25720,6648,Game Packs,12,0,0.0,12
25721,6648,Kits,9,2,0.2222222222222222,7
25722,6648,Stuff Packs,18,0,0.0,18
25723,6649,Expansion Packs,3,0,0.0,3
25724,6649,Game Packs,1,0,0.0,1
25725,6649,Kits,4,1,0.25,3
25726,6649,Stuff Packs,4,3,0.75,1
25727,6650,Expansion Packs,11,0,0.0,11
25728,6650,Game Packs,4,0,0.0,4
25729,6650,Kits,1,1,1.0,0
25730,6650,Stuff Packs,3,2,0.6666666666666666,1
25731,6651,Expansion Packs,10,0,0.0,10
25732,6651,Game Packs,8,0,0.0,8
25733,6651,Stuff Packs,9,0,0.0,9
25734,6652,Expansion Packs,13,0,0.0,13
25735,6652,Game Packs,10,0,0.0,10
25736,6652,Kits,2,1,0.5,1
25737,6652,Stuff Packs,15,1,0.06666666666666667,14
25738,6653,Expansion Packs,16,0,0.0,16
25739,6653,Game Packs,12,0,0.0,12
25740,6653,Kits,33,0,0.0,33
25741,6653,Stuff Packs,20,0,0.0,20
25742,6654,Expansion Packs,16,0,0.0,16
25743,6654,Game Packs,12,0,0.0,12
25744,6654,Kits,30,0,0.0,30
25745,6654,Stuff Packs,20,0,0.0,20
25746,6655,Expansion Packs,3,0,0.0,3
25747,6655,Game Packs,1,0,0.0,1
25748,6655,Kits,3,0,0.0,3
25749,6655,Stuff Packs,4,1,0.25,3
25750,6656,Expansion Packs,7,0,0.0,7
25751,6656,Game Packs,4,0,0.0,4
25752,6656,Kits,3,1,0.3333333333333333,2
25753,6656,Stuff Packs,6,3,0.5,3
25754,6657,Expansion Packs,14,0,0.0,14
25755,6657,Game Packs,10,0,0.0,10
25756,6657,Kits,1,0,0.0,1
25757,6657,Stuff Packs,9,0,0.0,9
25758,6658,Expansion Packs,16,0,0.0,16
25759,6658,Game Packs,12,2,0.16666666666666666,10
25760,6658,Kits,33,1,0.030303030303030304,32
25761,6658,Stuff Packs,20,1,0.05,19
25762,6659,Expansion Packs,8,0,0.0,8
25763,6659,Game Packs,5,0,0.0,5
25764,6659,Kits,3,3,1.0,0
25765,6659,Stuff Packs,4,1,0.25,3
25766,6660,Expansion Packs,12,0,0.0,12
25767,6660,Game Packs,7,1,0.14285714285714285,6
25768,6660,Kits,3,3,1.0,0
25769,6660,Stuff Packs,8,3,0.375,5
25770,6661,Expansion Packs,1,0,0.0,1
25771,6662,Expansion Packs,2,0,0.0,2
25772,6662,Game Packs,1,1,1.0,0
25773,6662,Kits,3,3,1.0,0
25774,6662,Stuff Packs,4,4,1.0,0
25775,6663,Expansion Packs,12,0,0.0,12
25776,6663,Game Packs,6,0,0.0,6
25777,6663,Kits,1,0,0.0,1
25778,6663,Stuff Packs,8,0,0.0,8
25779,6664,Expansion Packs,6,0,0.0,6
25780,6664,Game Packs,2,0,0.0,2
25781,6664,Kits,1,1,1.0,0
25782,6664,Stuff Packs,4,3,0.75,1
25783,6665,Expansion Packs,16,0,0.0,16
25784,6665,Game Packs,11,0,0.0,11
25785,6665,Kits,25,0,0.0,25
25786,6665,Stuff Packs,16,0,0.0,16
25787,6666,Expansion Packs,5,0,0.0,5
25788,6666,Game Packs,3,0,0.0,3
25789,6666,Stuff Packs,5,3,0.6,2
25790,6667,Expansion Packs,14,0,0.0,14
25791,6667,Game Packs,8,1,0.125,7
25792,6667,Kits,9,2,0.2222222222222222,7
25793,6667,Stuff Packs,10,4,0.4,6
25794,6668,Expansion Packs,8,0,0.0,8
25795,6668,Game Packs,2,0,0.0,2
25796,6668,Kits,4,1,0.25,3
25797,6668,Stuff Packs,6,0,0.0,6
25798,6669,Expansion Packs,16,0,0.0,16
25799,6669,Game Packs,10,0,0.0,10
25800,6669,Kits,15,1,0.06666666666666667,14
25801,6669,Stuff Packs,16,0,0.0,16
25802,6670,Expansion Packs,16,0,0.0,16
25803,6670,Game Packs,12,0,0.0,12
25804,6670,Kits,23,1,0.043478260869565216,22
25805,6670,Stuff Packs,20,0,0.0,20
25806,6671,Expansion Packs,10,0,0.0,10
25807,6671,Game Packs,9,0,0.0,9
25808,6671,Kits,1,0,0.0,1
25809,6671,Stuff Packs,10,1,0.1,9
25810,6672,Expansion Packs,13,0,0.0,13
25811,6672,Game Packs,10,0,0.0,10
25812,6672,Kits,3,1,0.3333333333333333,2
25813,6672,Stuff Packs,12,0,0.0,12
25814,6673,Expansion Packs,16,12,0.75,4
25815,6673,Game Packs,12,10,0.8333333333333334,2
25816,6673,Kits,33,30,0.9090909090909091,3
25817,6673,Stuff Packs,20,17,0.85,3
25818,6674,Expansion Packs,16,0,0.0,16
25819,6674,Game Packs,12,0,0.0,12
25820,6674,Kits,33,0,0.0,33
25821,6674,Stuff Packs,20,0,0.0,20
25822,6675,Expansion Packs,14,0,0.0,14
25823,6675,Game Packs,8,1,0.125,7
25824,6675,Kits,5,3,0.6,2
25825,6675,Stuff Packs,11,4,0.36363636363636365,7
25826,6676,Expansion Packs,5,0,0.0,5
25827,6676,Game Packs,3,0,0.0,3
25828,6676,Kits,3,1,0.3333333333333333,2
25829,6676,Stuff Packs,4,1,0.25,3
25830,6677,Expansion Packs,14,0,0.0,14
25831,6677,Game Packs,9,0,0.0,9
25832,6677,Kits,5,2,0.4,3
25833,6677,Stuff Packs,13,5,0.38461538461538464,8
25834,6678,Expansion Packs,12,0,0.0,12
25835,6678,Game Packs,8,1,0.125,7
25836,6678,Kits,3,1,0.3333333333333333,2
25837,6678,Stuff Packs,6,1,0.16666666666666666,5
25838,6679,Expansion Packs,16,0,0.0,16
25839,6679,Game Packs,10,0,0.0,10
25840,6679,Stuff Packs,6,1,0.16666666666666666,5
25841,6680,Expansion Packs,16,0,0.0,16
25842,6680,Game Packs,12,0,0.0,12
25843,6680,Kits,33,1,0.030303030303030304,32
25844,6680,Stuff Packs,20,0,0.0,20
25845,6681,Expansion Packs,6,0,0.0,6
25846,6681,Game Packs,3,1,0.3333333333333333,2
25847,6681,Kits,3,3,1.0,0
25848,6681,Stuff Packs,3,3,1.0,0
25849,6682,Expansion Packs,15,0,0.0,15
25850,6682,Game Packs,8,0,0.0,8
25851,6682,Kits,11,1,0.09090909090909091,10
25852,6682,Stuff Packs,9,0,0.0,9
25853,6683,Expansion Packs,7,0,0.0,7
25854,6683,Game Packs,6,0,0.0,6
25855,6683,Kits,2,0,0.0,2
25856,6683,Stuff Packs,8,0,0.0,8
25857,6684,Expansion Packs,5,1,0.2,4
25858,6684,Game Packs,5,0,0.0,5
25859,6684,Kits,3,0,0.0,3
25860,6684,Stuff Packs,4,0,0.0,4
25861,6685,Expansion Packs,2,1,0.5,1
25862,6685,Game Packs,1,0,0.0,1
25863,6685,Stuff Packs,1,0,0.0,1
25864,6686,Expansion Packs,16,0,0.0,16
25865,6686,Game Packs,10,0,0.0,10
25866,6686,Kits,10,1,0.1,9
25867,6686,Stuff Packs,19,1,0.05263157894736842,18
25868,6687,Expansion Packs,5,0,0.0,5
25869,6687,Game Packs,4,0,0.0,4
25870,6687,Stuff Packs,2,0,0.0,2
25871,6688,Expansion Packs,13,0,0.0,13
25872,6688,Game Packs,9,0,0.0,9
25873,6688,Kits,6,1,0.16666666666666666,5
25874,6688,Stuff Packs,9,2,0.2222222222222222,7
25875,6689,Expansion Packs,7,0,0.0,7
25876,6689,Game Packs,5,0,0.0,5
25877,6689,Kits,3,1,0.3333333333333333,2
25878,6689,Stuff Packs,10,0,0.0,10
25879,6690,Expansion Packs,16,1,0.0625,15
25880,6690,Game Packs,7,0,0.0,7
25881,6690,Kits,8,0,0.0,8
25882,6690,Stuff Packs,7,1,0.14285714285714285,6
25883,6691,Expansion Packs,6,0,0.0,6
25884,6691,Game Packs,1,0,0.0,1
25885,6691,Stuff Packs,3,2,0.6666666666666666,1
25886,6692,Expansion Packs,13,0,0.0,13
25887,6692,Game Packs,6,1,0.16666666666666666,5
25888,6692,Kits,1,1,1.0,0
25889,6692,Stuff Packs,6,3,0.5,3
25890,6693,Expansion Packs,4,0,0.0,4
25891,6693,Game Packs,3,1,0.3333333333333333,2
25892,6693,Kits,4,3,0.75,1
25893,6693,Stuff Packs,3,2,0.6666666666666666,1
25894,6694,Expansion Packs,16,0,0.0,16
25895,6694,Game Packs,12,0,0.0,12
25896,6694,Kits,23,1,0.043478260869565216,22
25897,6694,Stuff Packs,20,0,0.0,20
25898,6695,Expansion Packs,16,0,0.0,16
25899,6695,Game Packs,12,0,0.0,12
25900,6695,Kits,33,0,0.0,33
25901,6695,Stuff Packs,20,0,0.0,20
25902,6696,Expansion Packs,8,0,0.0,8
25903,6696,Game Packs,5,0,0.0,5
25904,6696,Kits,3,3,1.0,0
25905,6696,Stuff Packs,8,4,0.5,4
25906,6697,Expansion Packs,11,0,0.0,11
25907,6697,Game Packs,3,0,0.0,3
25908,6697,Kits,3,1,0.3333333333333333,2
25909,6697,Stuff Packs,4,0,0.0,4
25910,6698,Expansion Packs,16,0,0.0,16
25911,6698,Game Packs,9,0,0.0,9
25912,6698,Kits,18,0,0.0,18
25913,6698,Stuff Packs,15,0,0.0,15
25914,6699,Expansion Packs,16,0,0.0,16
25915,6699,Game Packs,12,0,0.0,12
25916,6699,Kits,33,0,0.0,33
25917,6699,Stuff Packs,20,0,0.0,20
25918,6700,Expansion Packs,14,0,0.0,14
25919,6700,Game Packs,11,0,0.0,11
25920,6700,Kits,2,2,1.0,0
25921,6700,Stuff Packs,13,1,0.07692307692307693,12
25922,6701,Expansion Packs,2,0,0.0,2
25923,6701,Game Packs,3,1,0.3333333333333333,2
25924,6701,Kits,3,3,1.0,0
25925,6701,Stuff Packs,5,4,0.8,1
25926,6702,Expansion Packs,15,0,0.0,15
25927,6702,Game Packs,12,0,0.0,12
25928,6702,Kits,7,1,0.14285714285714285,6
25929,6702,Stuff Packs,20,0,0.0,20
25930,6703,Expansion Packs,16,0,0.0,16
25931,6703,Game Packs,12,0,0.0,12
25932,6703,Kits,33,1,0.030303030303030304,32
25933,6703,Stuff Packs,20,0,0.0,20
25934,6704,Expansion Packs,5,0,0.0,5
25935,6704,Game Packs,4,0,0.0,4
25936,6704,Kits,6,0,0.0,6
25937,6704,Stuff Packs,4,0,0.0,4
25938,6705,Expansion Packs,16,0,0.0,16
25939,6705,Game Packs,9,0,0.0,9
25940,6705,Kits,10,3,0.3,7
25941,6705,Stuff Packs,18,0,0.0,18
25942,6706,Expansion Packs,8,0,0.0,8
25943,6706,Game Packs,5,0,0.0,5
25944,6706,Kits,1,1,1.0,0
25945,6706,Stuff Packs,6,3,0.5,3
25946,6707,Expansion Packs,14,0,0.0,14
25947,6707,Game Packs,11,0,0.0,11
25948,6707,Kits,9,0,0.0,9
25949,6707,Stuff Packs,18,0,0.0,18
25950,6708,Expansion Packs,16,0,0.0,16
25951,6708,Game Packs,12,0,0.0,12
25952,6708,Kits,21,0,0.0,21
25953,6708,Stuff Packs,19,0,0.0,19
25954,6709,Expansion Packs,16,0,0.0,16
25955,6709,Game Packs,12,0,0.0,12
25956,6709,Kits,33,1,0.030303030303030304,32
25957,6709,Stuff Packs,20,0,0.0,20
25958,6710,Expansion Packs,13,0,0.0,13
25959,6710,Game Packs,9,0,0.0,9
25960,6710,Kits,2,1,0.5,1
25961,6710,Stuff Packs,19,0,0.0,19
25962,6711,Expansion Packs,4,0,0.0,4
25963,6711,Game Packs,4,0,0.0,4
25964,6711,Kits,1,0,0.0,1
25965,6711,Stuff Packs,4,0,0.0,4
25966,6712,Expansion Packs,16,0,0.0,16
25967,6712,Game Packs,12,0,0.0,12
25968,6712,Kits,33,0,0.0,33
25969,6712,Stuff Packs,20,0,0.0,20
25970,6713,Expansion Packs,6,0,0.0,6
25971,6713,Kits,3,2,0.6666666666666666,1
25972,6713,Stuff Packs,5,2,0.4,3
25973,6714,Expansion Packs,11,0,0.0,11
25974,6714,Game Packs,3,0,0.0,3
25975,6714,Kits,2,2,1.0,0
25976,6714,Stuff Packs,7,3,0.42857142857142855,4
25977,6715,Expansion Packs,15,0,0.0,15
25978,6715,Game Packs,12,0,0.0,12
25979,6715,Kits,30,0,0.0,30
25980,6715,Stuff Packs,20,0,0.0,20
25981,6716,Expansion Packs,13,0,0.0,13
25982,6716,Game Packs,9,0,0.0,9
25983,6716,Kits,5,0,0.0,5
25984,6716,Stuff Packs,11,2,0.18181818181818182,9
25985,6717,Expansion Packs,12,1,0.08333333333333333,11
25986,6717,Game Packs,2,0,0.0,2
25987,6717,Kits,1,1,1.0,0
25988,6717,Stuff Packs,2,0,0.0,2
25989,6718,Expansion Packs,14,0,0.0,14
25990,6718,Game Packs,9,1,0.1111111111111111,8
25991,6718,Kits,6,2,0.3333333333333333,4
25992,6718,Stuff Packs,17,3,0.17647058823529413,14
25993,6719,Expansion Packs,13,0,0.0,13
25994,6719,Game Packs,7,0,0.0,7
25995,6719,Kits,4,1,0.25,3
25996,6719,Stuff Packs,9,2,0.2222222222222222,7
25997,6720,Expansion Packs,14,0,0.0,14
25998,6720,Game Packs,6,0,0.0,6
25999,6720,Kits,2,1,0.5,1
26000,6720,Stuff Packs,8,2,0.25,6
26001,6721,Expansion Packs,6,0,0.0,6
26002,6721,Game Packs,4,0,0.0,4
26003,6721,Stuff Packs,6,3,0.5,3
26004,6722,Expansion Packs,8,0,0.0,8
26005,6722,Game Packs,4,0,0.0,4
26006,6722,Kits,6,0,0.0,6
26007,6722,Stuff Packs,5,1,0.2,4
26008,6723,Expansion Packs,16,0,0.0,16
26009,6723,Game Packs,12,0,0.0,12
26010,6723,Kits,33,0,0.0,33
26011,6723,Stuff Packs,20,0,0.0,20
26012,6724,Expansion Packs,11,0,0.0,11
26013,6724,Game Packs,9,0,0.0,9
26014,6724,Kits,2,2,1.0,0
26015,6724,Stuff Packs,18,0,0.0,18
26016,6725,Expansion Packs,16,0,0.0,16
26017,6725,Game Packs,10,2,0.2,8
26018,6725,Kits,5,0,0.0,5
26019,6725,Stuff Packs,17,0,0.0,17
26020,6726,Expansion Packs,12,0,0.0,12
26021,6726,Game Packs,5,0,0.0,5
26022,6726,Kits,2,0,0.0,2
26023,6726,Stuff Packs,11,4,0.36363636363636365,7
26024,6727,Expansion Packs,16,0,0.0,16
26025,6727,Game Packs,12,0,0.0,12
26026,6727,Kits,33,0,0.0,33
26027,6727,Stuff Packs,20,0,0.0,20
26028,6728,Expansion Packs,13,0,0.0,13
26029,6728,Game Packs,9,1,0.1111111111111111,8
26030,6728,Kits,3,3,1.0,0
26031,6728,Stuff Packs,14,3,0.21428571428571427,11
26032,6729,Expansion Packs,14,0,0.0,14
26033,6729,Game Packs,10,0,0.0,10
26034,6729,Kits,2,1,0.5,1
26035,6729,Stuff Packs,6,1,0.16666666666666666,5
26036,6730,Expansion Packs,16,0,0.0,16
26037,6730,Game Packs,12,0,0.0,12
26038,6730,Kits,33,0,0.0,33
26039,6730,Stuff Packs,20,0,0.0,20
26040,6731,Expansion Packs,13,0,0.0,13
26041,6731,Game Packs,5,1,0.2,4
26042,6731,Kits,3,0,0.0,3
26043,6731,Stuff Packs,10,6,0.6,4
26044,6732,Expansion Packs,15,0,0.0,15
26045,6732,Game Packs,8,0,0.0,8
26046,6732,Kits,9,1,0.1111111111111111,8
26047,6732,Stuff Packs,15,1,0.06666666666666667,14
26048,6733,Expansion Packs,16,0,0.0,16
26049,6733,Game Packs,11,0,0.0,11
26050,6733,Kits,31,1,0.03225806451612903,30
26051,6733,Stuff Packs,19,0,0.0,19
26052,6734,Expansion Packs,16,0,0.0,16
26053,6734,Game Packs,12,0,0.0,12
26054,6734,Kits,33,1,0.030303030303030304,32
26055,6734,Stuff Packs,20,0,0.0,20
26056,6735,Expansion Packs,15,0,0.0,15
26057,6735,Game Packs,6,1,0.16666666666666666,5
26058,6735,Kits,2,0,0.0,2
26059,6735,Stuff Packs,8,2,0.25,6
26060,6736,Expansion Packs,13,0,0.0,13
26061,6736,Game Packs,6,0,0.0,6
26062,6736,Kits,15,0,0.0,15
26063,6736,Stuff Packs,10,0,0.0,10
26064,6737,Expansion Packs,16,0,0.0,16
26065,6737,Game Packs,12,0,0.0,12
26066,6737,Kits,33,1,0.030303030303030304,32
26067,6737,Stuff Packs,20,0,0.0,20
26068,6738,Expansion Packs,15,0,0.0,15
26069,6738,Game Packs,11,0,0.0,11
26070,6738,Kits,30,0,0.0,30
26071,6738,Stuff Packs,19,0,0.0,19
26072,6739,Expansion Packs,16,0,0.0,16
26073,6739,Game Packs,11,0,0.0,11
26074,6739,Kits,23,1,0.043478260869565216,22
26075,6739,Stuff Packs,16,1,0.0625,15
26076,6740,Expansion Packs,16,0,0.0,16
26077,6740,Game Packs,12,0,0.0,12
26078,6740,Kits,20,1,0.05,19
26079,6740,Stuff Packs,20,0,0.0,20
26080,6741,Expansion Packs,12,0,0.0,12
26081,6741,Game Packs,7,0,0.0,7
26082,6741,Kits,1,1,1.0,0
26083,6741,Stuff Packs,12,1,0.08333333333333333,11
26084,6742,Expansion Packs,16,0,0.0,16
26085,6742,Game Packs,12,0,0.0,12
26086,6742,Kits,6,1,0.16666666666666666,5
26087,6742,Stuff Packs,20,0,0.0,20
26088,6743,Expansion Packs,15,0,0.0,15
26089,6743,Game Packs,10,0,0.0,10
26090,6743,Kits,9,1,0.1111111111111111,8
26091,6743,Stuff Packs,16,2,0.125,14
26092,6744,Expansion Packs,16,0,0.0,16
26093,6744,Game Packs,12,0,0.0,12
26094,6744,Kits,32,0,0.0,32
26095,6744,Stuff Packs,20,0,0.0,20
26096,6745,Expansion Packs,15,0,0.0,15
26097,6745,Game Packs,10,0,0.0,10
26098,6745,Kits,3,0,0.0,3
26099,6745,Stuff Packs,17,1,0.058823529411764705,16
26100,6746,Expansion Packs,16,1,0.0625,15
26101,6746,Game Packs,7,0,0.0,7
26102,6746,Kits,13,0,0.0,13
26103,6746,Stuff Packs,14,2,0.14285714285714285,12
26104,6747,Expansion Packs,8,1,0.125,7
26105,6747,Game Packs,3,1,0.3333333333333333,2
26106,6747,Kits,4,0,0.0,4
26107,6747,Stuff Packs,6,2,0.3333333333333333,4
26108,6748,Expansion Packs,3,0,0.0,3
26109,6748,Game Packs,2,0,0.0,2
26110,6748,Kits,1,0,0.0,1
26111,6748,Stuff Packs,1,0,0.0,1
26112,6749,Expansion Packs,16,0,0.0,16
26113,6749,Game Packs,12,0,0.0,12
26114,6749,Kits,28,1,0.03571428571428571,27
26115,6749,Stuff Packs,20,0,0.0,20
26116,6750,Expansion Packs,16,0,0.0,16
26117,6750,Game Packs,11,0,0.0,11
26118,6750,Kits,19,0,0.0,19
26119,6750,Stuff Packs,20,0,0.0,20
26120,6751,Expansion Packs,6,0,0.0,6
26121,6751,Game Packs,4,1,0.25,3
26122,6751,Kits,3,3,1.0,0
26123,6751,Stuff Packs,7,4,0.5714285714285714,3
26124,6752,Expansion Packs,14,0,0.0,14
26125,6752,Game Packs,5,0,0.0,5
26126,6752,Kits,2,0,0.0,2
26127,6752,Stuff Packs,4,0,0.0,4
26128,6753,Expansion Packs,15,0,0.0,15
26129,6753,Game Packs,10,0,0.0,10
26130,6753,Kits,12,0,0.0,12
26131,6753,Stuff Packs,19,1,0.05263157894736842,18
26132,6754,Expansion Packs,15,0,0.0,15
26133,6754,Game Packs,12,0,0.0,12
26134,6754,Kits,25,0,0.0,25
26135,6754,Stuff Packs,20,0,0.0,20
26136,6755,Expansion Packs,16,0,0.0,16
26137,6755,Game Packs,11,0,0.0,11
26138,6755,Kits,17,0,0.0,17
26139,6755,Stuff Packs,18,1,0.05555555555555555,17
26140,6756,Expansion Packs,8,1,0.125,7
26141,6756,Game Packs,6,1,0.16666666666666666,5
26142,6756,Kits,7,0,0.0,7
26143,6756,Stuff Packs,9,1,0.1111111111111111,8
26144,6757,Expansion Packs,11,0,0.0,11
26145,6757,Game Packs,6,0,0.0,6
26146,6757,Kits,2,0,0.0,2
26147,6757,Stuff Packs,5,1,0.2,4
26148,6758,Expansion Packs,6,0,0.0,6
26149,6758,Game Packs,3,0,0.0,3
26150,6758,Kits,2,2,1.0,0
26151,6758,Stuff Packs,6,0,0.0,6
26152,6759,Expansion Packs,12,0,0.0,12
26153,6759,Game Packs,4,0,0.0,4
26154,6759,Kits,11,1,0.09090909090909091,10
26155,6759,Stuff Packs,7,3,0.42857142857142855,4
26156,6760,Expansion Packs,11,0,0.0,11
26157,6760,Game Packs,10,0,0.0,10
26158,6760,Kits,1,1,1.0,0
26159,6760,Stuff Packs,16,0,0.0,16
26160,6761,Expansion Packs,16,0,0.0,16
26161,6761,Game Packs,11,0,0.0,11
26162,6761,Kits,33,1,0.030303030303030304,32
26163,6761,Stuff Packs,20,2,0.1,18
26164,6762,Expansion Packs,16,0,0.0,16
26165,6762,Game Packs,11,0,0.0,11
26166,6762,Kits,13,0,0.0,13
26167,6762,Stuff Packs,20,3,0.15,17
26168,6763,Expansion Packs,12,0,0.0,12
26169,6763,Game Packs,7,0,0.0,7
26170,6763,Kits,5,1,0.2,4
26171,6763,Stuff Packs,12,3,0.25,9
26172,6764,Expansion Packs,6,0,0.0,6
26173,6764,Game Packs,1,0,0.0,1
26174,6764,Kits,1,0,0.0,1
26175,6764,Stuff Packs,3,0,0.0,3
26176,6765,Expansion Packs,16,6,0.375,10
26177,6765,Game Packs,12,4,0.3333333333333333,8
26178,6765,Kits,33,23,0.696969696969697,10
26179,6765,Stuff Packs,20,6,0.3,14
26180,6766,Expansion Packs,16,0,0.0,16
26181,6766,Game Packs,11,1,0.09090909090909091,10
26182,6766,Kits,19,1,0.05263157894736842,18
26183,6766,Stuff Packs,20,1,0.05,19
26184,6767,Expansion Packs,5,0,0.0,5
26185,6767,Game Packs,3,1,0.3333333333333333,2
26186,6767,Kits,2,2,1.0,0
26187,6767,Stuff Packs,6,4,0.6666666666666666,2
26188,6768,Expansion Packs,16,0,0.0,16
26189,6768,Game Packs,12,0,0.0,12
26190,6768,Kits,29,0,0.0,29
26191,6768,Stuff Packs,20,0,0.0,20
26192,6769,Expansion Packs,16,1,0.0625,15
26193,6769,Game Packs,12,0,0.0,12
26194,6769,Kits,33,1,0.030303030303030304,32
26195,6769,Stuff Packs,20,0,0.0,20
26196,6770,Expansion Packs,13,0,0.0,13
26197,6770,Game Packs,12,0,0.0,12
26198,6770,Kits,13,1,0.07692307692307693,12
26199,6770,Stuff Packs,18,0,0.0,18
26200,6771,Expansion Packs,7,0,0.0,7
26201,6771,Game Packs,4,1,0.25,3
26202,6771,Kits,3,3,1.0,0
26203,6771,Stuff Packs,6,3,0.5,3
26204,6772,Expansion Packs,5,0,0.0,5
26205,6772,Game Packs,1,0,0.0,1
26206,6772,Stuff Packs,1,0,0.0,1
26207,6773,Expansion Packs,13,0,0.0,13
26208,6773,Game Packs,11,0,0.0,11
26209,6773,Kits,3,3,1.0,0
26210,6773,Stuff Packs,18,0,0.0,18
26211,6774,Expansion Packs,16,1,0.0625,15
26212,6774,Game Packs,12,0,0.0,12
26213,6774,Kits,33,2,0.06060606060606061,31
26214,6774,Stuff Packs,20,3,0.15,17
26215,6775,Expansion Packs,14,0,0.0,14
26216,6775,Game Packs,8,0,0.0,8
26217,6775,Kits,6,0,0.0,6
26218,6775,Stuff Packs,8,1,0.125,7
26219,6776,Expansion Packs,16,0,0.0,16
26220,6776,Game Packs,12,0,0.0,12
26221,6776,Kits,27,0,0.0,27
26222,6776,Stuff Packs,20,0,0.0,20
26223,6777,Expansion Packs,16,0,0.0,16
26224,6777,Game Packs,10,0,0.0,10
26225,6777,Kits,13,1,0.07692307692307693,12
26226,6777,Stuff Packs,19,2,0.10526315789473684,17
26227,6778,Expansion Packs,15,0,0.0,15
26228,6778,Game Packs,9,0,0.0,9
26229,6778,Kits,4,0,0.0,4
26230,6778,Stuff Packs,9,0,0.0,9
26231,6779,Expansion Packs,4,0,0.0,4
26232,6779,Game Packs,2,0,0.0,2
26233,6779,Stuff Packs,2,0,0.0,2
26234,6780,Expansion Packs,15,0,0.0,15
26235,6780,Game Packs,9,0,0.0,9
26236,6780,Kits,10,0,0.0,10
26237,6780,Stuff Packs,20,0,0.0,20
26238,6781,Expansion Packs,13,0,0.0,13
26239,6781,Game Packs,12,0,0.0,12
26240,6781,Kits,25,0,0.0,25
26241,6781,Stuff Packs,20,0,0.0,20
26242,6782,Expansion Packs,15,0,0.0,15
26243,6782,Game Packs,5,0,0.0,5
26244,6782,Kits,3,0,0.0,3
26245,6782,Stuff Packs,6,0,0.0,6
26246,6783,Expansion Packs,14,0,0.0,14
26247,6783,Game Packs,8,0,0.0,8
26248,6783,Kits,10,0,0.0,10
26249,6783,Stuff Packs,11,0,0.0,11
26250,6784,Expansion Packs,15,0,0.0,15
26251,6784,Game Packs,6,0,0.0,6
26252,6784,Kits,11,0,0.0,11
26253,6784,Stuff Packs,14,0,0.0,14
26254,6785,Expansion Packs,2,0,0.0,2
26255,6785,Game Packs,3,0,0.0,3
26256,6785,Kits,7,2,0.2857142857142857,5
26257,6785,Stuff Packs,6,1,0.16666666666666666,5
26258,6786,Expansion Packs,15,0,0.0,15
26259,6786,Game Packs,11,0,0.0,11
26260,6786,Kits,13,2,0.15384615384615385,11
26261,6786,Stuff Packs,17,2,0.11764705882352941,15
26262,6787,Expansion Packs,7,0,0.0,7
26263,6787,Game Packs,4,0,0.0,4
26264,6787,Kits,2,2,1.0,0
26265,6787,Stuff Packs,6,3,0.5,3
26266,6788,Expansion Packs,15,15,1.0,0
26267,6788,Game Packs,12,12,1.0,0
26268,6788,Kits,27,27,1.0,0
26269,6788,Stuff Packs,18,18,1.0,0
26270,6789,Expansion Packs,4,0,0.0,4
26271,6789,Game Packs,3,1,0.3333333333333333,2
26272,6789,Kits,2,2,1.0,0
26273,6789,Stuff Packs,2,1,0.5,1
26274,6790,Expansion Packs,16,0,0.0,16
26275,6790,Game Packs,12,0,0.0,12
26276,6790,Kits,15,0,0.0,15
26277,6790,Stuff Packs,20,0,0.0,20
26278,6791,Expansion Packs,16,0,0.0,16
26279,6791,Game Packs,12,0,0.0,12
26280,6791,Kits,28,1,0.03571428571428571,27
26281,6791,Stuff Packs,20,0,0.0,20
26282,6792,Expansion Packs,16,0,0.0,16
26283,6792,Game Packs,7,0,0.0,7
26284,6792,Kits,20,2,0.1,18
26285,6792,Stuff Packs,16,2,0.125,14
26286,6793,Expansion Packs,16,0,0.0,16
26287,6793,Game Packs,8,0,0.0,8
26288,6793,Kits,9,0,0.0,9
26289,6793,Stuff Packs,16,2,0.125,14
26290,6794,Expansion Packs,5,0,0.0,5
26291,6794,Game Packs,2,0,0.0,2
26292,6794,Stuff Packs,3,0,0.0,3
26293,6795,Expansion Packs,2,0,0.0,2
26294,6795,Game Packs,1,0,0.0,1
26295,6795,Kits,3,2,0.6666666666666666,1
26296,6795,Stuff Packs,6,3,0.5,3
26297,6796,Expansion Packs,14,0,0.0,14
26298,6796,Game Packs,7,0,0.0,7
26299,6796,Kits,17,1,0.058823529411764705,16
26300,6796,Stuff Packs,13,0,0.0,13
26301,6797,Expansion Packs,13,0,0.0,13
26302,6797,Game Packs,9,0,0.0,9
26303,6797,Kits,2,2,1.0,0
26304,6797,Stuff Packs,14,2,0.14285714285714285,12
26305,6798,Expansion Packs,16,0,0.0,16
26306,6798,Game Packs,12,0,0.0,12
26307,6798,Kits,31,0,0.0,31
26308,6798,Stuff Packs,20,0,0.0,20
26309,6799,Expansion Packs,16,0,0.0,16
26310,6799,Game Packs,11,0,0.0,11
26311,6799,Kits,27,0,0.0,27
26312,6799,Stuff Packs,18,0,0.0,18
26313,6800,Expansion Packs,8,0,0.0,8
26314,6800,Game Packs,2,1,0.5,1
26315,6800,Kits,2,2,1.0,0
26316,6800,Stuff Packs,4,3,0.75,1
26317,6801,Expansion Packs,6,0,0.0,6
26318,6801,Game Packs,6,0,0.0,6
26319,6801,Kits,5,1,0.2,4
26320,6801,Stuff Packs,11,2,0.18181818181818182,9
26321,6802,Expansion Packs,15,0,0.0,15
26322,6802,Game Packs,7,0,0.0,7
26323,6802,Kits,3,1,0.3333333333333333,2
26324,6802,Stuff Packs,9,0,0.0,9
26325,6803,Expansion Packs,13,0,0.0,13
26326,6803,Game Packs,8,0,0.0,8
26327,6803,Kits,7,2,0.2857142857142857,5
26328,6803,Stuff Packs,7,2,0.2857142857142857,5
26329,6804,Expansion Packs,12,0,0.0,12
26330,6804,Game Packs,7,0,0.0,7
26331,6804,Kits,2,0,0.0,2
26332,6804,Stuff Packs,1,0,0.0,1
26333,6805,Expansion Packs,2,0,0.0,2
26334,6805,Game Packs,3,0,0.0,3
26335,6805,Kits,1,0,0.0,1
26336,6805,Stuff Packs,2,0,0.0,2
26337,6806,Expansion Packs,16,0,0.0,16
26338,6806,Game Packs,12,0,0.0,12
26339,6806,Kits,27,0,0.0,27
26340,6806,Stuff Packs,20,0,0.0,20
26341,6807,Expansion Packs,8,0,0.0,8
26342,6807,Game Packs,2,0,0.0,2
26343,6807,Stuff Packs,2,0,0.0,2
26344,6808,Expansion Packs,4,0,0.0,4
26345,6808,Game Packs,2,0,0.0,2
26346,6808,Kits,3,0,0.0,3
26347,6808,Stuff Packs,4,0,0.0,4
26348,6809,Expansion Packs,6,0,0.0,6
26349,6809,Game Packs,7,0,0.0,7
26350,6809,Kits,2,0,0.0,2
26351,6809,Stuff Packs,8,0,0.0,8
26352,6810,Expansion Packs,14,0,0.0,14
26353,6810,Game Packs,9,0,0.0,9
26354,6810,Kits,14,1,0.07142857142857142,13
26355,6810,Stuff Packs,12,3,0.25,9
26356,6811,Expansion Packs,13,0,0.0,13
26357,6811,Game Packs,5,0,0.0,5
26358,6811,Kits,7,0,0.0,7
26359,6811,Stuff Packs,5,0,0.0,5
26360,6812,Expansion Packs,16,0,0.0,16
26361,6812,Game Packs,12,0,0.0,12
26362,6812,Kits,33,0,0.0,33
26363,6812,Stuff Packs,20,0,0.0,20
26364,6813,Expansion Packs,9,0,0.0,9
26365,6813,Game Packs,5,1,0.2,4
26366,6813,Kits,4,3,0.75,1
26367,6813,Stuff Packs,11,3,0.2727272727272727,8
26368,6814,Expansion Packs,16,0,0.0,16
26369,6814,Game Packs,10,0,0.0,10
26370,6814,Kits,30,0,0.0,30
26371,6814,Stuff Packs,19,0,0.0,19
26372,6815,Expansion Packs,7,0,0.0,7
26373,6815,Game Packs,5,0,0.0,5
26374,6815,Kits,2,2,1.0,0
26375,6815,Stuff Packs,7,2,0.2857142857142857,5
26376,6816,Expansion Packs,16,0,0.0,16
26377,6816,Game Packs,12,0,0.0,12
26378,6816,Kits,33,1,0.030303030303030304,32
26379,6816,Stuff Packs,20,0,0.0,20
26380,6817,Expansion Packs,16,0,0.0,16
26381,6817,Game Packs,12,0,0.0,12
26382,6817,Kits,33,2,0.06060606060606061,31
26383,6817,Stuff Packs,20,2,0.1,18
26384,6818,Expansion Packs,8,0,0.0,8
26385,6818,Game Packs,5,0,0.0,5
26386,6818,Kits,3,0,0.0,3
26387,6818,Stuff Packs,4,0,0.0,4
26388,6819,Expansion Packs,14,0,0.0,14
26389,6819,Game Packs,10,0,0.0,10
26390,6819,Kits,2,2,1.0,0
26391,6819,Stuff Packs,8,1,0.125,7
26392,6820,Expansion Packs,16,0,0.0,16
26393,6820,Game Packs,12,2,0.16666666666666666,10
26394,6820,Kits,12,2,0.16666666666666666,10
26395,6820,Stuff Packs,20,0,0.0,20
26396,6821,Expansion Packs,16,0,0.0,16
26397,6821,Game Packs,12,0,0.0,12
26398,6821,Kits,25,0,0.0,25
26399,6821,Stuff Packs,17,0,0.0,17
26400,6822,Expansion Packs,13,0,0.0,13
26401,6822,Game Packs,6,0,0.0,6
26402,6822,Kits,1,0,0.0,1
26403,6822,Stuff Packs,7,0,0.0,7
26404,6823,Expansion Packs,15,0,0.0,15
26405,6823,Game Packs,12,0,0.0,12
26406,6823,Kits,5,1,0.2,4
26407,6823,Stuff Packs,19,1,0.05263157894736842,18
26408,6824,Expansion Packs,15,0,0.0,15
26409,6824,Game Packs,11,0,0.0,11
26410,6824,Kits,6,0,0.0,6
26411,6824,Stuff Packs,11,1,0.09090909090909091,10
26412,6825,Expansion Packs,15,0,0.0,15
26413,6825,Game Packs,12,0,0.0,12
26414,6825,Kits,32,2,0.0625,30
26415,6825,Stuff Packs,20,0,0.0,20
26416,6826,Expansion Packs,16,0,0.0,16
26417,6826,Game Packs,11,0,0.0,11
26418,6826,Kits,21,1,0.047619047619047616,20
26419,6826,Stuff Packs,19,0,0.0,19
26420,6827,Expansion Packs,16,0,0.0,16
26421,6827,Game Packs,12,0,0.0,12
26422,6827,Kits,28,0,0.0,28
26423,6827,Stuff Packs,20,0,0.0,20
26424,6828,Expansion Packs,16,0,0.0,16
26425,6828,Game Packs,12,0,0.0,12
26426,6828,Kits,31,0,0.0,31
26427,6828,Stuff Packs,20,0,0.0,20
26428,6829,Expansion Packs,7,0,0.0,7
26429,6829,Game Packs,2,0,0.0,2
26430,6829,Stuff Packs,4,2,0.5,2
26431,6830,Expansion Packs,16,0,0.0,16
26432,6830,Game Packs,12,0,0.0,12
26433,6830,Kits,33,0,0.0,33
26434,6830,Stuff Packs,20,0,0.0,20
26435,6831,Expansion Packs,16,0,0.0,16
26436,6831,Game Packs,11,0,0.0,11
26437,6831,Kits,13,0,0.0,13
26438,6831,Stuff Packs,16,0,0.0,16
26439,6832,Expansion Packs,16,0,0.0,16
26440,6832,Game Packs,12,0,0.0,12
26441,6832,Kits,33,0,0.0,33
26442,6832,Stuff Packs,20,0,0.0,20
26443,6833,Expansion Packs,14,0,0.0,14
26444,6833,Game Packs,12,0,0.0,12
26445,6833,Kits,2,2,1.0,0
26446,6833,Stuff Packs,20,0,0.0,20
26447,6834,Expansion Packs,6,0,0.0,6
26448,6834,Game Packs,3,0,0.0,3
26449,6834,Kits,5,0,0.0,5
26450,6834,Stuff Packs,3,0,0.0,3
26451,6835,Expansion Packs,16,0,0.0,16
26452,6835,Game Packs,12,0,0.0,12
26453,6835,Kits,20,0,0.0,20
26454,6835,Stuff Packs,20,0,0.0,20
26455,6836,Expansion Packs,7,0,0.0,7
26456,6836,Game Packs,1,0,0.0,1
26457,6836,Kits,1,1,1.0,0
26458,6836,Stuff Packs,3,2,0.6666666666666666,1
26459,6837,Expansion Packs,16,0,0.0,16
26460,6837,Game Packs,12,0,0.0,12
26461,6837,Kits,30,0,0.0,30
26462,6837,Stuff Packs,20,0,0.0,20
26463,6838,Expansion Packs,12,0,0.0,12
26464,6838,Game Packs,8,0,0.0,8
26465,6838,Kits,2,2,1.0,0
26466,6838,Stuff Packs,10,1,0.1,9
26467,6839,Expansion Packs,6,0,0.0,6
26468,6839,Game Packs,1,0,0.0,1
26469,6839,Kits,1,0,0.0,1
26470,6839,Stuff Packs,3,1,0.3333333333333333,2
26471,6840,Expansion Packs,7,0,0.0,7
26472,6840,Game Packs,3,0,0.0,3
26473,6840,Stuff Packs,1,0,0.0,1
26474,6841,Expansion Packs,13,0,0.0,13
26475,6841,Game Packs,5,0,0.0,5
26476,6841,Kits,3,2,0.6666666666666666,1
26477,6841,Stuff Packs,14,2,0.14285714285714285,12
26478,6842,Expansion Packs,15,0,0.0,15
26479,6842,Game Packs,6,0,0.0,6
26480,6842,Kits,6,1,0.16666666666666666,5
26481,6842,Stuff Packs,10,3,0.3,7
26482,6843,Expansion Packs,9,0,0.0,9
26483,6843,Game Packs,5,0,0.0,5
26484,6844,Expansion Packs,15,0,0.0,15
26485,6844,Game Packs,8,0,0.0,8
26486,6844,Kits,3,0,0.0,3
26487,6844,Stuff Packs,13,1,0.07692307692307693,12
26488,6845,Expansion Packs,9,0,0.0,9
26489,6845,Game Packs,8,0,0.0,8
26490,6845,Kits,18,0,0.0,18
26491,6845,Stuff Packs,16,0,0.0,16
26492,6846,Expansion Packs,4,0,0.0,4
26493,6846,Kits,1,1,1.0,0
26494,6847,Expansion Packs,15,0,0.0,15
26495,6847,Game Packs,9,0,0.0,9
26496,6847,Kits,2,2,1.0,0
26497,6847,Stuff Packs,19,0,0.0,19
26498,6848,Expansion Packs,16,0,0.0,16
26499,6848,Game Packs,10,0,0.0,10
26500,6848,Kits,12,1,0.08333333333333333,11
26501,6848,Stuff Packs,18,0,0.0,18
26502,6849,Expansion Packs,16,0,0.0,16
26503,6849,Game Packs,12,0,0.0,12
26504,6849,Kits,29,0,0.0,29
26505,6849,Stuff Packs,20,0,0.0,20
26506,6850,Expansion Packs,16,0,0.0,16
26507,6850,Game Packs,12,0,0.0,12
26508,6850,Kits,18,0,0.0,18
26509,6850,Stuff Packs,19,1,0.05263157894736842,18
26510,6851,Expansion Packs,15,0,0.0,15
26511,6851,Game Packs,11,0,0.0,11
26512,6851,Kits,6,0,0.0,6
26513,6851,Stuff Packs,15,1,0.06666666666666667,14
26514,6852,Expansion Packs,5,0,0.0,5
26515,6852,Game Packs,4,1,0.25,3
26516,6852,Kits,3,2,0.6666666666666666,1
26517,6852,Stuff Packs,5,3,0.6,2
26518,6853,Expansion Packs,16,0,0.0,16
26519,6853,Game Packs,12,0,0.0,12
26520,6853,Kits,33,0,0.0,33
26521,6853,Stuff Packs,20,0,0.0,20
26522,6854,Expansion Packs,14,0,0.0,14
26523,6854,Game Packs,12,0,0.0,12
26524,6854,Kits,12,1,0.08333333333333333,11
26525,6854,Stuff Packs,14,3,0.21428571428571427,11
26526,6855,Expansion Packs,16,0,0.0,16
26527,6855,Game Packs,10,0,0.0,10
26528,6855,Kits,3,2,0.6666666666666666,1
26529,6855,Stuff Packs,13,3,0.23076923076923078,10
26530,6856,Expansion Packs,4,0,0.0,4
26531,6856,Game Packs,3,1,0.3333333333333333,2
26532,6856,Stuff Packs,7,0,0.0,7
26533,6857,Expansion Packs,16,0,0.0,16
26534,6857,Game Packs,9,0,0.0,9
26535,6857,Kits,7,0,0.0,7
26536,6857,Stuff Packs,11,3,0.2727272727272727,8
26537,6858,Expansion Packs,3,0,0.0,3
26538,6858,Game Packs,1,0,0.0,1
26539,6858,Kits,3,0,0.0,3
26540,6858,Stuff Packs,2,1,0.5,1
26541,6859,Expansion Packs,15,1,0.06666666666666667,14
26542,6859,Game Packs,10,0,0.0,10
26543,6859,Kits,5,0,0.0,5
26544,6859,Stuff Packs,8,5,0.625,3
26545,6860,Expansion Packs,12,0,0.0,12
26546,6860,Game Packs,8,0,0.0,8
26547,6860,Stuff Packs,16,0,0.0,16
26548,6861,Expansion Packs,14,0,0.0,14
26549,6861,Game Packs,7,0,0.0,7
26550,6861,Kits,3,2,0.6666666666666666,1
26551,6861,Stuff Packs,13,1,0.07692307692307693,12
26552,6862,Expansion Packs,16,0,0.0,16
26553,6862,Game Packs,12,0,0.0,12
26554,6862,Kits,33,0,0.0,33
26555,6862,Stuff Packs,20,0,0.0,20
26556,6863,Expansion Packs,16,0,0.0,16
26557,6863,Game Packs,12,0,0.0,12
26558,6863,Kits,29,0,0.0,29
26559,6863,Stuff Packs,20,0,0.0,20
26560,6864,Expansion Packs,7,0,0.0,7
26561,6864,Game Packs,3,0,0.0,3
26562,6864,Kits,6,2,0.3333333333333333,4
26563,6864,Stuff Packs,8,1,0.125,7
26564,6865,Expansion Packs,16,0,0.0,16
26565,6865,Game Packs,12,0,0.0,12
26566,6865,Kits,31,0,0.0,31
26567,6865,Stuff Packs,20,0,0.0,20
26568,6866,Expansion Packs,15,0,0.0,15
26569,6866,Game Packs,3,0,0.0,3
26570,6866,Kits,4,2,0.5,2
26571,6866,Stuff Packs,7,3,0.42857142857142855,4
26572,6867,Expansion Packs,9,0,0.0,9
26573,6867,Game Packs,3,0,0.0,3
26574,6867,Stuff Packs,3,1,0.3333333333333333,2
26575,6868,Expansion Packs,13,0,0.0,13
26576,6868,Game Packs,8,0,0.0,8
26577,6868,Kits,2,1,0.5,1
26578,6868,Stuff Packs,10,0,0.0,10
26579,6869,Expansion Packs,16,0,0.0,16
26580,6869,Game Packs,11,0,0.0,11
26581,6869,Kits,13,3,0.23076923076923078,10
26582,6869,Stuff Packs,16,4,0.25,12
26583,6870,Expansion Packs,15,0,0.0,15
26584,6870,Game Packs,11,0,0.0,11
26585,6870,Kits,25,0,0.0,25
26586,6870,Stuff Packs,19,0,0.0,19
26587,6871,Expansion Packs,16,0,0.0,16
26588,6871,Game Packs,12,0,0.0,12
26589,6871,Kits,21,1,0.047619047619047616,20
26590,6871,Stuff Packs,20,0,0.0,20
26591,6872,Expansion Packs,16,0,0.0,16
26592,6872,Game Packs,12,0,0.0,12
26593,6872,Kits,30,1,0.03333333333333333,29
26594,6872,Stuff Packs,20,0,0.0,20
26595,6873,Expansion Packs,13,0,0.0,13
26596,6873,Game Packs,5,0,0.0,5
26597,6873,Kits,3,1,0.3333333333333333,2
26598,6873,Stuff Packs,8,2,0.25,6
26599,6874,Expansion Packs,16,0,0.0,16
26600,6874,Game Packs,12,0,0.0,12
26601,6874,Kits,17,1,0.058823529411764705,16
26602,6874,Stuff Packs,18,0,0.0,18
26603,6875,Expansion Packs,15,0,0.0,15
26604,6875,Game Packs,11,0,0.0,11
26605,6875,Kits,2,2,1.0,0
26606,6875,Stuff Packs,19,0,0.0,19
26607,6876,Expansion Packs,16,0,0.0,16
26608,6876,Game Packs,9,0,0.0,9
26609,6876,Kits,15,1,0.06666666666666667,14
26610,6876,Stuff Packs,15,3,0.2,12
26611,6877,Expansion Packs,16,0,0.0,16
26612,6877,Game Packs,11,0,0.0,11
26613,6877,Kits,4,1,0.25,3
26614,6877,Stuff Packs,18,0,0.0,18
26615,6878,Expansion Packs,16,0,0.0,16
26616,6878,Game Packs,11,0,0.0,11
26617,6878,Kits,21,2,0.09523809523809523,19
26618,6878,Stuff Packs,19,1,0.05263157894736842,18
26619,6879,Expansion Packs,10,0,0.0,10
26620,6879,Game Packs,10,0,0.0,10
26621,6879,Kits,5,2,0.4,3
26622,6879,Stuff Packs,18,3,0.16666666666666666,15
26623,6880,Expansion Packs,4,0,0.0,4
26624,6880,Game Packs,4,0,0.0,4
26625,6880,Kits,1,1,1.0,0
26626,6880,Stuff Packs,6,1,0.16666666666666666,5
26627,6881,Expansion Packs,16,0,0.0,16
26628,6881,Game Packs,11,0,0.0,11
26629,6881,Kits,10,1,0.1,9
26630,6881,Stuff Packs,20,0,0.0,20
26631,6882,Expansion Packs,8,0,0.0,8
26632,6882,Game Packs,4,0,0.0,4
26633,6882,Kits,5,1,0.2,4
26634,6882,Stuff Packs,6,0,0.0,6
26635,6883,Expansion Packs,14,1,0.07142857142857142,13
26636,6883,Game Packs,8,1,0.125,7
26637,6883,Kits,6,0,0.0,6
26638,6883,Stuff Packs,16,3,0.1875,13
26639,6884,Expansion Packs,6,0,0.0,6
26640,6884,Game Packs,2,0,0.0,2
26641,6884,Kits,1,1,1.0,0
26642,6884,Stuff Packs,6,1,0.16666666666666666,5
26643,6885,Expansion Packs,16,0,0.0,16
26644,6885,Game Packs,12,0,0.0,12
26645,6885,Kits,33,1,0.030303030303030304,32
26646,6885,Stuff Packs,20,0,0.0,20
26647,6886,Expansion Packs,6,0,0.0,6
26648,6886,Game Packs,2,1,0.5,1
26649,6886,Kits,3,3,1.0,0
26650,6886,Stuff Packs,5,4,0.8,1
26651,6887,Expansion Packs,15,0,0.0,15
26652,6887,Game Packs,12,0,0.0,12
26653,6887,Kits,8,2,0.25,6
26654,6887,Stuff Packs,19,1,0.05263157894736842,18
26655,6888,Expansion Packs,16,0,0.0,16
26656,6888,Game Packs,12,1,0.08333333333333333,11
26657,6888,Kits,33,0,0.0,33
26658,6888,Stuff Packs,20,0,0.0,20
26659,6889,Expansion Packs,16,0,0.0,16
26660,6889,Game Packs,12,0,0.0,12
26661,6889,Kits,32,0,0.0,32
26662,6889,Stuff Packs,20,0,0.0,20
26663,6890,Expansion Packs,2,0,0.0,2
26664,6890,Game Packs,3,1,0.3333333333333333,2
26665,6890,Stuff Packs,4,3,0.75,1
26666,6891,Expansion Packs,11,0,0.0,11
26667,6891,Game Packs,7,0,0.0,7
26668,6891,Kits,5,2,0.4,3
26669,6891,Stuff Packs,14,5,0.35714285714285715,9
26670,6892,Expansion Packs,16,0,0.0,16
26671,6892,Game Packs,12,0,0.0,12
26672,6892,Kits,33,0,0.0,33
26673,6892,Stuff Packs,20,0,0.0,20
26674,6893,Expansion Packs,11,0,0.0,11
26675,6893,Game Packs,5,0,0.0,5
26676,6893,Stuff Packs,4,0,0.0,4
26677,6894,Expansion Packs,15,0,0.0,15
26678,6894,Game Packs,11,0,0.0,11
26679,6894,Kits,11,1,0.09090909090909091,10
26680,6894,Stuff Packs,20,0,0.0,20
26681,6895,Expansion Packs,16,0,0.0,16
26682,6895,Game Packs,12,0,0.0,12
26683,6895,Kits,33,0,0.0,33
26684,6895,Stuff Packs,20,0,0.0,20
26685,6896,Expansion Packs,9,0,0.0,9
26686,6896,Game Packs,2,0,0.0,2
26687,6896,Kits,2,2,1.0,0
26688,6896,Stuff Packs,2,0,0.0,2
26689,6897,Expansion Packs,16,0,0.0,16
26690,6897,Game Packs,12,0,0.0,12
26691,6897,Kits,33,0,0.0,33
26692,6897,Stuff Packs,20,0,0.0,20
26693,6898,Expansion Packs,14,0,0.0,14
26694,6898,Game Packs,10,0,0.0,10
26695,6898,Kits,12,0,0.0,12
26696,6898,Stuff Packs,19,0,0.0,19
26697,6899,Expansion Packs,16,0,0.0,16
26698,6899,Game Packs,12,0,0.0,12
26699,6899,Kits,18,1,0.05555555555555555,17
26700,6899,Stuff Packs,20,0,0.0,20
26701,6900,Expansion Packs,16,0,0.0,16
26702,6900,Game Packs,12,0,0.0,12
26703,6900,Kits,33,0,0.0,33
26704,6900,Stuff Packs,19,0,0.0,19
26705,6901,Expansion Packs,5,0,0.0,5
26706,6901,Game Packs,2,0,0.0,2
26707,6901,Kits,1,1,1.0,0
26708,6902,Expansion Packs,1,0,0.0,1
26709,6902,Game Packs,1,0,0.0,1
26710,6902,Stuff Packs,3,3,1.0,0
26711,6903,Expansion Packs,13,0,0.0,13
26712,6903,Game Packs,2,0,0.0,2
26713,6903,Kits,7,1,0.14285714285714285,6
26714,6903,Stuff Packs,10,3,0.3,7
26715,6904,Expansion Packs,14,0,0.0,14
26716,6904,Game Packs,9,0,0.0,9
26717,6904,Kits,6,2,0.3333333333333333,4
26718,6904,Stuff Packs,18,1,0.05555555555555555,17
26719,6905,Expansion Packs,14,0,0.0,14
26720,6905,Game Packs,10,0,0.0,10
26721,6905,Kits,3,1,0.3333333333333333,2
26722,6905,Stuff Packs,13,1,0.07692307692307693,12
26723,6906,Expansion Packs,15,0,0.0,15
26724,6906,Game Packs,11,0,0.0,11
26725,6906,Kits,18,0,0.0,18
26726,6906,Stuff Packs,20,0,0.0,20
26727,6907,Expansion Packs,12,0,0.0,12
26728,6907,Game Packs,7,0,0.0,7
26729,6907,Kits,2,1,0.5,1
26730,6907,Stuff Packs,14,1,0.07142857142857142,13
26731,6908,Expansion Packs,16,0,0.0,16
26732,6908,Game Packs,10,0,0.0,10
26733,6908,Kits,11,1,0.09090909090909091,10
26734,6908,Stuff Packs,12,5,0.4166666666666667,7
26735,6909,Expansion Packs,11,0,0.0,11
26736,6909,Game Packs,6,0,0.0,6
26737,6909,Kits,1,1,1.0,0
26738,6909,Stuff Packs,11,2,0.18181818181818182,9
26739,6910,Expansion Packs,15,0,0.0,15
26740,6910,Game Packs,12,0,0.0,12
26741,6910,Kits,25,0,0.0,25
26742,6910,Stuff Packs,20,13,0.65,7
26743,6911,Expansion Packs,12,0,0.0,12
26744,6911,Game Packs,7,0,0.0,7
26745,6911,Kits,9,0,0.0,9
26746,6911,Stuff Packs,6,2,0.3333333333333333,4
26747,6912,Expansion Packs,10,0,0.0,10
26748,6912,Game Packs,1,0,0.0,1
26749,6912,Kits,2,0,0.0,2
26750,6912,Stuff Packs,4,0,0.0,4
26751,6913,Expansion Packs,6,0,0.0,6
26752,6913,Game Packs,4,1,0.25,3
26753,6913,Kits,3,3,1.0,0
26754,6913,Stuff Packs,7,2,0.2857142857142857,5
26755,6914,Expansion Packs,16,0,0.0,16
26756,6914,Game Packs,11,0,0.0,11
26757,6914,Kits,17,1,0.058823529411764705,16
26758,6914,Stuff Packs,20,1,0.05,19
26759,6915,Expansion Packs,16,0,0.0,16
26760,6915,Game Packs,7,1,0.14285714285714285,6
26761,6915,Kits,16,0,0.0,16
26762,6915,Stuff Packs,8,1,0.125,7
26763,6916,Expansion Packs,12,0,0.0,12
26764,6916,Game Packs,7,0,0.0,7
26765,6916,Kits,13,0,0.0,13
26766,6916,Stuff Packs,9,1,0.1111111111111111,8
26767,6917,Expansion Packs,12,0,0.0,12
26768,6917,Game Packs,4,0,0.0,4
26769,6917,Kits,3,1,0.3333333333333333,2
26770,6917,Stuff Packs,11,1,0.09090909090909091,10
26771,6918,Expansion Packs,5,0,0.0,5
26772,6918,Game Packs,4,0,0.0,4
26773,6918,Kits,3,3,1.0,0
26774,6918,Stuff Packs,5,4,0.8,1
26775,6919,Expansion Packs,15,0,0.0,15
26776,6919,Game Packs,11,0,0.0,11
26777,6919,Kits,11,2,0.18181818181818182,9
26778,6919,Stuff Packs,18,0,0.0,18
26779,6920,Expansion Packs,16,0,0.0,16
26780,6920,Game Packs,12,1,0.08333333333333333,11
26781,6920,Kits,33,0,0.0,33
26782,6920,Stuff Packs,20,0,0.0,20
26783,6921,Expansion Packs,16,0,0.0,16
26784,6921,Game Packs,11,0,0.0,11
26785,6921,Kits,6,0,0.0,6
26786,6921,Stuff Packs,16,0,0.0,16
26787,6922,Expansion Packs,14,0,0.0,14
26788,6922,Game Packs,8,0,0.0,8
26789,6922,Kits,9,1,0.1111111111111111,8
26790,6922,Stuff Packs,13,1,0.07692307692307693,12
26791,6923,Expansion Packs,16,0,0.0,16
26792,6923,Game Packs,7,0,0.0,7
26793,6923,Kits,12,0,0.0,12
26794,6923,Stuff Packs,14,0,0.0,14
26795,6924,Expansion Packs,16,1,0.0625,15
26796,6924,Game Packs,12,0,0.0,12
26797,6924,Kits,33,0,0.0,33
26798,6924,Stuff Packs,20,0,0.0,20
26799,6925,Expansion Packs,13,0,0.0,13
26800,6925,Game Packs,10,0,0.0,10
26801,6925,Kits,2,0,0.0,2
26802,6925,Stuff Packs,11,0,0.0,11
26803,6926,Expansion Packs,16,0,0.0,16
26804,6926,Game Packs,12,0,0.0,12
26805,6926,Kits,33,0,0.0,33
26806,6926,Stuff Packs,20,0,0.0,20
26807,6927,Expansion Packs,8,0,0.0,8
26808,6927,Game Packs,5,1,0.2,4
26809,6927,Kits,6,1,0.16666666666666666,5
26810,6927,Stuff Packs,7,4,0.5714285714285714,3
26811,6928,Expansion Packs,14,0,0.0,14
26812,6928,Game Packs,6,0,0.0,6
26813,6928,Kits,3,3,1.0,0
26814,6928,Stuff Packs,16,1,0.0625,15
26815,6929,Expansion Packs,14,0,0.0,14
26816,6929,Game Packs,10,0,0.0,10
26817,6929,Kits,4,0,0.0,4
26818,6929,Stuff Packs,18,0,0.0,18
26819,6930,Expansion Packs,8,0,0.0,8
26820,6930,Game Packs,8,1,0.125,7
26821,6930,Kits,3,2,0.6666666666666666,1
26822,6930,Stuff Packs,5,3,0.6,2
26823,6931,Expansion Packs,14,0,0.0,14
26824,6931,Game Packs,12,0,0.0,12
26825,6931,Kits,1,0,0.0,1
26826,6931,Stuff Packs,19,0,0.0,19
26827,6932,Expansion Packs,6,0,0.0,6
26828,6932,Game Packs,4,0,0.0,4
26829,6932,Stuff Packs,4,0,0.0,4
26830,6933,Expansion Packs,13,0,0.0,13
26831,6933,Game Packs,10,0,0.0,10
26832,6933,Kits,19,0,0.0,19
26833,6933,Stuff Packs,12,0,0.0,12
26834,6934,Expansion Packs,5,0,0.0,5
26835,6934,Game Packs,2,0,0.0,2
26836,6934,Stuff Packs,2,1,0.5,1
26837,6935,Expansion Packs,11,0,0.0,11
26838,6935,Game Packs,10,0,0.0,10
26839,6935,Kits,4,1,0.25,3
26840,6935,Stuff Packs,14,2,0.14285714285714285,12
26841,6936,Expansion Packs,14,0,0.0,14
26842,6936,Game Packs,10,0,0.0,10
26843,6936,Kits,11,0,0.0,11
26844,6936,Stuff Packs,8,0,0.0,8
26845,6937,Expansion Packs,10,0,0.0,10
26846,6937,Game Packs,2,1,0.5,1
26847,6937,Kits,3,0,0.0,3
26848,6937,Stuff Packs,2,0,0.0,2
26849,6938,Expansion Packs,14,0,0.0,14
26850,6938,Game Packs,9,1,0.1111111111111111,8
26851,6938,Kits,1,1,1.0,0
26852,6938,Stuff Packs,5,1,0.2,4
26853,6939,Expansion Packs,9,0,0.0,9
26854,6939,Game Packs,5,0,0.0,5
26855,6939,Kits,5,0,0.0,5
26856,6939,Stuff Packs,6,0,0.0,6
26857,6940,Expansion Packs,13,0,0.0,13
26858,6940,Game Packs,10,0,0.0,10
26859,6940,Stuff Packs,18,0,0.0,18
26860,6941,Expansion Packs,2,0,0.0,2
26861,6941,Kits,1,1,1.0,0
26862,6941,Stuff Packs,1,1,1.0,0
26863,6942,Expansion Packs,4,0,0.0,4
26864,6942,Game Packs,3,1,0.3333333333333333,2
26865,6942,Kits,6,3,0.5,3
26866,6942,Stuff Packs,4,1,0.25,3
26867,6943,Expansion Packs,16,0,0.0,16
26868,6943,Game Packs,12,1,0.08333333333333333,11
26869,6943,Kits,33,0,0.0,33
26870,6943,Stuff Packs,20,1,0.05,19
26871,6944,Expansion Packs,16,0,0.0,16
26872,6944,Game Packs,12,0,0.0,12
26873,6944,Kits,15,0,0.0,15
26874,6944,Stuff Packs,20,0,0.0,20
26875,6945,Expansion Packs,2,0,0.0,2
26876,6945,Game Packs,1,0,0.0,1
26877,6945,Stuff Packs,1,0,0.0,1
26878,6946,Expansion Packs,15,0,0.0,15
26879,6946,Game Packs,11,0,0.0,11
26880,6946,Kits,14,1,0.07142857142857142,13
26881,6946,Stuff Packs,20,0,0.0,20
26882,6947,Expansion Packs,14,0,0.0,14
26883,6947,Game Packs,6,0,0.0,6
26884,6947,Kits,4,2,0.5,2
26885,6947,Stuff Packs,14,2,0.14285714285714285,12
26886,6948,Expansion Packs,16,0,0.0,16
26887,6948,Game Packs,12,0,0.0,12
26888,6948,Kits,33,0,0.0,33
26889,6948,Stuff Packs,20,0,0.0,20
26890,6949,Expansion Packs,14,0,0.0,14
26891,6949,Game Packs,8,1,0.125,7
26892,6949,Kits,9,1,0.1111111111111111,8
26893,6949,Stuff Packs,8,3,0.375,5
26894,6950,Expansion Packs,15,0,0.0,15
26895,6950,Game Packs,12,0,0.0,12
26896,6950,Kits,24,2,0.08333333333333333,22
26897,6950,Stuff Packs,18,0,0.0,18
26898,6951,Expansion Packs,6,0,0.0,6
26899,6951,Game Packs,3,0,0.0,3
26900,6951,Kits,3,1,0.3333333333333333,2
26901,6951,Stuff Packs,3,1,0.3333333333333333,2
26902,6952,Expansion Packs,16,0,0.0,16
26903,6952,Game Packs,12,0,0.0,12
26904,6952,Kits,33,0,0.0,33
26905,6952,Stuff Packs,20,0,0.0,20
26906,6953,Expansion Packs,13,0,0.0,13
26907,6953,Game Packs,8,0,0.0,8
26908,6953,Kits,2,1,0.5,1
26909,6953,Stuff Packs,13,2,0.15384615384615385,11
26910,6954,Expansion Packs,12,0,0.0,12
26911,6954,Game Packs,6,1,0.16666666666666666,5
26912,6954,Kits,20,1,0.05,19
26913,6954,Stuff Packs,8,3,0.375,5
26914,6955,Expansion Packs,16,0,0.0,16
26915,6955,Game Packs,12,0,0.0,12
26916,6955,Kits,21,0,0.0,21
26917,6955,Stuff Packs,20,0,0.0,20
26918,6956,Expansion Packs,6,0,0.0,6
26919,6956,Game Packs,4,1,0.25,3
26920,6956,Kits,3,3,1.0,0
26921,6956,Stuff Packs,7,4,0.5714285714285714,3
26922,6957,Expansion Packs,9,0,0.0,9
26923,6957,Game Packs,3,0,0.0,3
26924,6957,Kits,3,2,0.6666666666666666,1
26925,6957,Stuff Packs,3,3,1.0,0
26926,6958,Expansion Packs,13,0,0.0,13
26927,6958,Game Packs,7,2,0.2857142857142857,5
26928,6958,Kits,11,0,0.0,11
26929,6958,Stuff Packs,13,1,0.07692307692307693,12
26930,6959,Expansion Packs,4,0,0.0,4
26931,6959,Game Packs,3,0,0.0,3
26932,6959,Stuff Packs,3,0,0.0,3
26933,6960,Expansion Packs,13,0,0.0,13
26934,6960,Game Packs,4,0,0.0,4
26935,6960,Kits,5,1,0.2,4
26936,6960,Stuff Packs,7,2,0.2857142857142857,5
26937,6961,Expansion Packs,2,0,0.0,2
26938,6961,Game Packs,1,0,0.0,1
26939,6961,Kits,2,2,1.0,0
26940,6961,Stuff Packs,3,3,1.0,0
26941,6962,Expansion Packs,15,0,0.0,15
26942,6962,Game Packs,8,0,0.0,8
26943,6962,Kits,6,3,0.5,3
26944,6962,Stuff Packs,16,0,0.0,16
26945,6963,Expansion Packs,14,0,0.0,14
26946,6963,Game Packs,6,0,0.0,6
26947,6963,Kits,4,2,0.5,2
26948,6963,Stuff Packs,9,1,0.1111111111111111,8
26949,6964,Expansion Packs,16,0,0.0,16
26950,6964,Game Packs,12,0,0.0,12
26951,6964,Kits,13,1,0.07692307692307693,12
26952,6964,Stuff Packs,20,0,0.0,20
26953,6965,Expansion Packs,15,0,0.0,15
26954,6965,Game Packs,11,0,0.0,11
26955,6965,Kits,29,1,0.034482758620689655,28
26956,6965,Stuff Packs,20,0,0.0,20
26957,6966,Expansion Packs,8,0,0.0,8
26958,6966,Game Packs,1,0,0.0,1
26959,6966,Kits,1,0,0.0,1
26960,6966,Stuff Packs,2,0,0.0,2
26961,6967,Expansion Packs,15,0,0.0,15
26962,6967,Game Packs,11,0,0.0,11
26963,6967,Kits,11,1,0.09090909090909091,10
26964,6967,Stuff Packs,20,0,0.0,20
26965,6968,Expansion Packs,15,0,0.0,15
26966,6968,Game Packs,10,0,0.0,10
26967,6968,Kits,6,1,0.16666666666666666,5
26968,6968,Stuff Packs,15,0,0.0,15
26969,6969,Expansion Packs,13,0,0.0,13
26970,6969,Game Packs,11,0,0.0,11
26971,6969,Kits,3,0,0.0,3
26972,6969,Stuff Packs,8,0,0.0,8
26973,6970,Game Packs,2,0,0.0,2
26974,6970,Kits,2,0,0.0,2
26975,6970,Stuff Packs,4,1,0.25,3
26976,6971,Expansion Packs,16,0,0.0,16
26977,6971,Game Packs,12,0,0.0,12
26978,6971,Kits,21,0,0.0,21
26979,6971,Stuff Packs,20,0,0.0,20
26980,6972,Expansion Packs,4,0,0.0,4
26981,6972,Game Packs,2,0,0.0,2
26982,6972,Kits,3,2,0.6666666666666666,1
26983,6972,Stuff Packs,7,3,0.42857142857142855,4
26984,6973,Expansion Packs,9,0,0.0,9
26985,6973,Game Packs,6,0,0.0,6
26986,6973,Kits,8,0,0.0,8
26987,6973,Stuff Packs,16,3,0.1875,13
26988,6974,Expansion Packs,16,0,0.0,16
26989,6974,Game Packs,12,0,0.0,12
26990,6974,Kits,33,1,0.030303030303030304,32
26991,6974,Stuff Packs,20,0,0.0,20
26992,6975,Expansion Packs,15,0,0.0,15
26993,6975,Game Packs,11,1,0.09090909090909091,10
26994,6975,Kits,15,0,0.0,15
26995,6975,Stuff Packs,20,0,0.0,20
26996,6976,Expansion Packs,15,0,0.0,15
26997,6976,Game Packs,10,1,0.1,9
26998,6976,Kits,14,2,0.14285714285714285,12
26999,6976,Stuff Packs,16,4,0.25,12
27000,6977,Expansion Packs,4,0,0.0,4
27001,6977,Game Packs,1,0,0.0,1
27002,6977,Kits,2,1,0.5,1
27003,6977,Stuff Packs,4,3,0.75,1
27004,6978,Expansion Packs,9,0,0.0,9
27005,6978,Game Packs,8,0,0.0,8
27006,6978,Kits,1,1,1.0,0
27007,6978,Stuff Packs,7,1,0.14285714285714285,6
27008,6979,Expansion Packs,10,0,0.0,10
27009,6979,Game Packs,4,0,0.0,4
27010,6979,Kits,4,1,0.25,3
27011,6979,Stuff Packs,10,4,0.4,6
27012,6980,Expansion Packs,12,0,0.0,12
27013,6980,Game Packs,4,0,0.0,4
27014,6980,Kits,10,3,0.3,7
27015,6980,Stuff Packs,8,1,0.125,7
27016,6981,Expansion Packs,8,0,0.0,8
27017,6981,Game Packs,2,0,0.0,2
27018,6981,Kits,4,0,0.0,4
27019,6981,Stuff Packs,4,0,0.0,4
27020,6982,Expansion Packs,16,0,0.0,16
27021,6982,Game Packs,12,0,0.0,12
27022,6982,Kits,32,0,0.0,32
27023,6982,Stuff Packs,20,0,0.0,20
27024,6983,Expansion Packs,15,0,0.0,15
27025,6983,Game Packs,12,0,0.0,12
27026,6983,Kits,24,1,0.041666666666666664,23
27027,6983,Stuff Packs,20,0,0.0,20
27028,6984,Expansion Packs,16,0,0.0,16
27029,6984,Game Packs,11,0,0.0,11
27030,6984,Kits,31,1,0.03225806451612903,30
27031,6984,Stuff Packs,20,0,0.0,20
27032,6985,Expansion Packs,7,0,0.0,7
27033,6985,Game Packs,6,0,0.0,6
27034,6985,Kits,2,1,0.5,1
27035,6985,Stuff Packs,14,1,0.07142857142857142,13
27036,6986,Expansion Packs,16,0,0.0,16
27037,6986,Game Packs,12,0,0.0,12
27038,6986,Kits,28,2,0.07142857142857142,26
27039,6986,Stuff Packs,20,0,0.0,20
27040,6987,Expansion Packs,16,11,0.6875,5
27041,6987,Game Packs,12,6,0.5,6
27042,6987,Kits,33,33,1.0,0
27043,6987,Stuff Packs,20,8,0.4,12
27044,6988,Expansion Packs,13,0,0.0,13
27045,6988,Game Packs,10,1,0.1,9
27046,6988,Kits,5,2,0.4,3
27047,6988,Stuff Packs,12,5,0.4166666666666667,7
27048,6989,Expansion Packs,16,0,0.0,16
27049,6989,Game Packs,12,0,0.0,12
27050,6989,Kits,13,1,0.07692307692307693,12
27051,6989,Stuff Packs,12,1,0.08333333333333333,11
27052,6990,Expansion Packs,3,0,0.0,3
27053,6990,Stuff Packs,3,1,0.3333333333333333,2
27054,6991,Expansion Packs,12,0,0.0,12
27055,6991,Game Packs,5,0,0.0,5
27056,6991,Kits,1,0,0.0,1
27057,6991,Stuff Packs,6,0,0.0,6
27058,6992,Expansion Packs,13,0,0.0,13
27059,6992,Game Packs,8,0,0.0,8
27060,6992,Kits,2,0,0.0,2
27061,6992,Stuff Packs,10,2,0.2,8
27062,6993,Expansion Packs,16,0,0.0,16
27063,6993,Game Packs,12,0,0.0,12
27064,6993,Kits,32,0,0.0,32
27065,6993,Stuff Packs,20,1,0.05,19
27066,6994,Expansion Packs,7,0,0.0,7
27067,6994,Game Packs,6,1,0.16666666666666666,5
27068,6994,Kits,3,2,0.6666666666666666,1
27069,6994,Stuff Packs,4,1,0.25,3
27070,6995,Expansion Packs,16,0,0.0,16
27071,6995,Game Packs,12,0,0.0,12
27072,6995,Kits,33,1,0.030303030303030304,32
27073,6995,Stuff Packs,20,0,0.0,20
27074,6996,Expansion Packs,15,1,0.06666666666666667,14
27075,6996,Game Packs,9,0,0.0,9
27076,6996,Kits,12,0,0.0,12
27077,6996,Stuff Packs,10,0,0.0,10
27078,6997,Expansion Packs,14,0,0.0,14
27079,6997,Game Packs,8,0,0.0,8
27080,6997,Kits,3,0,0.0,3
27081,6997,Stuff Packs,15,0,0.0,15
27082,6998,Expansion Packs,11,0,0.0,11
27083,6998,Game Packs,11,0,0.0,11
27084,6998,Kits,5,2,0.4,3
27085,6998,Stuff Packs,16,1,0.0625,15
27086,6999,Expansion Packs,11,0,0.0,11
27087,6999,Game Packs,5,0,0.0,5
27088,6999,Kits,1,1,1.0,0
27089,6999,Stuff Packs,6,3,0.5,3
27090,7000,Expansion Packs,4,0,0.0,4
27091,7000,Kits,2,2,1.0,0
27092,7000,Stuff Packs,2,2,1.0,0
27093,7001,Expansion Packs,6,0,0.0,6
27094,7001,Game Packs,2,0,0.0,2
27095,7001,Kits,2,2,1.0,0
27096,7001,Stuff Packs,6,2,0.3333333333333333,4
27097,7002,Expansion Packs,10,0,0.0,10
27098,7002,Game Packs,10,0,0.0,10
27099,7002,Kits,18,0,0.0,18
27100,7002,Stuff Packs,16,0,0.0,16
27101,7003,Expansion Packs,5,0,0.0,5
27102,7003,Game Packs,4,0,0.0,4
27103,7003,Kits,3,2,0.6666666666666666,1
27104,7003,Stuff Packs,6,3,0.5,3
27105,7004,Expansion Packs,11,0,0.0,11
27106,7004,Game Packs,7,0,0.0,7
27107,7004,Kits,1,0,0.0,1
27108,7004,Stuff Packs,10,0,0.0,10
27109,7005,Expansion Packs,16,0,0.0,16
27110,7005,Game Packs,12,0,0.0,12
27111,7005,Kits,25,1,0.04,24
27112,7005,Stuff Packs,20,0,0.0,20
27113,7006,Expansion Packs,15,0,0.0,15
27114,7006,Game Packs,10,0,0.0,10
27115,7006,Kits,7,1,0.14285714285714285,6
27116,7006,Stuff Packs,18,0,0.0,18
27117,7007,Expansion Packs,14,0,0.0,14
27118,7007,Game Packs,9,0,0.0,9
27119,7007,Kits,2,2,1.0,0
27120,7007,Stuff Packs,14,2,0.14285714285714285,12
27121,7008,Expansion Packs,16,0,0.0,16
27122,7008,Game Packs,9,0,0.0,9
27123,7008,Kits,17,0,0.0,17
27124,7008,Stuff Packs,16,0,0.0,16
27125,7009,Expansion Packs,11,0,0.0,11
27126,7009,Game Packs,6,1,0.16666666666666666,5
27127,7009,Stuff Packs,9,4,0.4444444444444444,5
27128,7010,Expansion Packs,11,0,0.0,11
27129,7010,Game Packs,8,0,0.0,8
27130,7010,Kits,8,2,0.25,6
27131,7010,Stuff Packs,9,3,0.3333333333333333,6
27132,7011,Expansion Packs,7,0,0.0,7
27133,7011,Game Packs,1,0,0.0,1
27134,7011,Kits,1,0,0.0,1
27135,7011,Stuff Packs,5,3,0.6,2
27136,7012,Expansion Packs,16,1,0.0625,15
27137,7012,Game Packs,10,0,0.0,10
27138,7012,Kits,4,1,0.25,3
27139,7012,Stuff Packs,6,0,0.0,6
27140,7013,Expansion Packs,6,0,0.0,6
27141,7013,Game Packs,3,0,0.0,3
27142,7013,Stuff Packs,3,0,0.0,3
27143,7014,Expansion Packs,16,0,0.0,16
27144,7014,Game Packs,12,0,0.0,12
27145,7014,Kits,33,0,0.0,33
27146,7014,Stuff Packs,20,0,0.0,20
27147,7015,Expansion Packs,14,0,0.0,14
27148,7015,Game Packs,5,0,0.0,5
27149,7015,Kits,2,2,1.0,0
27150,7015,Stuff Packs,5,1,0.2,4
27151,7016,Expansion Packs,11,0,0.0,11
27152,7016,Game Packs,5,0,0.0,5
27153,7016,Kits,2,2,1.0,0
27154,7016,Stuff Packs,8,3,0.375,5
27155,7017,Expansion Packs,16,0,0.0,16
27156,7017,Game Packs,12,0,0.0,12
27157,7017,Kits,33,0,0.0,33
27158,7017,Stuff Packs,20,0,0.0,20
27159,7018,Expansion Packs,11,0,0.0,11
27160,7018,Game Packs,6,0,0.0,6
27161,7018,Kits,2,1,0.5,1
27162,7018,Stuff Packs,10,1,0.1,9
27163,7019,Expansion Packs,16,0,0.0,16
27164,7019,Game Packs,12,0,0.0,12
27165,7019,Kits,33,0,0.0,33
27166,7019,Stuff Packs,20,0,0.0,20
27167,7020,Expansion Packs,15,0,0.0,15
27168,7020,Game Packs,12,0,0.0,12
27169,7020,Kits,4,1,0.25,3
27170,7020,Stuff Packs,19,0,0.0,19
27171,7021,Expansion Packs,6,0,0.0,6
27172,7021,Game Packs,1,0,0.0,1
27173,7021,Kits,1,1,1.0,0
27174,7021,Stuff Packs,3,1,0.3333333333333333,2
27175,7022,Expansion Packs,16,0,0.0,16
27176,7022,Game Packs,8,0,0.0,8
27177,7022,Kits,15,1,0.06666666666666667,14
27178,7022,Stuff Packs,11,1,0.09090909090909091,10
27179,7023,Expansion Packs,15,0,0.0,15
27180,7023,Game Packs,9,0,0.0,9
27181,7023,Kits,2,2,1.0,0
27182,7023,Stuff Packs,8,2,0.25,6
27183,7024,Expansion Packs,12,0,0.0,12
27184,7024,Game Packs,8,0,0.0,8
27185,7024,Kits,9,1,0.1111111111111111,8
27186,7024,Stuff Packs,12,1,0.08333333333333333,11
27187,7025,Expansion Packs,15,0,0.0,15
27188,7025,Game Packs,10,0,0.0,10
27189,7025,Kits,11,0,0.0,11
27190,7025,Stuff Packs,20,0,0.0,20
27191,7026,Expansion Packs,16,0,0.0,16
27192,7026,Game Packs,11,0,0.0,11
27193,7026,Kits,12,0,0.0,12
27194,7026,Stuff Packs,12,0,0.0,12
27195,7027,Expansion Packs,16,0,0.0,16
27196,7027,Game Packs,12,0,0.0,12
27197,7027,Kits,7,1,0.14285714285714285,6
27198,7027,Stuff Packs,20,0,0.0,20
27199,7028,Expansion Packs,4,0,0.0,4
27200,7028,Game Packs,2,0,0.0,2
27201,7028,Kits,2,1,0.5,1
27202,7028,Stuff Packs,7,3,0.42857142857142855,4
27203,7029,Expansion Packs,16,0,0.0,16
27204,7029,Game Packs,12,0,0.0,12
27205,7029,Kits,33,0,0.0,33
27206,7029,Stuff Packs,20,0,0.0,20
27207,7030,Expansion Packs,14,0,0.0,14
27208,7030,Game Packs,8,0,0.0,8
27209,7030,Kits,10,2,0.2,8
27210,7030,Stuff Packs,18,2,0.1111111111111111,16
27211,7031,Expansion Packs,16,0,0.0,16
27212,7031,Game Packs,12,0,0.0,12
27213,7031,Kits,33,0,0.0,33
27214,7031,Stuff Packs,20,0,0.0,20
27215,7032,Expansion Packs,14,0,0.0,14
27216,7032,Game Packs,7,0,0.0,7
27217,7032,Kits,2,1,0.5,1
27218,7032,Stuff Packs,6,1,0.16666666666666666,5
27219,7033,Expansion Packs,14,0,0.0,14
27220,7033,Game Packs,9,0,0.0,9
27221,7033,Kits,13,0,0.0,13
27222,7033,Stuff Packs,17,0,0.0,17
27223,7034,Expansion Packs,16,0,0.0,16
27224,7034,Game Packs,12,0,0.0,12
27225,7034,Kits,29,3,0.10344827586206896,26
27226,7034,Stuff Packs,19,0,0.0,19
27227,7035,Expansion Packs,16,0,0.0,16
27228,7035,Game Packs,12,0,0.0,12
27229,7035,Kits,15,1,0.06666666666666667,14
27230,7035,Stuff Packs,20,0,0.0,20
27231,7036,Expansion Packs,5,0,0.0,5
27232,7036,Game Packs,3,0,0.0,3
27233,7036,Kits,2,0,0.0,2
27234,7036,Stuff Packs,5,0,0.0,5
27235,7037,Expansion Packs,15,0,0.0,15
27236,7037,Game Packs,11,1,0.09090909090909091,10
27237,7037,Kits,3,3,1.0,0
27238,7037,Stuff Packs,15,4,0.26666666666666666,11
27239,7038,Expansion Packs,9,0,0.0,9
27240,7038,Game Packs,4,0,0.0,4
27241,7038,Kits,3,3,1.0,0
27242,7038,Stuff Packs,6,4,0.6666666666666666,2
27243,7039,Expansion Packs,16,0,0.0,16
27244,7039,Game Packs,12,0,0.0,12
27245,7039,Kits,33,0,0.0,33
27246,7039,Stuff Packs,20,0,0.0,20
27247,7040,Expansion Packs,12,0,0.0,12
27248,7040,Game Packs,4,0,0.0,4
27249,7040,Stuff Packs,9,2,0.2222222222222222,7
27250,7041,Expansion Packs,8,0,0.0,8
27251,7041,Game Packs,4,1,0.25,3
27252,7041,Kits,2,2,1.0,0
27253,7041,Stuff Packs,6,3,0.5,3
27254,7042,Expansion Packs,10,0,0.0,10
27255,7042,Game Packs,3,1,0.3333333333333333,2
27256,7042,Kits,4,2,0.5,2
27257,7042,Stuff Packs,10,3,0.3,7
27258,7043,Expansion Packs,12,0,0.0,12
27259,7043,Game Packs,4,1,0.25,3
27260,7043,Kits,8,2,0.25,6
27261,7043,Stuff Packs,6,3,0.5,3
27262,7044,Expansion Packs,11,0,0.0,11
27263,7044,Game Packs,2,0,0.0,2
27264,7044,Kits,1,1,1.0,0
27265,7044,Stuff Packs,5,2,0.4,3
27266,7045,Expansion Packs,16,0,0.0,16
27267,7045,Game Packs,7,0,0.0,7
27268,7045,Kits,12,3,0.25,9
27269,7045,Stuff Packs,15,0,0.0,15
27270,7046,Expansion Packs,8,0,0.0,8
27271,7046,Game Packs,4,0,0.0,4
27272,7046,Kits,1,1,1.0,0
27273,7046,Stuff Packs,7,1,0.14285714285714285,6
27274,7047,Expansion Packs,6,0,0.0,6
27275,7047,Game Packs,2,1,0.5,1
27276,7047,Kits,2,1,0.5,1
27277,7047,Stuff Packs,5,3,0.6,2
27278,7048,Expansion Packs,16,0,0.0,16
27279,7048,Game Packs,12,0,0.0,12
27280,7048,Kits,11,2,0.18181818181818182,9
27281,7048,Stuff Packs,20,0,0.0,20
27282,7049,Expansion Packs,8,0,0.0,8
27283,7049,Game Packs,5,0,0.0,5
27284,7049,Kits,9,2,0.2222222222222222,7
27285,7049,Stuff Packs,9,3,0.3333333333333333,6
27286,7050,Expansion Packs,16,0,0.0,16
27287,7050,Game Packs,9,0,0.0,9
27288,7050,Kits,10,0,0.0,10
27289,7050,Stuff Packs,18,0,0.0,18
27290,7051,Expansion Packs,16,0,0.0,16
27291,7051,Game Packs,12,0,0.0,12
27292,7051,Kits,18,0,0.0,18
27293,7051,Stuff Packs,19,0,0.0,19
27294,7052,Expansion Packs,11,0,0.0,11
27295,7052,Game Packs,6,0,0.0,6
27296,7052,Kits,12,0,0.0,12
27297,7052,Stuff Packs,12,0,0.0,12
27298,7053,Expansion Packs,9,0,0.0,9
27299,7053,Game Packs,5,0,0.0,5
27300,7053,Stuff Packs,8,0,0.0,8
27301,7054,Expansion Packs,15,0,0.0,15
27302,7054,Game Packs,11,0,0.0,11
27303,7054,Kits,21,1,0.047619047619047616,20
27304,7054,Stuff Packs,15,0,0.0,15
27305,7055,Expansion Packs,10,0,0.0,10
27306,7055,Game Packs,2,0,0.0,2
27307,7055,Kits,1,1,1.0,0
27308,7055,Stuff Packs,6,2,0.3333333333333333,4
27309,7056,Expansion Packs,10,0,0.0,10
27310,7056,Game Packs,7,0,0.0,7
27311,7056,Stuff Packs,13,0,0.0,13
27312,7057,Expansion Packs,11,0,0.0,11
27313,7057,Game Packs,4,0,0.0,4
27314,7057,Kits,5,1,0.2,4
27315,7057,Stuff Packs,2,0,0.0,2
27316,7058,Expansion Packs,14,0,0.0,14
27317,7058,Game Packs,10,0,0.0,10
27318,7058,Kits,14,1,0.07142857142857142,13
27319,7058,Stuff Packs,14,2,0.14285714285714285,12
27320,7059,Expansion Packs,16,0,0.0,16
27321,7059,Game Packs,12,0,0.0,12
27322,7059,Kits,33,0,0.0,33
27323,7059,Stuff Packs,20,0,0.0,20
27324,7060,Expansion Packs,13,0,0.0,13
27325,7060,Game Packs,9,0,0.0,9
27326,7060,Kits,6,2,0.3333333333333333,4
27327,7060,Stuff Packs,13,2,0.15384615384615385,11
27328,7061,Expansion Packs,15,0,0.0,15
27329,7061,Game Packs,11,1,0.09090909090909091,10
27330,7061,Kits,16,1,0.0625,15
27331,7061,Stuff Packs,14,4,0.2857142857142857,10
27332,7062,Expansion Packs,14,0,0.0,14
27333,7062,Game Packs,12,0,0.0,12
27334,7062,Kits,14,0,0.0,14
27335,7062,Stuff Packs,18,0,0.0,18
27336,7063,Expansion Packs,15,0,0.0,15
27337,7063,Game Packs,11,0,0.0,11
27338,7063,Kits,11,0,0.0,11
27339,7063,Stuff Packs,20,0,0.0,20
27340,7064,Expansion Packs,14,0,0.0,14
27341,7064,Game Packs,9,0,0.0,9
27342,7064,Kits,19,3,0.15789473684210525,16
27343,7064,Stuff Packs,18,5,0.2777777777777778,13
27344,7065,Expansion Packs,11,0,0.0,11
27345,7065,Game Packs,9,0,0.0,9
27346,7065,Kits,13,1,0.07692307692307693,12
27347,7065,Stuff Packs,12,0,0.0,12
27348,7066,Expansion Packs,5,0,0.0,5
27349,7066,Game Packs,1,0,0.0,1
27350,7066,Kits,1,0,0.0,1
27351,7067,Expansion Packs,9,0,0.0,9
27352,7067,Game Packs,7,0,0.0,7
27353,7067,Stuff Packs,2,2,1.0,0
27354,7068,Expansion Packs,16,0,0.0,16
27355,7068,Game Packs,11,0,0.0,11
27356,7068,Kits,22,0,0.0,22
27357,7068,Stuff Packs,18,3,0.16666666666666666,15
27358,7069,Expansion Packs,7,0,0.0,7
27359,7069,Game Packs,8,0,0.0,8
27360,7069,Kits,11,0,0.0,11
27361,7069,Stuff Packs,7,2,0.2857142857142857,5
27362,7070,Expansion Packs,12,0,0.0,12
27363,7070,Game Packs,8,1,0.125,7
27364,7070,Kits,19,2,0.10526315789473684,17
27365,7070,Stuff Packs,15,4,0.26666666666666666,11
27366,7071,Expansion Packs,15,0,0.0,15
27367,7071,Game Packs,11,0,0.0,11
27368,7071,Kits,5,1,0.2,4
27369,7071,Stuff Packs,12,2,0.16666666666666666,10
27370,7072,Expansion Packs,2,0,0.0,2
27371,7072,Kits,2,2,1.0,0
27372,7072,Stuff Packs,3,3,1.0,0
27373,7073,Expansion Packs,16,0,0.0,16
27374,7073,Game Packs,11,0,0.0,11
27375,7073,Kits,19,1,0.05263157894736842,18
27376,7073,Stuff Packs,19,0,0.0,19
27377,7074,Expansion Packs,5,1,0.2,4
27378,7074,Game Packs,1,0,0.0,1
27379,7074,Kits,3,0,0.0,3
27380,7074,Stuff Packs,5,0,0.0,5
27381,7075,Expansion Packs,11,0,0.0,11
27382,7075,Game Packs,5,0,0.0,5
27383,7075,Kits,1,0,0.0,1
27384,7075,Stuff Packs,12,0,0.0,12
27385,7076,Expansion Packs,16,0,0.0,16
27386,7076,Game Packs,12,0,0.0,12
27387,7076,Kits,33,1,0.030303030303030304,32
27388,7076,Stuff Packs,20,0,0.0,20
27389,7077,Expansion Packs,14,0,0.0,14
27390,7077,Game Packs,5,0,0.0,5
27391,7077,Kits,2,2,1.0,0
27392,7077,Stuff Packs,8,1,0.125,7
27393,7078,Expansion Packs,16,0,0.0,16
27394,7078,Game Packs,12,0,0.0,12
27395,7078,Kits,33,1,0.030303030303030304,32
27396,7078,Stuff Packs,20,0,0.0,20
27397,7079,Expansion Packs,16,0,0.0,16
27398,7079,Game Packs,11,0,0.0,11
27399,7079,Kits,33,0,0.0,33
27400,7079,Stuff Packs,20,0,0.0,20
27401,7080,Expansion Packs,16,0,0.0,16
27402,7080,Game Packs,11,0,0.0,11
27403,7080,Kits,5,1,0.2,4
27404,7080,Stuff Packs,19,1,0.05263157894736842,18
27405,7081,Expansion Packs,14,0,0.0,14
27406,7081,Game Packs,3,0,0.0,3
27407,7081,Kits,1,0,0.0,1
27408,7081,Stuff Packs,4,2,0.5,2
27409,7082,Expansion Packs,16,15,0.9375,1
27410,7082,Game Packs,12,12,1.0,0
27411,7082,Kits,33,33,1.0,0
27412,7082,Stuff Packs,20,19,0.95,1
27413,7083,Expansion Packs,14,0,0.0,14
27414,7083,Game Packs,9,0,0.0,9
27415,7083,Kits,10,1,0.1,9
27416,7083,Stuff Packs,16,3,0.1875,13
27417,7084,Expansion Packs,16,0,0.0,16
27418,7084,Game Packs,12,0,0.0,12
27419,7084,Kits,33,0,0.0,33
27420,7084,Stuff Packs,20,0,0.0,20
27421,7085,Expansion Packs,16,0,0.0,16
27422,7085,Game Packs,12,0,0.0,12
27423,7085,Kits,29,0,0.0,29
27424,7085,Stuff Packs,20,0,0.0,20
27425,7086,Expansion Packs,12,0,0.0,12
27426,7086,Game Packs,11,0,0.0,11
27427,7086,Kits,31,0,0.0,31
27428,7086,Stuff Packs,20,0,0.0,20
27429,7087,Expansion Packs,14,0,0.0,14
27430,7087,Game Packs,5,0,0.0,5
27431,7087,Kits,13,3,0.23076923076923078,10
27432,7087,Stuff Packs,14,1,0.07142857142857142,13
27433,7088,Expansion Packs,13,0,0.0,13
27434,7088,Game Packs,7,0,0.0,7
27435,7088,Kits,10,1,0.1,9
27436,7088,Stuff Packs,16,2,0.125,14
27437,7089,Expansion Packs,16,0,0.0,16
27438,7089,Game Packs,12,0,0.0,12
27439,7089,Kits,23,0,0.0,23
27440,7089,Stuff Packs,20,0,0.0,20
27441,7090,Expansion Packs,14,1,0.07142857142857142,13
27442,7090,Game Packs,7,0,0.0,7
27443,7090,Stuff Packs,2,0,0.0,2
27444,7091,Expansion Packs,13,0,0.0,13
27445,7091,Game Packs,9,0,0.0,9
27446,7091,Kits,9,0,0.0,9
27447,7091,Stuff Packs,10,0,0.0,10
27448,7092,Expansion Packs,16,0,0.0,16
27449,7092,Game Packs,12,0,0.0,12
27450,7092,Kits,33,0,0.0,33
27451,7092,Stuff Packs,20,0,0.0,20
27452,7093,Expansion Packs,10,0,0.0,10
27453,7093,Game Packs,5,0,0.0,5
27454,7093,Kits,3,2,0.6666666666666666,1
27455,7093,Stuff Packs,6,2,0.3333333333333333,4
27456,7094,Expansion Packs,16,0,0.0,16
27457,7094,Game Packs,11,0,0.0,11
27458,7094,Kits,17,2,0.11764705882352941,15
27459,7094,Stuff Packs,20,0,0.0,20
27460,7095,Expansion Packs,3,0,0.0,3
27461,7095,Kits,1,1,1.0,0
27462,7096,Expansion Packs,5,0,0.0,5
27463,7096,Game Packs,5,1,0.2,4
27464,7096,Kits,1,1,1.0,0
27465,7096,Stuff Packs,3,0,0.0,3
27466,7097,Expansion Packs,9,0,0.0,9
27467,7097,Game Packs,7,0,0.0,7
27468,7097,Stuff Packs,3,1,0.3333333333333333,2
27469,7098,Expansion Packs,16,0,0.0,16
27470,7098,Game Packs,12,0,0.0,12
27471,7098,Kits,33,0,0.0,33
27472,7098,Stuff Packs,20,0,0.0,20
27473,7099,Expansion Packs,1,0,0.0,1
27474,7099,Kits,1,1,1.0,0
27475,7100,Expansion Packs,16,0,0.0,16
27476,7100,Game Packs,6,0,0.0,6
27477,7100,Kits,12,1,0.08333333333333333,11
27478,7100,Stuff Packs,14,2,0.14285714285714285,12
27479,7101,Expansion Packs,3,0,0.0,3
27480,7101,Game Packs,1,0,0.0,1
27481,7101,Kits,2,2,1.0,0
27482,7101,Stuff Packs,4,2,0.5,2
27483,7102,Expansion Packs,16,0,0.0,16
27484,7102,Game Packs,12,0,0.0,12
27485,7102,Kits,33,0,0.0,33
27486,7102,Stuff Packs,20,0,0.0,20
27487,7103,Expansion Packs,16,0,0.0,16
27488,7103,Game Packs,12,0,0.0,12
27489,7103,Kits,33,0,0.0,33
27490,7103,Stuff Packs,20,0,0.0,20
27491,7104,Expansion Packs,11,0,0.0,11
27492,7104,Game Packs,9,0,0.0,9
27493,7104,Kits,4,2,0.5,2
27494,7104,Stuff Packs,15,0,0.0,15
27495,7105,Expansion Packs,16,0,0.0,16
27496,7105,Game Packs,11,0,0.0,11
27497,7105,Kits,19,1,0.05263157894736842,18
27498,7105,Stuff Packs,20,1,0.05,19
27499,7106,Expansion Packs,4,0,0.0,4
27500,7106,Game Packs,2,1,0.5,1
27501,7106,Kits,3,3,1.0,0
27502,7106,Stuff Packs,5,4,0.8,1
27503,7107,Expansion Packs,14,0,0.0,14
27504,7107,Game Packs,6,0,0.0,6
27505,7107,Kits,2,2,1.0,0
27506,7107,Stuff Packs,6,0,0.0,6
27507,7108,Expansion Packs,16,0,0.0,16
27508,7108,Game Packs,11,0,0.0,11
27509,7108,Kits,13,0,0.0,13
27510,7108,Stuff Packs,17,0,0.0,17
27511,7109,Expansion Packs,13,0,0.0,13
27512,7109,Game Packs,10,1,0.1,9
27513,7109,Kits,14,2,0.14285714285714285,12
27514,7109,Stuff Packs,14,2,0.14285714285714285,12
27515,7110,Expansion Packs,6,2,0.3333333333333333,4
27516,7110,Game Packs,1,0,0.0,1
27517,7110,Kits,3,2,0.6666666666666666,1
27518,7110,Stuff Packs,3,2,0.6666666666666666,1
27519,7111,Expansion Packs,13,0,0.0,13
27520,7111,Game Packs,8,0,0.0,8
27521,7111,Kits,2,2,1.0,0
27522,7111,Stuff Packs,12,4,0.3333333333333333,8
27523,7112,Expansion Packs,14,0,0.0,14
27524,7112,Game Packs,7,1,0.14285714285714285,6
27525,7112,Kits,8,1,0.125,7
27526,7112,Stuff Packs,9,5,0.5555555555555556,4
27527,7113,Expansion Packs,16,0,0.0,16
27528,7113,Game Packs,9,0,0.0,9
27529,7113,Kits,30,2,0.06666666666666667,28
27530,7113,Stuff Packs,10,1,0.1,9
27531,7114,Expansion Packs,16,0,0.0,16
27532,7114,Game Packs,10,0,0.0,10
27533,7114,Kits,4,0,0.0,4
27534,7114,Stuff Packs,10,1,0.1,9
27535,7115,Expansion Packs,14,0,0.0,14
27536,7115,Game Packs,12,0,0.0,12
27537,7115,Kits,13,0,0.0,13
27538,7115,Stuff Packs,19,0,0.0,19
27539,7116,Expansion Packs,16,1,0.0625,15
27540,7116,Game Packs,12,0,0.0,12
27541,7116,Kits,33,4,0.12121212121212122,29
27542,7116,Stuff Packs,20,0,0.0,20
27543,7117,Expansion Packs,6,0,0.0,6
27544,7117,Game Packs,6,0,0.0,6
27545,7117,Stuff Packs,3,0,0.0,3
27546,7118,Expansion Packs,7,0,0.0,7
27547,7118,Game Packs,3,1,0.3333333333333333,2
27548,7118,Kits,5,2,0.4,3
27549,7118,Stuff Packs,6,4,0.6666666666666666,2
27550,7119,Expansion Packs,12,0,0.0,12
27551,7119,Game Packs,7,0,0.0,7
27552,7119,Kits,6,0,0.0,6
27553,7119,Stuff Packs,5,0,0.0,5
27554,7120,Expansion Packs,9,0,0.0,9
27555,7120,Game Packs,7,0,0.0,7
27556,7120,Stuff Packs,10,3,0.3,7
27557,7121,Expansion Packs,9,2,0.2222222222222222,7
27558,7121,Game Packs,2,0,0.0,2
27559,7121,Kits,12,0,0.0,12
27560,7121,Stuff Packs,5,0,0.0,5
27561,7122,Expansion Packs,3,0,0.0,3
27562,7122,Game Packs,3,1,0.3333333333333333,2
27563,7122,Kits,3,2,0.6666666666666666,1
27564,7122,Stuff Packs,6,4,0.6666666666666666,2
27565,7123,Expansion Packs,6,0,0.0,6
27566,7123,Game Packs,6,0,0.0,6
27567,7123,Kits,23,1,0.043478260869565216,22
27568,7123,Stuff Packs,18,1,0.05555555555555555,17
27569,7124,Expansion Packs,12,0,0.0,12
27570,7124,Game Packs,3,0,0.0,3
27571,7124,Kits,16,0,0.0,16
27572,7124,Stuff Packs,6,0,0.0,6
27573,7125,Expansion Packs,16,0,0.0,16
27574,7125,Game Packs,12,0,0.0,12
27575,7125,Kits,32,1,0.03125,31
27576,7125,Stuff Packs,20,0,0.0,20
27577,7126,Expansion Packs,16,0,0.0,16
27578,7126,Game Packs,9,0,0.0,9
27579,7126,Kits,4,2,0.5,2
27580,7126,Stuff Packs,11,1,0.09090909090909091,10
27581,7127,Expansion Packs,15,0,0.0,15
27582,7127,Game Packs,12,0,0.0,12
27583,7127,Kits,7,1,0.14285714285714285,6
27584,7127,Stuff Packs,16,1,0.0625,15
27585,7128,Expansion Packs,8,0,0.0,8
27586,7128,Game Packs,4,0,0.0,4
27587,7128,Kits,7,0,0.0,7
27588,7128,Stuff Packs,7,2,0.2857142857142857,5
27589,7129,Expansion Packs,15,0,0.0,15
27590,7129,Game Packs,10,0,0.0,10
27591,7129,Kits,9,1,0.1111111111111111,8
27592,7129,Stuff Packs,18,0,0.0,18
27593,7130,Expansion Packs,9,0,0.0,9
27594,7130,Game Packs,2,0,0.0,2
27595,7130,Kits,1,1,1.0,0
27596,7130,Stuff Packs,7,2,0.2857142857142857,5
27597,7131,Expansion Packs,16,0,0.0,16
27598,7131,Game Packs,12,0,0.0,12
27599,7131,Kits,21,1,0.047619047619047616,20
27600,7131,Stuff Packs,20,0,0.0,20
27601,7132,Expansion Packs,16,1,0.0625,15
27602,7132,Game Packs,12,0,0.0,12
27603,7132,Kits,33,1,0.030303030303030304,32
27604,7132,Stuff Packs,20,0,0.0,20
27605,7133,Expansion Packs,13,0,0.0,13
27606,7133,Game Packs,4,0,0.0,4
27607,7133,Kits,5,0,0.0,5
27608,7133,Stuff Packs,10,2,0.2,8
27609,7134,Expansion Packs,11,0,0.0,11
27610,7134,Game Packs,3,0,0.0,3
27611,7134,Kits,3,1,0.3333333333333333,2
27612,7134,Stuff Packs,9,1,0.1111111111111111,8
27613,7135,Expansion Packs,14,1,0.07142857142857142,13
27614,7135,Game Packs,12,0,0.0,12
27615,7135,Kits,6,1,0.16666666666666666,5
27616,7135,Stuff Packs,19,2,0.10526315789473684,17
27617,7136,Expansion Packs,12,0,0.0,12
27618,7136,Game Packs,5,0,0.0,5
27619,7136,Kits,4,1,0.25,3
27620,7136,Stuff Packs,6,2,0.3333333333333333,4
27621,7137,Expansion Packs,11,0,0.0,11
27622,7137,Game Packs,7,0,0.0,7
27623,7137,Kits,2,2,1.0,0
27624,7137,Stuff Packs,12,0,0.0,12
27625,7138,Expansion Packs,16,0,0.0,16
27626,7138,Game Packs,10,0,0.0,10
27627,7138,Stuff Packs,18,3,0.16666666666666666,15
27628,7139,Expansion Packs,16,0,0.0,16
27629,7139,Game Packs,12,0,0.0,12
27630,7139,Kits,2,1,0.5,1
27631,7139,Stuff Packs,13,3,0.23076923076923078,10
27632,7140,Expansion Packs,16,0,0.0,16
27633,7140,Game Packs,12,0,0.0,12
27634,7140,Kits,33,0,0.0,33
27635,7140,Stuff Packs,20,0,0.0,20
27636,7141,Expansion Packs,6,0,0.0,6
27637,7141,Game Packs,3,0,0.0,3
27638,7141,Stuff Packs,5,0,0.0,5
27639,7142,Expansion Packs,16,0,0.0,16
27640,7142,Game Packs,9,0,0.0,9
27641,7142,Kits,5,1,0.2,4
27642,7142,Stuff Packs,11,1,0.09090909090909091,10
27643,7143,Expansion Packs,16,0,0.0,16
27644,7143,Game Packs,12,0,0.0,12
27645,7143,Kits,33,0,0.0,33
27646,7143,Stuff Packs,20,1,0.05,19
27647,7144,Expansion Packs,14,0,0.0,14
27648,7144,Game Packs,9,0,0.0,9
27649,7144,Kits,2,2,1.0,0
27650,7144,Stuff Packs,13,3,0.23076923076923078,10
27651,7145,Expansion Packs,11,0,0.0,11
27652,7145,Game Packs,3,0,0.0,3
27653,7145,Stuff Packs,2,0,0.0,2
27654,7146,Expansion Packs,9,0,0.0,9
27655,7146,Game Packs,4,0,0.0,4
27656,7146,Stuff Packs,1,0,0.0,1
27657,7147,Expansion Packs,10,0,0.0,10
27658,7147,Game Packs,7,0,0.0,7
27659,7147,Kits,4,0,0.0,4
27660,7147,Stuff Packs,4,0,0.0,4
27661,7148,Expansion Packs,16,0,0.0,16
27662,7148,Game Packs,12,0,0.0,12
27663,7148,Kits,33,1,0.030303030303030304,32
27664,7148,Stuff Packs,20,0,0.0,20
27665,7149,Expansion Packs,16,0,0.0,16
27666,7149,Game Packs,11,0,0.0,11
27667,7149,Kits,15,1,0.06666666666666667,14
27668,7149,Stuff Packs,15,0,0.0,15
27669,7150,Expansion Packs,13,0,0.0,13
27670,7150,Game Packs,10,0,0.0,10
27671,7150,Kits,7,0,0.0,7
27672,7150,Stuff Packs,19,1,0.05263157894736842,18
27673,7151,Expansion Packs,16,0,0.0,16
27674,7151,Game Packs,12,0,0.0,12
27675,7151,Kits,19,2,0.10526315789473684,17
27676,7151,Stuff Packs,20,0,0.0,20
27677,7152,Expansion Packs,16,0,0.0,16
27678,7152,Game Packs,12,0,0.0,12
27679,7152,Kits,33,1,0.030303030303030304,32
27680,7152,Stuff Packs,20,0,0.0,20
27681,7153,Expansion Packs,4,2,0.5,2
27682,7153,Game Packs,2,1,0.5,1
27683,7153,Stuff Packs,1,1,1.0,0
27684,7154,Expansion Packs,14,0,0.0,14
27685,7154,Game Packs,4,0,0.0,4
27686,7154,Kits,2,2,1.0,0
27687,7154,Stuff Packs,6,3,0.5,3
27688,7155,Expansion Packs,9,0,0.0,9
27689,7155,Game Packs,7,0,0.0,7
27690,7155,Kits,5,1,0.2,4
27691,7155,Stuff Packs,12,1,0.08333333333333333,11
27692,7156,Expansion Packs,6,0,0.0,6
27693,7156,Game Packs,4,1,0.25,3
27694,7156,Kits,3,3,1.0,0
27695,7156,Stuff Packs,7,4,0.5714285714285714,3
27696,7157,Expansion Packs,8,0,0.0,8
27697,7157,Game Packs,1,0,0.0,1
27698,7157,Kits,1,0,0.0,1
27699,7157,Stuff Packs,5,0,0.0,5
27700,7158,Expansion Packs,16,0,0.0,16
27701,7158,Game Packs,11,0,0.0,11
27702,7158,Kits,6,2,0.3333333333333333,4
27703,7158,Stuff Packs,17,1,0.058823529411764705,16
27704,7159,Expansion Packs,16,0,0.0,16
27705,7159,Game Packs,12,0,0.0,12
27706,7159,Kits,27,0,0.0,27
27707,7159,Stuff Packs,20,0,0.0,20
27708,7160,Expansion Packs,13,0,0.0,13
27709,7160,Game Packs,7,0,0.0,7
27710,7160,Kits,7,2,0.2857142857142857,5
27711,7160,Stuff Packs,16,1,0.0625,15
27712,7161,Expansion Packs,16,0,0.0,16
27713,7161,Game Packs,12,0,0.0,12
27714,7161,Kits,33,0,0.0,33
27715,7161,Stuff Packs,20,0,0.0,20
27716,7162,Expansion Packs,3,0,0.0,3
27717,7162,Game Packs,1,0,0.0,1
27718,7162,Kits,3,2,0.6666666666666666,1
27719,7162,Stuff Packs,4,3,0.75,1
27720,7163,Expansion Packs,16,0,0.0,16
27721,7163,Game Packs,11,0,0.0,11
27722,7163,Kits,18,0,0.0,18
27723,7163,Stuff Packs,19,0,0.0,19
27724,7164,Expansion Packs,4,0,0.0,4
27725,7164,Game Packs,3,1,0.3333333333333333,2
27726,7164,Kits,3,3,1.0,0
27727,7164,Stuff Packs,4,4,1.0,0
27728,7165,Expansion Packs,16,0,0.0,16
27729,7165,Game Packs,12,0,0.0,12
27730,7165,Kits,33,1,0.030303030303030304,32
27731,7165,Stuff Packs,20,1,0.05,19
27732,7166,Expansion Packs,14,1,0.07142857142857142,13
27733,7166,Game Packs,10,1,0.1,9
27734,7166,Kits,5,3,0.6,2
27735,7166,Stuff Packs,13,3,0.23076923076923078,10
27736,7167,Expansion Packs,9,0,0.0,9
27737,7167,Game Packs,6,0,0.0,6
27738,7167,Kits,2,2,1.0,0
27739,7167,Stuff Packs,5,2,0.4,3
27740,7168,Expansion Packs,10,0,0.0,10
27741,7168,Game Packs,9,0,0.0,9
27742,7168,Kits,2,0,0.0,2
27743,7168,Stuff Packs,12,0,0.0,12
27744,7169,Expansion Packs,16,0,0.0,16
27745,7169,Game Packs,12,0,0.0,12
27746,7169,Kits,33,0,0.0,33
27747,7169,Stuff Packs,20,0,0.0,20
27748,7170,Expansion Packs,16,0,0.0,16
27749,7170,Game Packs,12,0,0.0,12
27750,7170,Kits,12,0,0.0,12
27751,7170,Stuff Packs,18,2,0.1111111111111111,16
27752,7171,Expansion Packs,7,0,0.0,7
27753,7171,Game Packs,5,0,0.0,5
27754,7171,Kits,2,1,0.5,1
27755,7171,Stuff Packs,8,2,0.25,6
27756,7172,Expansion Packs,15,0,0.0,15
27757,7172,Game Packs,9,1,0.1111111111111111,8
27758,7172,Kits,7,3,0.42857142857142855,4
27759,7172,Stuff Packs,11,3,0.2727272727272727,8
27760,7173,Expansion Packs,16,0,0.0,16
27761,7173,Game Packs,12,0,0.0,12
27762,7173,Kits,33,1,0.030303030303030304,32
27763,7173,Stuff Packs,20,0,0.0,20
27764,7174,Expansion Packs,16,0,0.0,16
27765,7174,Game Packs,12,0,0.0,12
27766,7174,Kits,13,2,0.15384615384615385,11
27767,7174,Stuff Packs,20,0,0.0,20
27768,7175,Expansion Packs,16,0,0.0,16
27769,7175,Game Packs,11,0,0.0,11
27770,7175,Kits,33,0,0.0,33
27771,7175,Stuff Packs,20,0,0.0,20
27772,7176,Expansion Packs,16,0,0.0,16
27773,7176,Game Packs,12,0,0.0,12
27774,7176,Kits,31,1,0.03225806451612903,30
27775,7176,Stuff Packs,20,0,0.0,20
27776,7177,Expansion Packs,6,0,0.0,6
27777,7177,Game Packs,1,0,0.0,1
27778,7177,Kits,5,2,0.4,3
27779,7177,Stuff Packs,5,2,0.4,3
27780,7178,Expansion Packs,4,0,0.0,4
27781,7178,Game Packs,4,0,0.0,4
27782,7178,Kits,2,2,1.0,0
27783,7178,Stuff Packs,6,1,0.16666666666666666,5
27784,7179,Expansion Packs,10,0,0.0,10
27785,7179,Game Packs,6,0,0.0,6
27786,7179,Kits,3,0,0.0,3
27787,7179,Stuff Packs,6,0,0.0,6
27788,7180,Expansion Packs,12,0,0.0,12
27789,7180,Game Packs,6,0,0.0,6
27790,7180,Kits,2,2,1.0,0
27791,7180,Stuff Packs,15,1,0.06666666666666667,14
27792,7181,Expansion Packs,16,0,0.0,16
27793,7181,Game Packs,12,0,0.0,12
27794,7181,Kits,19,1,0.05263157894736842,18
27795,7181,Stuff Packs,20,0,0.0,20
27796,7182,Expansion Packs,12,1,0.08333333333333333,11
27797,7182,Game Packs,7,2,0.2857142857142857,5
27798,7182,Kits,5,0,0.0,5
27799,7182,Stuff Packs,5,3,0.6,2
27800,7183,Expansion Packs,16,0,0.0,16
27801,7183,Game Packs,12,0,0.0,12
27802,7183,Kits,21,0,0.0,21
27803,7183,Stuff Packs,20,0,0.0,20
27804,7184,Expansion Packs,16,0,0.0,16
27805,7184,Game Packs,12,0,0.0,12
27806,7184,Kits,30,1,0.03333333333333333,29
27807,7184,Stuff Packs,20,0,0.0,20
27808,7185,Expansion Packs,14,0,0.0,14
27809,7185,Game Packs,12,0,0.0,12
27810,7185,Kits,3,1,0.3333333333333333,2
27811,7185,Stuff Packs,20,0,0.0,20
27812,7186,Expansion Packs,16,0,0.0,16
27813,7186,Game Packs,12,0,0.0,12
27814,7186,Kits,5,1,0.2,4
27815,7186,Stuff Packs,20,0,0.0,20
27816,7187,Expansion Packs,7,0,0.0,7
27817,7187,Game Packs,2,1,0.5,1
27818,7187,Kits,1,1,1.0,0
27819,7187,Stuff Packs,5,3,0.6,2
27820,7188,Expansion Packs,12,0,0.0,12
27821,7188,Game Packs,7,0,0.0,7
27822,7188,Kits,6,3,0.5,3
27823,7188,Stuff Packs,9,4,0.4444444444444444,5
27824,7189,Expansion Packs,16,0,0.0,16
27825,7189,Game Packs,12,1,0.08333333333333333,11
27826,7189,Kits,13,0,0.0,13
27827,7189,Stuff Packs,20,0,0.0,20
27828,7190,Expansion Packs,14,0,0.0,14
27829,7190,Game Packs,10,0,0.0,10
27830,7190,Kits,8,1,0.125,7
27831,7190,Stuff Packs,10,0,0.0,10
27832,7191,Expansion Packs,1,0,0.0,1
27833,7191,Game Packs,1,0,0.0,1
27834,7191,Kits,1,1,1.0,0
27835,7191,Stuff Packs,1,0,0.0,1
27836,7192,Expansion Packs,16,0,0.0,16
27837,7192,Game Packs,11,0,0.0,11
27838,7192,Kits,8,1,0.125,7
27839,7192,Stuff Packs,20,0,0.0,20
27840,7193,Expansion Packs,11,0,0.0,11
27841,7193,Game Packs,6,0,0.0,6
27842,7193,Stuff Packs,4,0,0.0,4
27843,7194,Expansion Packs,16,0,0.0,16
27844,7194,Game Packs,12,0,0.0,12
27845,7194,Kits,33,0,0.0,33
27846,7194,Stuff Packs,20,0,0.0,20
27847,7195,Expansion Packs,14,0,0.0,14
27848,7195,Game Packs,10,0,0.0,10
27849,7195,Kits,4,0,0.0,4
27850,7195,Stuff Packs,15,0,0.0,15
27851,7196,Expansion Packs,12,0,0.0,12
27852,7196,Game Packs,8,1,0.125,7
27853,7196,Kits,15,2,0.13333333333333333,13
27854,7196,Stuff Packs,15,4,0.26666666666666666,11
27855,7197,Expansion Packs,16,1,0.0625,15
27856,7197,Game Packs,12,0,0.0,12
27857,7197,Kits,11,0,0.0,11
27858,7197,Stuff Packs,20,0,0.0,20
27859,7198,Expansion Packs,16,0,0.0,16
27860,7198,Game Packs,11,0,0.0,11
27861,7198,Kits,29,1,0.034482758620689655,28
27862,7198,Stuff Packs,20,0,0.0,20
27863,7199,Expansion Packs,6,0,0.0,6
27864,7199,Game Packs,2,0,0.0,2
27865,7199,Stuff Packs,3,1,0.3333333333333333,2
27866,7200,Expansion Packs,16,0,0.0,16
27867,7200,Game Packs,12,0,0.0,12
27868,7200,Kits,27,0,0.0,27
27869,7200,Stuff Packs,19,0,0.0,19
27870,7201,Expansion Packs,16,0,0.0,16
27871,7201,Game Packs,11,0,0.0,11
27872,7201,Kits,14,1,0.07142857142857142,13
27873,7201,Stuff Packs,19,1,0.05263157894736842,18
27874,7202,Expansion Packs,11,0,0.0,11
27875,7202,Game Packs,7,0,0.0,7
27876,7202,Kits,5,0,0.0,5
27877,7202,Stuff Packs,18,0,0.0,18
27878,7203,Expansion Packs,11,0,0.0,11
27879,7203,Game Packs,4,0,0.0,4
27880,7203,Kits,6,1,0.16666666666666666,5
27881,7203,Stuff Packs,6,0,0.0,6
27882,7204,Expansion Packs,13,0,0.0,13
27883,7204,Game Packs,8,0,0.0,8
27884,7204,Kits,3,2,0.6666666666666666,1
27885,7204,Stuff Packs,9,3,0.3333333333333333,6
27886,7205,Expansion Packs,16,0,0.0,16
27887,7205,Game Packs,12,0,0.0,12
27888,7205,Kits,33,0,0.0,33
27889,7205,Stuff Packs,20,0,0.0,20
27890,7206,Expansion Packs,16,1,0.0625,15
27891,7206,Game Packs,12,0,0.0,12
27892,7206,Kits,33,0,0.0,33
27893,7206,Stuff Packs,20,0,0.0,20
27894,7207,Expansion Packs,14,0,0.0,14
27895,7207,Game Packs,9,0,0.0,9
27896,7207,Kits,5,0,0.0,5
27897,7207,Stuff Packs,7,1,0.14285714285714285,6
27898,7208,Expansion Packs,16,0,0.0,16
27899,7208,Game Packs,12,0,0.0,12
27900,7208,Kits,26,0,0.0,26
27901,7208,Stuff Packs,20,0,0.0,20
27902,7209,Expansion Packs,13,0,0.0,13
27903,7209,Game Packs,8,0,0.0,8
27904,7209,Kits,10,1,0.1,9
27905,7209,Stuff Packs,14,1,0.07142857142857142,13
27906,7210,Expansion Packs,16,0,0.0,16
27907,7210,Game Packs,11,0,0.0,11
27908,7210,Kits,33,0,0.0,33
27909,7210,Stuff Packs,20,0,0.0,20
27910,7211,Expansion Packs,15,0,0.0,15
27911,7211,Game Packs,11,0,0.0,11
27912,7211,Kits,14,1,0.07142857142857142,13
27913,7211,Stuff Packs,19,1,0.05263157894736842,18
27914,7212,Expansion Packs,16,0,0.0,16
27915,7212,Game Packs,12,0,0.0,12
27916,7212,Kits,33,1,0.030303030303030304,32
27917,7212,Stuff Packs,20,0,0.0,20
27918,7213,Expansion Packs,3,0,0.0,3
27919,7213,Game Packs,1,0,0.0,1
27920,7213,Kits,1,1,1.0,0
27921,7213,Stuff Packs,1,1,1.0,0
27922,7214,Expansion Packs,4,0,0.0,4
27923,7214,Stuff Packs,1,0,0.0,1
27924,7215,Expansion Packs,16,0,0.0,16
27925,7215,Game Packs,12,0,0.0,12
27926,7215,Kits,33,0,0.0,33
27927,7215,Stuff Packs,20,0,0.0,20
27928,7216,Expansion Packs,13,0,0.0,13
27929,7216,Game Packs,9,0,0.0,9
27930,7216,Kits,2,2,1.0,0
27931,7216,Stuff Packs,15,1,0.06666666666666667,14
27932,7217,Expansion Packs,13,0,0.0,13
27933,7217,Game Packs,9,0,0.0,9
27934,7217,Kits,5,1,0.2,4
27935,7217,Stuff Packs,8,0,0.0,8
27936,7218,Expansion Packs,7,0,0.0,7
27937,7218,Game Packs,5,0,0.0,5
27938,7218,Kits,9,1,0.1111111111111111,8
27939,7218,Stuff Packs,4,0,0.0,4
27940,7219,Expansion Packs,11,0,0.0,11
27941,7219,Game Packs,7,0,0.0,7
27942,7219,Kits,3,3,1.0,0
27943,7219,Stuff Packs,11,3,0.2727272727272727,8
27944,7220,Expansion Packs,16,0,0.0,16
27945,7220,Game Packs,8,0,0.0,8
27946,7220,Kits,4,0,0.0,4
27947,7220,Stuff Packs,8,3,0.375,5
27948,7221,Expansion Packs,14,0,0.0,14
27949,7221,Game Packs,8,0,0.0,8
27950,7221,Kits,1,1,1.0,0
27951,7221,Stuff Packs,10,1,0.1,9
27952,7222,Expansion Packs,12,0,0.0,12
27953,7222,Game Packs,4,0,0.0,4
27954,7222,Kits,2,2,1.0,0
27955,7222,Stuff Packs,9,3,0.3333333333333333,6
27956,7223,Expansion Packs,8,0,0.0,8
27957,7223,Game Packs,2,0,0.0,2
27958,7223,Stuff Packs,2,0,0.0,2
27959,7224,Kits,24,0,0.0,24
27960,7225,Expansion Packs,12,0,0.0,12
27961,7225,Game Packs,5,0,0.0,5
27962,7225,Kits,2,2,1.0,0
27963,7225,Stuff Packs,10,3,0.3,7
27964,7226,Expansion Packs,9,0,0.0,9
27965,7226,Game Packs,5,0,0.0,5
27966,7226,Kits,1,1,1.0,0
27967,7226,Stuff Packs,8,1,0.125,7
27968,7227,Expansion Packs,13,0,0.0,13
27969,7227,Game Packs,11,0,0.0,11
27970,7227,Kits,6,1,0.16666666666666666,5
27971,7227,Stuff Packs,8,0,0.0,8
27972,7228,Expansion Packs,14,0,0.0,14
27973,7228,Game Packs,12,0,0.0,12
27974,7228,Kits,8,0,0.0,8
27975,7228,Stuff Packs,13,0,0.0,13
27976,7229,Expansion Packs,4,0,0.0,4
27977,7229,Game Packs,3,0,0.0,3
27978,7229,Kits,1,1,1.0,0
27979,7229,Stuff Packs,6,2,0.3333333333333333,4
27980,7230,Expansion Packs,16,0,0.0,16
27981,7230,Game Packs,11,0,0.0,11
27982,7230,Kits,15,2,0.13333333333333333,13
27983,7230,Stuff Packs,20,0,0.0,20
27984,7231,Expansion Packs,2,0,0.0,2
27985,7231,Kits,2,2,1.0,0
27986,7231,Stuff Packs,4,3,0.75,1
27987,7232,Expansion Packs,7,0,0.0,7
27988,7232,Game Packs,3,1,0.3333333333333333,2
27989,7232,Kits,1,0,0.0,1
27990,7232,Stuff Packs,7,4,0.5714285714285714,3
27991,7233,Expansion Packs,13,0,0.0,13
27992,7233,Game Packs,8,0,0.0,8
27993,7233,Kits,10,2,0.2,8
27994,7233,Stuff Packs,7,3,0.42857142857142855,4
27995,7234,Expansion Packs,16,0,0.0,16
27996,7234,Game Packs,12,0,0.0,12
27997,7234,Kits,33,0,0.0,33
27998,7234,Stuff Packs,20,0,0.0,20
27999,7235,Expansion Packs,7,1,0.14285714285714285,6
28000,7235,Game Packs,4,0,0.0,4
28001,7235,Stuff Packs,7,2,0.2857142857142857,5
28002,7236,Expansion Packs,10,0,0.0,10
28003,7236,Game Packs,4,0,0.0,4
28004,7236,Kits,9,0,0.0,9
28005,7236,Stuff Packs,8,0,0.0,8
28006,7237,Expansion Packs,15,0,0.0,15
28007,7237,Game Packs,7,0,0.0,7
28008,7237,Kits,17,13,0.7647058823529411,4
28009,7237,Stuff Packs,15,4,0.26666666666666666,11
28010,7238,Expansion Packs,6,0,0.0,6
28011,7238,Game Packs,4,1,0.25,3
28012,7238,Kits,3,3,1.0,0
28013,7238,Stuff Packs,8,4,0.5,4
28014,7239,Stuff Packs,1,1,1.0,0
28015,7240,Expansion Packs,16,1,0.0625,15
28016,7240,Game Packs,12,0,0.0,12
28017,7240,Kits,29,1,0.034482758620689655,28
28018,7240,Stuff Packs,20,0,0.0,20
28019,7241,Expansion Packs,16,0,0.0,16
28020,7241,Game Packs,10,0,0.0,10
28021,7241,Kits,3,2,0.6666666666666666,1
28022,7241,Stuff Packs,10,1,0.1,9
28023,7242,Expansion Packs,16,0,0.0,16
28024,7242,Game Packs,11,0,0.0,11
28025,7242,Kits,15,0,0.0,15
28026,7242,Stuff Packs,16,0,0.0,16
28027,7243,Expansion Packs,16,0,0.0,16
28028,7243,Game Packs,12,0,0.0,12
28029,7243,Kits,33,0,0.0,33
28030,7243,Stuff Packs,20,0,0.0,20
28031,7244,Expansion Packs,14,0,0.0,14
28032,7244,Game Packs,5,0,0.0,5
28033,7244,Kits,10,1,0.1,9
28034,7244,Stuff Packs,12,1,0.08333333333333333,11
28035,7245,Expansion Packs,10,1,0.1,9
28036,7245,Game Packs,9,2,0.2222222222222222,7
28037,7245,Kits,5,0,0.0,5
28038,7245,Stuff Packs,12,0,0.0,12
28039,7246,Expansion Packs,15,0,0.0,15
28040,7246,Game Packs,11,1,0.09090909090909091,10
28041,7246,Kits,3,0,0.0,3
28042,7246,Stuff Packs,15,0,0.0,15
28043,7247,Expansion Packs,12,0,0.0,12
28044,7247,Game Packs,9,0,0.0,9
28045,7247,Kits,5,0,0.0,5
28046,7247,Stuff Packs,18,0,0.0,18
28047,7248,Expansion Packs,11,0,0.0,11
28048,7248,Game Packs,2,0,0.0,2
28049,7248,Kits,1,1,1.0,0
28050,7248,Stuff Packs,7,2,0.2857142857142857,5
28051,7249,Expansion Packs,15,0,0.0,15
28052,7249,Game Packs,12,0,0.0,12
28053,7249,Kits,1,0,0.0,1
28054,7249,Stuff Packs,12,0,0.0,12
28055,7250,Expansion Packs,11,0,0.0,11
28056,7250,Game Packs,7,0,0.0,7
28057,7250,Kits,2,1,0.5,1
28058,7250,Stuff Packs,6,0,0.0,6
28059,7251,Expansion Packs,8,0,0.0,8
28060,7251,Game Packs,4,0,0.0,4
28061,7251,Kits,2,2,1.0,0
28062,7251,Stuff Packs,5,0,0.0,5
28063,7252,Expansion Packs,11,0,0.0,11
28064,7252,Game Packs,4,0,0.0,4
28065,7252,Kits,4,2,0.5,2
28066,7252,Stuff Packs,4,3,0.75,1
28067,7253,Expansion Packs,15,0,0.0,15
28068,7253,Game Packs,9,0,0.0,9
28069,7253,Kits,18,2,0.1111111111111111,16
28070,7253,Stuff Packs,19,0,0.0,19
28071,7254,Expansion Packs,9,0,0.0,9
28072,7254,Kits,1,1,1.0,0
28073,7254,Stuff Packs,3,3,1.0,0
28074,7255,Expansion Packs,14,0,0.0,14
28075,7255,Game Packs,8,0,0.0,8
28076,7255,Kits,9,0,0.0,9
28077,7255,Stuff Packs,11,3,0.2727272727272727,8
28078,7256,Expansion Packs,16,0,0.0,16
28079,7256,Game Packs,12,0,0.0,12
28080,7256,Kits,33,1,0.030303030303030304,32
28081,7256,Stuff Packs,20,0,0.0,20
28082,7257,Expansion Packs,15,0,0.0,15
28083,7257,Game Packs,11,0,0.0,11
28084,7257,Kits,19,1,0.05263157894736842,18
28085,7257,Stuff Packs,17,0,0.0,17
28086,7258,Expansion Packs,16,0,0.0,16
28087,7258,Game Packs,10,1,0.1,9
28088,7258,Kits,8,0,0.0,8
28089,7258,Stuff Packs,14,3,0.21428571428571427,11
28090,7259,Expansion Packs,13,0,0.0,13
28091,7259,Game Packs,5,0,0.0,5
28092,7259,Kits,5,3,0.6,2
28093,7259,Stuff Packs,4,1,0.25,3
28094,7260,Expansion Packs,10,0,0.0,10
28095,7260,Game Packs,7,0,0.0,7
28096,7260,Kits,1,0,0.0,1
28097,7260,Stuff Packs,5,3,0.6,2
28098,7261,Expansion Packs,16,0,0.0,16
28099,7261,Game Packs,12,0,0.0,12
28100,7261,Kits,6,2,0.3333333333333333,4
28101,7261,Stuff Packs,13,0,0.0,13
28102,7262,Expansion Packs,12,0,0.0,12
28103,7262,Game Packs,9,0,0.0,9
28104,7262,Kits,4,1,0.25,3
28105,7262,Stuff Packs,9,1,0.1111111111111111,8
28106,7263,Expansion Packs,13,0,0.0,13
28107,7263,Game Packs,5,0,0.0,5
28108,7263,Kits,28,0,0.0,28
28109,7263,Stuff Packs,11,0,0.0,11
28110,7264,Expansion Packs,12,0,0.0,12
28111,7264,Game Packs,7,0,0.0,7
28112,7264,Kits,1,1,1.0,0
28113,7264,Stuff Packs,19,2,0.10526315789473684,17
28114,7265,Expansion Packs,16,0,0.0,16
28115,7265,Game Packs,12,0,0.0,12
28116,7265,Kits,17,1,0.058823529411764705,16
28117,7265,Stuff Packs,20,0,0.0,20
28118,7266,Expansion Packs,16,0,0.0,16
28119,7266,Game Packs,12,0,0.0,12
28120,7266,Kits,23,0,0.0,23
28121,7266,Stuff Packs,20,0,0.0,20
28122,7267,Expansion Packs,13,0,0.0,13
28123,7267,Game Packs,5,0,0.0,5
28124,7267,Kits,2,0,0.0,2
28125,7267,Stuff Packs,3,0,0.0,3
28126,7268,Expansion Packs,9,0,0.0,9
28127,7268,Game Packs,4,0,0.0,4
28128,7268,Kits,2,1,0.5,1
28129,7268,Stuff Packs,6,0,0.0,6
28130,7269,Expansion Packs,14,0,0.0,14
28131,7269,Game Packs,7,1,0.14285714285714285,6
28132,7269,Kits,10,3,0.3,7
28133,7269,Stuff Packs,19,1,0.05263157894736842,18
28134,7270,Expansion Packs,14,0,0.0,14
28135,7270,Game Packs,10,0,0.0,10
28136,7270,Kits,7,2,0.2857142857142857,5
28137,7270,Stuff Packs,15,2,0.13333333333333333,13
28138,7271,Expansion Packs,16,0,0.0,16
28139,7271,Game Packs,12,0,0.0,12
28140,7271,Kits,27,1,0.037037037037037035,26
28141,7271,Stuff Packs,20,0,0.0,20
28142,7272,Expansion Packs,15,0,0.0,15
28143,7272,Game Packs,6,0,0.0,6
28144,7272,Kits,6,0,0.0,6
28145,7272,Stuff Packs,9,0,0.0,9
28146,7273,Expansion Packs,8,0,0.0,8
28147,7273,Game Packs,4,0,0.0,4
28148,7273,Kits,1,1,1.0,0
28149,7273,Stuff Packs,4,2,0.5,2
28150,7274,Expansion Packs,16,0,0.0,16
28151,7274,Game Packs,12,0,0.0,12
28152,7274,Kits,33,0,0.0,33
28153,7274,Stuff Packs,20,0,0.0,20
28154,7275,Expansion Packs,15,0,0.0,15
28155,7275,Game Packs,9,0,0.0,9
28156,7275,Kits,3,2,0.6666666666666666,1
28157,7275,Stuff Packs,20,0,0.0,20
28158,7276,Expansion Packs,16,0,0.0,16
28159,7276,Game Packs,12,0,0.0,12
28160,7276,Kits,33,0,0.0,33
28161,7276,Stuff Packs,20,1,0.05,19
28162,7277,Expansion Packs,13,0,0.0,13
28163,7277,Game Packs,8,0,0.0,8
28164,7277,Kits,3,2,0.6666666666666666,1
28165,7277,Stuff Packs,12,0,0.0,12
28166,7278,Expansion Packs,14,0,0.0,14
28167,7278,Game Packs,12,0,0.0,12
28168,7278,Kits,21,2,0.09523809523809523,19
28169,7278,Stuff Packs,19,0,0.0,19
28170,7279,Expansion Packs,9,0,0.0,9
28171,7279,Game Packs,3,0,0.0,3
28172,7279,Kits,2,2,1.0,0
28173,7279,Stuff Packs,7,3,0.42857142857142855,4
28174,7280,Expansion Packs,16,0,0.0,16
28175,7280,Game Packs,11,0,0.0,11
28176,7280,Kits,7,2,0.2857142857142857,5
28177,7280,Stuff Packs,20,1,0.05,19
28178,7281,Expansion Packs,16,0,0.0,16
28179,7281,Game Packs,11,0,0.0,11
28180,7281,Kits,13,2,0.15384615384615385,11
28181,7281,Stuff Packs,17,0,0.0,17
28182,7282,Expansion Packs,11,0,0.0,11
28183,7282,Game Packs,8,1,0.125,7
28184,7282,Kits,4,4,1.0,0
28185,7282,Stuff Packs,13,2,0.15384615384615385,11
28186,7283,Expansion Packs,16,0,0.0,16
28187,7283,Game Packs,10,0,0.0,10
28188,7283,Kits,7,1,0.14285714285714285,6
28189,7283,Stuff Packs,9,3,0.3333333333333333,6
28190,7284,Expansion Packs,12,1,0.08333333333333333,11
28191,7284,Game Packs,4,0,0.0,4
28192,7284,Kits,6,2,0.3333333333333333,4
28193,7284,Stuff Packs,6,2,0.3333333333333333,4
28194,7285,Expansion Packs,8,0,0.0,8
28195,7285,Game Packs,5,0,0.0,5
28196,7285,Kits,10,1,0.1,9
28197,7285,Stuff Packs,9,3,0.3333333333333333,6
28198,7286,Expansion Packs,13,0,0.0,13
28199,7286,Game Packs,10,0,0.0,10
28200,7286,Kits,2,2,1.0,0
28201,7286,Stuff Packs,18,0,0.0,18
28202,7287,Expansion Packs,11,0,0.0,11
28203,7287,Game Packs,5,0,0.0,5
28204,7288,Expansion Packs,9,0,0.0,9
28205,7288,Game Packs,3,0,0.0,3
28206,7288,Kits,2,2,1.0,0
28207,7288,Stuff Packs,7,2,0.2857142857142857,5
28208,7289,Expansion Packs,16,0,0.0,16
28209,7289,Game Packs,12,0,0.0,12
28210,7289,Kits,27,2,0.07407407407407407,25
28211,7289,Stuff Packs,20,0,0.0,20
28212,7290,Expansion Packs,7,1,0.14285714285714285,6
28213,7290,Game Packs,3,1,0.3333333333333333,2
28214,7290,Kits,7,2,0.2857142857142857,5
28215,7290,Stuff Packs,7,4,0.5714285714285714,3
28216,7291,Expansion Packs,12,0,0.0,12
28217,7291,Game Packs,4,0,0.0,4
28218,7291,Kits,2,2,1.0,0
28219,7291,Stuff Packs,9,0,0.0,9
28220,7292,Expansion Packs,10,3,0.3,7
28221,7292,Game Packs,6,4,0.6666666666666666,2
28222,7292,Kits,5,2,0.4,3
28223,7292,Stuff Packs,12,5,0.4166666666666667,7
28224,7293,Expansion Packs,12,0,0.0,12
28225,7293,Game Packs,5,0,0.0,5
28226,7293,Kits,7,1,0.14285714285714285,6
28227,7293,Stuff Packs,15,1,0.06666666666666667,14
28228,7294,Expansion Packs,16,0,0.0,16
28229,7294,Game Packs,12,0,0.0,12
28230,7294,Kits,33,2,0.06060606060606061,31
28231,7294,Stuff Packs,20,0,0.0,20
28232,7295,Expansion Packs,15,15,1.0,0
28233,7295,Game Packs,12,12,1.0,0
28234,7295,Kits,30,30,1.0,0
28235,7295,Stuff Packs,19,19,1.0,0
28236,7296,Expansion Packs,16,0,0.0,16
28237,7296,Game Packs,12,0,0.0,12
28238,7296,Kits,33,2,0.06060606060606061,31
28239,7296,Stuff Packs,20,0,0.0,20
28240,7297,Expansion Packs,12,0,0.0,12
28241,7297,Game Packs,8,0,0.0,8
28242,7297,Kits,11,2,0.18181818181818182,9
28243,7297,Stuff Packs,8,2,0.25,6
28244,7298,Expansion Packs,16,0,0.0,16
28245,7298,Game Packs,12,0,0.0,12
28246,7298,Kits,23,0,0.0,23
28247,7298,Stuff Packs,20,0,0.0,20
28248,7299,Expansion Packs,16,0,0.0,16
28249,7299,Game Packs,12,0,0.0,12
28250,7299,Kits,31,1,0.03225806451612903,30
28251,7299,Stuff Packs,20,0,0.0,20
28252,7300,Expansion Packs,10,0,0.0,10
28253,7300,Game Packs,8,0,0.0,8
28254,7300,Kits,1,1,1.0,0
28255,7300,Stuff Packs,8,2,0.25,6
28256,7301,Expansion Packs,16,0,0.0,16
28257,7301,Game Packs,12,0,0.0,12
28258,7301,Kits,23,0,0.0,23
28259,7301,Stuff Packs,20,0,0.0,20
28260,7302,Expansion Packs,7,0,0.0,7
28261,7302,Game Packs,2,0,0.0,2
28262,7302,Kits,2,1,0.5,1
28263,7302,Stuff Packs,6,3,0.5,3
28264,7303,Expansion Packs,10,0,0.0,10
28265,7303,Game Packs,7,0,0.0,7
28266,7303,Kits,3,1,0.3333333333333333,2
28267,7303,Stuff Packs,10,2,0.2,8
28268,7304,Expansion Packs,16,0,0.0,16
28269,7304,Game Packs,12,0,0.0,12
28270,7304,Kits,33,0,0.0,33
28271,7304,Stuff Packs,20,0,0.0,20
28272,7305,Expansion Packs,15,0,0.0,15
28273,7305,Game Packs,10,0,0.0,10
28274,7305,Kits,7,2,0.2857142857142857,5
28275,7305,Stuff Packs,19,0,0.0,19
28276,7306,Expansion Packs,16,0,0.0,16
28277,7306,Game Packs,12,0,0.0,12
28278,7306,Kits,33,0,0.0,33
28279,7306,Stuff Packs,20,0,0.0,20
28280,7307,Expansion Packs,11,0,0.0,11
28281,7307,Game Packs,10,0,0.0,10
28282,7307,Stuff Packs,17,1,0.058823529411764705,16
28283,7308,Expansion Packs,15,0,0.0,15
28284,7308,Game Packs,10,0,0.0,10
28285,7308,Kits,16,1,0.0625,15
28286,7308,Stuff Packs,20,0,0.0,20
28287,7309,Expansion Packs,5,2,0.4,3
28288,7309,Game Packs,3,2,0.6666666666666666,1
28289,7309,Kits,4,3,0.75,1
28290,7309,Stuff Packs,6,4,0.6666666666666666,2
28291,7310,Expansion Packs,14,0,0.0,14
28292,7310,Game Packs,10,0,0.0,10
28293,7310,Kits,7,1,0.14285714285714285,6
28294,7310,Stuff Packs,15,0,0.0,15
28295,7311,Expansion Packs,15,0,0.0,15
28296,7311,Game Packs,12,0,0.0,12
28297,7311,Kits,14,1,0.07142857142857142,13
28298,7311,Stuff Packs,18,1,0.05555555555555555,17
28299,7312,Expansion Packs,16,0,0.0,16
28300,7312,Game Packs,12,0,0.0,12
28301,7312,Kits,20,1,0.05,19
28302,7312,Stuff Packs,20,1,0.05,19
28303,7313,Expansion Packs,2,0,0.0,2
28304,7313,Game Packs,4,1,0.25,3
28305,7313,Kits,6,0,0.0,6
28306,7313,Stuff Packs,6,2,0.3333333333333333,4
28307,7314,Expansion Packs,3,0,0.0,3
28308,7315,Expansion Packs,15,0,0.0,15
28309,7315,Game Packs,12,0,0.0,12
28310,7315,Kits,15,0,0.0,15
28311,7315,Stuff Packs,19,0,0.0,19
28312,7316,Expansion Packs,12,0,0.0,12
28313,7316,Game Packs,8,0,0.0,8
28314,7316,Kits,7,1,0.14285714285714285,6
28315,7316,Stuff Packs,10,3,0.3,7
28316,7317,Expansion Packs,14,0,0.0,14
28317,7317,Game Packs,5,0,0.0,5
28318,7317,Kits,4,1,0.25,3
28319,7317,Stuff Packs,11,0,0.0,11
28320,7318,Expansion Packs,7,0,0.0,7
28321,7318,Game Packs,3,0,0.0,3
28322,7318,Kits,2,2,1.0,0
28323,7318,Stuff Packs,5,3,0.6,2
28324,7319,Expansion Packs,7,0,0.0,7
28325,7319,Game Packs,3,0,0.0,3
28326,7319,Stuff Packs,8,3,0.375,5
28327,7320,Expansion Packs,16,0,0.0,16
28328,7320,Game Packs,12,0,0.0,12
28329,7320,Kits,33,0,0.0,33
28330,7320,Stuff Packs,20,0,0.0,20
28331,7321,Expansion Packs,12,0,0.0,12
28332,7321,Game Packs,10,0,0.0,10
28333,7321,Kits,16,0,0.0,16
28334,7321,Stuff Packs,17,0,0.0,17
28335,7322,Expansion Packs,15,0,0.0,15
28336,7322,Game Packs,11,0,0.0,11
28337,7322,Kits,28,0,0.0,28
28338,7322,Stuff Packs,20,0,0.0,20
28339,7323,Expansion Packs,16,0,0.0,16
28340,7323,Game Packs,12,0,0.0,12
28341,7323,Kits,31,0,0.0,31
28342,7323,Stuff Packs,18,0,0.0,18
28343,7324,Expansion Packs,4,0,0.0,4
28344,7324,Game Packs,2,1,0.5,1
28345,7324,Kits,3,2,0.6666666666666666,1
28346,7324,Stuff Packs,5,3,0.6,2
28347,7325,Expansion Packs,16,0,0.0,16
28348,7325,Game Packs,10,0,0.0,10
28349,7325,Kits,11,0,0.0,11
28350,7325,Stuff Packs,20,0,0.0,20
28351,7326,Expansion Packs,16,0,0.0,16
28352,7326,Game Packs,11,0,0.0,11
28353,7326,Kits,8,2,0.25,6
28354,7326,Stuff Packs,20,1,0.05,19
28355,7327,Expansion Packs,10,1,0.1,9
28356,7327,Game Packs,6,0,0.0,6
28357,7327,Kits,2,2,1.0,0
28358,7327,Stuff Packs,11,2,0.18181818181818182,9
28359,7328,Expansion Packs,16,0,0.0,16
28360,7328,Game Packs,12,0,0.0,12
28361,7328,Kits,33,0,0.0,33
28362,7328,Stuff Packs,20,0,0.0,20
28363,7329,Expansion Packs,3,0,0.0,3
28364,7329,Game Packs,1,0,0.0,1
28365,7329,Kits,1,1,1.0,0
28366,7329,Stuff Packs,4,3,0.75,1
28367,7330,Expansion Packs,2,0,0.0,2
28368,7330,Game Packs,2,0,0.0,2
28369,7330,Kits,1,0,0.0,1
28370,7330,Stuff Packs,5,0,0.0,5
28371,7331,Expansion Packs,10,0,0.0,10
28372,7331,Game Packs,5,0,0.0,5
28373,7331,Kits,2,1,0.5,1
28374,7331,Stuff Packs,7,0,0.0,7
28375,7332,Expansion Packs,16,0,0.0,16
28376,7332,Game Packs,12,0,0.0,12
28377,7332,Kits,19,0,0.0,19
28378,7332,Stuff Packs,17,0,0.0,17
28379,7333,Expansion Packs,14,0,0.0,14
28380,7333,Game Packs,11,0,0.0,11
28381,7333,Kits,9,1,0.1111111111111111,8
28382,7333,Stuff Packs,17,1,0.058823529411764705,16
28383,7334,Expansion Packs,16,0,0.0,16
28384,7334,Game Packs,11,0,0.0,11
28385,7334,Kits,29,1,0.034482758620689655,28
28386,7334,Stuff Packs,20,0,0.0,20
28387,7335,Expansion Packs,15,0,0.0,15
28388,7335,Game Packs,8,0,0.0,8
28389,7335,Kits,6,2,0.3333333333333333,4
28390,7335,Stuff Packs,12,2,0.16666666666666666,10
28391,7336,Expansion Packs,10,0,0.0,10
28392,7336,Game Packs,9,0,0.0,9
28393,7336,Stuff Packs,17,0,0.0,17
28394,7337,Expansion Packs,16,0,0.0,16
28395,7337,Game Packs,12,0,0.0,12
28396,7337,Kits,27,0,0.0,27
28397,7337,Stuff Packs,20,0,0.0,20
28398,7338,Expansion Packs,16,0,0.0,16
28399,7338,Game Packs,12,0,0.0,12
28400,7338,Kits,33,0,0.0,33
28401,7338,Stuff Packs,20,0,0.0,20
28402,7339,Expansion Packs,16,0,0.0,16
28403,7339,Game Packs,10,0,0.0,10
28404,7339,Kits,1,1,1.0,0
28405,7339,Stuff Packs,7,1,0.14285714285714285,6
28406,7340,Expansion Packs,7,0,0.0,7
28407,7340,Game Packs,1,0,0.0,1
28408,7340,Kits,6,1,0.16666666666666666,5
28409,7340,Stuff Packs,6,1,0.16666666666666666,5
28410,7341,Expansion Packs,7,0,0.0,7
28411,7341,Game Packs,1,0,0.0,1
28412,7341,Stuff Packs,3,3,1.0,0
28413,7342,Expansion Packs,16,0,0.0,16
28414,7342,Game Packs,12,0,0.0,12
28415,7342,Kits,33,0,0.0,33
28416,7342,Stuff Packs,20,0,0.0,20
28417,7343,Expansion Packs,15,0,0.0,15
28418,7343,Game Packs,12,0,0.0,12
28419,7343,Kits,10,1,0.1,9
28420,7343,Stuff Packs,19,0,0.0,19
28421,7344,Expansion Packs,3,0,0.0,3
28422,7344,Game Packs,3,0,0.0,3
28423,7344,Stuff Packs,2,0,0.0,2
28424,7345,Expansion Packs,16,0,0.0,16
28425,7345,Game Packs,12,0,0.0,12
28426,7345,Kits,33,0,0.0,33
28427,7345,Stuff Packs,20,0,0.0,20
28428,7346,Expansion Packs,7,0,0.0,7
28429,7346,Game Packs,4,0,0.0,4
28430,7346,Stuff Packs,10,1,0.1,9
28431,7347,Expansion Packs,9,0,0.0,9
28432,7347,Game Packs,8,0,0.0,8
28433,7347,Kits,3,0,0.0,3
28434,7347,Stuff Packs,4,0,0.0,4
28435,7348,Expansion Packs,16,0,0.0,16
28436,7348,Game Packs,11,0,0.0,11
28437,7348,Kits,33,0,0.0,33
28438,7348,Stuff Packs,20,0,0.0,20
28439,7349,Expansion Packs,5,0,0.0,5
28440,7349,Game Packs,2,0,0.0,2
28441,7349,Kits,3,1,0.3333333333333333,2
28442,7349,Stuff Packs,5,4,0.8,1
28443,7350,Expansion Packs,16,0,0.0,16
28444,7350,Game Packs,12,0,0.0,12
28445,7350,Kits,30,1,0.03333333333333333,29
28446,7350,Stuff Packs,20,0,0.0,20
28447,7351,Expansion Packs,13,0,0.0,13
28448,7351,Game Packs,12,0,0.0,12
28449,7351,Kits,16,0,0.0,16
28450,7351,Stuff Packs,18,0,0.0,18
28451,7352,Expansion Packs,15,0,0.0,15
28452,7352,Game Packs,9,0,0.0,9
28453,7352,Kits,4,0,0.0,4
28454,7352,Stuff Packs,17,0,0.0,17
28455,7353,Expansion Packs,16,0,0.0,16
28456,7353,Game Packs,6,0,0.0,6
28457,7353,Kits,17,1,0.058823529411764705,16
28458,7353,Stuff Packs,9,2,0.2222222222222222,7
28459,7354,Expansion Packs,10,1,0.1,9
28460,7354,Game Packs,2,0,0.0,2
28461,7354,Kits,6,1,0.16666666666666666,5
28462,7354,Stuff Packs,7,4,0.5714285714285714,3
28463,7355,Expansion Packs,14,0,0.0,14
28464,7355,Game Packs,9,0,0.0,9
28465,7355,Kits,1,0,0.0,1
28466,7355,Stuff Packs,7,1,0.14285714285714285,6
28467,7356,Expansion Packs,16,5,0.3125,11
28468,7356,Game Packs,12,4,0.3333333333333333,8
28469,7356,Kits,33,9,0.2727272727272727,24
28470,7356,Stuff Packs,20,12,0.6,8
28471,7357,Expansion Packs,16,0,0.0,16
28472,7357,Game Packs,12,0,0.0,12
28473,7357,Kits,33,0,0.0,33
28474,7357,Stuff Packs,20,0,0.0,20
28475,7358,Expansion Packs,16,0,0.0,16
28476,7358,Game Packs,12,0,0.0,12
28477,7358,Kits,19,0,0.0,19
28478,7358,Stuff Packs,20,0,0.0,20
28479,7359,Expansion Packs,10,0,0.0,10
28480,7359,Game Packs,5,0,0.0,5
28481,7359,Kits,1,1,1.0,0
28482,7359,Stuff Packs,4,1,0.25,3
28483,7360,Expansion Packs,7,0,0.0,7
28484,7360,Game Packs,4,0,0.0,4
28485,7360,Stuff Packs,10,1,0.1,9
28486,7361,Expansion Packs,16,0,0.0,16
28487,7361,Game Packs,12,0,0.0,12
28488,7361,Kits,33,0,0.0,33
28489,7361,Stuff Packs,20,0,0.0,20
28490,7362,Expansion Packs,5,0,0.0,5
28491,7362,Game Packs,1,0,0.0,1
28492,7362,Stuff Packs,7,2,0.2857142857142857,5
28493,7363,Expansion Packs,16,0,0.0,16
28494,7363,Game Packs,12,0,0.0,12
28495,7363,Kits,32,0,0.0,32
28496,7363,Stuff Packs,20,0,0.0,20
28497,7364,Expansion Packs,12,0,0.0,12
28498,7364,Game Packs,5,1,0.2,4
28499,7364,Kits,4,4,1.0,0
28500,7364,Stuff Packs,9,2,0.2222222222222222,7
28501,7365,Expansion Packs,7,0,0.0,7
28502,7365,Kits,2,2,1.0,0
28503,7365,Stuff Packs,6,3,0.5,3
28504,7366,Expansion Packs,16,0,0.0,16
28505,7366,Game Packs,12,0,0.0,12
28506,7366,Kits,11,1,0.09090909090909091,10
28507,7366,Stuff Packs,18,0,0.0,18
28508,7367,Expansion Packs,11,0,0.0,11
28509,7367,Game Packs,7,0,0.0,7
28510,7367,Kits,4,0,0.0,4
28511,7367,Stuff Packs,7,2,0.2857142857142857,5
28512,7368,Expansion Packs,16,0,0.0,16
28513,7368,Game Packs,7,0,0.0,7
28514,7368,Kits,10,2,0.2,8
28515,7368,Stuff Packs,19,3,0.15789473684210525,16
28516,7369,Expansion Packs,15,0,0.0,15
28517,7369,Game Packs,6,1,0.16666666666666666,5
28518,7369,Kits,5,2,0.4,3
28519,7369,Stuff Packs,9,4,0.4444444444444444,5
28520,7370,Expansion Packs,15,0,0.0,15
28521,7370,Game Packs,7,0,0.0,7
28522,7370,Kits,6,1,0.16666666666666666,5
28523,7370,Stuff Packs,9,0,0.0,9
28524,7371,Expansion Packs,16,0,0.0,16
28525,7371,Game Packs,12,0,0.0,12
28526,7371,Kits,33,0,0.0,33
28527,7371,Stuff Packs,20,0,0.0,20
28528,7372,Expansion Packs,13,0,0.0,13
28529,7372,Game Packs,11,0,0.0,11
28530,7372,Kits,7,1,0.14285714285714285,6
28531,7372,Stuff Packs,10,0,0.0,10
28532,7373,Expansion Packs,16,0,0.0,16
28533,7373,Game Packs,9,0,0.0,9
28534,7373,Kits,13,1,0.07692307692307693,12
28535,7373,Stuff Packs,18,0,0.0,18
28536,7374,Expansion Packs,13,0,0.0,13
28537,7374,Game Packs,4,0,0.0,4
28538,7374,Stuff Packs,5,1,0.2,4
28539,7375,Expansion Packs,16,0,0.0,16
28540,7375,Game Packs,12,0,0.0,12
28541,7375,Kits,33,0,0.0,33
28542,7376,Expansion Packs,12,0,0.0,12
28543,7376,Game Packs,4,0,0.0,4
28544,7376,Kits,1,1,1.0,0
28545,7376,Stuff Packs,4,2,0.5,2
28546,7377,Expansion Packs,16,0,0.0,16
28547,7377,Game Packs,12,0,0.0,12
28548,7377,Kits,33,0,0.0,33
28549,7377,Stuff Packs,20,0,0.0,20
28550,7378,Expansion Packs,6,0,0.0,6
28551,7378,Game Packs,3,0,0.0,3
28552,7378,Kits,2,1,0.5,1
28553,7378,Stuff Packs,6,2,0.3333333333333333,4
28554,7379,Expansion Packs,5,0,0.0,5
28555,7379,Game Packs,5,0,0.0,5
28556,7379,Kits,3,2,0.6666666666666666,1
28557,7379,Stuff Packs,6,3,0.5,3
28558,7380,Expansion Packs,14,0,0.0,14
28559,7380,Game Packs,9,0,0.0,9
28560,7380,Kits,2,2,1.0,0
28561,7380,Stuff Packs,14,1,0.07142857142857142,13
28562,7381,Expansion Packs,2,0,0.0,2
28563,7381,Game Packs,1,1,1.0,0
28564,7381,Kits,3,1,0.3333333333333333,2
28565,7381,Stuff Packs,1,0,0.0,1
28566,7382,Expansion Packs,12,0,0.0,12
28567,7382,Game Packs,6,0,0.0,6
28568,7382,Kits,16,0,0.0,16
28569,7382,Stuff Packs,10,1,0.1,9
28570,7383,Expansion Packs,14,0,0.0,14
28571,7383,Game Packs,10,0,0.0,10
28572,7383,Kits,1,1,1.0,0
28573,7383,Stuff Packs,18,1,0.05555555555555555,17
28574,7384,Expansion Packs,15,0,0.0,15
28575,7384,Game Packs,12,0,0.0,12
28576,7384,Kits,16,0,0.0,16
28577,7384,Stuff Packs,18,0,0.0,18
28578,7385,Expansion Packs,6,0,0.0,6
28579,7385,Game Packs,3,1,0.3333333333333333,2
28580,7385,Kits,3,3,1.0,0
28581,7385,Stuff Packs,10,3,0.3,7
28582,7386,Expansion Packs,16,0,0.0,16
28583,7386,Game Packs,12,0,0.0,12
28584,7386,Kits,31,0,0.0,31
28585,7386,Stuff Packs,18,0,0.0,18
28586,7387,Expansion Packs,7,0,0.0,7
28587,7387,Game Packs,3,0,0.0,3
28588,7387,Kits,3,0,0.0,3
28589,7387,Stuff Packs,2,0,0.0,2
28590,7388,Expansion Packs,9,0,0.0,9
28591,7388,Game Packs,7,0,0.0,7
28592,7388,Kits,4,0,0.0,4
28593,7388,Stuff Packs,9,2,0.2222222222222222,7
28594,7389,Expansion Packs,16,0,0.0,16
28595,7389,Game Packs,12,0,0.0,12
28596,7389,Kits,33,0,0.0,33
28597,7389,Stuff Packs,20,0,0.0,20
28598,7390,Expansion Packs,6,0,0.0,6
28599,7390,Stuff Packs,2,1,0.5,1
28600,7391,Expansion Packs,16,0,0.0,16
28601,7391,Game Packs,12,0,0.0,12
28602,7391,Kits,24,0,0.0,24
28603,7391,Stuff Packs,20,0,0.0,20
28604,7392,Expansion Packs,16,0,0.0,16
28605,7392,Game Packs,6,0,0.0,6
28606,7392,Kits,9,2,0.2222222222222222,7
28607,7392,Stuff Packs,10,2,0.2,8
28608,7393,Expansion Packs,10,0,0.0,10
28609,7393,Game Packs,4,0,0.0,4
28610,7393,Kits,4,1,0.25,3
28611,7393,Stuff Packs,8,3,0.375,5
28612,7394,Expansion Packs,12,0,0.0,12
28613,7394,Game Packs,9,0,0.0,9
28614,7394,Kits,3,1,0.3333333333333333,2
28615,7394,Stuff Packs,17,0,0.0,17
28616,7395,Expansion Packs,16,0,0.0,16
28617,7395,Game Packs,12,0,0.0,12
28618,7395,Kits,19,0,0.0,19
28619,7395,Stuff Packs,20,0,0.0,20
28620,7396,Expansion Packs,14,0,0.0,14
28621,7396,Game Packs,10,0,0.0,10
28622,7396,Kits,9,2,0.2222222222222222,7
28623,7396,Stuff Packs,17,1,0.058823529411764705,16
28624,7397,Expansion Packs,15,0,0.0,15
28625,7397,Game Packs,12,0,0.0,12
28626,7397,Kits,28,1,0.03571428571428571,27
28627,7397,Stuff Packs,20,0,0.0,20
28628,7398,Expansion Packs,12,0,0.0,12
28629,7398,Game Packs,10,0,0.0,10
28630,7398,Kits,20,0,0.0,20
28631,7398,Stuff Packs,19,0,0.0,19
28632,7399,Expansion Packs,2,0,0.0,2
28633,7399,Game Packs,1,0,0.0,1
28634,7399,Kits,4,1,0.25,3
28635,7399,Stuff Packs,4,3,0.75,1
28636,7400,Expansion Packs,15,0,0.0,15
28637,7400,Game Packs,12,0,0.0,12
28638,7400,Kits,28,0,0.0,28
28639,7400,Stuff Packs,20,0,0.0,20
28640,7401,Expansion Packs,4,0,0.0,4
28641,7401,Game Packs,1,0,0.0,1
28642,7401,Kits,2,0,0.0,2
28643,7401,Stuff Packs,2,0,0.0,2
28644,7402,Expansion Packs,5,0,0.0,5
28645,7402,Game Packs,1,0,0.0,1
28646,7402,Stuff Packs,3,2,0.6666666666666666,1
28647,7403,Expansion Packs,15,0,0.0,15
28648,7403,Game Packs,11,0,0.0,11
28649,7403,Kits,3,1,0.3333333333333333,2
28650,7403,Stuff Packs,14,0,0.0,14
28651,7404,Expansion Packs,6,0,0.0,6
28652,7404,Kits,1,1,1.0,0
28653,7404,Stuff Packs,2,0,0.0,2
28654,7405,Expansion Packs,3,0,0.0,3
28655,7405,Game Packs,5,1,0.2,4
28656,7405,Kits,3,3,1.0,0
28657,7405,Stuff Packs,6,4,0.6666666666666666,2
28658,7406,Expansion Packs,3,0,0.0,3
28659,7406,Game Packs,3,1,0.3333333333333333,2
28660,7406,Kits,3,3,1.0,0
28661,7406,Stuff Packs,5,4,0.8,1
28662,7407,Expansion Packs,15,0,0.0,15
28663,7407,Game Packs,11,0,0.0,11
28664,7407,Kits,12,1,0.08333333333333333,11
28665,7407,Stuff Packs,20,1,0.05,19
28666,7408,Expansion Packs,15,0,0.0,15
28667,7408,Game Packs,7,0,0.0,7
28668,7408,Kits,10,0,0.0,10
28669,7408,Stuff Packs,14,0,0.0,14
28670,7409,Expansion Packs,13,0,0.0,13
28671,7409,Game Packs,2,0,0.0,2
28672,7409,Kits,7,0,0.0,7
28673,7409,Stuff Packs,6,2,0.3333333333333333,4
28674,7410,Expansion Packs,16,0,0.0,16
28675,7410,Game Packs,11,0,0.0,11
28676,7410,Kits,1,1,1.0,0
28677,7410,Stuff Packs,20,0,0.0,20
28678,7411,Expansion Packs,15,15,1.0,0
28679,7411,Game Packs,12,12,1.0,0
28680,7411,Kits,33,33,1.0,0
28681,7411,Stuff Packs,19,18,0.9473684210526315,1
28682,7412,Expansion Packs,12,0,0.0,12
28683,7412,Game Packs,6,1,0.16666666666666666,5
28684,7412,Kits,7,0,0.0,7
28685,7412,Stuff Packs,10,4,0.4,6
28686,7413,Expansion Packs,14,0,0.0,14
28687,7413,Game Packs,7,0,0.0,7
28688,7413,Kits,5,2,0.4,3
28689,7413,Stuff Packs,13,3,0.23076923076923078,10
28690,7414,Expansion Packs,13,1,0.07692307692307693,12
28691,7414,Game Packs,6,0,0.0,6
28692,7414,Stuff Packs,7,3,0.42857142857142855,4
28693,7415,Expansion Packs,14,0,0.0,14
28694,7415,Game Packs,9,0,0.0,9
28695,7415,Kits,2,0,0.0,2
28696,7415,Stuff Packs,19,1,0.05263157894736842,18
28697,7416,Expansion Packs,16,0,0.0,16
28698,7416,Game Packs,12,0,0.0,12
28699,7416,Kits,33,0,0.0,33
28700,7416,Stuff Packs,20,0,0.0,20
28701,7417,Expansion Packs,16,0,0.0,16
28702,7417,Game Packs,12,0,0.0,12
28703,7417,Kits,33,0,0.0,33
28704,7417,Stuff Packs,20,0,0.0,20
28705,7418,Expansion Packs,11,0,0.0,11
28706,7418,Game Packs,6,0,0.0,6
28707,7418,Kits,1,0,0.0,1
28708,7418,Stuff Packs,8,0,0.0,8
28709,7419,Expansion Packs,15,0,0.0,15
28710,7419,Game Packs,12,0,0.0,12
28711,7419,Kits,27,0,0.0,27
28712,7419,Stuff Packs,20,0,0.0,20
28713,7420,Expansion Packs,10,0,0.0,10
28714,7420,Game Packs,7,0,0.0,7
28715,7420,Kits,3,1,0.3333333333333333,2
28716,7420,Stuff Packs,7,1,0.14285714285714285,6
28717,7421,Expansion Packs,15,0,0.0,15
28718,7421,Game Packs,12,0,0.0,12
28719,7421,Kits,17,0,0.0,17
28720,7421,Stuff Packs,20,0,0.0,20
28721,7422,Expansion Packs,11,0,0.0,11
28722,7422,Game Packs,4,0,0.0,4
28723,7422,Kits,2,2,1.0,0
28724,7422,Stuff Packs,8,2,0.25,6
28725,7423,Expansion Packs,16,0,0.0,16
28726,7423,Game Packs,12,1,0.08333333333333333,11
28727,7423,Kits,27,3,0.1111111111111111,24
28728,7423,Stuff Packs,18,1,0.05555555555555555,17
28729,7424,Expansion Packs,16,0,0.0,16
28730,7424,Game Packs,12,0,0.0,12
28731,7424,Kits,28,0,0.0,28
28732,7424,Stuff Packs,20,0,0.0,20
28733,7425,Expansion Packs,4,0,0.0,4
28734,7425,Game Packs,3,0,0.0,3
28735,7425,Stuff Packs,3,0,0.0,3
28736,7426,Expansion Packs,16,0,0.0,16
28737,7426,Game Packs,12,1,0.08333333333333333,11
28738,7426,Kits,33,1,0.030303030303030304,32
28739,7426,Stuff Packs,20,1,0.05,19
28740,7427,Expansion Packs,3,0,0.0,3
28741,7427,Kits,1,0,0.0,1
28742,7427,Stuff Packs,4,4,1.0,0
28743,7428,Expansion Packs,16,0,0.0,16
28744,7428,Game Packs,8,0,0.0,8
28745,7428,Kits,18,1,0.05555555555555555,17
28746,7428,Stuff Packs,17,2,0.11764705882352941,15
28747,7429,Expansion Packs,9,0,0.0,9
28748,7429,Game Packs,2,0,0.0,2
28749,7429,Kits,4,2,0.5,2
28750,7429,Stuff Packs,6,3,0.5,3
28751,7430,Expansion Packs,16,0,0.0,16
28752,7430,Game Packs,12,0,0.0,12
28753,7430,Kits,29,2,0.06896551724137931,27
28754,7430,Stuff Packs,20,0,0.0,20
28755,7431,Expansion Packs,9,0,0.0,9
28756,7431,Game Packs,4,0,0.0,4
28757,7431,Kits,4,3,0.75,1
28758,7431,Stuff Packs,9,3,0.3333333333333333,6
28759,7432,Expansion Packs,15,0,0.0,15
28760,7432,Game Packs,11,0,0.0,11
28761,7432,Stuff Packs,17,0,0.0,17
28762,7433,Expansion Packs,16,0,0.0,16
28763,7433,Game Packs,12,0,0.0,12
28764,7433,Kits,33,0,0.0,33
28765,7433,Stuff Packs,20,0,0.0,20
28766,7434,Expansion Packs,11,0,0.0,11
28767,7434,Game Packs,8,0,0.0,8
28768,7434,Kits,1,0,0.0,1
28769,7434,Stuff Packs,10,1,0.1,9
28770,7435,Expansion Packs,16,1,0.0625,15
28771,7435,Game Packs,12,1,0.08333333333333333,11
28772,7435,Kits,33,12,0.36363636363636365,21
28773,7435,Stuff Packs,20,2,0.1,18
28774,7436,Expansion Packs,12,0,0.0,12
28775,7436,Game Packs,8,0,0.0,8
28776,7436,Kits,3,0,0.0,3
28777,7436,Stuff Packs,5,1,0.2,4
28778,7437,Expansion Packs,11,0,0.0,11
28779,7437,Game Packs,8,0,0.0,8
28780,7437,Kits,2,0,0.0,2
28781,7437,Stuff Packs,5,1,0.2,4
28782,7438,Expansion Packs,16,0,0.0,16
28783,7438,Game Packs,11,0,0.0,11
28784,7438,Kits,16,0,0.0,16
28785,7438,Stuff Packs,20,1,0.05,19
28786,7439,Expansion Packs,1,0,0.0,1
28787,7439,Kits,2,0,0.0,2
28788,7440,Expansion Packs,16,0,0.0,16
28789,7440,Game Packs,12,0,0.0,12
28790,7440,Kits,33,0,0.0,33
28791,7440,Stuff Packs,20,0,0.0,20
28792,7441,Expansion Packs,16,0,0.0,16
28793,7441,Game Packs,12,0,0.0,12
28794,7441,Kits,31,1,0.03225806451612903,30
28795,7441,Stuff Packs,20,0,0.0,20
28796,7442,Expansion Packs,16,0,0.0,16
28797,7442,Game Packs,12,0,0.0,12
28798,7442,Kits,33,0,0.0,33
28799,7442,Stuff Packs,20,0,0.0,20
28800,7443,Expansion Packs,16,0,0.0,16
28801,7443,Game Packs,10,0,0.0,10
28802,7443,Kits,15,3,0.2,12
28803,7443,Stuff Packs,17,3,0.17647058823529413,14
28804,7444,Expansion Packs,8,0,0.0,8
28805,7444,Game Packs,6,0,0.0,6
28806,7444,Kits,3,2,0.6666666666666666,1
28807,7444,Stuff Packs,5,2,0.4,3
28808,7445,Expansion Packs,15,0,0.0,15
28809,7445,Game Packs,11,0,0.0,11
28810,7445,Kits,7,1,0.14285714285714285,6
28811,7445,Stuff Packs,20,1,0.05,19
28812,7446,Expansion Packs,16,0,0.0,16
28813,7446,Game Packs,12,0,0.0,12
28814,7446,Kits,14,2,0.14285714285714285,12
28815,7446,Stuff Packs,19,1,0.05263157894736842,18
28816,7447,Expansion Packs,13,0,0.0,13
28817,7447,Game Packs,10,0,0.0,10
28818,7447,Kits,7,1,0.14285714285714285,6
28819,7447,Stuff Packs,12,0,0.0,12
28820,7448,Expansion Packs,16,0,0.0,16
28821,7448,Game Packs,12,0,0.0,12
28822,7448,Kits,33,1,0.030303030303030304,32
28823,7448,Stuff Packs,20,0,0.0,20
28824,7449,Expansion Packs,16,0,0.0,16
28825,7449,Game Packs,12,0,0.0,12
28826,7449,Stuff Packs,19,1,0.05263157894736842,18
28827,7450,Expansion Packs,16,0,0.0,16
28828,7450,Game Packs,12,0,0.0,12
28829,7450,Kits,26,1,0.038461538461538464,25
28830,7450,Stuff Packs,20,1,0.05,19
28831,7451,Expansion Packs,12,0,0.0,12
28832,7451,Game Packs,5,0,0.0,5
28833,7451,Kits,4,2,0.5,2
28834,7451,Stuff Packs,4,1,0.25,3
28835,7452,Expansion Packs,13,0,0.0,13
28836,7452,Game Packs,6,0,0.0,6
28837,7452,Kits,3,2,0.6666666666666666,1
28838,7452,Stuff Packs,10,2,0.2,8
28839,7453,Expansion Packs,16,0,0.0,16
28840,7453,Game Packs,11,1,0.09090909090909091,10
28841,7453,Kits,27,1,0.037037037037037035,26
28842,7453,Stuff Packs,20,3,0.15,17
28843,7454,Expansion Packs,13,0,0.0,13
28844,7454,Game Packs,9,0,0.0,9
28845,7454,Kits,2,2,1.0,0
28846,7454,Stuff Packs,16,0,0.0,16
28847,7455,Expansion Packs,12,0,0.0,12
28848,7455,Game Packs,7,0,0.0,7
28849,7455,Kits,2,1,0.5,1
28850,7455,Stuff Packs,10,2,0.2,8
28851,7456,Expansion Packs,15,0,0.0,15
28852,7456,Game Packs,11,0,0.0,11
28853,7456,Kits,4,2,0.5,2
28854,7456,Stuff Packs,19,0,0.0,19
28855,7457,Expansion Packs,16,0,0.0,16
28856,7457,Game Packs,12,0,0.0,12
28857,7457,Kits,31,1,0.03225806451612903,30
28858,7457,Stuff Packs,20,0,0.0,20
28859,7458,Expansion Packs,16,0,0.0,16
28860,7458,Game Packs,11,0,0.0,11
28861,7458,Kits,26,0,0.0,26
28862,7458,Stuff Packs,20,0,0.0,20
28863,7459,Expansion Packs,9,0,0.0,9
28864,7459,Game Packs,5,0,0.0,5
28865,7459,Kits,5,2,0.4,3
28866,7459,Stuff Packs,10,2,0.2,8
28867,7460,Expansion Packs,16,0,0.0,16
28868,7460,Game Packs,12,0,0.0,12
28869,7460,Kits,33,0,0.0,33
28870,7460,Stuff Packs,20,0,0.0,20
28871,7461,Expansion Packs,12,0,0.0,12
28872,7461,Game Packs,4,0,0.0,4
28873,7461,Kits,3,3,1.0,0
28874,7461,Stuff Packs,10,3,0.3,7
28875,7462,Expansion Packs,9,0,0.0,9
28876,7462,Game Packs,8,0,0.0,8
28877,7462,Kits,2,0,0.0,2
28878,7462,Stuff Packs,8,0,0.0,8
28879,7463,Expansion Packs,4,0,0.0,4
28880,7463,Game Packs,1,0,0.0,1
28881,7463,Kits,2,1,0.5,1
28882,7463,Stuff Packs,5,3,0.6,2
28883,7464,Expansion Packs,10,0,0.0,10
28884,7464,Game Packs,6,0,0.0,6
28885,7464,Kits,4,1,0.25,3
28886,7464,Stuff Packs,6,3,0.5,3
28887,7465,Expansion Packs,16,0,0.0,16
28888,7465,Game Packs,12,0,0.0,12
28889,7465,Kits,33,0,0.0,33
28890,7465,Stuff Packs,20,0,0.0,20
28891,7466,Expansion Packs,1,0,0.0,1
28892,7466,Game Packs,1,0,0.0,1
28893,7466,Stuff Packs,1,0,0.0,1
28894,7467,Expansion Packs,15,0,0.0,15
28895,7467,Game Packs,10,0,0.0,10
28896,7467,Kits,16,0,0.0,16
28897,7467,Stuff Packs,14,3,0.21428571428571427,11
28898,7468,Expansion Packs,11,0,0.0,11
28899,7468,Game Packs,6,0,0.0,6
28900,7468,Kits,4,1,0.25,3
28901,7468,Stuff Packs,8,1,0.125,7
28902,7469,Expansion Packs,16,0,0.0,16
28903,7469,Game Packs,12,0,0.0,12
28904,7469,Kits,21,1,0.047619047619047616,20
28905,7469,Stuff Packs,20,1,0.05,19
28906,7470,Expansion Packs,7,0,0.0,7
28907,7470,Game Packs,5,0,0.0,5
28908,7470,Kits,7,0,0.0,7
28909,7470,Stuff Packs,8,1,0.125,7
28910,7471,Expansion Packs,13,0,0.0,13
28911,7471,Game Packs,10,0,0.0,10
28912,7471,Kits,2,0,0.0,2
28913,7471,Stuff Packs,12,0,0.0,12
28914,7472,Expansion Packs,16,0,0.0,16
28915,7472,Game Packs,11,0,0.0,11
28916,7472,Kits,9,1,0.1111111111111111,8
28917,7472,Stuff Packs,12,3,0.25,9
28918,7473,Expansion Packs,10,0,0.0,10
28919,7473,Game Packs,3,1,0.3333333333333333,2
28920,7473,Kits,4,2,0.5,2
28921,7473,Stuff Packs,7,4,0.5714285714285714,3
28922,7474,Expansion Packs,14,0,0.0,14
28923,7474,Game Packs,11,0,0.0,11
28924,7474,Kits,4,2,0.5,2
28925,7474,Stuff Packs,13,1,0.07692307692307693,12
28926,7475,Expansion Packs,14,0,0.0,14
28927,7475,Game Packs,10,0,0.0,10
28928,7475,Kits,15,1,0.06666666666666667,14
28929,7475,Stuff Packs,19,0,0.0,19
28930,7476,Expansion Packs,10,0,0.0,10
28931,7476,Game Packs,5,0,0.0,5
28932,7476,Kits,4,0,0.0,4
28933,7476,Stuff Packs,8,0,0.0,8
28934,7477,Expansion Packs,16,0,0.0,16
28935,7477,Game Packs,12,0,0.0,12
28936,7477,Kits,33,1,0.030303030303030304,32
28937,7477,Stuff Packs,20,0,0.0,20
28938,7478,Expansion Packs,16,0,0.0,16
28939,7478,Game Packs,12,0,0.0,12
28940,7478,Kits,33,0,0.0,33
28941,7478,Stuff Packs,20,0,0.0,20
28942,7479,Expansion Packs,16,0,0.0,16
28943,7479,Game Packs,12,0,0.0,12
28944,7479,Kits,33,0,0.0,33
28945,7479,Stuff Packs,20,0,0.0,20
28946,7480,Expansion Packs,13,0,0.0,13
28947,7480,Game Packs,3,0,0.0,3
28948,7480,Kits,7,0,0.0,7
28949,7480,Stuff Packs,4,0,0.0,4
28950,7481,Expansion Packs,15,0,0.0,15
28951,7481,Game Packs,12,0,0.0,12
28952,7481,Kits,8,1,0.125,7
28953,7481,Stuff Packs,19,0,0.0,19
28954,7482,Expansion Packs,12,0,0.0,12
28955,7482,Game Packs,7,1,0.14285714285714285,6
28956,7482,Kits,12,0,0.0,12
28957,7482,Stuff Packs,15,4,0.26666666666666666,11
28958,7483,Expansion Packs,16,1,0.0625,15
28959,7483,Game Packs,11,0,0.0,11
28960,7483,Kits,18,0,0.0,18
28961,7483,Stuff Packs,17,1,0.058823529411764705,16
28962,7484,Expansion Packs,16,16,1.0,0
28963,7484,Game Packs,12,12,1.0,0
28964,7484,Kits,33,33,1.0,0
28965,7484,Stuff Packs,20,20,1.0,0
28966,7485,Expansion Packs,16,0,0.0,16
28967,7485,Game Packs,12,0,0.0,12
28968,7485,Kits,3,1,0.3333333333333333,2
28969,7485,Stuff Packs,17,0,0.0,17
28970,7486,Expansion Packs,14,0,0.0,14
28971,7486,Game Packs,6,0,0.0,6
28972,7486,Kits,3,2,0.6666666666666666,1
28973,7486,Stuff Packs,8,2,0.25,6
28974,7487,Expansion Packs,12,0,0.0,12
28975,7487,Game Packs,4,0,0.0,4
28976,7487,Kits,4,0,0.0,4
28977,7487,Stuff Packs,10,0,0.0,10
28978,7488,Expansion Packs,15,0,0.0,15
28979,7488,Game Packs,7,0,0.0,7
28980,7488,Kits,5,3,0.6,2
28981,7488,Stuff Packs,10,4,0.4,6
28982,7489,Expansion Packs,4,0,0.0,4
28983,7489,Game Packs,2,0,0.0,2
28984,7489,Stuff Packs,3,1,0.3333333333333333,2
28985,7490,Expansion Packs,16,0,0.0,16
28986,7490,Game Packs,10,0,0.0,10
28987,7490,Kits,23,1,0.043478260869565216,22
28988,7490,Stuff Packs,20,0,0.0,20
28989,7491,Expansion Packs,3,0,0.0,3
28990,7491,Game Packs,6,1,0.16666666666666666,5
28991,7491,Kits,5,3,0.6,2
28992,7491,Stuff Packs,7,4,0.5714285714285714,3
28993,7492,Expansion Packs,15,0,0.0,15
28994,7492,Game Packs,11,0,0.0,11
28995,7492,Kits,2,1,0.5,1
28996,7492,Stuff Packs,19,0,0.0,19
28997,7493,Expansion Packs,16,1,0.0625,15
28998,7493,Game Packs,12,0,0.0,12
28999,7493,Kits,2,2,1.0,0
29000,7493,Stuff Packs,14,0,0.0,14
29001,7494,Expansion Packs,9,0,0.0,9
29002,7494,Game Packs,4,0,0.0,4
29003,7494,Stuff Packs,7,0,0.0,7
29004,7495,Expansion Packs,15,0,0.0,15
29005,7495,Game Packs,11,0,0.0,11
29006,7495,Kits,22,0,0.0,22
29007,7495,Stuff Packs,20,0,0.0,20
29008,7496,Expansion Packs,11,0,0.0,11
29009,7496,Game Packs,3,0,0.0,3
29010,7496,Kits,5,1,0.2,4
29011,7496,Stuff Packs,9,4,0.4444444444444444,5
29012,7497,Expansion Packs,16,11,0.6875,5
29013,7497,Game Packs,12,8,0.6666666666666666,4
29014,7497,Kits,33,28,0.8484848484848485,5
29015,7497,Stuff Packs,20,17,0.85,3
29016,7498,Expansion Packs,15,0,0.0,15
29017,7498,Game Packs,11,0,0.0,11
29018,7498,Kits,24,0,0.0,24
29019,7498,Stuff Packs,19,0,0.0,19
29020,7499,Expansion Packs,13,0,0.0,13
29021,7499,Game Packs,10,0,0.0,10
29022,7499,Kits,2,2,1.0,0
29023,7499,Stuff Packs,14,1,0.07142857142857142,13
29024,7500,Expansion Packs,16,0,0.0,16
29025,7500,Game Packs,12,0,0.0,12
29026,7500,Kits,33,0,0.0,33
29027,7500,Stuff Packs,20,0,0.0,20
29028,7501,Expansion Packs,1,0,0.0,1
29029,7501,Game Packs,1,0,0.0,1
29030,7501,Kits,1,1,1.0,0
29031,7501,Stuff Packs,4,4,1.0,0
29032,7502,Expansion Packs,16,0,0.0,16
29033,7502,Game Packs,12,0,0.0,12
29034,7502,Kits,33,1,0.030303030303030304,32
29035,7502,Stuff Packs,20,0,0.0,20
29036,7503,Expansion Packs,13,0,0.0,13
29037,7503,Game Packs,7,1,0.14285714285714285,6
29038,7503,Kits,3,2,0.6666666666666666,1
29039,7503,Stuff Packs,10,3,0.3,7
29040,7504,Expansion Packs,16,0,0.0,16
29041,7504,Game Packs,11,0,0.0,11
29042,7504,Kits,7,0,0.0,7
29043,7504,Stuff Packs,20,0,0.0,20
29044,7505,Expansion Packs,9,0,0.0,9
29045,7505,Game Packs,4,0,0.0,4
29046,7505,Kits,6,2,0.3333333333333333,4
29047,7505,Stuff Packs,9,3,0.3333333333333333,6
29048,7506,Expansion Packs,14,0,0.0,14
29049,7506,Game Packs,10,0,0.0,10
29050,7506,Kits,3,1,0.3333333333333333,2
29051,7506,Stuff Packs,17,1,0.058823529411764705,16
29052,7507,Expansion Packs,16,0,0.0,16
29053,7507,Game Packs,12,0,0.0,12
29054,7507,Kits,28,0,0.0,28
29055,7507,Stuff Packs,20,0,0.0,20
29056,7508,Expansion Packs,8,0,0.0,8
29057,7508,Game Packs,4,0,0.0,4
29058,7508,Kits,1,0,0.0,1
29059,7508,Stuff Packs,6,1,0.16666666666666666,5
29060,7509,Expansion Packs,8,0,0.0,8
29061,7509,Game Packs,4,0,0.0,4
29062,7509,Kits,8,2,0.25,6
29063,7509,Stuff Packs,6,1,0.16666666666666666,5
29064,7510,Expansion Packs,14,1,0.07142857142857142,13
29065,7510,Game Packs,7,0,0.0,7
29066,7510,Kits,11,2,0.18181818181818182,9
29067,7510,Stuff Packs,10,4,0.4,6
29068,7511,Expansion Packs,13,0,0.0,13
29069,7511,Game Packs,7,0,0.0,7
29070,7511,Stuff Packs,15,3,0.2,12
29071,7512,Expansion Packs,12,0,0.0,12
29072,7512,Game Packs,2,0,0.0,2
29073,7512,Kits,10,1,0.1,9
29074,7512,Stuff Packs,6,0,0.0,6
29075,7513,Expansion Packs,2,0,0.0,2
29076,7514,Expansion Packs,6,0,0.0,6
29077,7514,Game Packs,4,0,0.0,4
29078,7514,Kits,2,2,1.0,0
29079,7514,Stuff Packs,14,1,0.07142857142857142,13
29080,7515,Expansion Packs,16,0,0.0,16
29081,7515,Game Packs,12,0,0.0,12
29082,7515,Kits,33,0,0.0,33
29083,7515,Stuff Packs,20,0,0.0,20
29084,7516,Expansion Packs,10,6,0.6,4
29085,7516,Game Packs,5,5,1.0,0
29086,7516,Kits,16,3,0.1875,13
29087,7516,Stuff Packs,9,7,0.7777777777777778,2
29088,7517,Expansion Packs,16,0,0.0,16
29089,7517,Game Packs,12,1,0.08333333333333333,11
29090,7517,Kits,33,1,0.030303030303030304,32
29091,7517,Stuff Packs,20,2,0.1,18
29092,7518,Expansion Packs,13,0,0.0,13
29093,7518,Game Packs,12,0,0.0,12
29094,7518,Kits,5,0,0.0,5
29095,7518,Stuff Packs,8,0,0.0,8
29096,7519,Expansion Packs,13,0,0.0,13
29097,7519,Game Packs,6,0,0.0,6
29098,7519,Kits,4,2,0.5,2
29099,7519,Stuff Packs,10,3,0.3,7
29100,7520,Expansion Packs,16,0,0.0,16
29101,7520,Game Packs,12,0,0.0,12
29102,7520,Kits,33,0,0.0,33
29103,7520,Stuff Packs,20,0,0.0,20
29104,7521,Expansion Packs,16,0,0.0,16
29105,7521,Game Packs,11,0,0.0,11
29106,7521,Kits,20,0,0.0,20
29107,7521,Stuff Packs,17,0,0.0,17
29108,7522,Expansion Packs,16,0,0.0,16
29109,7522,Game Packs,12,0,0.0,12
29110,7522,Kits,23,0,0.0,23
29111,7522,Stuff Packs,20,0,0.0,20
29112,7523,Expansion Packs,15,0,0.0,15
29113,7523,Game Packs,11,0,0.0,11
29114,7523,Kits,7,0,0.0,7
29115,7523,Stuff Packs,16,6,0.375,10
29116,7524,Expansion Packs,8,0,0.0,8
29117,7524,Game Packs,3,1,0.3333333333333333,2
29118,7524,Kits,2,2,1.0,0
29119,7524,Stuff Packs,3,2,0.6666666666666666,1
29120,7525,Expansion Packs,4,0,0.0,4
29121,7525,Game Packs,4,0,0.0,4
29122,7525,Kits,3,3,1.0,0
29123,7525,Stuff Packs,5,1,0.2,4
29124,7526,Expansion Packs,15,0,0.0,15
29125,7526,Game Packs,10,0,0.0,10
29126,7526,Kits,11,2,0.18181818181818182,9
29127,7526,Stuff Packs,19,0,0.0,19
29128,7527,Expansion Packs,16,0,0.0,16
29129,7527,Game Packs,11,0,0.0,11
29130,7527,Kits,32,1,0.03125,31
29131,7527,Stuff Packs,20,0,0.0,20
29132,7528,Expansion Packs,14,0,0.0,14
29133,7528,Game Packs,9,0,0.0,9
29134,7528,Kits,13,1,0.07692307692307693,12
29135,7528,Stuff Packs,17,1,0.058823529411764705,16
29136,7529,Expansion Packs,16,5,0.3125,11
29137,7529,Game Packs,12,5,0.4166666666666667,7
29138,7529,Kits,32,0,0.0,32
29139,7529,Stuff Packs,20,7,0.35,13
29140,7530,Expansion Packs,16,0,0.0,16
29141,7530,Game Packs,7,0,0.0,7
29142,7530,Kits,6,2,0.3333333333333333,4
29143,7530,Stuff Packs,14,2,0.14285714285714285,12
29144,7531,Expansion Packs,9,0,0.0,9
29145,7531,Game Packs,4,0,0.0,4
29146,7531,Kits,1,0,0.0,1
29147,7531,Stuff Packs,5,1,0.2,4
29148,7532,Expansion Packs,13,0,0.0,13
29149,7532,Game Packs,12,0,0.0,12
29150,7532,Kits,10,1,0.1,9
29151,7532,Stuff Packs,18,0,0.0,18
29152,7533,Expansion Packs,10,0,0.0,10
29153,7533,Game Packs,8,1,0.125,7
29154,7533,Kits,7,1,0.14285714285714285,6
29155,7533,Stuff Packs,8,1,0.125,7
29156,7534,Expansion Packs,6,0,0.0,6
29157,7534,Game Packs,2,0,0.0,2
29158,7534,Kits,2,0,0.0,2
29159,7534,Stuff Packs,3,0,0.0,3
29160,7535,Expansion Packs,16,0,0.0,16
29161,7535,Game Packs,12,0,0.0,12
29162,7535,Kits,33,0,0.0,33
29163,7535,Stuff Packs,20,0,0.0,20
29164,7536,Expansion Packs,15,0,0.0,15
29165,7536,Game Packs,12,0,0.0,12
29166,7536,Kits,6,0,0.0,6
29167,7536,Stuff Packs,8,0,0.0,8
29168,7537,Expansion Packs,16,0,0.0,16
29169,7537,Game Packs,11,0,0.0,11
29170,7537,Kits,10,0,0.0,10
29171,7537,Stuff Packs,12,0,0.0,12
29172,7538,Expansion Packs,16,0,0.0,16
29173,7538,Game Packs,12,0,0.0,12
29174,7538,Kits,33,0,0.0,33
29175,7538,Stuff Packs,20,0,0.0,20
29176,7539,Game Packs,2,0,0.0,2
29177,7539,Stuff Packs,1,0,0.0,1
29178,7540,Expansion Packs,11,1,0.09090909090909091,10
29179,7540,Game Packs,8,1,0.125,7
29180,7540,Kits,5,5,1.0,0
29181,7540,Stuff Packs,8,3,0.375,5
29182,7541,Expansion Packs,13,0,0.0,13
29183,7541,Game Packs,7,0,0.0,7
29184,7541,Kits,3,2,0.6666666666666666,1
29185,7541,Stuff Packs,11,3,0.2727272727272727,8
29186,7542,Expansion Packs,16,0,0.0,16
29187,7542,Game Packs,9,0,0.0,9
29188,7542,Kits,9,1,0.1111111111111111,8
29189,7542,Stuff Packs,10,3,0.3,7
29190,7543,Expansion Packs,16,0,0.0,16
29191,7543,Game Packs,12,0,0.0,12
29192,7543,Kits,21,0,0.0,21
29193,7543,Stuff Packs,20,0,0.0,20
29194,7544,Expansion Packs,12,0,0.0,12
29195,7544,Game Packs,5,0,0.0,5
29196,7544,Kits,8,1,0.125,7
29197,7544,Stuff Packs,10,1,0.1,9
29198,7545,Expansion Packs,15,0,0.0,15
29199,7545,Game Packs,12,0,0.0,12
29200,7545,Kits,14,1,0.07142857142857142,13
29201,7545,Stuff Packs,18,0,0.0,18
29202,7546,Expansion Packs,9,0,0.0,9
29203,7546,Game Packs,2,0,0.0,2
29204,7546,Kits,1,0,0.0,1
29205,7546,Stuff Packs,5,0,0.0,5
29206,7547,Expansion Packs,8,0,0.0,8
29207,7547,Game Packs,8,1,0.125,7
29208,7547,Kits,3,3,1.0,0
29209,7547,Stuff Packs,7,2,0.2857142857142857,5
29210,7548,Expansion Packs,13,0,0.0,13
29211,7548,Game Packs,11,0,0.0,11
29212,7548,Kits,3,2,0.6666666666666666,1
29213,7548,Stuff Packs,11,1,0.09090909090909091,10
29214,7549,Expansion Packs,9,0,0.0,9
29215,7549,Game Packs,8,0,0.0,8
29216,7549,Kits,2,2,1.0,0
29217,7549,Stuff Packs,11,0,0.0,11
29218,7550,Expansion Packs,10,0,0.0,10
29219,7550,Game Packs,11,1,0.09090909090909091,10
29220,7550,Kits,5,2,0.4,3
29221,7550,Stuff Packs,18,3,0.16666666666666666,15
29222,7551,Expansion Packs,9,0,0.0,9
29223,7551,Game Packs,3,0,0.0,3
29224,7551,Stuff Packs,1,0,0.0,1
29225,7552,Expansion Packs,11,0,0.0,11
29226,7552,Game Packs,3,0,0.0,3
29227,7552,Kits,9,2,0.2222222222222222,7
29228,7552,Stuff Packs,12,3,0.25,9
29229,7553,Expansion Packs,16,0,0.0,16
29230,7553,Game Packs,12,0,0.0,12
29231,7553,Kits,33,0,0.0,33
29232,7553,Stuff Packs,20,0,0.0,20
29233,7554,Expansion Packs,16,4,0.25,12
29234,7554,Game Packs,12,1,0.08333333333333333,11
29235,7554,Kits,32,0,0.0,32
29236,7554,Stuff Packs,20,0,0.0,20
29237,7555,Expansion Packs,7,0,0.0,7
29238,7555,Game Packs,1,0,0.0,1
29239,7555,Kits,2,1,0.5,1
29240,7555,Stuff Packs,1,1,1.0,0
29241,7556,Expansion Packs,16,0,0.0,16
29242,7556,Game Packs,12,1,0.08333333333333333,11
29243,7556,Kits,32,2,0.0625,30
29244,7556,Stuff Packs,20,2,0.1,18
29245,7557,Expansion Packs,8,0,0.0,8
29246,7557,Game Packs,2,1,0.5,1
29247,7557,Kits,3,3,1.0,0
29248,7557,Stuff Packs,5,4,0.8,1
29249,7558,Expansion Packs,15,0,0.0,15
29250,7558,Game Packs,12,0,0.0,12
29251,7558,Kits,32,0,0.0,32
29252,7558,Stuff Packs,20,0,0.0,20
29253,7559,Expansion Packs,16,0,0.0,16
29254,7559,Game Packs,12,0,0.0,12
29255,7559,Kits,33,1,0.030303030303030304,32
29256,7559,Stuff Packs,20,0,0.0,20
29257,7560,Expansion Packs,10,0,0.0,10
29258,7560,Game Packs,8,0,0.0,8
29259,7560,Kits,4,4,1.0,0
29260,7560,Stuff Packs,17,3,0.17647058823529413,14
29261,7561,Expansion Packs,5,0,0.0,5
29262,7561,Game Packs,3,0,0.0,3
29263,7561,Kits,1,1,1.0,0
29264,7561,Stuff Packs,4,3,0.75,1
29265,7562,Expansion Packs,9,0,0.0,9
29266,7562,Game Packs,4,0,0.0,4
29267,7562,Stuff Packs,4,0,0.0,4
29268,7563,Expansion Packs,16,0,0.0,16
29269,7563,Game Packs,12,0,0.0,12
29270,7563,Kits,29,0,0.0,29
29271,7563,Stuff Packs,20,0,0.0,20
29272,7564,Expansion Packs,13,0,0.0,13
29273,7564,Game Packs,10,0,0.0,10
29274,7564,Kits,2,2,1.0,0
29275,7564,Stuff Packs,14,1,0.07142857142857142,13
29276,7565,Expansion Packs,16,0,0.0,16
29277,7565,Game Packs,11,0,0.0,11
29278,7565,Kits,25,1,0.04,24
29279,7565,Stuff Packs,20,0,0.0,20
29280,7566,Expansion Packs,8,0,0.0,8
29281,7566,Game Packs,2,1,0.5,1
29282,7566,Kits,9,1,0.1111111111111111,8
29283,7566,Stuff Packs,8,4,0.5,4
29284,7567,Expansion Packs,16,0,0.0,16
29285,7567,Game Packs,12,0,0.0,12
29286,7567,Kits,33,1,0.030303030303030304,32
29287,7567,Stuff Packs,20,0,0.0,20
29288,7568,Expansion Packs,8,0,0.0,8
29289,7568,Game Packs,3,0,0.0,3
29290,7568,Kits,3,0,0.0,3
29291,7568,Stuff Packs,7,2,0.2857142857142857,5
29292,7569,Expansion Packs,16,0,0.0,16
29293,7569,Game Packs,12,0,0.0,12
29294,7569,Kits,33,0,0.0,33
29295,7569,Stuff Packs,20,0,0.0,20
29296,7570,Expansion Packs,3,0,0.0,3
29297,7570,Game Packs,3,0,0.0,3
29298,7570,Kits,2,2,1.0,0
29299,7570,Stuff Packs,6,3,0.5,3
29300,7571,Expansion Packs,15,0,0.0,15
29301,7571,Game Packs,8,0,0.0,8
29302,7571,Kits,12,2,0.16666666666666666,10
29303,7571,Stuff Packs,15,1,0.06666666666666667,14
29304,7572,Expansion Packs,16,0,0.0,16
29305,7572,Game Packs,6,0,0.0,6
29306,7572,Kits,23,0,0.0,23
29307,7572,Stuff Packs,12,2,0.16666666666666666,10
29308,7573,Expansion Packs,16,0,0.0,16
29309,7573,Game Packs,11,0,0.0,11
29310,7573,Kits,21,1,0.047619047619047616,20
29311,7573,Stuff Packs,20,1,0.05,19
29312,7574,Expansion Packs,16,0,0.0,16
29313,7574,Game Packs,11,0,0.0,11
29314,7574,Kits,15,2,0.13333333333333333,13
29315,7574,Stuff Packs,13,0,0.0,13
29316,7575,Expansion Packs,11,0,0.0,11
29317,7575,Game Packs,5,1,0.2,4
29318,7575,Kits,13,2,0.15384615384615385,11
29319,7575,Stuff Packs,5,4,0.8,1
29320,7576,Expansion Packs,9,0,0.0,9
29321,7576,Game Packs,2,0,0.0,2
29322,7576,Stuff Packs,1,0,0.0,1
29323,7577,Expansion Packs,15,0,0.0,15
29324,7577,Game Packs,6,0,0.0,6
29325,7577,Kits,6,0,0.0,6
29326,7577,Stuff Packs,14,0,0.0,14
29327,7578,Expansion Packs,8,0,0.0,8
29328,7578,Game Packs,4,0,0.0,4
29329,7578,Kits,2,2,1.0,0
29330,7578,Stuff Packs,10,3,0.3,7
29331,7579,Expansion Packs,16,0,0.0,16
29332,7579,Game Packs,11,0,0.0,11
29333,7579,Kits,8,2,0.25,6
29334,7579,Stuff Packs,15,0,0.0,15
29335,7580,Expansion Packs,16,0,0.0,16
29336,7580,Game Packs,12,0,0.0,12
29337,7580,Kits,2,2,1.0,0
29338,7580,Stuff Packs,12,0,0.0,12
29339,7581,Expansion Packs,10,0,0.0,10
29340,7581,Game Packs,5,0,0.0,5
29341,7581,Kits,1,0,0.0,1
29342,7581,Stuff Packs,2,2,1.0,0
29343,7582,Expansion Packs,16,0,0.0,16
29344,7582,Game Packs,12,0,0.0,12
29345,7582,Kits,33,0,0.0,33
29346,7582,Stuff Packs,20,0,0.0,20
29347,7583,Expansion Packs,6,0,0.0,6
29348,7583,Game Packs,3,0,0.0,3
29349,7583,Stuff Packs,1,0,0.0,1
29350,7584,Expansion Packs,10,0,0.0,10
29351,7584,Game Packs,9,0,0.0,9
29352,7584,Kits,2,1,0.5,1
29353,7584,Stuff Packs,17,1,0.058823529411764705,16
29354,7585,Expansion Packs,10,1,0.1,9
29355,7585,Game Packs,4,0,0.0,4
29356,7585,Kits,12,0,0.0,12
29357,7585,Stuff Packs,8,0,0.0,8
29358,7586,Expansion Packs,14,0,0.0,14
29359,7586,Game Packs,11,0,0.0,11
29360,7586,Kits,1,1,1.0,0
29361,7586,Stuff Packs,9,1,0.1111111111111111,8
29362,7587,Expansion Packs,13,0,0.0,13
29363,7587,Game Packs,10,0,0.0,10
29364,7587,Kits,7,1,0.14285714285714285,6
29365,7587,Stuff Packs,18,2,0.1111111111111111,16
29366,7588,Expansion Packs,16,0,0.0,16
29367,7588,Game Packs,11,0,0.0,11
29368,7588,Kits,30,1,0.03333333333333333,29
29369,7588,Stuff Packs,20,0,0.0,20
29370,7589,Expansion Packs,14,0,0.0,14
29371,7589,Game Packs,7,0,0.0,7
29372,7589,Kits,3,2,0.6666666666666666,1
29373,7589,Stuff Packs,13,1,0.07692307692307693,12
29374,7590,Expansion Packs,10,0,0.0,10
29375,7590,Game Packs,6,1,0.16666666666666666,5
29376,7590,Kits,3,3,1.0,0
29377,7590,Stuff Packs,5,4,0.8,1
29378,7591,Expansion Packs,10,0,0.0,10
29379,7591,Game Packs,4,0,0.0,4
29380,7591,Kits,6,2,0.3333333333333333,4
29381,7591,Stuff Packs,13,1,0.07692307692307693,12
29382,7592,Expansion Packs,11,0,0.0,11
29383,7592,Game Packs,3,0,0.0,3
29384,7592,Stuff Packs,6,3,0.5,3
29385,7593,Expansion Packs,9,0,0.0,9
29386,7593,Game Packs,5,1,0.2,4
29387,7593,Kits,3,0,0.0,3
29388,7593,Stuff Packs,4,0,0.0,4
29389,7594,Expansion Packs,6,0,0.0,6
29390,7594,Game Packs,1,0,0.0,1
29391,7594,Stuff Packs,4,0,0.0,4
29392,7595,Expansion Packs,10,0,0.0,10
29393,7595,Game Packs,7,1,0.14285714285714285,6
29394,7595,Kits,5,3,0.6,2
29395,7595,Stuff Packs,10,3,0.3,7
29396,7596,Expansion Packs,11,0,0.0,11
29397,7596,Game Packs,8,0,0.0,8
29398,7596,Kits,12,2,0.16666666666666666,10
29399,7596,Stuff Packs,9,3,0.3333333333333333,6
29400,7597,Expansion Packs,16,0,0.0,16
29401,7597,Game Packs,12,0,0.0,12
29402,7597,Kits,33,2,0.06060606060606061,31
29403,7597,Stuff Packs,20,3,0.15,17
29404,7598,Expansion Packs,15,0,0.0,15
29405,7598,Game Packs,11,1,0.09090909090909091,10
29406,7598,Kits,3,3,1.0,0
29407,7598,Stuff Packs,12,1,0.08333333333333333,11
29408,7599,Expansion Packs,14,0,0.0,14
29409,7599,Game Packs,11,0,0.0,11
29410,7599,Kits,3,0,0.0,3
29411,7599,Stuff Packs,11,2,0.18181818181818182,9
29412,7600,Expansion Packs,14,0,0.0,14
29413,7600,Game Packs,11,0,0.0,11
29414,7600,Kits,3,0,0.0,3
29415,7600,Stuff Packs,11,2,0.18181818181818182,9
29416,7601,Expansion Packs,14,0,0.0,14
29417,7601,Game Packs,10,0,0.0,10
29418,7601,Kits,7,1,0.14285714285714285,6
29419,7601,Stuff Packs,19,0,0.0,19
29420,7602,Expansion Packs,15,0,0.0,15
29421,7602,Game Packs,11,0,0.0,11
29422,7602,Kits,10,1,0.1,9
29423,7602,Stuff Packs,17,1,0.058823529411764705,16
29424,7603,Expansion Packs,16,0,0.0,16
29425,7603,Game Packs,11,0,0.0,11
29426,7603,Kits,30,1,0.03333333333333333,29
29427,7603,Stuff Packs,20,0,0.0,20
29428,7604,Expansion Packs,15,1,0.06666666666666667,14
29429,7604,Game Packs,8,0,0.0,8
29430,7604,Kits,3,2,0.6666666666666666,1
29431,7604,Stuff Packs,8,1,0.125,7
29432,7605,Expansion Packs,12,0,0.0,12
29433,7605,Game Packs,4,0,0.0,4
29434,7605,Kits,2,2,1.0,0
29435,7605,Stuff Packs,3,3,1.0,0
29436,7606,Expansion Packs,15,0,0.0,15
29437,7606,Game Packs,10,0,0.0,10
29438,7606,Kits,18,1,0.05555555555555555,17
29439,7606,Stuff Packs,13,0,0.0,13
29440,7607,Expansion Packs,16,0,0.0,16
29441,7607,Game Packs,12,0,0.0,12
29442,7607,Kits,33,0,0.0,33
29443,7607,Stuff Packs,20,0,0.0,20
29444,7608,Expansion Packs,9,0,0.0,9
29445,7608,Game Packs,4,0,0.0,4
29446,7608,Kits,6,2,0.3333333333333333,4
29447,7608,Stuff Packs,8,2,0.25,6
29448,7609,Expansion Packs,16,0,0.0,16
29449,7609,Game Packs,12,0,0.0,12
29450,7609,Kits,33,2,0.06060606060606061,31
29451,7609,Stuff Packs,20,1,0.05,19
29452,7610,Expansion Packs,16,0,0.0,16
29453,7610,Game Packs,12,0,0.0,12
29454,7610,Kits,33,0,0.0,33
29455,7610,Stuff Packs,20,0,0.0,20
29456,7611,Expansion Packs,16,0,0.0,16
29457,7611,Game Packs,11,0,0.0,11
29458,7611,Kits,12,3,0.25,9
29459,7611,Stuff Packs,15,0,0.0,15
29460,7612,Expansion Packs,16,0,0.0,16
29461,7612,Game Packs,11,0,0.0,11
29462,7612,Kits,8,1,0.125,7
29463,7612,Stuff Packs,20,0,0.0,20
29464,7613,Expansion Packs,6,0,0.0,6
29465,7613,Kits,4,1,0.25,3
29466,7613,Stuff Packs,8,3,0.375,5
29467,7614,Expansion Packs,16,0,0.0,16
29468,7614,Game Packs,11,0,0.0,11
29469,7614,Kits,22,2,0.09090909090909091,20
29470,7614,Stuff Packs,20,1,0.05,19
29471,7615,Expansion Packs,16,0,0.0,16
29472,7615,Game Packs,12,0,0.0,12
29473,7615,Kits,31,0,0.0,31
29474,7615,Stuff Packs,20,0,0.0,20
29475,7616,Expansion Packs,16,0,0.0,16
29476,7616,Game Packs,12,0,0.0,12
29477,7616,Kits,33,0,0.0,33
29478,7616,Stuff Packs,20,0,0.0,20
29479,7617,Expansion Packs,16,0,0.0,16
29480,7617,Game Packs,12,0,0.0,12
29481,7617,Kits,18,0,0.0,18
29482,7617,Stuff Packs,19,0,0.0,19
29483,7618,Expansion Packs,3,0,0.0,3
29484,7618,Game Packs,2,1,0.5,1
29485,7618,Kits,4,2,0.5,2
29486,7618,Stuff Packs,7,3,0.42857142857142855,4
29487,7619,Expansion Packs,15,0,0.0,15
29488,7619,Game Packs,10,0,0.0,10
29489,7619,Kits,3,2,0.6666666666666666,1
29490,7619,Stuff Packs,19,0,0.0,19
29491,7620,Expansion Packs,13,0,0.0,13
29492,7620,Game Packs,6,0,0.0,6
29493,7620,Kits,5,1,0.2,4
29494,7620,Stuff Packs,11,0,0.0,11
29495,7621,Expansion Packs,6,0,0.0,6
29496,7621,Game Packs,3,0,0.0,3
29497,7621,Stuff Packs,1,0,0.0,1
29498,7622,Expansion Packs,14,0,0.0,14
29499,7622,Game Packs,8,3,0.375,5
29500,7622,Kits,4,0,0.0,4
29501,7622,Stuff Packs,16,0,0.0,16
29502,7623,Expansion Packs,16,0,0.0,16
29503,7623,Game Packs,12,0,0.0,12
29504,7623,Kits,10,1,0.1,9
29505,7623,Stuff Packs,20,0,0.0,20
29506,7624,Expansion Packs,9,0,0.0,9
29507,7624,Game Packs,6,0,0.0,6
29508,7624,Stuff Packs,14,0,0.0,14
29509,7625,Expansion Packs,15,0,0.0,15
29510,7625,Game Packs,11,0,0.0,11
29511,7625,Kits,5,0,0.0,5
29512,7625,Stuff Packs,19,0,0.0,19
29513,7626,Expansion Packs,16,0,0.0,16
29514,7626,Game Packs,12,0,0.0,12
29515,7626,Kits,8,1,0.125,7
29516,7626,Stuff Packs,18,1,0.05555555555555555,17
29517,7627,Expansion Packs,10,0,0.0,10
29518,7627,Game Packs,3,0,0.0,3
29519,7627,Kits,1,0,0.0,1
29520,7627,Stuff Packs,8,2,0.25,6
29521,7628,Expansion Packs,6,0,0.0,6
29522,7628,Game Packs,5,0,0.0,5
29523,7628,Kits,2,2,1.0,0
29524,7628,Stuff Packs,8,1,0.125,7
29525,7629,Expansion Packs,15,0,0.0,15
29526,7629,Game Packs,12,0,0.0,12
29527,7629,Kits,25,0,0.0,25
29528,7629,Stuff Packs,19,0,0.0,19
29529,7630,Expansion Packs,16,0,0.0,16
29530,7630,Game Packs,12,0,0.0,12
29531,7630,Kits,33,1,0.030303030303030304,32
29532,7630,Stuff Packs,20,0,0.0,20
29533,7631,Expansion Packs,7,1,0.14285714285714285,6
29534,7631,Kits,2,0,0.0,2
29535,7631,Stuff Packs,5,3,0.6,2
29536,7632,Expansion Packs,6,0,0.0,6
29537,7632,Game Packs,2,0,0.0,2
29538,7632,Kits,5,1,0.2,4
29539,7632,Stuff Packs,5,3,0.6,2
29540,7633,Expansion Packs,10,0,0.0,10
29541,7633,Game Packs,3,0,0.0,3
29542,7633,Kits,5,0,0.0,5
29543,7633,Stuff Packs,3,0,0.0,3
29544,7634,Expansion Packs,15,0,0.0,15
29545,7634,Game Packs,11,0,0.0,11
29546,7634,Kits,3,2,0.6666666666666666,1
29547,7634,Stuff Packs,15,3,0.2,12
29548,7635,Expansion Packs,15,0,0.0,15
29549,7635,Game Packs,7,0,0.0,7
29550,7635,Kits,10,1,0.1,9
29551,7635,Stuff Packs,17,1,0.058823529411764705,16
29552,7636,Expansion Packs,2,0,0.0,2
29553,7636,Game Packs,2,0,0.0,2
29554,7636,Stuff Packs,4,3,0.75,1
29555,7637,Expansion Packs,16,0,0.0,16
29556,7637,Game Packs,12,0,0.0,12
29557,7637,Kits,2,2,1.0,0
29558,7637,Stuff Packs,18,1,0.05555555555555555,17
29559,7638,Expansion Packs,16,1,0.0625,15
29560,7638,Game Packs,12,0,0.0,12
29561,7638,Kits,29,2,0.06896551724137931,27
29562,7638,Stuff Packs,17,1,0.058823529411764705,16
29563,7639,Expansion Packs,16,0,0.0,16
29564,7639,Game Packs,10,0,0.0,10
29565,7639,Kits,4,0,0.0,4
29566,7639,Stuff Packs,19,0,0.0,19
29567,7640,Expansion Packs,15,0,0.0,15
29568,7640,Game Packs,11,0,0.0,11
29569,7640,Kits,4,1,0.25,3
29570,7640,Stuff Packs,18,0,0.0,18
29571,7641,Expansion Packs,16,0,0.0,16
29572,7641,Game Packs,11,0,0.0,11
29573,7641,Kits,3,2,0.6666666666666666,1
29574,7641,Stuff Packs,20,0,0.0,20
29575,7642,Expansion Packs,11,0,0.0,11
29576,7642,Game Packs,8,0,0.0,8
29577,7642,Kits,4,2,0.5,2
29578,7642,Stuff Packs,11,3,0.2727272727272727,8
29579,7643,Expansion Packs,13,1,0.07692307692307693,12
29580,7643,Game Packs,8,1,0.125,7
29581,7643,Kits,2,1,0.5,1
29582,7643,Stuff Packs,9,1,0.1111111111111111,8
29583,7644,Expansion Packs,14,0,0.0,14
29584,7644,Game Packs,10,0,0.0,10
29585,7644,Kits,8,1,0.125,7
29586,7644,Stuff Packs,9,1,0.1111111111111111,8
29587,7645,Expansion Packs,10,0,0.0,10
29588,7645,Game Packs,5,0,0.0,5
29589,7645,Kits,5,0,0.0,5
29590,7645,Stuff Packs,13,2,0.15384615384615385,11
29591,7646,Expansion Packs,4,0,0.0,4
29592,7646,Game Packs,4,0,0.0,4
29593,7646,Kits,1,0,0.0,1
29594,7646,Stuff Packs,5,0,0.0,5
29595,7647,Expansion Packs,16,0,0.0,16
29596,7647,Game Packs,12,0,0.0,12
29597,7647,Kits,33,0,0.0,33
29598,7647,Stuff Packs,20,0,0.0,20
29599,7648,Expansion Packs,16,0,0.0,16
29600,7648,Game Packs,12,0,0.0,12
29601,7648,Kits,30,2,0.06666666666666667,28
29602,7648,Stuff Packs,20,0,0.0,20
29603,7649,Expansion Packs,10,0,0.0,10
29604,7649,Game Packs,7,1,0.14285714285714285,6
29605,7649,Kits,6,3,0.5,3
29606,7649,Stuff Packs,10,3,0.3,7
29607,7650,Expansion Packs,11,0,0.0,11
29608,7650,Game Packs,8,0,0.0,8
29609,7650,Kits,2,2,1.0,0
29610,7650,Stuff Packs,13,0,0.0,13
29611,7651,Expansion Packs,15,0,0.0,15
29612,7651,Game Packs,11,0,0.0,11
29613,7651,Kits,8,0,0.0,8
29614,7651,Stuff Packs,10,1,0.1,9
29615,7652,Expansion Packs,16,0,0.0,16
29616,7652,Game Packs,11,0,0.0,11
29617,7652,Kits,16,1,0.0625,15
29618,7652,Stuff Packs,20,1,0.05,19
29619,7653,Expansion Packs,8,0,0.0,8
29620,7653,Game Packs,6,2,0.3333333333333333,4
29621,7653,Kits,3,3,1.0,0
29622,7653,Stuff Packs,5,4,0.8,1
29623,7654,Expansion Packs,7,0,0.0,7
29624,7654,Game Packs,5,1,0.2,4
29625,7654,Stuff Packs,2,0,0.0,2
29626,7655,Expansion Packs,13,3,0.23076923076923078,10
29627,7655,Game Packs,6,1,0.16666666666666666,5
29628,7655,Kits,16,4,0.25,12
29629,7655,Stuff Packs,11,2,0.18181818181818182,9
29630,7656,Expansion Packs,16,0,0.0,16
29631,7656,Game Packs,12,0,0.0,12
29632,7656,Kits,33,0,0.0,33
29633,7656,Stuff Packs,20,0,0.0,20
29634,7657,Expansion Packs,16,0,0.0,16
29635,7657,Game Packs,9,0,0.0,9
29636,7657,Kits,21,2,0.09523809523809523,19
29637,7657,Stuff Packs,19,0,0.0,19
29638,7658,Expansion Packs,4,0,0.0,4
29639,7658,Game Packs,2,0,0.0,2
29640,7658,Stuff Packs,2,0,0.0,2
29641,7659,Expansion Packs,10,0,0.0,10
29642,7659,Game Packs,4,0,0.0,4
29643,7659,Kits,4,1,0.25,3
29644,7659,Stuff Packs,9,2,0.2222222222222222,7
29645,7660,Expansion Packs,4,0,0.0,4
29646,7660,Game Packs,3,0,0.0,3
29647,7660,Kits,5,2,0.4,3
29648,7660,Stuff Packs,7,3,0.42857142857142855,4
29649,7661,Expansion Packs,16,0,0.0,16
29650,7661,Game Packs,12,0,0.0,12
29651,7661,Kits,19,0,0.0,19
29652,7661,Stuff Packs,15,1,0.06666666666666667,14
29653,7662,Expansion Packs,11,0,0.0,11
29654,7662,Game Packs,4,0,0.0,4
29655,7662,Kits,13,1,0.07692307692307693,12
29656,7662,Stuff Packs,8,3,0.375,5
29657,7663,Expansion Packs,14,1,0.07142857142857142,13
29658,7663,Game Packs,12,0,0.0,12
29659,7663,Kits,14,0,0.0,14
29660,7663,Stuff Packs,17,0,0.0,17
29661,7664,Expansion Packs,16,0,0.0,16
29662,7664,Game Packs,8,0,0.0,8
29663,7664,Kits,11,0,0.0,11
29664,7664,Stuff Packs,14,2,0.14285714285714285,12
29665,7665,Expansion Packs,14,0,0.0,14
29666,7665,Game Packs,8,0,0.0,8
29667,7665,Kits,5,3,0.6,2
29668,7665,Stuff Packs,11,1,0.09090909090909091,10
29669,7666,Expansion Packs,16,0,0.0,16
29670,7666,Game Packs,11,0,0.0,11
29671,7666,Kits,12,1,0.08333333333333333,11
29672,7666,Stuff Packs,16,0,0.0,16
29673,7667,Expansion Packs,15,0,0.0,15
29674,7667,Game Packs,10,0,0.0,10
29675,7667,Kits,16,0,0.0,16
29676,7667,Stuff Packs,19,0,0.0,19
29677,7668,Expansion Packs,10,0,0.0,10
29678,7668,Game Packs,8,0,0.0,8
29679,7668,Stuff Packs,16,0,0.0,16
29680,7669,Expansion Packs,13,0,0.0,13
29681,7669,Game Packs,8,1,0.125,7
29682,7669,Kits,5,3,0.6,2
29683,7669,Stuff Packs,10,3,0.3,7
29684,7670,Expansion Packs,13,0,0.0,13
29685,7670,Game Packs,8,0,0.0,8
29686,7670,Kits,14,0,0.0,14
29687,7670,Stuff Packs,10,0,0.0,10
29688,7671,Expansion Packs,16,0,0.0,16
29689,7671,Game Packs,11,0,0.0,11
29690,7671,Kits,8,1,0.125,7
29691,7671,Stuff Packs,20,0,0.0,20
29692,7672,Expansion Packs,16,0,0.0,16
29693,7672,Game Packs,12,1,0.08333333333333333,11
29694,7672,Kits,16,2,0.125,14
29695,7672,Stuff Packs,20,5,0.25,15
29696,7673,Expansion Packs,14,0,0.0,14
29697,7673,Game Packs,7,0,0.0,7
29698,7673,Kits,7,0,0.0,7
29699,7673,Stuff Packs,11,0,0.0,11
29700,7674,Expansion Packs,9,0,0.0,9
29701,7674,Game Packs,5,0,0.0,5
29702,7674,Kits,3,1,0.3333333333333333,2
29703,7674,Stuff Packs,3,0,0.0,3
29704,7675,Expansion Packs,10,0,0.0,10
29705,7675,Game Packs,6,0,0.0,6
29706,7675,Kits,8,2,0.25,6
29707,7675,Stuff Packs,6,0,0.0,6
29708,7676,Expansion Packs,16,0,0.0,16
29709,7676,Game Packs,12,0,0.0,12
29710,7676,Kits,33,0,0.0,33
29711,7676,Stuff Packs,20,0,0.0,20
29712,7677,Expansion Packs,14,0,0.0,14
29713,7677,Game Packs,10,0,0.0,10
29714,7677,Kits,10,0,0.0,10
29715,7677,Stuff Packs,15,0,0.0,15
29716,7678,Expansion Packs,16,0,0.0,16
29717,7678,Game Packs,12,0,0.0,12
29718,7678,Kits,12,2,0.16666666666666666,10
29719,7678,Stuff Packs,15,0,0.0,15
29720,7679,Expansion Packs,14,0,0.0,14
29721,7679,Game Packs,11,0,0.0,11
29722,7679,Kits,10,1,0.1,9
29723,7679,Stuff Packs,19,0,0.0,19
29724,7680,Expansion Packs,16,0,0.0,16
29725,7680,Game Packs,12,0,0.0,12
29726,7680,Kits,22,2,0.09090909090909091,20
29727,7680,Stuff Packs,20,0,0.0,20
29728,7681,Expansion Packs,14,0,0.0,14
29729,7681,Game Packs,6,0,0.0,6
29730,7681,Kits,1,0,0.0,1
29731,7681,Stuff Packs,9,2,0.2222222222222222,7
29732,7682,Expansion Packs,14,0,0.0,14
29733,7682,Game Packs,10,0,0.0,10
29734,7682,Kits,9,2,0.2222222222222222,7
29735,7682,Stuff Packs,14,1,0.07142857142857142,13
29736,7683,Expansion Packs,16,0,0.0,16
29737,7683,Game Packs,12,0,0.0,12
29738,7683,Kits,33,0,0.0,33
29739,7683,Stuff Packs,20,0,0.0,20
29740,7684,Expansion Packs,15,0,0.0,15
29741,7684,Game Packs,12,0,0.0,12
29742,7684,Kits,19,1,0.05263157894736842,18
29743,7684,Stuff Packs,20,0,0.0,20
29744,7685,Expansion Packs,8,0,0.0,8
29745,7685,Game Packs,2,0,0.0,2
29746,7685,Stuff Packs,3,2,0.6666666666666666,1
29747,7686,Expansion Packs,16,0,0.0,16
29748,7686,Game Packs,12,0,0.0,12
29749,7686,Kits,33,1,0.030303030303030304,32
29750,7686,Stuff Packs,20,0,0.0,20
29751,7687,Expansion Packs,11,0,0.0,11
29752,7687,Game Packs,5,1,0.2,4
29753,7687,Kits,3,3,1.0,0
29754,7687,Stuff Packs,7,4,0.5714285714285714,3
29755,7688,Expansion Packs,8,0,0.0,8
29756,7688,Game Packs,6,0,0.0,6
29757,7688,Kits,2,0,0.0,2
29758,7688,Stuff Packs,3,1,0.3333333333333333,2
29759,7689,Expansion Packs,13,0,0.0,13
29760,7689,Game Packs,11,0,0.0,11
29761,7689,Kits,5,1,0.2,4
29762,7689,Stuff Packs,18,0,0.0,18
29763,7690,Expansion Packs,14,0,0.0,14
29764,7690,Game Packs,11,0,0.0,11
29765,7690,Kits,7,0,0.0,7
29766,7690,Stuff Packs,14,0,0.0,14
29767,7691,Expansion Packs,16,0,0.0,16
29768,7691,Game Packs,12,0,0.0,12
29769,7691,Kits,30,1,0.03333333333333333,29
29770,7691,Stuff Packs,20,2,0.1,18
29771,7692,Expansion Packs,12,0,0.0,12
29772,7692,Game Packs,6,0,0.0,6
29773,7692,Kits,3,3,1.0,0
29774,7692,Stuff Packs,10,4,0.4,6
29775,7693,Expansion Packs,12,0,0.0,12
29776,7693,Game Packs,4,1,0.25,3
29777,7693,Kits,2,2,1.0,0
29778,7693,Stuff Packs,7,1,0.14285714285714285,6
29779,7694,Expansion Packs,3,0,0.0,3
29780,7694,Game Packs,2,0,0.0,2
29781,7694,Kits,2,2,1.0,0
29782,7694,Stuff Packs,2,1,0.5,1
29783,7695,Expansion Packs,16,0,0.0,16
29784,7695,Game Packs,12,0,0.0,12
29785,7695,Kits,33,1,0.030303030303030304,32
29786,7695,Stuff Packs,20,0,0.0,20
29787,7696,Expansion Packs,14,0,0.0,14
29788,7696,Game Packs,9,0,0.0,9
29789,7696,Stuff Packs,7,0,0.0,7
29790,7697,Expansion Packs,16,0,0.0,16
29791,7697,Game Packs,10,3,0.3,7
29792,7697,Kits,2,1,0.5,1
29793,7697,Stuff Packs,12,5,0.4166666666666667,7
29794,7698,Expansion Packs,16,0,0.0,16
29795,7698,Game Packs,12,0,0.0,12
29796,7698,Kits,33,0,0.0,33
29797,7698,Stuff Packs,20,0,0.0,20
29798,7699,Expansion Packs,16,0,0.0,16
29799,7699,Game Packs,12,0,0.0,12
29800,7699,Kits,24,1,0.041666666666666664,23
29801,7699,Stuff Packs,20,0,0.0,20
29802,7700,Expansion Packs,16,0,0.0,16
29803,7700,Game Packs,12,0,0.0,12
29804,7700,Kits,18,0,0.0,18
29805,7700,Stuff Packs,20,0,0.0,20
29806,7701,Expansion Packs,16,0,0.0,16
29807,7701,Game Packs,12,0,0.0,12
29808,7701,Kits,33,1,0.030303030303030304,32
29809,7701,Stuff Packs,20,0,0.0,20
29810,7702,Expansion Packs,10,0,0.0,10
29811,7702,Game Packs,5,0,0.0,5
29812,7702,Kits,2,2,1.0,0
29813,7702,Stuff Packs,8,2,0.25,6
29814,7703,Expansion Packs,16,0,0.0,16
29815,7703,Game Packs,12,0,0.0,12
29816,7703,Kits,2,1,0.5,1
29817,7703,Stuff Packs,20,0,0.0,20
29818,7704,Expansion Packs,16,0,0.0,16
29819,7704,Game Packs,12,0,0.0,12
29820,7704,Kits,33,0,0.0,33
29821,7704,Stuff Packs,20,0,0.0,20
29822,7705,Expansion Packs,14,0,0.0,14
29823,7705,Game Packs,8,1,0.125,7
29824,7705,Kits,2,2,1.0,0
29825,7705,Stuff Packs,16,1,0.0625,15
29826,7706,Expansion Packs,16,0,0.0,16
29827,7706,Game Packs,11,0,0.0,11
29828,7706,Kits,6,2,0.3333333333333333,4
29829,7706,Stuff Packs,18,1,0.05555555555555555,17
29830,7707,Expansion Packs,11,0,0.0,11
29831,7707,Game Packs,8,0,0.0,8
29832,7707,Kits,2,2,1.0,0
29833,7707,Stuff Packs,9,3,0.3333333333333333,6
29834,7708,Expansion Packs,13,0,0.0,13
29835,7708,Game Packs,8,1,0.125,7
29836,7708,Kits,5,1,0.2,4
29837,7708,Stuff Packs,8,3,0.375,5
29838,7709,Expansion Packs,16,0,0.0,16
29839,7709,Game Packs,12,0,0.0,12
29840,7709,Kits,33,1,0.030303030303030304,32
29841,7709,Stuff Packs,20,0,0.0,20
29842,7710,Expansion Packs,16,0,0.0,16
29843,7710,Game Packs,12,0,0.0,12
29844,7710,Kits,33,1,0.030303030303030304,32
29845,7710,Stuff Packs,20,0,0.0,20
29846,7711,Expansion Packs,9,0,0.0,9
29847,7711,Game Packs,3,0,0.0,3
29848,7711,Kits,4,1,0.25,3
29849,7711,Stuff Packs,6,0,0.0,6
29850,7712,Expansion Packs,16,0,0.0,16
29851,7712,Game Packs,12,0,0.0,12
29852,7712,Kits,33,0,0.0,33
29853,7712,Stuff Packs,20,0,0.0,20
29854,7713,Expansion Packs,8,0,0.0,8
29855,7713,Game Packs,1,0,0.0,1
29856,7713,Kits,2,2,1.0,0
29857,7713,Stuff Packs,3,2,0.6666666666666666,1
29858,7714,Expansion Packs,16,0,0.0,16
29859,7714,Game Packs,11,0,0.0,11
29860,7714,Kits,6,1,0.16666666666666666,5
29861,7714,Stuff Packs,20,0,0.0,20
29862,7715,Expansion Packs,16,0,0.0,16
29863,7715,Game Packs,12,0,0.0,12
29864,7715,Kits,24,2,0.08333333333333333,22
29865,7715,Stuff Packs,20,0,0.0,20
29866,7716,Expansion Packs,12,0,0.0,12
29867,7716,Game Packs,11,0,0.0,11
29868,7716,Kits,4,2,0.5,2
29869,7716,Stuff Packs,15,1,0.06666666666666667,14
29870,7717,Expansion Packs,16,1,0.0625,15
29871,7717,Game Packs,12,0,0.0,12
29872,7717,Kits,33,1,0.030303030303030304,32
29873,7717,Stuff Packs,20,0,0.0,20
29874,7718,Expansion Packs,16,0,0.0,16
29875,7718,Game Packs,12,0,0.0,12
29876,7718,Kits,33,0,0.0,33
29877,7718,Stuff Packs,20,0,0.0,20
29878,7719,Expansion Packs,16,0,0.0,16
29879,7719,Game Packs,12,0,0.0,12
29880,7719,Kits,27,1,0.037037037037037035,26
29881,7719,Stuff Packs,18,3,0.16666666666666666,15
29882,7720,Expansion Packs,16,0,0.0,16
29883,7720,Game Packs,12,0,0.0,12
29884,7720,Kits,33,2,0.06060606060606061,31
29885,7720,Stuff Packs,20,0,0.0,20
29886,7721,Expansion Packs,2,0,0.0,2
29887,7721,Game Packs,1,0,0.0,1
29888,7721,Stuff Packs,4,3,0.75,1
29889,7722,Expansion Packs,16,0,0.0,16
29890,7722,Game Packs,12,0,0.0,12
29891,7722,Kits,32,0,0.0,32
29892,7722,Stuff Packs,20,0,0.0,20
29893,7723,Expansion Packs,16,0,0.0,16
29894,7723,Game Packs,11,0,0.0,11
29895,7723,Kits,8,0,0.0,8
29896,7723,Stuff Packs,20,0,0.0,20
29897,7724,Expansion Packs,10,1,0.1,9
29898,7724,Game Packs,10,2,0.2,8
29899,7724,Kits,13,2,0.15384615384615385,11
29900,7724,Stuff Packs,13,5,0.38461538461538464,8
29901,7725,Expansion Packs,9,0,0.0,9
29902,7725,Game Packs,2,0,0.0,2
29903,7725,Kits,1,0,0.0,1
29904,7725,Stuff Packs,2,0,0.0,2
29905,7726,Expansion Packs,9,0,0.0,9
29906,7726,Game Packs,5,0,0.0,5
29907,7726,Kits,5,1,0.2,4
29908,7726,Stuff Packs,4,1,0.25,3
29909,7727,Expansion Packs,16,0,0.0,16
29910,7727,Game Packs,12,0,0.0,12
29911,7727,Kits,31,1,0.03225806451612903,30
29912,7727,Stuff Packs,20,0,0.0,20
29913,7728,Expansion Packs,1,0,0.0,1
29914,7728,Kits,1,1,1.0,0
29915,7728,Stuff Packs,1,1,1.0,0
29916,7729,Expansion Packs,15,0,0.0,15
29917,7729,Game Packs,11,0,0.0,11
29918,7729,Kits,13,0,0.0,13
29919,7729,Stuff Packs,18,3,0.16666666666666666,15
29920,7730,Expansion Packs,14,1,0.07142857142857142,13
29921,7730,Game Packs,10,0,0.0,10
29922,7730,Kits,2,2,1.0,0
29923,7730,Stuff Packs,12,3,0.25,9
29924,7731,Expansion Packs,14,0,0.0,14
29925,7731,Game Packs,9,0,0.0,9
29926,7731,Kits,6,1,0.16666666666666666,5
29927,7731,Stuff Packs,12,3,0.25,9
29928,7732,Expansion Packs,3,0,0.0,3
29929,7732,Game Packs,1,0,0.0,1
29930,7732,Kits,2,1,0.5,1
29931,7732,Stuff Packs,3,0,0.0,3
29932,7733,Expansion Packs,10,0,0.0,10
29933,7733,Game Packs,3,0,0.0,3
29934,7733,Stuff Packs,5,2,0.4,3
29935,7734,Expansion Packs,16,0,0.0,16
29936,7734,Game Packs,9,0,0.0,9
29937,7734,Kits,4,0,0.0,4
29938,7734,Stuff Packs,11,1,0.09090909090909091,10
29939,7735,Expansion Packs,10,0,0.0,10
29940,7735,Game Packs,10,0,0.0,10
29941,7735,Kits,3,2,0.6666666666666666,1
29942,7735,Stuff Packs,10,3,0.3,7
29943,7736,Expansion Packs,15,0,0.0,15
29944,7736,Game Packs,12,1,0.08333333333333333,11
29945,7736,Kits,6,0,0.0,6
29946,7736,Stuff Packs,19,1,0.05263157894736842,18
29947,7737,Expansion Packs,15,0,0.0,15
29948,7737,Game Packs,10,0,0.0,10
29949,7737,Kits,4,0,0.0,4
29950,7737,Stuff Packs,19,0,0.0,19
29951,7738,Expansion Packs,16,0,0.0,16
29952,7738,Game Packs,12,0,0.0,12
29953,7738,Kits,32,0,0.0,32
29954,7738,Stuff Packs,20,0,0.0,20
29955,7739,Expansion Packs,16,0,0.0,16
29956,7739,Game Packs,12,0,0.0,12
29957,7739,Kits,33,1,0.030303030303030304,32
29958,7739,Stuff Packs,20,0,0.0,20
29959,7740,Expansion Packs,4,0,0.0,4
29960,7740,Game Packs,3,0,0.0,3
29961,7740,Kits,6,0,0.0,6
29962,7740,Stuff Packs,7,2,0.2857142857142857,5
29963,7741,Expansion Packs,16,0,0.0,16
29964,7741,Game Packs,12,0,0.0,12
29965,7741,Kits,8,1,0.125,7
29966,7741,Stuff Packs,20,0,0.0,20
29967,7742,Expansion Packs,14,0,0.0,14
29968,7742,Game Packs,7,0,0.0,7
29969,7742,Kits,2,2,1.0,0
29970,7742,Stuff Packs,17,1,0.058823529411764705,16
29971,7743,Expansion Packs,16,0,0.0,16
29972,7743,Game Packs,12,0,0.0,12
29973,7743,Kits,11,1,0.09090909090909091,10
29974,7743,Stuff Packs,20,0,0.0,20
29975,7744,Expansion Packs,13,0,0.0,13
29976,7744,Game Packs,6,0,0.0,6
29977,7744,Kits,5,1,0.2,4
29978,7744,Stuff Packs,12,1,0.08333333333333333,11
29979,7745,Expansion Packs,16,0,0.0,16
29980,7745,Game Packs,11,0,0.0,11
29981,7745,Kits,6,0,0.0,6
29982,7745,Stuff Packs,17,1,0.058823529411764705,16
29983,7746,Expansion Packs,16,0,0.0,16
29984,7746,Game Packs,11,0,0.0,11
29985,7746,Kits,15,0,0.0,15
29986,7746,Stuff Packs,20,0,0.0,20
29987,7747,Expansion Packs,16,0,0.0,16
29988,7747,Game Packs,12,0,0.0,12
29989,7747,Kits,29,1,0.034482758620689655,28
29990,7747,Stuff Packs,20,1,0.05,19
29991,7748,Expansion Packs,10,0,0.0,10
29992,7748,Game Packs,5,0,0.0,5
29993,7748,Stuff Packs,6,1,0.16666666666666666,5
29994,7749,Expansion Packs,11,0,0.0,11
29995,7749,Game Packs,6,0,0.0,6
29996,7749,Kits,1,1,1.0,0
29997,7749,Stuff Packs,13,0,0.0,13
29998,7750,Expansion Packs,16,0,0.0,16
29999,7750,Game Packs,12,0,0.0,12
30000,7750,Kits,30,0,0.0,30
30001,7750,Stuff Packs,20,0,0.0,20
30002,7751,Expansion Packs,16,0,0.0,16
30003,7751,Game Packs,12,0,0.0,12
30004,7751,Kits,5,2,0.4,3
30005,7751,Stuff Packs,15,0,0.0,15
30006,7752,Expansion Packs,10,0,0.0,10
30007,7752,Game Packs,1,0,0.0,1
30008,7752,Kits,2,1,0.5,1
30009,7752,Stuff Packs,4,0,0.0,4
30010,7753,Expansion Packs,16,0,0.0,16
30011,7753,Game Packs,12,0,0.0,12
30012,7753,Kits,31,2,0.06451612903225806,29
30013,7753,Stuff Packs,20,0,0.0,20
30014,7754,Expansion Packs,10,0,0.0,10
30015,7754,Game Packs,4,0,0.0,4
30016,7754,Kits,7,2,0.2857142857142857,5
30017,7754,Stuff Packs,8,2,0.25,6
30018,7755,Expansion Packs,13,0,0.0,13
30019,7755,Game Packs,4,1,0.25,3
30020,7755,Kits,7,2,0.2857142857142857,5
30021,7755,Stuff Packs,11,3,0.2727272727272727,8
30022,7756,Expansion Packs,12,0,0.0,12
30023,7756,Game Packs,8,0,0.0,8
30024,7756,Kits,2,0,0.0,2
30025,7756,Stuff Packs,7,0,0.0,7
30026,7757,Expansion Packs,15,0,0.0,15
30027,7757,Game Packs,12,0,0.0,12
30028,7757,Kits,2,2,1.0,0
30029,7757,Stuff Packs,19,0,0.0,19
30030,7758,Expansion Packs,16,0,0.0,16
30031,7758,Game Packs,12,0,0.0,12
30032,7758,Kits,33,0,0.0,33
30033,7758,Stuff Packs,20,0,0.0,20
30034,7759,Expansion Packs,16,16,1.0,0
30035,7759,Game Packs,8,8,1.0,0
30036,7759,Kits,20,20,1.0,0
30037,7759,Stuff Packs,13,13,1.0,0
30038,7760,Expansion Packs,15,0,0.0,15
30039,7760,Game Packs,11,0,0.0,11
30040,7760,Kits,11,1,0.09090909090909091,10
30041,7760,Stuff Packs,14,2,0.14285714285714285,12
30042,7761,Expansion Packs,12,0,0.0,12
30043,7761,Game Packs,8,0,0.0,8
30044,7761,Kits,18,2,0.1111111111111111,16
30045,7761,Stuff Packs,15,3,0.2,12
30046,7762,Expansion Packs,15,0,0.0,15
30047,7762,Game Packs,12,0,0.0,12
30048,7762,Kits,6,0,0.0,6
30049,7762,Stuff Packs,20,0,0.0,20
30050,7763,Expansion Packs,15,0,0.0,15
30051,7763,Game Packs,9,0,0.0,9
30052,7763,Kits,5,1,0.2,4
30053,7763,Stuff Packs,14,1,0.07142857142857142,13
30054,7764,Expansion Packs,16,0,0.0,16
30055,7764,Game Packs,12,0,0.0,12
30056,7764,Kits,23,1,0.043478260869565216,22
30057,7764,Stuff Packs,20,0,0.0,20
30058,7765,Expansion Packs,15,0,0.0,15
30059,7765,Game Packs,9,0,0.0,9
30060,7765,Kits,4,0,0.0,4
30061,7765,Stuff Packs,11,0,0.0,11
30062,7766,Expansion Packs,13,0,0.0,13
30063,7766,Game Packs,4,0,0.0,4
30064,7766,Kits,2,2,1.0,0
30065,7766,Stuff Packs,4,3,0.75,1
30066,7767,Expansion Packs,3,0,0.0,3
30067,7767,Game Packs,2,0,0.0,2
30068,7767,Kits,1,1,1.0,0
30069,7768,Expansion Packs,16,0,0.0,16
30070,7768,Game Packs,11,0,0.0,11
30071,7768,Kits,22,1,0.045454545454545456,21
30072,7768,Stuff Packs,20,0,0.0,20
30073,7769,Expansion Packs,8,0,0.0,8
30074,7769,Game Packs,5,1,0.2,4
30075,7769,Kits,2,1,0.5,1
30076,7769,Stuff Packs,9,4,0.4444444444444444,5
30077,7770,Expansion Packs,9,0,0.0,9
30078,7770,Game Packs,5,0,0.0,5
30079,7770,Kits,3,1,0.3333333333333333,2
30080,7770,Stuff Packs,3,0,0.0,3
30081,7771,Expansion Packs,5,0,0.0,5
30082,7771,Game Packs,1,0,0.0,1
30083,7771,Kits,1,1,1.0,0
30084,7771,Stuff Packs,5,3,0.6,2
30085,7772,Expansion Packs,16,0,0.0,16
30086,7772,Game Packs,7,0,0.0,7
30087,7772,Kits,14,1,0.07142857142857142,13
30088,7772,Stuff Packs,14,1,0.07142857142857142,13
30089,7773,Expansion Packs,16,0,0.0,16
30090,7773,Game Packs,12,0,0.0,12
30091,7773,Kits,27,1,0.037037037037037035,26
30092,7773,Stuff Packs,20,0,0.0,20
30093,7774,Expansion Packs,11,0,0.0,11
30094,7774,Game Packs,9,0,0.0,9
30095,7774,Stuff Packs,14,0,0.0,14
30096,7775,Expansion Packs,9,0,0.0,9
30097,7775,Game Packs,3,0,0.0,3
30098,7775,Kits,1,0,0.0,1
30099,7775,Stuff Packs,6,0,0.0,6
30100,7776,Expansion Packs,15,0,0.0,15
30101,7776,Game Packs,12,0,0.0,12
30102,7776,Kits,18,1,0.05555555555555555,17
30103,7776,Stuff Packs,16,1,0.0625,15
30104,7777,Expansion Packs,15,0,0.0,15
30105,7777,Game Packs,10,0,0.0,10
30106,7777,Kits,4,2,0.5,2
30107,7777,Stuff Packs,5,1,0.2,4
30108,7778,Expansion Packs,13,0,0.0,13
30109,7778,Game Packs,6,0,0.0,6
30110,7778,Kits,1,1,1.0,0
30111,7778,Stuff Packs,6,3,0.5,3
30112,7779,Expansion Packs,14,0,0.0,14
30113,7779,Game Packs,9,0,0.0,9
30114,7779,Kits,2,2,1.0,0
30115,7779,Stuff Packs,15,0,0.0,15
30116,7780,Expansion Packs,16,0,0.0,16
30117,7780,Game Packs,12,1,0.08333333333333333,11
30118,7780,Kits,33,2,0.06060606060606061,31
30119,7780,Stuff Packs,20,3,0.15,17
30120,7781,Expansion Packs,16,0,0.0,16
30121,7781,Game Packs,11,0,0.0,11
30122,7781,Kits,33,1,0.030303030303030304,32
30123,7781,Stuff Packs,18,0,0.0,18
30124,7782,Expansion Packs,16,0,0.0,16
30125,7782,Game Packs,12,0,0.0,12
30126,7782,Kits,29,1,0.034482758620689655,28
30127,7782,Stuff Packs,20,0,0.0,20
30128,7783,Expansion Packs,16,0,0.0,16
30129,7783,Game Packs,10,0,0.0,10
30130,7783,Kits,9,1,0.1111111111111111,8
30131,7783,Stuff Packs,20,1,0.05,19
30132,7784,Expansion Packs,13,0,0.0,13
30133,7784,Game Packs,10,0,0.0,10
30134,7784,Kits,8,1,0.125,7
30135,7784,Stuff Packs,17,0,0.0,17
30136,7785,Expansion Packs,12,1,0.08333333333333333,11
30137,7785,Game Packs,4,0,0.0,4
30138,7785,Kits,2,2,1.0,0
30139,7785,Stuff Packs,7,2,0.2857142857142857,5
30140,7786,Expansion Packs,15,0,0.0,15
30141,7786,Game Packs,9,0,0.0,9
30142,7786,Kits,2,2,1.0,0
30143,7786,Stuff Packs,10,1,0.1,9
30144,7787,Expansion Packs,16,0,0.0,16
30145,7787,Game Packs,12,0,0.0,12
30146,7787,Kits,33,0,0.0,33
30147,7787,Stuff Packs,20,0,0.0,20
30148,7788,Expansion Packs,15,0,0.0,15
30149,7788,Game Packs,8,0,0.0,8
30150,7788,Kits,14,2,0.14285714285714285,12
30151,7788,Stuff Packs,18,2,0.1111111111111111,16
30152,7789,Expansion Packs,10,0,0.0,10
30153,7789,Game Packs,5,0,0.0,5
30154,7789,Kits,1,1,1.0,0
30155,7789,Stuff Packs,5,0,0.0,5
30156,7790,Expansion Packs,14,0,0.0,14
30157,7790,Game Packs,4,0,0.0,4
30158,7790,Kits,3,2,0.6666666666666666,1
30159,7790,Stuff Packs,8,3,0.375,5
30160,7791,Expansion Packs,2,0,0.0,2
30161,7791,Game Packs,2,0,0.0,2
30162,7791,Kits,1,1,1.0,0
30163,7791,Stuff Packs,4,2,0.5,2
30164,7792,Expansion Packs,14,0,0.0,14
30165,7792,Game Packs,5,0,0.0,5
30166,7792,Kits,8,3,0.375,5
30167,7792,Stuff Packs,12,1,0.08333333333333333,11
30168,7793,Expansion Packs,16,0,0.0,16
30169,7793,Game Packs,12,0,0.0,12
30170,7793,Kits,24,0,0.0,24
30171,7793,Stuff Packs,19,0,0.0,19
30172,7794,Expansion Packs,9,0,0.0,9
30173,7794,Game Packs,5,0,0.0,5
30174,7794,Kits,4,2,0.5,2
30175,7794,Stuff Packs,7,3,0.42857142857142855,4
30176,7795,Expansion Packs,16,0,0.0,16
30177,7795,Game Packs,12,0,0.0,12
30178,7795,Kits,33,0,0.0,33
30179,7795,Stuff Packs,20,0,0.0,20
30180,7796,Expansion Packs,9,0,0.0,9
30181,7796,Game Packs,6,0,0.0,6
30182,7796,Kits,5,1,0.2,4
30183,7796,Stuff Packs,7,2,0.2857142857142857,5
30184,7797,Expansion Packs,14,0,0.0,14
30185,7797,Game Packs,10,0,0.0,10
30186,7797,Kits,10,3,0.3,7
30187,7797,Stuff Packs,19,1,0.05263157894736842,18
30188,7798,Expansion Packs,11,0,0.0,11
30189,7798,Game Packs,3,0,0.0,3
30190,7798,Kits,1,1,1.0,0
30191,7798,Stuff Packs,5,1,0.2,4
30192,7799,Expansion Packs,16,0,0.0,16
30193,7799,Game Packs,11,0,0.0,11
30194,7799,Kits,14,1,0.07142857142857142,13
30195,7799,Stuff Packs,12,1,0.08333333333333333,11
30196,7800,Expansion Packs,8,0,0.0,8
30197,7800,Game Packs,6,0,0.0,6
30198,7800,Kits,1,1,1.0,0
30199,7800,Stuff Packs,9,3,0.3333333333333333,6
30200,7801,Expansion Packs,11,0,0.0,11
30201,7801,Game Packs,3,1,0.3333333333333333,2
30202,7801,Kits,5,3,0.6,2
30203,7801,Stuff Packs,4,3,0.75,1
30204,7802,Expansion Packs,12,0,0.0,12
30205,7802,Game Packs,9,0,0.0,9
30206,7802,Kits,2,2,1.0,0
30207,7802,Stuff Packs,11,2,0.18181818181818182,9
30208,7803,Expansion Packs,15,0,0.0,15
30209,7803,Game Packs,12,0,0.0,12
30210,7803,Kits,18,1,0.05555555555555555,17
30211,7803,Stuff Packs,20,0,0.0,20
30212,7804,Expansion Packs,16,0,0.0,16
30213,7804,Game Packs,12,0,0.0,12
30214,7804,Kits,33,0,0.0,33
30215,7804,Stuff Packs,20,0,0.0,20
30216,7805,Expansion Packs,5,1,0.2,4
30217,7805,Game Packs,5,0,0.0,5
30218,7805,Kits,7,0,0.0,7
30219,7805,Stuff Packs,3,0,0.0,3
30220,7806,Expansion Packs,16,0,0.0,16
30221,7806,Game Packs,9,1,0.1111111111111111,8
30222,7806,Kits,11,1,0.09090909090909091,10
30223,7806,Stuff Packs,13,0,0.0,13
30224,7807,Expansion Packs,16,0,0.0,16
30225,7807,Game Packs,6,1,0.16666666666666666,5
30226,7807,Kits,9,2,0.2222222222222222,7
30227,7807,Stuff Packs,11,2,0.18181818181818182,9
30228,7808,Expansion Packs,6,0,0.0,6
30229,7808,Game Packs,2,0,0.0,2
30230,7808,Kits,1,1,1.0,0
30231,7808,Stuff Packs,3,1,0.3333333333333333,2
30232,7809,Expansion Packs,16,2,0.125,14
30233,7809,Game Packs,12,0,0.0,12
30234,7809,Kits,33,0,0.0,33
30235,7809,Stuff Packs,20,2,0.1,18
30236,7810,Expansion Packs,9,0,0.0,9
30237,7810,Game Packs,8,0,0.0,8
30238,7810,Kits,2,2,1.0,0
30239,7810,Stuff Packs,14,3,0.21428571428571427,11
30240,7811,Expansion Packs,16,0,0.0,16
30241,7811,Game Packs,11,0,0.0,11
30242,7811,Kits,22,1,0.045454545454545456,21
30243,7811,Stuff Packs,19,1,0.05263157894736842,18
30244,7812,Expansion Packs,15,0,0.0,15
30245,7812,Game Packs,11,0,0.0,11
30246,7812,Kits,4,1,0.25,3
30247,7812,Stuff Packs,17,1,0.058823529411764705,16
30248,7813,Expansion Packs,14,0,0.0,14
30249,7813,Game Packs,5,0,0.0,5
30250,7813,Kits,6,0,0.0,6
30251,7813,Stuff Packs,12,2,0.16666666666666666,10
30252,7814,Expansion Packs,7,0,0.0,7
30253,7814,Game Packs,3,0,0.0,3
30254,7814,Kits,1,1,1.0,0
30255,7814,Stuff Packs,6,3,0.5,3
30256,7815,Expansion Packs,2,1,0.5,1
30257,7815,Kits,1,1,1.0,0
30258,7815,Stuff Packs,4,4,1.0,0
30259,7816,Expansion Packs,14,0,0.0,14
30260,7816,Game Packs,10,0,0.0,10
30261,7816,Kits,8,0,0.0,8
30262,7816,Stuff Packs,19,1,0.05263157894736842,18
30263,7817,Expansion Packs,16,0,0.0,16
30264,7817,Game Packs,11,0,0.0,11
30265,7817,Kits,4,0,0.0,4
30266,7817,Stuff Packs,14,1,0.07142857142857142,13
30267,7818,Expansion Packs,13,0,0.0,13
30268,7818,Game Packs,10,0,0.0,10
30269,7818,Kits,4,1,0.25,3
30270,7818,Stuff Packs,15,0,0.0,15
30271,7819,Expansion Packs,16,0,0.0,16
30272,7819,Game Packs,10,0,0.0,10
30273,7819,Kits,5,0,0.0,5
30274,7819,Stuff Packs,19,0,0.0,19
30275,7820,Expansion Packs,14,0,0.0,14
30276,7820,Game Packs,11,0,0.0,11
30277,7820,Kits,8,2,0.25,6
30278,7820,Stuff Packs,18,0,0.0,18
30279,7821,Expansion Packs,16,0,0.0,16
30280,7821,Game Packs,11,0,0.0,11
30281,7821,Kits,7,1,0.14285714285714285,6
30282,7821,Stuff Packs,20,0,0.0,20
30283,7822,Expansion Packs,11,0,0.0,11
30284,7822,Game Packs,6,1,0.16666666666666666,5
30285,7822,Kits,9,3,0.3333333333333333,6
30286,7822,Stuff Packs,8,3,0.375,5
30287,7823,Expansion Packs,6,0,0.0,6
30288,7823,Game Packs,2,0,0.0,2
30289,7823,Kits,2,1,0.5,1
30290,7823,Stuff Packs,2,0,0.0,2
30291,7824,Expansion Packs,16,0,0.0,16
30292,7824,Game Packs,11,0,0.0,11
30293,7824,Kits,29,0,0.0,29
30294,7824,Stuff Packs,19,0,0.0,19
30295,7825,Expansion Packs,11,0,0.0,11
30296,7825,Game Packs,4,0,0.0,4
30297,7825,Kits,8,1,0.125,7
30298,7825,Stuff Packs,7,1,0.14285714285714285,6
30299,7826,Expansion Packs,9,0,0.0,9
30300,7826,Game Packs,1,0,0.0,1
30301,7826,Kits,1,1,1.0,0
30302,7826,Stuff Packs,5,1,0.2,4
30303,7827,Expansion Packs,16,0,0.0,16
30304,7827,Game Packs,11,0,0.0,11
30305,7827,Kits,31,17,0.5483870967741935,14
30306,7827,Stuff Packs,19,0,0.0,19
30307,7828,Expansion Packs,16,0,0.0,16
30308,7828,Game Packs,12,0,0.0,12
30309,7828,Kits,33,0,0.0,33
30310,7828,Stuff Packs,20,0,0.0,20
30311,7829,Expansion Packs,14,0,0.0,14
30312,7829,Game Packs,8,0,0.0,8
30313,7829,Kits,1,1,1.0,0
30314,7829,Stuff Packs,12,3,0.25,9
30315,7830,Expansion Packs,16,0,0.0,16
30316,7830,Game Packs,12,0,0.0,12
30317,7830,Kits,10,1,0.1,9
30318,7830,Stuff Packs,18,0,0.0,18
30319,7831,Expansion Packs,13,0,0.0,13
30320,7831,Game Packs,7,0,0.0,7
30321,7831,Kits,5,1,0.2,4
30322,7831,Stuff Packs,8,2,0.25,6
30323,7832,Expansion Packs,16,0,0.0,16
30324,7832,Game Packs,12,0,0.0,12
30325,7832,Kits,33,1,0.030303030303030304,32
30326,7832,Stuff Packs,20,0,0.0,20
30327,7833,Expansion Packs,10,0,0.0,10
30328,7833,Game Packs,3,0,0.0,3
30329,7833,Stuff Packs,6,3,0.5,3
30330,7834,Expansion Packs,4,0,0.0,4
30331,7834,Game Packs,2,0,0.0,2
30332,7834,Kits,2,0,0.0,2
30333,7834,Stuff Packs,5,3,0.6,2
30334,7835,Expansion Packs,16,0,0.0,16
30335,7835,Game Packs,12,0,0.0,12
30336,7835,Kits,33,0,0.0,33
30337,7835,Stuff Packs,20,0,0.0,20
30338,7836,Expansion Packs,11,0,0.0,11
30339,7836,Game Packs,5,1,0.2,4
30340,7836,Kits,1,1,1.0,0
30341,7836,Stuff Packs,5,1,0.2,4
30342,7837,Expansion Packs,15,0,0.0,15
30343,7837,Game Packs,12,0,0.0,12
30344,7837,Kits,20,2,0.1,18
30345,7837,Stuff Packs,20,0,0.0,20
30346,7838,Expansion Packs,16,0,0.0,16
30347,7838,Game Packs,6,0,0.0,6
30348,7838,Kits,16,0,0.0,16
30349,7838,Stuff Packs,14,0,0.0,14
30350,7839,Expansion Packs,16,0,0.0,16
30351,7839,Game Packs,12,0,0.0,12
30352,7839,Kits,33,1,0.030303030303030304,32
30353,7839,Stuff Packs,20,0,0.0,20
30354,7840,Expansion Packs,13,0,0.0,13
30355,7840,Game Packs,11,0,0.0,11
30356,7840,Kits,4,2,0.5,2
30357,7840,Stuff Packs,9,3,0.3333333333333333,6
30358,7841,Expansion Packs,14,0,0.0,14
30359,7841,Game Packs,11,0,0.0,11
30360,7841,Kits,7,2,0.2857142857142857,5
30361,7841,Stuff Packs,19,1,0.05263157894736842,18
30362,7842,Expansion Packs,15,0,0.0,15
30363,7842,Game Packs,12,0,0.0,12
30364,7842,Kits,25,1,0.04,24
30365,7842,Stuff Packs,19,0,0.0,19
30366,7843,Expansion Packs,16,0,0.0,16
30367,7843,Game Packs,12,0,0.0,12
30368,7843,Kits,28,1,0.03571428571428571,27
30369,7843,Stuff Packs,20,0,0.0,20
30370,7844,Expansion Packs,13,0,0.0,13
30371,7844,Game Packs,4,0,0.0,4
30372,7844,Kits,2,0,0.0,2
30373,7844,Stuff Packs,9,0,0.0,9
30374,7845,Expansion Packs,3,0,0.0,3
30375,7845,Game Packs,3,0,0.0,3
30376,7845,Stuff Packs,5,0,0.0,5
30377,7846,Expansion Packs,14,0,0.0,14
30378,7846,Game Packs,12,0,0.0,12
30379,7846,Kits,8,1,0.125,7
30380,7846,Stuff Packs,19,0,0.0,19
30381,7847,Expansion Packs,7,0,0.0,7
30382,7847,Game Packs,3,0,0.0,3
30383,7847,Kits,2,2,1.0,0
30384,7847,Stuff Packs,8,3,0.375,5
30385,7848,Expansion Packs,10,0,0.0,10
30386,7848,Game Packs,6,1,0.16666666666666666,5
30387,7848,Stuff Packs,5,2,0.4,3
30388,7849,Expansion Packs,16,0,0.0,16
30389,7849,Game Packs,11,2,0.18181818181818182,9
30390,7849,Kits,14,2,0.14285714285714285,12
30391,7849,Stuff Packs,16,4,0.25,12
30392,7850,Expansion Packs,1,1,1.0,0
30393,7850,Stuff Packs,1,0,0.0,1
30394,7851,Expansion Packs,12,0,0.0,12
30395,7851,Game Packs,6,1,0.16666666666666666,5
30396,7851,Kits,3,2,0.6666666666666666,1
30397,7851,Stuff Packs,12,3,0.25,9
30398,7852,Expansion Packs,16,0,0.0,16
30399,7852,Game Packs,12,0,0.0,12
30400,7852,Kits,32,0,0.0,32
30401,7852,Stuff Packs,20,0,0.0,20
30402,7853,Expansion Packs,7,0,0.0,7
30403,7853,Game Packs,3,1,0.3333333333333333,2
30404,7853,Kits,3,3,1.0,0
30405,7853,Stuff Packs,5,4,0.8,1
30406,7854,Expansion Packs,15,0,0.0,15
30407,7854,Game Packs,10,0,0.0,10
30408,7854,Kits,14,0,0.0,14
30409,7854,Stuff Packs,19,0,0.0,19
30410,7855,Expansion Packs,16,0,0.0,16
30411,7855,Game Packs,12,0,0.0,12
30412,7855,Kits,32,1,0.03125,31
30413,7855,Stuff Packs,20,0,0.0,20
30414,7856,Expansion Packs,14,0,0.0,14
30415,7856,Game Packs,5,0,0.0,5
30416,7856,Kits,10,1,0.1,9
30417,7856,Stuff Packs,9,2,0.2222222222222222,7
30418,7857,Expansion Packs,16,0,0.0,16
30419,7857,Game Packs,12,0,0.0,12
30420,7857,Kits,33,1,0.030303030303030304,32
30421,7857,Stuff Packs,20,2,0.1,18
30422,7858,Expansion Packs,5,0,0.0,5
30423,7858,Kits,1,1,1.0,0
30424,7858,Stuff Packs,3,3,1.0,0
30425,7859,Expansion Packs,16,0,0.0,16
30426,7859,Game Packs,7,0,0.0,7
30427,7859,Kits,9,1,0.1111111111111111,8
30428,7859,Stuff Packs,12,1,0.08333333333333333,11
30429,7860,Expansion Packs,8,0,0.0,8
30430,7860,Game Packs,6,0,0.0,6
30431,7860,Kits,2,1,0.5,1
30432,7860,Stuff Packs,8,0,0.0,8
30433,7861,Expansion Packs,15,0,0.0,15
30434,7861,Game Packs,11,0,0.0,11
30435,7861,Kits,13,1,0.07692307692307693,12
30436,7861,Stuff Packs,12,1,0.08333333333333333,11
30437,7862,Expansion Packs,11,0,0.0,11
30438,7862,Game Packs,5,0,0.0,5
30439,7862,Kits,1,1,1.0,0
30440,7862,Stuff Packs,7,0,0.0,7
30441,7863,Expansion Packs,16,0,0.0,16
30442,7863,Game Packs,12,0,0.0,12
30443,7863,Kits,32,0,0.0,32
30444,7863,Stuff Packs,20,0,0.0,20
30445,7864,Expansion Packs,16,0,0.0,16
30446,7864,Game Packs,11,0,0.0,11
30447,7864,Kits,32,0,0.0,32
30448,7864,Stuff Packs,20,0,0.0,20
30449,7865,Expansion Packs,11,0,0.0,11
30450,7865,Game Packs,7,0,0.0,7
30451,7865,Kits,2,0,0.0,2
30452,7865,Stuff Packs,8,0,0.0,8
30453,7866,Expansion Packs,10,0,0.0,10
30454,7866,Game Packs,5,0,0.0,5
30455,7866,Kits,1,1,1.0,0
30456,7866,Stuff Packs,8,3,0.375,5
30457,7867,Expansion Packs,16,0,0.0,16
30458,7867,Game Packs,12,0,0.0,12
30459,7867,Kits,33,0,0.0,33
30460,7867,Stuff Packs,20,0,0.0,20
30461,7868,Expansion Packs,13,0,0.0,13
30462,7868,Game Packs,10,0,0.0,10
30463,7868,Kits,3,3,1.0,0
30464,7868,Stuff Packs,10,3,0.3,7
30465,7869,Expansion Packs,16,0,0.0,16
30466,7869,Game Packs,10,0,0.0,10
30467,7869,Kits,18,0,0.0,18
30468,7869,Stuff Packs,15,1,0.06666666666666667,14
30469,7870,Expansion Packs,16,1,0.0625,15
30470,7870,Game Packs,11,2,0.18181818181818182,9
30471,7870,Kits,16,1,0.0625,15
30472,7870,Stuff Packs,19,5,0.2631578947368421,14
30473,7871,Expansion Packs,16,0,0.0,16
30474,7871,Game Packs,11,0,0.0,11
30475,7871,Kits,15,1,0.06666666666666667,14
30476,7871,Stuff Packs,17,1,0.058823529411764705,16
30477,7872,Expansion Packs,16,0,0.0,16
30478,7872,Game Packs,10,0,0.0,10
30479,7872,Kits,6,2,0.3333333333333333,4
30480,7872,Stuff Packs,15,2,0.13333333333333333,13
30481,7873,Expansion Packs,16,0,0.0,16
30482,7873,Game Packs,11,0,0.0,11
30483,7873,Kits,11,0,0.0,11
30484,7873,Stuff Packs,19,0,0.0,19
30485,7874,Expansion Packs,10,0,0.0,10
30486,7874,Game Packs,8,0,0.0,8
30487,7874,Stuff Packs,2,0,0.0,2
30488,7875,Expansion Packs,15,0,0.0,15
30489,7875,Game Packs,6,0,0.0,6
30490,7875,Kits,6,1,0.16666666666666666,5
30491,7875,Stuff Packs,10,2,0.2,8
30492,7876,Expansion Packs,5,1,0.2,4
30493,7876,Game Packs,2,0,0.0,2
30494,7876,Kits,13,1,0.07692307692307693,12
30495,7876,Stuff Packs,6,1,0.16666666666666666,5
30496,7877,Expansion Packs,16,0,0.0,16
30497,7877,Game Packs,12,0,0.0,12
30498,7877,Kits,33,0,0.0,33
30499,7877,Stuff Packs,20,0,0.0,20
30500,7878,Expansion Packs,14,0,0.0,14
30501,7878,Game Packs,8,0,0.0,8
30502,7878,Kits,2,2,1.0,0
30503,7878,Stuff Packs,9,2,0.2222222222222222,7
30504,7879,Expansion Packs,5,0,0.0,5
30505,7879,Game Packs,2,0,0.0,2
30506,7879,Kits,4,0,0.0,4
30507,7879,Stuff Packs,3,0,0.0,3
30508,7880,Expansion Packs,13,0,0.0,13
30509,7880,Game Packs,10,0,0.0,10
30510,7880,Kits,6,1,0.16666666666666666,5
30511,7880,Stuff Packs,13,1,0.07692307692307693,12
30512,7881,Expansion Packs,4,0,0.0,4
30513,7881,Game Packs,2,0,0.0,2
30514,7881,Stuff Packs,5,0,0.0,5
30515,7882,Expansion Packs,13,0,0.0,13
30516,7882,Game Packs,10,0,0.0,10
30517,7882,Kits,4,2,0.5,2
30518,7882,Stuff Packs,13,1,0.07692307692307693,12
30519,7883,Expansion Packs,16,10,0.625,6
30520,7883,Game Packs,12,6,0.5,6
30521,7883,Kits,25,15,0.6,10
30522,7883,Stuff Packs,19,5,0.2631578947368421,14
30523,7884,Expansion Packs,7,0,0.0,7
30524,7884,Game Packs,3,0,0.0,3
30525,7884,Kits,1,1,1.0,0
30526,7884,Stuff Packs,7,3,0.42857142857142855,4
30527,7885,Expansion Packs,15,0,0.0,15
30528,7885,Game Packs,12,0,0.0,12
30529,7885,Kits,8,2,0.25,6
30530,7885,Stuff Packs,16,2,0.125,14
30531,7886,Expansion Packs,16,0,0.0,16
30532,7886,Game Packs,12,0,0.0,12
30533,7886,Kits,20,1,0.05,19
30534,7886,Stuff Packs,20,0,0.0,20
30535,7887,Expansion Packs,16,0,0.0,16
30536,7887,Game Packs,12,0,0.0,12
30537,7887,Kits,33,0,0.0,33
30538,7887,Stuff Packs,20,0,0.0,20
30539,7888,Expansion Packs,15,0,0.0,15
30540,7888,Game Packs,11,0,0.0,11
30541,7888,Kits,16,0,0.0,16
30542,7888,Stuff Packs,18,1,0.05555555555555555,17
30543,7889,Expansion Packs,14,0,0.0,14
30544,7889,Game Packs,7,0,0.0,7
30545,7889,Kits,3,2,0.6666666666666666,1
30546,7889,Stuff Packs,13,0,0.0,13
30547,7890,Expansion Packs,16,0,0.0,16
30548,7890,Game Packs,12,0,0.0,12
30549,7890,Kits,15,0,0.0,15
30550,7890,Stuff Packs,20,0,0.0,20
30551,7891,Expansion Packs,11,0,0.0,11
30552,7891,Game Packs,5,0,0.0,5
30553,7891,Kits,1,1,1.0,0
30554,7891,Stuff Packs,9,0,0.0,9
30555,7892,Expansion Packs,4,0,0.0,4
30556,7892,Game Packs,3,0,0.0,3
30557,7892,Stuff Packs,2,2,1.0,0
30558,7893,Expansion Packs,16,1,0.0625,15
30559,7893,Kits,17,0,0.0,17
30560,7893,Stuff Packs,16,0,0.0,16
30561,7894,Expansion Packs,13,0,0.0,13
30562,7894,Game Packs,7,0,0.0,7
30563,7894,Kits,11,0,0.0,11
30564,7894,Stuff Packs,10,0,0.0,10
30565,7895,Expansion Packs,14,0,0.0,14
30566,7895,Game Packs,10,0,0.0,10
30567,7895,Kits,8,2,0.25,6
30568,7895,Stuff Packs,12,1,0.08333333333333333,11
30569,7896,Expansion Packs,13,0,0.0,13
30570,7896,Game Packs,10,0,0.0,10
30571,7896,Kits,1,0,0.0,1
30572,7896,Stuff Packs,19,0,0.0,19
30573,7897,Expansion Packs,3,0,0.0,3
30574,7897,Game Packs,2,1,0.5,1
30575,7897,Kits,3,3,1.0,0
30576,7897,Stuff Packs,5,4,0.8,1
30577,7898,Expansion Packs,14,0,0.0,14
30578,7898,Game Packs,12,0,0.0,12
30579,7898,Kits,19,0,0.0,19
30580,7898,Stuff Packs,19,0,0.0,19
30581,7899,Expansion Packs,16,2,0.125,14
30582,7899,Game Packs,12,0,0.0,12
30583,7899,Kits,25,10,0.4,15
30584,7899,Stuff Packs,20,1,0.05,19
30585,7900,Expansion Packs,14,0,0.0,14
30586,7900,Game Packs,7,0,0.0,7
30587,7900,Stuff Packs,13,1,0.07692307692307693,12
30588,7901,Expansion Packs,16,0,0.0,16
30589,7901,Game Packs,11,0,0.0,11
30590,7901,Kits,20,1,0.05,19
30591,7901,Stuff Packs,20,1,0.05,19
30592,7902,Expansion Packs,14,0,0.0,14
30593,7902,Game Packs,12,0,0.0,12
30594,7902,Kits,18,1,0.05555555555555555,17
30595,7902,Stuff Packs,15,1,0.06666666666666667,14
30596,7903,Expansion Packs,14,0,0.0,14
30597,7903,Game Packs,9,0,0.0,9
30598,7903,Kits,7,2,0.2857142857142857,5
30599,7903,Stuff Packs,13,1,0.07692307692307693,12
30600,7904,Expansion Packs,11,0,0.0,11
30601,7904,Game Packs,3,0,0.0,3
30602,7904,Kits,4,1,0.25,3
30603,7904,Stuff Packs,7,3,0.42857142857142855,4
30604,7905,Expansion Packs,5,1,0.2,4
30605,7905,Game Packs,3,0,0.0,3
30606,7905,Stuff Packs,3,2,0.6666666666666666,1
30607,7906,Expansion Packs,14,0,0.0,14
30608,7906,Game Packs,7,0,0.0,7
30609,7906,Kits,4,0,0.0,4
30610,7906,Stuff Packs,8,0,0.0,8
30611,7907,Expansion Packs,15,0,0.0,15
30612,7907,Game Packs,8,0,0.0,8
30613,7907,Kits,2,2,1.0,0
30614,7907,Stuff Packs,10,3,0.3,7
30615,7908,Expansion Packs,13,0,0.0,13
30616,7908,Game Packs,6,1,0.16666666666666666,5
30617,7908,Kits,5,0,0.0,5
30618,7908,Stuff Packs,7,3,0.42857142857142855,4
30619,7909,Expansion Packs,13,0,0.0,13
30620,7909,Game Packs,5,0,0.0,5
30621,7909,Kits,21,0,0.0,21
30622,7909,Stuff Packs,7,0,0.0,7
30623,7910,Expansion Packs,12,0,0.0,12
30624,7910,Game Packs,5,0,0.0,5
30625,7910,Kits,5,1,0.2,4
30626,7910,Stuff Packs,6,1,0.16666666666666666,5
30627,7911,Expansion Packs,11,0,0.0,11
30628,7911,Game Packs,8,0,0.0,8
30629,7911,Kits,3,1,0.3333333333333333,2
30630,7911,Stuff Packs,10,3,0.3,7
30631,7912,Expansion Packs,15,0,0.0,15
30632,7912,Game Packs,11,0,0.0,11
30633,7912,Kits,11,1,0.09090909090909091,10
30634,7912,Stuff Packs,17,1,0.058823529411764705,16
30635,7913,Expansion Packs,13,0,0.0,13
30636,7913,Game Packs,6,0,0.0,6
30637,7913,Kits,1,0,0.0,1
30638,7913,Stuff Packs,4,2,0.5,2
30639,7914,Expansion Packs,11,0,0.0,11
30640,7914,Game Packs,3,0,0.0,3
30641,7914,Kits,6,0,0.0,6
30642,7914,Stuff Packs,8,2,0.25,6
30643,7915,Expansion Packs,6,0,0.0,6
30644,7915,Game Packs,4,1,0.25,3
30645,7915,Kits,3,3,1.0,0
30646,7915,Stuff Packs,7,4,0.5714285714285714,3
30647,7916,Expansion Packs,15,0,0.0,15
30648,7916,Game Packs,11,0,0.0,11
30649,7916,Kits,15,2,0.13333333333333333,13
30650,7916,Stuff Packs,20,0,0.0,20
30651,7917,Expansion Packs,15,0,0.0,15
30652,7917,Game Packs,9,0,0.0,9
30653,7917,Kits,16,0,0.0,16
30654,7917,Stuff Packs,20,0,0.0,20
30655,7918,Expansion Packs,12,0,0.0,12
30656,7918,Game Packs,5,0,0.0,5
30657,7918,Kits,9,1,0.1111111111111111,8
30658,7918,Stuff Packs,10,2,0.2,8
30659,7919,Expansion Packs,7,0,0.0,7
30660,7919,Game Packs,5,0,0.0,5
30661,7919,Kits,2,2,1.0,0
30662,7919,Stuff Packs,6,2,0.3333333333333333,4
30663,7920,Expansion Packs,16,0,0.0,16
30664,7920,Game Packs,8,1,0.125,7
30665,7920,Kits,17,1,0.058823529411764705,16
30666,7920,Stuff Packs,11,4,0.36363636363636365,7
30667,7921,Expansion Packs,14,0,0.0,14
30668,7921,Game Packs,10,0,0.0,10
30669,7921,Kits,5,0,0.0,5
30670,7921,Stuff Packs,14,3,0.21428571428571427,11
30671,7922,Expansion Packs,16,2,0.125,14
30672,7922,Game Packs,12,4,0.3333333333333333,8
30673,7922,Kits,32,3,0.09375,29
30674,7922,Stuff Packs,19,1,0.05263157894736842,18
30675,7923,Expansion Packs,15,0,0.0,15
30676,7923,Game Packs,11,0,0.0,11
30677,7923,Kits,14,0,0.0,14
30678,7923,Stuff Packs,16,0,0.0,16
30679,7924,Expansion Packs,13,0,0.0,13
30680,7924,Game Packs,11,0,0.0,11
30681,7924,Kits,6,2,0.3333333333333333,4
30682,7924,Stuff Packs,16,1,0.0625,15
30683,7925,Expansion Packs,16,0,0.0,16
30684,7925,Game Packs,11,0,0.0,11
30685,7925,Kits,18,2,0.1111111111111111,16
30686,7925,Stuff Packs,20,0,0.0,20
30687,7926,Expansion Packs,16,0,0.0,16
30688,7926,Game Packs,9,0,0.0,9
30689,7926,Kits,21,0,0.0,21
30690,7926,Stuff Packs,19,0,0.0,19
30691,7927,Expansion Packs,16,0,0.0,16
30692,7927,Game Packs,11,0,0.0,11
30693,7927,Kits,33,1,0.030303030303030304,32
30694,7927,Stuff Packs,20,0,0.0,20
30695,7928,Expansion Packs,6,0,0.0,6
30696,7928,Game Packs,3,0,0.0,3
30697,7928,Stuff Packs,1,0,0.0,1
30698,7929,Expansion Packs,16,0,0.0,16
30699,7929,Game Packs,8,0,0.0,8
30700,7929,Kits,28,0,0.0,28
30701,7929,Stuff Packs,20,0,0.0,20
30702,7930,Expansion Packs,16,0,0.0,16
30703,7930,Game Packs,11,0,0.0,11
30704,7930,Kits,3,0,0.0,3
30705,7930,Stuff Packs,16,0,0.0,16
30706,7931,Expansion Packs,15,0,0.0,15
30707,7931,Game Packs,11,0,0.0,11
30708,7931,Kits,7,0,0.0,7
30709,7931,Stuff Packs,18,0,0.0,18
30710,7932,Expansion Packs,9,0,0.0,9
30711,7932,Game Packs,4,0,0.0,4
30712,7932,Kits,3,0,0.0,3
30713,7932,Stuff Packs,4,0,0.0,4
30714,7933,Expansion Packs,9,3,0.3333333333333333,6
30715,7933,Game Packs,4,4,1.0,0
30716,7933,Kits,10,10,1.0,0
30717,7933,Stuff Packs,9,8,0.8888888888888888,1
30718,7934,Expansion Packs,8,0,0.0,8
30719,7934,Game Packs,5,0,0.0,5
30720,7934,Stuff Packs,7,2,0.2857142857142857,5
30721,7935,Expansion Packs,12,0,0.0,12
30722,7935,Game Packs,4,0,0.0,4
30723,7935,Kits,5,0,0.0,5
30724,7935,Stuff Packs,5,0,0.0,5
30725,7936,Expansion Packs,16,1,0.0625,15
30726,7936,Game Packs,12,0,0.0,12
30727,7936,Kits,33,2,0.06060606060606061,31
30728,7936,Stuff Packs,20,0,0.0,20
30729,7937,Expansion Packs,16,0,0.0,16
30730,7937,Game Packs,12,0,0.0,12
30731,7937,Kits,32,1,0.03125,31
30732,7937,Stuff Packs,20,0,0.0,20
30733,7938,Expansion Packs,15,0,0.0,15
30734,7938,Game Packs,10,0,0.0,10
30735,7938,Kits,24,0,0.0,24
30736,7938,Stuff Packs,20,0,0.0,20
30737,7939,Expansion Packs,10,0,0.0,10
30738,7939,Game Packs,5,0,0.0,5
30739,7939,Kits,2,2,1.0,0
30740,7939,Stuff Packs,7,2,0.2857142857142857,5
30741,7940,Expansion Packs,3,0,0.0,3
30742,7940,Game Packs,1,0,0.0,1
30743,7940,Kits,4,0,0.0,4
30744,7940,Stuff Packs,4,1,0.25,3
30745,7941,Expansion Packs,16,0,0.0,16
30746,7941,Game Packs,12,0,0.0,12
30747,7941,Kits,33,1,0.030303030303030304,32
30748,7941,Stuff Packs,20,2,0.1,18
30749,7942,Expansion Packs,15,0,0.0,15
30750,7942,Game Packs,7,0,0.0,7
30751,7942,Kits,2,1,0.5,1
30752,7942,Stuff Packs,13,0,0.0,13
30753,7943,Expansion Packs,12,0,0.0,12
30754,7943,Game Packs,7,0,0.0,7
30755,7943,Stuff Packs,10,0,0.0,10
30756,7944,Expansion Packs,14,0,0.0,14
30757,7944,Game Packs,5,0,0.0,5
30758,7944,Kits,16,3,0.1875,13
30759,7944,Stuff Packs,12,3,0.25,9
30760,7945,Expansion Packs,16,0,0.0,16
30761,7945,Game Packs,6,0,0.0,6
30762,7945,Kits,4,1,0.25,3
30763,7945,Stuff Packs,5,0,0.0,5
30764,7946,Expansion Packs,16,0,0.0,16
30765,7946,Game Packs,10,0,0.0,10
30766,7946,Kits,18,1,0.05555555555555555,17
30767,7946,Stuff Packs,20,0,0.0,20
30768,7947,Expansion Packs,16,0,0.0,16
30769,7947,Game Packs,12,0,0.0,12
30770,7947,Kits,25,0,0.0,25
30771,7947,Stuff Packs,20,0,0.0,20
30772,7948,Expansion Packs,11,0,0.0,11
30773,7948,Game Packs,8,1,0.125,7
30774,7948,Kits,9,2,0.2222222222222222,7
30775,7948,Stuff Packs,6,3,0.5,3
30776,7949,Expansion Packs,16,0,0.0,16
30777,7949,Game Packs,9,0,0.0,9
30778,7949,Kits,24,2,0.08333333333333333,22
30779,7949,Stuff Packs,18,0,0.0,18
30780,7950,Expansion Packs,12,0,0.0,12
30781,7950,Game Packs,5,0,0.0,5
30782,7950,Stuff Packs,5,2,0.4,3
30783,7951,Expansion Packs,16,0,0.0,16
30784,7951,Game Packs,11,0,0.0,11
30785,7951,Kits,31,0,0.0,31
30786,7951,Stuff Packs,19,0,0.0,19
30787,7952,Expansion Packs,6,0,0.0,6
30788,7952,Game Packs,2,0,0.0,2
30789,7952,Kits,2,0,0.0,2
30790,7952,Stuff Packs,2,0,0.0,2
30791,7953,Expansion Packs,16,0,0.0,16
30792,7953,Game Packs,12,0,0.0,12
30793,7953,Kits,33,0,0.0,33
30794,7953,Stuff Packs,20,0,0.0,20
30795,7954,Expansion Packs,16,0,0.0,16
30796,7954,Game Packs,12,0,0.0,12
30797,7954,Kits,13,1,0.07692307692307693,12
30798,7954,Stuff Packs,20,0,0.0,20
30799,7955,Expansion Packs,15,0,0.0,15
30800,7955,Game Packs,9,1,0.1111111111111111,8
30801,7955,Kits,1,1,1.0,0
30802,7955,Stuff Packs,11,2,0.18181818181818182,9
30803,7956,Expansion Packs,11,0,0.0,11
30804,7956,Game Packs,5,1,0.2,4
30805,7956,Kits,1,1,1.0,0
30806,7956,Stuff Packs,8,0,0.0,8
30807,7957,Expansion Packs,9,0,0.0,9
30808,7957,Game Packs,2,0,0.0,2
30809,7957,Kits,2,2,1.0,0
30810,7957,Stuff Packs,7,1,0.14285714285714285,6
30811,7958,Expansion Packs,16,1,0.0625,15
30812,7958,Game Packs,10,0,0.0,10
30813,7958,Kits,8,3,0.375,5
30814,7958,Stuff Packs,13,3,0.23076923076923078,10
30815,7959,Expansion Packs,13,0,0.0,13
30816,7959,Game Packs,12,0,0.0,12
30817,7959,Kits,1,0,0.0,1
30818,7959,Stuff Packs,16,1,0.0625,15
30819,7960,Expansion Packs,16,0,0.0,16
30820,7960,Game Packs,12,0,0.0,12
30821,7960,Kits,33,1,0.030303030303030304,32
30822,7960,Stuff Packs,20,0,0.0,20
30823,7961,Expansion Packs,7,1,0.14285714285714285,6
30824,7961,Game Packs,7,1,0.14285714285714285,6
30825,7961,Kits,2,2,1.0,0
30826,7961,Stuff Packs,10,3,0.3,7
30827,7962,Expansion Packs,16,0,0.0,16
30828,7962,Game Packs,12,0,0.0,12
30829,7962,Kits,20,1,0.05,19
30830,7962,Stuff Packs,20,0,0.0,20
30831,7963,Expansion Packs,16,0,0.0,16
30832,7963,Game Packs,11,0,0.0,11
30833,7963,Kits,18,2,0.1111111111111111,16
30834,7963,Stuff Packs,19,1,0.05263157894736842,18
30835,7964,Expansion Packs,16,0,0.0,16
30836,7964,Game Packs,11,1,0.09090909090909091,10
30837,7964,Kits,30,1,0.03333333333333333,29
30838,7964,Stuff Packs,19,2,0.10526315789473684,17
30839,7965,Expansion Packs,10,0,0.0,10
30840,7965,Game Packs,5,0,0.0,5
30841,7965,Kits,3,0,0.0,3
30842,7965,Stuff Packs,7,1,0.14285714285714285,6
30843,7966,Expansion Packs,16,0,0.0,16
30844,7966,Game Packs,9,0,0.0,9
30845,7966,Kits,5,0,0.0,5
30846,7966,Stuff Packs,12,1,0.08333333333333333,11
30847,7967,Expansion Packs,10,0,0.0,10
30848,7967,Game Packs,6,1,0.16666666666666666,5
30849,7967,Kits,1,1,1.0,0
30850,7967,Stuff Packs,11,1,0.09090909090909091,10
30851,7968,Expansion Packs,6,0,0.0,6
30852,7968,Kits,1,1,1.0,0
30853,7969,Expansion Packs,16,0,0.0,16
30854,7969,Game Packs,12,0,0.0,12
30855,7969,Kits,33,0,0.0,33
30856,7969,Stuff Packs,20,0,0.0,20
30857,7970,Expansion Packs,11,0,0.0,11
30858,7970,Game Packs,3,0,0.0,3
30859,7970,Kits,14,1,0.07142857142857142,13
30860,7970,Stuff Packs,11,2,0.18181818181818182,9
30861,7971,Expansion Packs,4,0,0.0,4
30862,7971,Game Packs,1,0,0.0,1
30863,7971,Kits,1,0,0.0,1
30864,7971,Stuff Packs,4,0,0.0,4
30865,7972,Expansion Packs,7,0,0.0,7
30866,7972,Game Packs,2,0,0.0,2
30867,7972,Kits,2,0,0.0,2
30868,7972,Stuff Packs,8,2,0.25,6
30869,7973,Expansion Packs,16,0,0.0,16
30870,7973,Game Packs,12,0,0.0,12
30871,7973,Kits,10,0,0.0,10
30872,7973,Stuff Packs,19,1,0.05263157894736842,18
30873,7974,Expansion Packs,10,0,0.0,10
30874,7974,Game Packs,6,0,0.0,6
30875,7974,Kits,8,0,0.0,8
30876,7974,Stuff Packs,17,1,0.058823529411764705,16
30877,7975,Expansion Packs,12,0,0.0,12
30878,7975,Game Packs,11,0,0.0,11
30879,7975,Kits,1,0,0.0,1
30880,7975,Stuff Packs,18,1,0.05555555555555555,17
30881,7976,Expansion Packs,16,0,0.0,16
30882,7976,Game Packs,11,0,0.0,11
30883,7976,Kits,8,2,0.25,6
30884,7976,Stuff Packs,18,0,0.0,18
30885,7977,Expansion Packs,15,0,0.0,15
30886,7977,Game Packs,11,0,0.0,11
30887,7977,Kits,17,2,0.11764705882352941,15
30888,7977,Stuff Packs,18,1,0.05555555555555555,17
30889,7978,Expansion Packs,12,0,0.0,12
30890,7978,Game Packs,6,1,0.16666666666666666,5
30891,7978,Kits,6,2,0.3333333333333333,4
30892,7978,Stuff Packs,6,4,0.6666666666666666,2
30893,7979,Expansion Packs,15,0,0.0,15
30894,7979,Game Packs,11,0,0.0,11
30895,7979,Kits,28,1,0.03571428571428571,27
30896,7979,Stuff Packs,19,0,0.0,19
30897,7980,Expansion Packs,10,0,0.0,10
30898,7980,Game Packs,6,1,0.16666666666666666,5
30899,7980,Kits,3,3,1.0,0
30900,7980,Stuff Packs,7,3,0.42857142857142855,4
30901,7981,Expansion Packs,16,0,0.0,16
30902,7981,Game Packs,11,0,0.0,11
30903,7981,Kits,20,1,0.05,19
30904,7981,Stuff Packs,20,0,0.0,20
30905,7982,Expansion Packs,14,0,0.0,14
30906,7982,Game Packs,9,0,0.0,9
30907,7982,Kits,3,3,1.0,0
30908,7982,Stuff Packs,18,0,0.0,18
30909,7983,Expansion Packs,7,0,0.0,7
30910,7983,Game Packs,6,1,0.16666666666666666,5
30911,7983,Kits,4,2,0.5,2
30912,7983,Stuff Packs,15,1,0.06666666666666667,14
30913,7984,Game Packs,1,1,1.0,0
30914,7984,Kits,3,3,1.0,0
30915,7984,Stuff Packs,5,5,1.0,0
30916,7985,Expansion Packs,16,0,0.0,16
30917,7985,Game Packs,12,0,0.0,12
30918,7985,Kits,30,0,0.0,30
30919,7985,Stuff Packs,20,0,0.0,20
30920,7986,Expansion Packs,4,0,0.0,4
30921,7986,Kits,3,2,0.6666666666666666,1
30922,7986,Stuff Packs,6,3,0.5,3
30923,7987,Expansion Packs,9,0,0.0,9
30924,7987,Game Packs,2,0,0.0,2
30925,7987,Kits,2,1,0.5,1
30926,7987,Stuff Packs,4,2,0.5,2
30927,7988,Expansion Packs,9,0,0.0,9
30928,7988,Game Packs,4,0,0.0,4
30929,7988,Kits,2,0,0.0,2
30930,7988,Stuff Packs,12,2,0.16666666666666666,10
30931,7989,Expansion Packs,9,0,0.0,9
30932,7989,Game Packs,4,0,0.0,4
30933,7989,Kits,2,2,1.0,0
30934,7989,Stuff Packs,2,0,0.0,2
30935,7990,Expansion Packs,16,0,0.0,16
30936,7990,Game Packs,12,1,0.08333333333333333,11
30937,7990,Kits,28,1,0.03571428571428571,27
30938,7990,Stuff Packs,20,0,0.0,20
30939,7991,Expansion Packs,16,0,0.0,16
30940,7991,Game Packs,12,0,0.0,12
30941,7991,Kits,33,0,0.0,33
30942,7991,Stuff Packs,20,0,0.0,20
30943,7992,Expansion Packs,16,0,0.0,16
30944,7992,Game Packs,12,0,0.0,12
30945,7992,Kits,33,0,0.0,33
30946,7992,Stuff Packs,20,0,0.0,20
30947,7993,Expansion Packs,15,0,0.0,15
30948,7993,Game Packs,12,0,0.0,12
30949,7993,Kits,23,1,0.043478260869565216,22
30950,7993,Stuff Packs,17,1,0.058823529411764705,16
30951,7994,Expansion Packs,6,0,0.0,6
30952,7994,Game Packs,2,0,0.0,2
30953,7994,Kits,1,1,1.0,0
30954,7994,Stuff Packs,2,1,0.5,1
30955,7995,Expansion Packs,2,0,0.0,2
30956,7995,Kits,2,1,0.5,1
30957,7995,Stuff Packs,3,2,0.6666666666666666,1
30958,7996,Expansion Packs,10,0,0.0,10
30959,7996,Game Packs,5,1,0.2,4
30960,7996,Kits,3,1,0.3333333333333333,2
30961,7996,Stuff Packs,6,4,0.6666666666666666,2
30962,7997,Expansion Packs,16,0,0.0,16
30963,7997,Game Packs,8,0,0.0,8
30964,7997,Kits,13,0,0.0,13
30965,7997,Stuff Packs,11,3,0.2727272727272727,8
30966,7998,Expansion Packs,6,0,0.0,6
30967,7998,Game Packs,5,0,0.0,5
30968,7998,Stuff Packs,4,0,0.0,4
30969,7999,Expansion Packs,3,0,0.0,3
30970,7999,Game Packs,3,0,0.0,3
30971,7999,Stuff Packs,3,1,0.3333333333333333,2
30972,8000,Expansion Packs,16,0,0.0,16
30973,8000,Game Packs,12,0,0.0,12
30974,8000,Kits,24,1,0.041666666666666664,23
30975,8000,Stuff Packs,20,0,0.0,20
30976,8001,Expansion Packs,16,0,0.0,16
30977,8001,Game Packs,9,0,0.0,9
30978,8001,Kits,10,0,0.0,10
30979,8001,Stuff Packs,20,0,0.0,20
30980,8002,Expansion Packs,10,0,0.0,10
30981,8002,Game Packs,6,0,0.0,6
30982,8002,Stuff Packs,5,2,0.4,3
30983,8003,Expansion Packs,1,1,1.0,0
30984,8003,Game Packs,1,1,1.0,0
30985,8003,Kits,2,2,1.0,0
30986,8003,Stuff Packs,1,1,1.0,0
30987,8004,Expansion Packs,16,0,0.0,16
30988,8004,Game Packs,12,0,0.0,12
30989,8004,Kits,33,1,0.030303030303030304,32
30990,8004,Stuff Packs,20,0,0.0,20
30991,8005,Expansion Packs,16,0,0.0,16
30992,8005,Game Packs,4,0,0.0,4
30993,8005,Kits,9,0,0.0,9
30994,8005,Stuff Packs,4,0,0.0,4
30995,8006,Expansion Packs,1,0,0.0,1
30996,8006,Stuff Packs,1,0,0.0,1
30997,8007,Expansion Packs,16,2,0.125,14
30998,8007,Game Packs,12,4,0.3333333333333333,8
30999,8007,Kits,33,4,0.12121212121212122,29
31000,8007,Stuff Packs,20,6,0.3,14
31001,8008,Expansion Packs,9,0,0.0,9
31002,8008,Game Packs,3,0,0.0,3
31003,8008,Kits,2,1,0.5,1
31004,8008,Stuff Packs,8,3,0.375,5
31005,8009,Kits,1,1,1.0,0
31006,8009,Stuff Packs,2,2,1.0,0
31007,8010,Expansion Packs,13,0,0.0,13
31008,8010,Game Packs,12,0,0.0,12
31009,8010,Stuff Packs,13,0,0.0,13
31010,8011,Expansion Packs,12,0,0.0,12
31011,8011,Game Packs,1,0,0.0,1
31012,8011,Kits,2,1,0.5,1
31013,8011,Stuff Packs,7,1,0.14285714285714285,6
31014,8012,Expansion Packs,9,0,0.0,9
31015,8012,Game Packs,1,0,0.0,1
31016,8012,Stuff Packs,2,0,0.0,2
31017,8013,Expansion Packs,4,0,0.0,4
31018,8013,Game Packs,4,0,0.0,4
31019,8013,Kits,3,1,0.3333333333333333,2
31020,8013,Stuff Packs,7,4,0.5714285714285714,3
31021,8014,Expansion Packs,15,0,0.0,15
31022,8014,Game Packs,12,0,0.0,12
31023,8014,Kits,13,2,0.15384615384615385,11
31024,8014,Stuff Packs,19,0,0.0,19
31025,8015,Expansion Packs,9,0,0.0,9
31026,8015,Game Packs,3,1,0.3333333333333333,2
31027,8015,Kits,4,3,0.75,1
31028,8015,Stuff Packs,7,4,0.5714285714285714,3
31029,8016,Expansion Packs,16,0,0.0,16
31030,8016,Game Packs,11,0,0.0,11
31031,8016,Kits,30,1,0.03333333333333333,29
31032,8016,Stuff Packs,20,0,0.0,20
31033,8017,Kits,1,1,1.0,0
31034,8017,Stuff Packs,1,1,1.0,0
31035,8018,Expansion Packs,16,0,0.0,16
31036,8018,Game Packs,12,0,0.0,12
31037,8018,Kits,21,1,0.047619047619047616,20
31038,8018,Stuff Packs,19,0,0.0,19
31039,8019,Expansion Packs,2,0,0.0,2
31040,8020,Expansion Packs,16,0,0.0,16
31041,8020,Game Packs,12,0,0.0,12
31042,8020,Kits,33,0,0.0,33
31043,8020,Stuff Packs,20,0,0.0,20
31044,8021,Expansion Packs,13,0,0.0,13
31045,8021,Game Packs,9,0,0.0,9
31046,8021,Kits,3,2,0.6666666666666666,1
31047,8021,Stuff Packs,19,0,0.0,19
31048,8022,Expansion Packs,8,1,0.125,7
31049,8022,Game Packs,5,1,0.2,4
31050,8022,Kits,2,1,0.5,1
31051,8022,Stuff Packs,7,1,0.14285714285714285,6
31052,8023,Expansion Packs,14,0,0.0,14
31053,8023,Game Packs,8,0,0.0,8
31054,8023,Kits,14,1,0.07142857142857142,13
31055,8023,Stuff Packs,17,2,0.11764705882352941,15
31056,8024,Game Packs,1,0,0.0,1
31057,8024,Stuff Packs,4,3,0.75,1
31058,8025,Expansion Packs,4,0,0.0,4
31059,8025,Game Packs,2,0,0.0,2
31060,8025,Kits,1,0,0.0,1
31061,8025,Stuff Packs,3,0,0.0,3
31062,8026,Expansion Packs,15,12,0.8,3
31063,8026,Game Packs,12,7,0.5833333333333334,5
31064,8026,Kits,10,10,1.0,0
31065,8026,Stuff Packs,18,6,0.3333333333333333,12
31066,8027,Expansion Packs,10,0,0.0,10
31067,8027,Game Packs,5,0,0.0,5
31068,8027,Kits,3,1,0.3333333333333333,2
31069,8027,Stuff Packs,6,3,0.5,3
31070,8028,Expansion Packs,16,0,0.0,16
31071,8028,Game Packs,11,0,0.0,11
31072,8028,Kits,26,1,0.038461538461538464,25
31073,8028,Stuff Packs,20,0,0.0,20
31074,8029,Expansion Packs,16,0,0.0,16
31075,8029,Game Packs,12,0,0.0,12
31076,8029,Kits,31,0,0.0,31
31077,8029,Stuff Packs,20,0,0.0,20
31078,8030,Expansion Packs,9,0,0.0,9
31079,8030,Game Packs,3,1,0.3333333333333333,2
31080,8030,Kits,2,1,0.5,1
31081,8030,Stuff Packs,5,3,0.6,2
31082,8031,Expansion Packs,8,0,0.0,8
31083,8031,Game Packs,4,0,0.0,4
31084,8031,Kits,8,0,0.0,8
31085,8031,Stuff Packs,5,0,0.0,5
31086,8032,Expansion Packs,16,0,0.0,16
31087,8032,Game Packs,12,0,0.0,12
31088,8032,Kits,14,0,0.0,14
31089,8032,Stuff Packs,19,0,0.0,19
31090,8033,Expansion Packs,15,0,0.0,15
31091,8033,Game Packs,12,1,0.08333333333333333,11
31092,8033,Kits,14,7,0.5,7
31093,8033,Stuff Packs,20,3,0.15,17
31094,8034,Expansion Packs,12,0,0.0,12
31095,8034,Game Packs,8,0,0.0,8
31096,8034,Kits,1,1,1.0,0
31097,8034,Stuff Packs,11,1,0.09090909090909091,10
31098,8035,Expansion Packs,16,0,0.0,16
31099,8035,Game Packs,12,0,0.0,12
31100,8035,Kits,33,0,0.0,33
31101,8035,Stuff Packs,20,0,0.0,20
31102,8036,Expansion Packs,3,0,0.0,3
31103,8036,Game Packs,1,0,0.0,1
31104,8036,Kits,1,1,1.0,0
31105,8036,Stuff Packs,4,2,0.5,2
31106,8037,Expansion Packs,12,0,0.0,12
31107,8037,Game Packs,7,0,0.0,7
31108,8037,Kits,2,2,1.0,0
31109,8037,Stuff Packs,6,2,0.3333333333333333,4
31110,8038,Expansion Packs,15,0,0.0,15
31111,8038,Game Packs,11,0,0.0,11
31112,8038,Kits,2,2,1.0,0
31113,8038,Stuff Packs,11,3,0.2727272727272727,8
31114,8039,Expansion Packs,5,0,0.0,5
31115,8039,Game Packs,1,0,0.0,1
31116,8039,Kits,2,1,0.5,1
31117,8039,Stuff Packs,3,2,0.6666666666666666,1
31118,8040,Expansion Packs,16,0,0.0,16
31119,8040,Game Packs,11,0,0.0,11
31120,8040,Kits,32,0,0.0,32
31121,8040,Stuff Packs,20,0,0.0,20
31122,8041,Expansion Packs,16,0,0.0,16
31123,8041,Game Packs,12,2,0.16666666666666666,10
31124,8041,Kits,33,0,0.0,33
31125,8041,Stuff Packs,20,2,0.1,18
31126,8042,Expansion Packs,13,0,0.0,13
31127,8042,Game Packs,10,0,0.0,10
31128,8042,Kits,6,1,0.16666666666666666,5
31129,8042,Stuff Packs,18,0,0.0,18
31130,8043,Expansion Packs,14,0,0.0,14
31131,8043,Game Packs,8,0,0.0,8
31132,8043,Kits,5,3,0.6,2
31133,8043,Stuff Packs,16,2,0.125,14
31134,8044,Expansion Packs,4,0,0.0,4
31135,8044,Game Packs,2,0,0.0,2
31136,8045,Expansion Packs,13,0,0.0,13
31137,8045,Game Packs,8,0,0.0,8
31138,8045,Kits,5,1,0.2,4
31139,8045,Stuff Packs,18,0,0.0,18
31140,8046,Kits,1,1,1.0,0
31141,8046,Stuff Packs,3,3,1.0,0
31142,8047,Expansion Packs,3,0,0.0,3
31143,8047,Game Packs,2,0,0.0,2
31144,8047,Kits,1,1,1.0,0
31145,8047,Stuff Packs,3,3,1.0,0
31146,8048,Expansion Packs,8,2,0.25,6
31147,8048,Game Packs,6,0,0.0,6
31148,8048,Kits,4,1,0.25,3
31149,8048,Stuff Packs,6,1,0.16666666666666666,5
31150,8049,Expansion Packs,14,0,0.0,14
31151,8049,Game Packs,8,0,0.0,8
31152,8049,Kits,32,1,0.03125,31
31153,8049,Stuff Packs,15,0,0.0,15
31154,8050,Expansion Packs,10,0,0.0,10
31155,8050,Game Packs,5,0,0.0,5
31156,8050,Kits,6,0,0.0,6
31157,8050,Stuff Packs,8,3,0.375,5
31158,8051,Expansion Packs,3,0,0.0,3
31159,8051,Stuff Packs,1,0,0.0,1
31160,8052,Expansion Packs,10,0,0.0,10
31161,8052,Game Packs,4,0,0.0,4
31162,8052,Kits,2,0,0.0,2
31163,8052,Stuff Packs,8,0,0.0,8
31164,8053,Expansion Packs,15,0,0.0,15
31165,8053,Game Packs,6,0,0.0,6
31166,8053,Kits,11,0,0.0,11
31167,8053,Stuff Packs,10,1,0.1,9
31168,8054,Expansion Packs,8,0,0.0,8
31169,8054,Game Packs,2,0,0.0,2
31170,8054,Kits,5,0,0.0,5
31171,8054,Stuff Packs,4,0,0.0,4
31172,8055,Expansion Packs,9,0,0.0,9
31173,8055,Game Packs,4,0,0.0,4
31174,8055,Kits,1,1,1.0,0
31175,8055,Stuff Packs,6,0,0.0,6
31176,8056,Expansion Packs,16,0,0.0,16
31177,8056,Game Packs,11,0,0.0,11
31178,8056,Kits,33,0,0.0,33
31179,8056,Stuff Packs,20,0,0.0,20
31180,8057,Expansion Packs,10,0,0.0,10
31181,8057,Game Packs,3,0,0.0,3
31182,8057,Kits,2,2,1.0,0
31183,8057,Stuff Packs,6,1,0.16666666666666666,5
31184,8058,Expansion Packs,12,0,0.0,12
31185,8058,Game Packs,10,0,0.0,10
31186,8058,Kits,13,1,0.07692307692307693,12
31187,8058,Stuff Packs,18,0,0.0,18
31188,8059,Expansion Packs,11,0,0.0,11
31189,8059,Game Packs,5,0,0.0,5
31190,8059,Kits,11,2,0.18181818181818182,9
31191,8059,Stuff Packs,15,4,0.26666666666666666,11
31192,8060,Expansion Packs,8,0,0.0,8
31193,8060,Game Packs,5,0,0.0,5
31194,8060,Kits,8,1,0.125,7
31195,8060,Stuff Packs,3,0,0.0,3
31196,8061,Expansion Packs,16,1,0.0625,15
31197,8061,Game Packs,12,0,0.0,12
31198,8061,Kits,33,0,0.0,33
31199,8061,Stuff Packs,20,0,0.0,20
31200,8062,Expansion Packs,7,0,0.0,7
31201,8062,Game Packs,1,0,0.0,1
31202,8062,Kits,3,0,0.0,3
31203,8062,Stuff Packs,5,3,0.6,2
31204,8063,Expansion Packs,15,0,0.0,15
31205,8063,Game Packs,9,0,0.0,9
31206,8063,Kits,1,1,1.0,0
31207,8063,Stuff Packs,14,3,0.21428571428571427,11
31208,8064,Expansion Packs,13,0,0.0,13
31209,8064,Game Packs,7,0,0.0,7
31210,8064,Kits,8,1,0.125,7
31211,8064,Stuff Packs,11,0,0.0,11
31212,8065,Expansion Packs,16,0,0.0,16
31213,8065,Game Packs,12,0,0.0,12
31214,8065,Kits,33,0,0.0,33
31215,8065,Stuff Packs,20,0,0.0,20
31216,8066,Expansion Packs,7,0,0.0,7
31217,8066,Game Packs,6,0,0.0,6
31218,8066,Kits,1,1,1.0,0
31219,8066,Stuff Packs,5,3,0.6,2
31220,8067,Expansion Packs,10,0,0.0,10
31221,8067,Game Packs,5,0,0.0,5
31222,8067,Kits,2,0,0.0,2
31223,8067,Stuff Packs,10,0,0.0,10
31224,8068,Expansion Packs,15,0,0.0,15
31225,8068,Game Packs,4,0,0.0,4
31226,8068,Kits,5,1,0.2,4
31227,8068,Stuff Packs,12,2,0.16666666666666666,10
31228,8069,Expansion Packs,16,0,0.0,16
31229,8069,Game Packs,12,0,0.0,12
31230,8069,Kits,33,0,0.0,33
31231,8069,Stuff Packs,20,0,0.0,20
31232,8070,Expansion Packs,16,0,0.0,16
31233,8070,Game Packs,12,0,0.0,12
31234,8070,Kits,32,0,0.0,32
31235,8070,Stuff Packs,20,0,0.0,20
31236,8071,Expansion Packs,7,0,0.0,7
31237,8071,Game Packs,1,0,0.0,1
31238,8071,Kits,1,1,1.0,0
31239,8071,Stuff Packs,6,3,0.5,3
31240,8072,Expansion Packs,5,0,0.0,5
31241,8072,Game Packs,3,0,0.0,3
31242,8072,Stuff Packs,2,0,0.0,2
31243,8073,Expansion Packs,4,0,0.0,4
31244,8073,Game Packs,2,1,0.5,1
31245,8073,Stuff Packs,4,4,1.0,0
31246,8074,Expansion Packs,16,0,0.0,16
31247,8074,Game Packs,12,0,0.0,12
31248,8074,Kits,33,0,0.0,33
31249,8074,Stuff Packs,20,0,0.0,20
31250,8075,Expansion Packs,16,0,0.0,16
31251,8075,Game Packs,12,0,0.0,12
31252,8075,Kits,33,0,0.0,33
31253,8075,Stuff Packs,20,0,0.0,20
31254,8076,Expansion Packs,16,0,0.0,16
31255,8076,Game Packs,11,0,0.0,11
31256,8076,Kits,11,0,0.0,11
31257,8076,Stuff Packs,18,0,0.0,18
31258,8077,Expansion Packs,13,0,0.0,13
31259,8077,Game Packs,4,0,0.0,4
31260,8077,Kits,6,2,0.3333333333333333,4
31261,8077,Stuff Packs,13,2,0.15384615384615385,11
31262,8078,Expansion Packs,1,0,0.0,1
31263,8078,Game Packs,1,1,1.0,0
31264,8078,Kits,2,2,1.0,0
31265,8078,Stuff Packs,4,4,1.0,0
31266,8079,Expansion Packs,16,0,0.0,16
31267,8079,Game Packs,11,0,0.0,11
31268,8079,Kits,16,2,0.125,14
31269,8079,Stuff Packs,20,1,0.05,19
31270,8080,Expansion Packs,10,0,0.0,10
31271,8080,Game Packs,7,1,0.14285714285714285,6
31272,8080,Kits,6,3,0.5,3
31273,8080,Stuff Packs,11,3,0.2727272727272727,8
31274,8081,Expansion Packs,3,0,0.0,3
31275,8081,Game Packs,3,0,0.0,3
31276,8081,Kits,2,1,0.5,1
31277,8081,Stuff Packs,7,2,0.2857142857142857,5
31278,8082,Expansion Packs,16,16,1.0,0
31279,8082,Game Packs,12,12,1.0,0
31280,8082,Kits,33,33,1.0,0
31281,8082,Stuff Packs,20,20,1.0,0
31282,8083,Expansion Packs,11,0,0.0,11
31283,8083,Game Packs,6,1,0.16666666666666666,5
31284,8083,Kits,3,1,0.3333333333333333,2
31285,8083,Stuff Packs,9,2,0.2222222222222222,7
31286,8084,Expansion Packs,14,0,0.0,14
31287,8084,Game Packs,10,0,0.0,10
31288,8084,Kits,9,1,0.1111111111111111,8
31289,8084,Stuff Packs,20,0,0.0,20
31290,8085,Expansion Packs,9,0,0.0,9
31291,8085,Game Packs,1,0,0.0,1
31292,8085,Kits,9,0,0.0,9
31293,8085,Stuff Packs,5,0,0.0,5
31294,8086,Expansion Packs,16,0,0.0,16
31295,8086,Game Packs,12,0,0.0,12
31296,8086,Kits,28,0,0.0,28
31297,8086,Stuff Packs,20,0,0.0,20
31298,8087,Expansion Packs,10,0,0.0,10
31299,8087,Game Packs,5,0,0.0,5
31300,8087,Kits,1,1,1.0,0
31301,8087,Stuff Packs,8,2,0.25,6
31302,8088,Expansion Packs,16,0,0.0,16
31303,8088,Game Packs,12,0,0.0,12
31304,8088,Kits,33,0,0.0,33
31305,8088,Stuff Packs,20,0,0.0,20
31306,8089,Expansion Packs,8,0,0.0,8
31307,8089,Game Packs,3,0,0.0,3
31308,8089,Kits,1,0,0.0,1
31309,8089,Stuff Packs,11,4,0.36363636363636365,7
31310,8090,Expansion Packs,13,12,0.9230769230769231,1
31311,8090,Game Packs,5,5,1.0,0
31312,8090,Kits,2,2,1.0,0
31313,8090,Stuff Packs,6,6,1.0,0
31314,8091,Expansion Packs,9,0,0.0,9
31315,8091,Game Packs,2,0,0.0,2
31316,8091,Kits,1,0,0.0,1
31317,8091,Stuff Packs,5,0,0.0,5
31318,8092,Expansion Packs,11,0,0.0,11
31319,8092,Game Packs,8,0,0.0,8
31320,8092,Kits,5,2,0.4,3
31321,8092,Stuff Packs,13,3,0.23076923076923078,10
31322,8093,Expansion Packs,11,0,0.0,11
31323,8093,Game Packs,5,0,0.0,5
31324,8093,Kits,2,1,0.5,1
31325,8093,Stuff Packs,7,2,0.2857142857142857,5
31326,8094,Expansion Packs,15,0,0.0,15
31327,8094,Game Packs,11,0,0.0,11
31328,8094,Kits,5,1,0.2,4
31329,8094,Stuff Packs,20,0,0.0,20
31330,8095,Expansion Packs,10,0,0.0,10
31331,8095,Game Packs,5,0,0.0,5
31332,8095,Kits,1,1,1.0,0
31333,8095,Stuff Packs,6,2,0.3333333333333333,4
31334,8096,Expansion Packs,3,0,0.0,3
31335,8096,Game Packs,1,0,0.0,1
31336,8096,Kits,1,1,1.0,0
31337,8096,Stuff Packs,5,2,0.4,3
31338,8097,Expansion Packs,11,0,0.0,11
31339,8097,Game Packs,3,0,0.0,3
31340,8097,Kits,2,2,1.0,0
31341,8097,Stuff Packs,8,3,0.375,5
31342,8098,Expansion Packs,16,0,0.0,16
31343,8098,Game Packs,12,0,0.0,12
31344,8098,Kits,32,0,0.0,32
31345,8098,Stuff Packs,20,1,0.05,19
31346,8099,Expansion Packs,16,0,0.0,16
31347,8099,Game Packs,12,0,0.0,12
31348,8099,Kits,20,0,0.0,20
31349,8099,Stuff Packs,19,0,0.0,19
31350,8100,Expansion Packs,4,0,0.0,4
31351,8100,Kits,1,1,1.0,0
31352,8100,Stuff Packs,3,3,1.0,0
31353,8101,Expansion Packs,11,0,0.0,11
31354,8101,Game Packs,8,1,0.125,7
31355,8101,Kits,7,2,0.2857142857142857,5
31356,8101,Stuff Packs,12,1,0.08333333333333333,11
31357,8102,Expansion Packs,16,0,0.0,16
31358,8102,Game Packs,12,0,0.0,12
31359,8102,Kits,33,0,0.0,33
31360,8102,Stuff Packs,20,0,0.0,20
31361,8103,Expansion Packs,16,0,0.0,16
31362,8103,Game Packs,10,0,0.0,10
31363,8103,Kits,9,1,0.1111111111111111,8
31364,8103,Stuff Packs,19,0,0.0,19
31365,8104,Expansion Packs,16,0,0.0,16
31366,8104,Game Packs,10,0,0.0,10
31367,8104,Kits,33,0,0.0,33
31368,8104,Stuff Packs,20,0,0.0,20
31369,8105,Expansion Packs,15,0,0.0,15
31370,8105,Game Packs,10,0,0.0,10
31371,8105,Kits,12,1,0.08333333333333333,11
31372,8105,Stuff Packs,18,1,0.05555555555555555,17
31373,8106,Expansion Packs,11,0,0.0,11
31374,8106,Game Packs,7,0,0.0,7
31375,8106,Stuff Packs,3,0,0.0,3
31376,8107,Expansion Packs,5,0,0.0,5
31377,8107,Game Packs,3,1,0.3333333333333333,2
31378,8107,Kits,6,3,0.5,3
31379,8107,Stuff Packs,5,4,0.8,1
31380,8108,Expansion Packs,16,2,0.125,14
31381,8108,Game Packs,7,0,0.0,7
31382,8108,Kits,9,1,0.1111111111111111,8
31383,8108,Stuff Packs,14,1,0.07142857142857142,13
31384,8109,Expansion Packs,15,0,0.0,15
31385,8109,Game Packs,11,0,0.0,11
31386,8109,Kits,13,1,0.07692307692307693,12
31387,8109,Stuff Packs,19,1,0.05263157894736842,18
31388,8110,Expansion Packs,14,0,0.0,14
31389,8110,Game Packs,10,1,0.1,9
31390,8110,Kits,14,0,0.0,14
31391,8110,Stuff Packs,14,3,0.21428571428571427,11
31392,8111,Expansion Packs,16,0,0.0,16
31393,8111,Game Packs,12,0,0.0,12
31394,8111,Kits,29,0,0.0,29
31395,8111,Stuff Packs,20,0,0.0,20
31396,8112,Expansion Packs,10,0,0.0,10
31397,8112,Game Packs,5,0,0.0,5
31398,8112,Stuff Packs,2,0,0.0,2
31399,8113,Expansion Packs,4,0,0.0,4
31400,8113,Kits,1,1,1.0,0
31401,8113,Stuff Packs,2,2,1.0,0
31402,8114,Expansion Packs,11,0,0.0,11
31403,8114,Game Packs,5,1,0.2,4
31404,8114,Kits,5,2,0.4,3
31405,8114,Stuff Packs,6,2,0.3333333333333333,4
31406,8115,Expansion Packs,16,0,0.0,16
31407,8115,Game Packs,10,0,0.0,10
31408,8115,Kits,15,1,0.06666666666666667,14
31409,8115,Stuff Packs,14,3,0.21428571428571427,11
31410,8116,Expansion Packs,14,0,0.0,14
31411,8116,Game Packs,9,0,0.0,9
31412,8116,Kits,6,2,0.3333333333333333,4
31413,8116,Stuff Packs,19,0,0.0,19
31414,8117,Expansion Packs,16,0,0.0,16
31415,8117,Game Packs,12,0,0.0,12
31416,8117,Kits,33,0,0.0,33
31417,8117,Stuff Packs,20,0,0.0,20
31418,8118,Expansion Packs,10,0,0.0,10
31419,8118,Game Packs,1,0,0.0,1
31420,8118,Kits,3,0,0.0,3
31421,8118,Stuff Packs,2,0,0.0,2
31422,8119,Expansion Packs,12,0,0.0,12
31423,8119,Game Packs,7,0,0.0,7
31424,8119,Kits,3,3,1.0,0
31425,8119,Stuff Packs,12,3,0.25,9
31426,8120,Expansion Packs,13,0,0.0,13
31427,8120,Game Packs,2,0,0.0,2
31428,8120,Stuff Packs,2,0,0.0,2
31429,8121,Expansion Packs,14,3,0.21428571428571427,11
31430,8121,Game Packs,6,0,0.0,6
31431,8121,Stuff Packs,4,1,0.25,3
31432,8122,Expansion Packs,16,0,0.0,16
31433,8122,Game Packs,12,0,0.0,12
31434,8122,Kits,2,0,0.0,2
31435,8122,Stuff Packs,19,0,0.0,19
31436,8123,Expansion Packs,13,0,0.0,13
31437,8123,Game Packs,8,0,0.0,8
31438,8123,Kits,9,1,0.1111111111111111,8
31439,8123,Stuff Packs,13,1,0.07692307692307693,12
31440,8124,Expansion Packs,7,0,0.0,7
31441,8124,Game Packs,2,0,0.0,2
31442,8124,Kits,13,1,0.07692307692307693,12
31443,8124,Stuff Packs,7,3,0.42857142857142855,4
31444,8125,Expansion Packs,13,0,0.0,13
31445,8125,Game Packs,9,0,0.0,9
31446,8125,Kits,1,1,1.0,0
31447,8125,Stuff Packs,11,1,0.09090909090909091,10
31448,8126,Expansion Packs,13,0,0.0,13
31449,8126,Game Packs,12,0,0.0,12
31450,8126,Kits,10,0,0.0,10
31451,8126,Stuff Packs,19,0,0.0,19
31452,8127,Expansion Packs,15,0,0.0,15
31453,8127,Game Packs,9,1,0.1111111111111111,8
31454,8127,Kits,12,3,0.25,9
31455,8127,Stuff Packs,13,2,0.15384615384615385,11
31456,8128,Expansion Packs,14,0,0.0,14
31457,8128,Game Packs,11,0,0.0,11
31458,8128,Kits,19,0,0.0,19
31459,8128,Stuff Packs,20,0,0.0,20
31460,8129,Expansion Packs,13,0,0.0,13
31461,8129,Game Packs,5,1,0.2,4
31462,8129,Kits,2,2,1.0,0
31463,8129,Stuff Packs,5,2,0.4,3
31464,8130,Expansion Packs,16,0,0.0,16
31465,8130,Game Packs,12,0,0.0,12
31466,8130,Kits,33,0,0.0,33
31467,8130,Stuff Packs,20,0,0.0,20
31468,8131,Expansion Packs,9,0,0.0,9
31469,8131,Game Packs,2,0,0.0,2
31470,8131,Kits,2,2,1.0,0
31471,8131,Stuff Packs,6,1,0.16666666666666666,5
31472,8132,Expansion Packs,16,0,0.0,16
31473,8132,Game Packs,12,0,0.0,12
31474,8132,Kits,15,1,0.06666666666666667,14
31475,8132,Stuff Packs,20,0,0.0,20
31476,8133,Expansion Packs,14,0,0.0,14
31477,8133,Game Packs,4,0,0.0,4
31478,8133,Kits,2,2,1.0,0
31479,8133,Stuff Packs,10,2,0.2,8
31480,8134,Expansion Packs,4,0,0.0,4
31481,8134,Game Packs,5,1,0.2,4
31482,8134,Kits,3,3,1.0,0
31483,8134,Stuff Packs,2,2,1.0,0
31484,8135,Expansion Packs,8,0,0.0,8
31485,8135,Game Packs,4,1,0.25,3
31486,8135,Kits,1,1,1.0,0
31487,8135,Stuff Packs,4,3,0.75,1
31488,8136,Expansion Packs,16,0,0.0,16
31489,8136,Game Packs,12,0,0.0,12
31490,8136,Kits,21,1,0.047619047619047616,20
31491,8136,Stuff Packs,18,2,0.1111111111111111,16
31492,8137,Expansion Packs,16,0,0.0,16
31493,8137,Game Packs,10,0,0.0,10
31494,8137,Kits,5,0,0.0,5
31495,8137,Stuff Packs,14,0,0.0,14
31496,8138,Expansion Packs,13,0,0.0,13
31497,8138,Game Packs,8,0,0.0,8
31498,8138,Stuff Packs,11,0,0.0,11
31499,8139,Expansion Packs,13,1,0.07692307692307693,12
31500,8139,Game Packs,5,0,0.0,5
31501,8139,Kits,9,1,0.1111111111111111,8
31502,8139,Stuff Packs,7,1,0.14285714285714285,6
31503,8140,Expansion Packs,12,0,0.0,12
31504,8140,Game Packs,10,0,0.0,10
31505,8140,Kits,1,1,1.0,0
31506,8140,Stuff Packs,5,0,0.0,5
31507,8141,Expansion Packs,15,0,0.0,15
31508,8141,Game Packs,10,0,0.0,10
31509,8141,Kits,9,1,0.1111111111111111,8
31510,8141,Stuff Packs,18,1,0.05555555555555555,17
31511,8142,Expansion Packs,16,0,0.0,16
31512,8142,Game Packs,12,0,0.0,12
31513,8142,Kits,30,2,0.06666666666666667,28
31514,8142,Stuff Packs,20,0,0.0,20
31515,8143,Expansion Packs,16,0,0.0,16
31516,8143,Game Packs,12,0,0.0,12
31517,8143,Kits,33,0,0.0,33
31518,8143,Stuff Packs,20,0,0.0,20
31519,8144,Expansion Packs,14,1,0.07142857142857142,13
31520,8144,Game Packs,6,0,0.0,6
31521,8144,Stuff Packs,6,0,0.0,6
31522,8145,Expansion Packs,9,0,0.0,9
31523,8145,Game Packs,8,0,0.0,8
31524,8145,Stuff Packs,4,4,1.0,0
31525,8146,Expansion Packs,4,0,0.0,4
31526,8146,Game Packs,4,0,0.0,4
31527,8146,Kits,13,0,0.0,13
31528,8146,Stuff Packs,4,0,0.0,4
31529,8147,Expansion Packs,13,0,0.0,13
31530,8147,Game Packs,9,0,0.0,9
31531,8147,Kits,3,2,0.6666666666666666,1
31532,8147,Stuff Packs,11,3,0.2727272727272727,8
31533,8148,Expansion Packs,4,0,0.0,4
31534,8148,Game Packs,2,0,0.0,2
31535,8148,Kits,2,2,1.0,0
31536,8148,Stuff Packs,5,3,0.6,2
31537,8149,Expansion Packs,16,0,0.0,16
31538,8149,Game Packs,12,0,0.0,12
31539,8149,Kits,33,2,0.06060606060606061,31
31540,8149,Stuff Packs,20,0,0.0,20
31541,8150,Expansion Packs,13,0,0.0,13
31542,8150,Game Packs,7,0,0.0,7
31543,8150,Kits,10,1,0.1,9
31544,8150,Stuff Packs,18,1,0.05555555555555555,17
31545,8151,Expansion Packs,14,0,0.0,14
31546,8151,Game Packs,9,0,0.0,9
31547,8151,Kits,7,0,0.0,7
31548,8151,Stuff Packs,10,1,0.1,9
31549,8152,Expansion Packs,13,0,0.0,13
31550,8152,Game Packs,6,0,0.0,6
31551,8152,Kits,9,1,0.1111111111111111,8
31552,8152,Stuff Packs,13,0,0.0,13
31553,8153,Expansion Packs,2,1,0.5,1
31554,8153,Game Packs,1,0,0.0,1
31555,8153,Kits,1,1,1.0,0
31556,8154,Expansion Packs,11,0,0.0,11
31557,8154,Game Packs,6,1,0.16666666666666666,5
31558,8154,Kits,3,2,0.6666666666666666,1
31559,8154,Stuff Packs,12,2,0.16666666666666666,10
31560,8155,Expansion Packs,9,0,0.0,9
31561,8155,Game Packs,7,0,0.0,7
31562,8155,Kits,2,1,0.5,1
31563,8155,Stuff Packs,4,1,0.25,3
31564,8156,Expansion Packs,16,0,0.0,16
31565,8156,Game Packs,12,0,0.0,12
31566,8156,Kits,30,1,0.03333333333333333,29
31567,8156,Stuff Packs,20,0,0.0,20
31568,8157,Expansion Packs,15,0,0.0,15
31569,8157,Game Packs,5,0,0.0,5
31570,8157,Kits,7,0,0.0,7
31571,8157,Stuff Packs,9,1,0.1111111111111111,8
31572,8158,Expansion Packs,16,0,0.0,16
31573,8158,Game Packs,12,0,0.0,12
31574,8158,Kits,26,1,0.038461538461538464,25
31575,8158,Stuff Packs,20,0,0.0,20
31576,8159,Expansion Packs,14,0,0.0,14
31577,8159,Game Packs,7,1,0.14285714285714285,6
31578,8159,Kits,12,1,0.08333333333333333,11
31579,8159,Stuff Packs,10,2,0.2,8
31580,8160,Expansion Packs,10,0,0.0,10
31581,8160,Game Packs,6,0,0.0,6
31582,8160,Kits,13,0,0.0,13
31583,8160,Stuff Packs,10,1,0.1,9
31584,8161,Expansion Packs,15,0,0.0,15
31585,8161,Game Packs,12,0,0.0,12
31586,8161,Kits,23,0,0.0,23
31587,8161,Stuff Packs,20,0,0.0,20
31588,8162,Expansion Packs,6,0,0.0,6
31589,8162,Game Packs,5,1,0.2,4
31590,8162,Kits,2,2,1.0,0
31591,8162,Stuff Packs,9,4,0.4444444444444444,5
31592,8163,Expansion Packs,16,0,0.0,16
31593,8163,Game Packs,10,0,0.0,10
31594,8163,Kits,28,0,0.0,28
31595,8163,Stuff Packs,12,0,0.0,12
31596,8164,Expansion Packs,11,0,0.0,11
31597,8164,Game Packs,9,0,0.0,9
31598,8164,Kits,5,1,0.2,4
31599,8164,Stuff Packs,8,2,0.25,6
31600,8165,Expansion Packs,10,0,0.0,10
31601,8165,Game Packs,3,0,0.0,3
31602,8165,Kits,1,0,0.0,1
31603,8165,Stuff Packs,2,0,0.0,2
31604,8166,Expansion Packs,14,0,0.0,14
31605,8166,Game Packs,8,1,0.125,7
31606,8166,Kits,4,2,0.5,2
31607,8166,Stuff Packs,10,2,0.2,8
31608,8167,Expansion Packs,16,0,0.0,16
31609,8167,Game Packs,12,1,0.08333333333333333,11
31610,8167,Kits,28,1,0.03571428571428571,27
31611,8167,Stuff Packs,20,4,0.2,16
31612,8168,Expansion Packs,12,0,0.0,12
31613,8168,Game Packs,7,0,0.0,7
31614,8168,Kits,4,2,0.5,2
31615,8168,Stuff Packs,14,4,0.2857142857142857,10
31616,8169,Expansion Packs,16,0,0.0,16
31617,8169,Game Packs,12,0,0.0,12
31618,8169,Kits,33,0,0.0,33
31619,8169,Stuff Packs,20,0,0.0,20
31620,8170,Expansion Packs,16,0,0.0,16
31621,8170,Game Packs,10,0,0.0,10
31622,8170,Kits,2,0,0.0,2
31623,8170,Stuff Packs,8,1,0.125,7
31624,8171,Expansion Packs,16,0,0.0,16
31625,8171,Game Packs,8,0,0.0,8
31626,8171,Kits,19,0,0.0,19
31627,8171,Stuff Packs,15,0,0.0,15
31628,8172,Expansion Packs,16,0,0.0,16
31629,8172,Game Packs,10,0,0.0,10
31630,8172,Kits,4,1,0.25,3
31631,8172,Stuff Packs,20,1,0.05,19
31632,8173,Expansion Packs,14,0,0.0,14
31633,8173,Game Packs,6,0,0.0,6
31634,8173,Stuff Packs,10,2,0.2,8
31635,8174,Expansion Packs,5,2,0.4,3
31636,8174,Game Packs,2,1,0.5,1
31637,8174,Stuff Packs,1,1,1.0,0
31638,8175,Expansion Packs,3,0,0.0,3
31639,8175,Game Packs,1,0,0.0,1
31640,8176,Expansion Packs,11,0,0.0,11
31641,8176,Game Packs,5,0,0.0,5
31642,8176,Kits,5,1,0.2,4
31643,8176,Stuff Packs,4,0,0.0,4
31644,8177,Expansion Packs,13,13,1.0,0
31645,8177,Game Packs,5,5,1.0,0
31646,8177,Kits,2,2,1.0,0
31647,8177,Stuff Packs,3,3,1.0,0
31648,8178,Expansion Packs,13,0,0.0,13
31649,8178,Game Packs,4,0,0.0,4
31650,8178,Kits,1,1,1.0,0
31651,8178,Stuff Packs,6,1,0.16666666666666666,5
31652,8179,Expansion Packs,16,0,0.0,16
31653,8179,Game Packs,10,2,0.2,8
31654,8179,Kits,6,0,0.0,6
31655,8179,Stuff Packs,12,4,0.3333333333333333,8
31656,8180,Expansion Packs,15,0,0.0,15
31657,8180,Game Packs,9,1,0.1111111111111111,8
31658,8180,Kits,8,2,0.25,6
31659,8180,Stuff Packs,11,3,0.2727272727272727,8
31660,8181,Expansion Packs,12,0,0.0,12
31661,8181,Game Packs,8,0,0.0,8
31662,8181,Stuff Packs,9,2,0.2222222222222222,7
31663,8182,Expansion Packs,14,0,0.0,14
31664,8182,Game Packs,9,0,0.0,9
31665,8182,Kits,5,1,0.2,4
31666,8182,Stuff Packs,7,2,0.2857142857142857,5
31667,8183,Expansion Packs,16,0,0.0,16
31668,8183,Game Packs,12,0,0.0,12
31669,8183,Kits,31,0,0.0,31
31670,8183,Stuff Packs,20,0,0.0,20
31671,8184,Expansion Packs,15,0,0.0,15
31672,8184,Game Packs,8,1,0.125,7
31673,8184,Kits,7,3,0.42857142857142855,4
31674,8184,Stuff Packs,11,3,0.2727272727272727,8
31675,8185,Expansion Packs,16,0,0.0,16
31676,8185,Game Packs,11,0,0.0,11
31677,8185,Kits,7,3,0.42857142857142855,4
31678,8185,Stuff Packs,20,1,0.05,19
31679,8186,Expansion Packs,16,0,0.0,16
31680,8186,Game Packs,11,0,0.0,11
31681,8186,Kits,31,1,0.03225806451612903,30
31682,8186,Stuff Packs,20,1,0.05,19
31683,8187,Expansion Packs,13,0,0.0,13
31684,8187,Game Packs,4,0,0.0,4
31685,8187,Kits,2,1,0.5,1
31686,8187,Stuff Packs,5,0,0.0,5
31687,8188,Expansion Packs,16,0,0.0,16
31688,8188,Game Packs,11,0,0.0,11
31689,8188,Kits,11,1,0.09090909090909091,10
31690,8188,Stuff Packs,15,0,0.0,15
31691,8189,Expansion Packs,7,0,0.0,7
31692,8189,Game Packs,2,0,0.0,2
31693,8189,Stuff Packs,5,0,0.0,5
31694,8190,Expansion Packs,12,1,0.08333333333333333,11
31695,8190,Game Packs,7,1,0.14285714285714285,6
31696,8190,Kits,4,4,1.0,0
31697,8190,Stuff Packs,10,3,0.3,7
31698,8191,Expansion Packs,8,0,0.0,8
31699,8191,Game Packs,6,0,0.0,6
31700,8191,Stuff Packs,5,0,0.0,5
31701,8192,Expansion Packs,16,0,0.0,16
31702,8192,Game Packs,7,0,0.0,7
31703,8192,Kits,8,0,0.0,8
31704,8192,Stuff Packs,9,3,0.3333333333333333,6
31705,8193,Expansion Packs,16,0,0.0,16
31706,8193,Game Packs,12,0,0.0,12
31707,8193,Kits,16,0,0.0,16
31708,8193,Stuff Packs,17,0,0.0,17
31709,8194,Expansion Packs,15,0,0.0,15
31710,8194,Game Packs,6,0,0.0,6
31711,8194,Kits,2,0,0.0,2
31712,8194,Stuff Packs,6,2,0.3333333333333333,4
31713,8195,Expansion Packs,16,0,0.0,16
31714,8195,Game Packs,12,0,0.0,12
31715,8195,Kits,33,0,0.0,33
31716,8195,Stuff Packs,20,0,0.0,20
31717,8196,Expansion Packs,16,0,0.0,16
31718,8196,Game Packs,9,0,0.0,9
31719,8196,Kits,11,1,0.09090909090909091,10
31720,8196,Stuff Packs,12,1,0.08333333333333333,11
31721,8197,Expansion Packs,16,0,0.0,16
31722,8197,Game Packs,12,0,0.0,12
31723,8197,Kits,33,1,0.030303030303030304,32
31724,8197,Stuff Packs,20,0,0.0,20
31725,8198,Expansion Packs,15,0,0.0,15
31726,8198,Game Packs,12,0,0.0,12
31727,8198,Kits,10,1,0.1,9
31728,8198,Stuff Packs,18,0,0.0,18
31729,8199,Expansion Packs,9,0,0.0,9
31730,8199,Game Packs,6,0,0.0,6
31731,8199,Kits,2,2,1.0,0
31732,8199,Stuff Packs,7,2,0.2857142857142857,5
31733,8200,Expansion Packs,15,0,0.0,15
31734,8200,Game Packs,10,0,0.0,10
31735,8200,Kits,9,1,0.1111111111111111,8
31736,8200,Stuff Packs,15,1,0.06666666666666667,14
31737,8201,Expansion Packs,4,0,0.0,4
31738,8201,Game Packs,2,1,0.5,1
31739,8201,Kits,2,2,1.0,0
31740,8201,Stuff Packs,4,4,1.0,0
31741,8202,Expansion Packs,10,0,0.0,10
31742,8202,Game Packs,3,0,0.0,3
31743,8202,Stuff Packs,2,0,0.0,2
31744,8203,Expansion Packs,16,0,0.0,16
31745,8203,Game Packs,12,0,0.0,12
31746,8203,Kits,33,0,0.0,33
31747,8203,Stuff Packs,20,0,0.0,20
31748,8204,Expansion Packs,16,0,0.0,16
31749,8204,Game Packs,12,0,0.0,12
31750,8204,Kits,33,0,0.0,33
31751,8204,Stuff Packs,20,0,0.0,20
31752,8205,Expansion Packs,3,0,0.0,3
31753,8205,Game Packs,2,0,0.0,2
31754,8205,Kits,2,1,0.5,1
31755,8205,Stuff Packs,5,3,0.6,2
31756,8206,Expansion Packs,16,0,0.0,16
31757,8206,Game Packs,12,1,0.08333333333333333,11
31758,8206,Kits,23,1,0.043478260869565216,22
31759,8206,Stuff Packs,20,0,0.0,20
31760,8207,Expansion Packs,16,0,0.0,16
31761,8207,Game Packs,12,0,0.0,12
31762,8207,Kits,33,1,0.030303030303030304,32
31763,8207,Stuff Packs,20,0,0.0,20
31764,8208,Expansion Packs,16,0,0.0,16
31765,8208,Game Packs,12,0,0.0,12
31766,8208,Kits,33,0,0.0,33
31767,8208,Stuff Packs,20,0,0.0,20
31768,8209,Expansion Packs,9,0,0.0,9
31769,8209,Game Packs,5,0,0.0,5
31770,8209,Kits,1,0,0.0,1
31771,8209,Stuff Packs,9,0,0.0,9
31772,8210,Expansion Packs,12,0,0.0,12
31773,8210,Game Packs,3,0,0.0,3
31774,8210,Kits,2,1,0.5,1
31775,8210,Stuff Packs,6,1,0.16666666666666666,5
31776,8211,Expansion Packs,4,0,0.0,4
31777,8211,Stuff Packs,3,3,1.0,0
31778,8212,Expansion Packs,14,0,0.0,14
31779,8212,Game Packs,9,0,0.0,9
31780,8212,Kits,4,1,0.25,3
31781,8212,Stuff Packs,15,2,0.13333333333333333,13
31782,8213,Expansion Packs,14,0,0.0,14
31783,8213,Game Packs,11,0,0.0,11
31784,8213,Kits,13,0,0.0,13
31785,8213,Stuff Packs,17,0,0.0,17
31786,8214,Expansion Packs,1,0,0.0,1
31787,8215,Expansion Packs,16,0,0.0,16
31788,8215,Game Packs,12,0,0.0,12
31789,8215,Kits,33,0,0.0,33
31790,8215,Stuff Packs,20,0,0.0,20
31791,8216,Expansion Packs,16,0,0.0,16
31792,8216,Game Packs,12,0,0.0,12
31793,8216,Kits,25,1,0.04,24
31794,8216,Stuff Packs,20,0,0.0,20
31795,8217,Expansion Packs,16,0,0.0,16
31796,8217,Game Packs,11,0,0.0,11
31797,8217,Kits,33,0,0.0,33
31798,8217,Stuff Packs,20,0,0.0,20
31799,8218,Expansion Packs,13,0,0.0,13
31800,8218,Game Packs,6,1,0.16666666666666666,5
31801,8218,Kits,3,3,1.0,0
31802,8218,Stuff Packs,7,4,0.5714285714285714,3
31803,8219,Expansion Packs,15,0,0.0,15
31804,8219,Game Packs,10,0,0.0,10
31805,8219,Kits,1,1,1.0,0
31806,8219,Stuff Packs,16,0,0.0,16
31807,8220,Expansion Packs,16,0,0.0,16
31808,8220,Game Packs,12,0,0.0,12
31809,8220,Kits,28,1,0.03571428571428571,27
31810,8220,Stuff Packs,20,0,0.0,20
31811,8221,Expansion Packs,16,0,0.0,16
31812,8221,Game Packs,12,0,0.0,12
31813,8221,Kits,8,2,0.25,6
31814,8221,Stuff Packs,19,1,0.05263157894736842,18
31815,8222,Expansion Packs,16,0,0.0,16
31816,8222,Game Packs,12,0,0.0,12
31817,8222,Kits,14,0,0.0,14
31818,8222,Stuff Packs,20,0,0.0,20
31819,8223,Expansion Packs,14,0,0.0,14
31820,8223,Game Packs,8,1,0.125,7
31821,8223,Kits,2,1,0.5,1
31822,8223,Stuff Packs,7,0,0.0,7
31823,8224,Expansion Packs,14,0,0.0,14
31824,8224,Game Packs,5,0,0.0,5
31825,8224,Kits,3,1,0.3333333333333333,2
31826,8224,Stuff Packs,3,1,0.3333333333333333,2
31827,8225,Expansion Packs,15,0,0.0,15
31828,8225,Game Packs,12,0,0.0,12
31829,8225,Kits,24,1,0.041666666666666664,23
31830,8225,Stuff Packs,20,0,0.0,20
31831,8226,Expansion Packs,16,0,0.0,16
31832,8226,Game Packs,11,0,0.0,11
31833,8226,Kits,7,2,0.2857142857142857,5
31834,8226,Stuff Packs,13,3,0.23076923076923078,10
31835,8227,Expansion Packs,6,0,0.0,6
31836,8227,Game Packs,2,0,0.0,2
31837,8227,Kits,17,0,0.0,17
31838,8227,Stuff Packs,11,0,0.0,11
31839,8228,Expansion Packs,16,0,0.0,16
31840,8228,Game Packs,12,0,0.0,12
31841,8228,Kits,33,0,0.0,33
31842,8228,Stuff Packs,20,0,0.0,20
31843,8229,Expansion Packs,10,0,0.0,10
31844,8229,Game Packs,5,0,0.0,5
31845,8229,Kits,6,1,0.16666666666666666,5
31846,8229,Stuff Packs,7,2,0.2857142857142857,5
31847,8230,Expansion Packs,16,0,0.0,16
31848,8230,Game Packs,6,0,0.0,6
31849,8230,Kits,11,2,0.18181818181818182,9
31850,8230,Stuff Packs,7,1,0.14285714285714285,6
31851,8231,Expansion Packs,10,0,0.0,10
31852,8231,Game Packs,5,1,0.2,4
31853,8231,Kits,4,2,0.5,2
31854,8231,Stuff Packs,7,1,0.14285714285714285,6
31855,8232,Expansion Packs,14,0,0.0,14
31856,8232,Game Packs,12,0,0.0,12
31857,8232,Kits,14,1,0.07142857142857142,13
31858,8232,Stuff Packs,20,0,0.0,20
31859,8233,Expansion Packs,15,0,0.0,15
31860,8233,Game Packs,12,0,0.0,12
31861,8233,Kits,17,1,0.058823529411764705,16
31862,8233,Stuff Packs,20,0,0.0,20
31863,8234,Expansion Packs,13,0,0.0,13
31864,8234,Game Packs,8,0,0.0,8
31865,8234,Kits,17,0,0.0,17
31866,8234,Stuff Packs,11,0,0.0,11
31867,8235,Expansion Packs,9,0,0.0,9
31868,8235,Game Packs,4,0,0.0,4
31869,8235,Kits,1,1,1.0,0
31870,8235,Stuff Packs,8,3,0.375,5
31871,8236,Expansion Packs,13,0,0.0,13
31872,8236,Game Packs,9,0,0.0,9
31873,8236,Kits,3,2,0.6666666666666666,1
31874,8236,Stuff Packs,14,1,0.07142857142857142,13
31875,8237,Expansion Packs,9,0,0.0,9
31876,8237,Game Packs,5,0,0.0,5
31877,8237,Kits,11,4,0.36363636363636365,7
31878,8237,Stuff Packs,10,2,0.2,8
31879,8238,Expansion Packs,16,0,0.0,16
31880,8238,Game Packs,12,0,0.0,12
31881,8238,Kits,24,0,0.0,24
31882,8238,Stuff Packs,20,0,0.0,20
31883,8239,Expansion Packs,14,0,0.0,14
31884,8239,Game Packs,6,0,0.0,6
31885,8239,Kits,7,1,0.14285714285714285,6
31886,8239,Stuff Packs,13,1,0.07692307692307693,12
31887,8240,Expansion Packs,12,0,0.0,12
31888,8240,Game Packs,7,1,0.14285714285714285,6
31889,8240,Kits,4,3,0.75,1
31890,8240,Stuff Packs,7,3,0.42857142857142855,4
31891,8241,Expansion Packs,14,0,0.0,14
31892,8241,Game Packs,12,1,0.08333333333333333,11
31893,8241,Kits,7,2,0.2857142857142857,5
31894,8241,Stuff Packs,14,0,0.0,14
31895,8242,Expansion Packs,16,0,0.0,16
31896,8242,Game Packs,12,0,0.0,12
31897,8242,Kits,33,0,0.0,33
31898,8242,Stuff Packs,20,0,0.0,20
31899,8243,Expansion Packs,10,0,0.0,10
31900,8243,Game Packs,8,0,0.0,8
31901,8243,Kits,3,1,0.3333333333333333,2
31902,8243,Stuff Packs,7,0,0.0,7
31903,8244,Expansion Packs,15,0,0.0,15
31904,8244,Game Packs,9,0,0.0,9
31905,8244,Kits,3,0,0.0,3
31906,8244,Stuff Packs,17,0,0.0,17
31907,8245,Expansion Packs,16,0,0.0,16
31908,8245,Game Packs,12,1,0.08333333333333333,11
31909,8245,Kits,18,2,0.1111111111111111,16
31910,8245,Stuff Packs,16,4,0.25,12
31911,8246,Expansion Packs,10,0,0.0,10
31912,8246,Game Packs,5,0,0.0,5
31913,8246,Kits,4,4,1.0,0
31914,8246,Stuff Packs,6,3,0.5,3
31915,8247,Expansion Packs,7,0,0.0,7
31916,8247,Game Packs,4,0,0.0,4
31917,8247,Stuff Packs,7,0,0.0,7
31918,8248,Expansion Packs,16,0,0.0,16
31919,8248,Game Packs,12,0,0.0,12
31920,8248,Kits,23,0,0.0,23
31921,8248,Stuff Packs,20,0,0.0,20
31922,8249,Expansion Packs,16,0,0.0,16
31923,8249,Game Packs,12,0,0.0,12
31924,8249,Kits,33,0,0.0,33
31925,8249,Stuff Packs,20,0,0.0,20
31926,8250,Expansion Packs,9,0,0.0,9
31927,8250,Game Packs,4,1,0.25,3
31928,8250,Kits,5,3,0.6,2
31929,8250,Stuff Packs,9,4,0.4444444444444444,5
31930,8251,Expansion Packs,14,0,0.0,14
31931,8251,Game Packs,11,0,0.0,11
31932,8251,Kits,31,2,0.06451612903225806,29
31933,8251,Stuff Packs,20,1,0.05,19
31934,8252,Expansion Packs,16,0,0.0,16
31935,8252,Game Packs,11,0,0.0,11
31936,8252,Kits,33,1,0.030303030303030304,32
31937,8252,Stuff Packs,20,0,0.0,20
31938,8253,Expansion Packs,16,0,0.0,16
31939,8253,Game Packs,11,0,0.0,11
31940,8253,Stuff Packs,18,3,0.16666666666666666,15
31941,8254,Expansion Packs,16,0,0.0,16
31942,8254,Game Packs,11,0,0.0,11
31943,8254,Kits,26,1,0.038461538461538464,25
31944,8254,Stuff Packs,16,3,0.1875,13
31945,8255,Expansion Packs,7,0,0.0,7
31946,8255,Game Packs,1,0,0.0,1
31947,8255,Stuff Packs,2,2,1.0,0
31948,8256,Expansion Packs,1,0,0.0,1
31949,8256,Game Packs,1,0,0.0,1
31950,8256,Kits,2,2,1.0,0
31951,8256,Stuff Packs,3,3,1.0,0
31952,8257,Expansion Packs,14,0,0.0,14
31953,8257,Game Packs,9,1,0.1111111111111111,8
31954,8257,Stuff Packs,8,4,0.5,4
31955,8258,Expansion Packs,13,0,0.0,13
31956,8258,Game Packs,1,0,0.0,1
31957,8258,Kits,1,1,1.0,0
31958,8258,Stuff Packs,5,3,0.6,2
31959,8259,Expansion Packs,14,0,0.0,14
31960,8259,Game Packs,8,0,0.0,8
31961,8259,Kits,10,3,0.3,7
31962,8259,Stuff Packs,18,0,0.0,18
31963,8260,Expansion Packs,16,0,0.0,16
31964,8260,Game Packs,11,0,0.0,11
31965,8260,Kits,26,1,0.038461538461538464,25
31966,8260,Stuff Packs,18,1,0.05555555555555555,17
31967,8261,Expansion Packs,16,0,0.0,16
31968,8261,Game Packs,12,0,0.0,12
31969,8261,Kits,33,0,0.0,33
31970,8261,Stuff Packs,20,0,0.0,20
31971,8262,Expansion Packs,14,0,0.0,14
31972,8262,Game Packs,9,1,0.1111111111111111,8
31973,8262,Kits,10,2,0.2,8
31974,8262,Stuff Packs,10,0,0.0,10
31975,8263,Expansion Packs,16,0,0.0,16
31976,8263,Game Packs,12,0,0.0,12
31977,8263,Kits,33,0,0.0,33
31978,8263,Stuff Packs,20,0,0.0,20
31979,8264,Expansion Packs,16,1,0.0625,15
31980,8264,Game Packs,12,0,0.0,12
31981,8264,Kits,32,0,0.0,32
31982,8264,Stuff Packs,20,0,0.0,20
31983,8265,Expansion Packs,13,0,0.0,13
31984,8265,Game Packs,5,0,0.0,5
31985,8265,Kits,2,1,0.5,1
31986,8265,Stuff Packs,6,3,0.5,3
31987,8266,Expansion Packs,3,0,0.0,3
31988,8266,Game Packs,1,0,0.0,1
31989,8266,Kits,1,1,1.0,0
31990,8266,Stuff Packs,7,3,0.42857142857142855,4
31991,8267,Expansion Packs,16,0,0.0,16
31992,8267,Game Packs,6,1,0.16666666666666666,5
31993,8267,Kits,15,3,0.2,12
31994,8267,Stuff Packs,17,3,0.17647058823529413,14
31995,8268,Expansion Packs,6,0,0.0,6
31996,8268,Game Packs,2,1,0.5,1
31997,8268,Kits,2,1,0.5,1
31998,8268,Stuff Packs,6,4,0.6666666666666666,2
31999,8269,Expansion Packs,15,0,0.0,15
32000,8269,Game Packs,10,0,0.0,10
32001,8269,Kits,2,2,1.0,0
32002,8269,Stuff Packs,12,0,0.0,12
32003,8270,Expansion Packs,16,0,0.0,16
32004,8270,Game Packs,6,0,0.0,6
32005,8270,Kits,8,2,0.25,6
32006,8270,Stuff Packs,12,2,0.16666666666666666,10
32007,8271,Expansion Packs,7,0,0.0,7
32008,8271,Game Packs,3,0,0.0,3
32009,8271,Kits,3,0,0.0,3
32010,8271,Stuff Packs,7,0,0.0,7
32011,8272,Expansion Packs,8,0,0.0,8
32012,8272,Game Packs,3,0,0.0,3
32013,8272,Kits,1,1,1.0,0
32014,8272,Stuff Packs,3,0,0.0,3
32015,8273,Expansion Packs,9,0,0.0,9
32016,8273,Game Packs,7,1,0.14285714285714285,6
32017,8273,Kits,4,2,0.5,2
32018,8273,Stuff Packs,6,4,0.6666666666666666,2
32019,8274,Expansion Packs,16,0,0.0,16
32020,8274,Game Packs,12,0,0.0,12
32021,8274,Kits,33,1,0.030303030303030304,32
32022,8274,Stuff Packs,20,0,0.0,20
32023,8275,Expansion Packs,16,0,0.0,16
32024,8275,Game Packs,12,0,0.0,12
32025,8275,Kits,26,1,0.038461538461538464,25
32026,8275,Stuff Packs,20,0,0.0,20
32027,8276,Expansion Packs,11,0,0.0,11
32028,8276,Game Packs,8,0,0.0,8
32029,8276,Kits,7,2,0.2857142857142857,5
32030,8276,Stuff Packs,8,2,0.25,6
32031,8277,Expansion Packs,16,0,0.0,16
32032,8277,Game Packs,11,0,0.0,11
32033,8277,Kits,25,0,0.0,25
32034,8277,Stuff Packs,20,0,0.0,20
32035,8278,Expansion Packs,10,0,0.0,10
32036,8278,Game Packs,5,1,0.2,4
32037,8278,Kits,4,1,0.25,3
32038,8278,Stuff Packs,9,4,0.4444444444444444,5
32039,8279,Expansion Packs,16,0,0.0,16
32040,8279,Game Packs,12,0,0.0,12
32041,8279,Kits,2,2,1.0,0
32042,8279,Stuff Packs,13,0,0.0,13
32043,8280,Expansion Packs,12,0,0.0,12
32044,8280,Game Packs,6,0,0.0,6
32045,8280,Kits,14,0,0.0,14
32046,8280,Stuff Packs,11,0,0.0,11
32047,8281,Expansion Packs,12,0,0.0,12
32048,8281,Game Packs,3,1,0.3333333333333333,2
32049,8281,Kits,8,3,0.375,5
32050,8281,Stuff Packs,6,3,0.5,3
32051,8282,Expansion Packs,12,0,0.0,12
32052,8282,Game Packs,5,0,0.0,5
32053,8282,Kits,14,0,0.0,14
32054,8282,Stuff Packs,7,0,0.0,7
32055,8283,Expansion Packs,14,0,0.0,14
32056,8283,Game Packs,11,0,0.0,11
32057,8283,Kits,19,1,0.05263157894736842,18
32058,8283,Stuff Packs,15,2,0.13333333333333333,13
32059,8284,Expansion Packs,16,0,0.0,16
32060,8284,Game Packs,7,0,0.0,7
32061,8284,Kits,13,1,0.07692307692307693,12
32062,8284,Stuff Packs,17,3,0.17647058823529413,14
32063,8285,Expansion Packs,13,0,0.0,13
32064,8285,Game Packs,6,0,0.0,6
32065,8285,Kits,2,2,1.0,0
32066,8285,Stuff Packs,7,3,0.42857142857142855,4
32067,8286,Expansion Packs,10,0,0.0,10
32068,8286,Game Packs,6,0,0.0,6
32069,8286,Kits,3,1,0.3333333333333333,2
32070,8286,Stuff Packs,9,1,0.1111111111111111,8
32071,8287,Expansion Packs,16,0,0.0,16
32072,8287,Game Packs,12,1,0.08333333333333333,11
32073,8287,Kits,33,1,0.030303030303030304,32
32074,8287,Stuff Packs,20,0,0.0,20
32075,8288,Expansion Packs,16,0,0.0,16
32076,8288,Game Packs,11,0,0.0,11
32077,8288,Kits,23,1,0.043478260869565216,22
32078,8288,Stuff Packs,16,1,0.0625,15
32079,8289,Expansion Packs,14,0,0.0,14
32080,8289,Game Packs,10,0,0.0,10
32081,8289,Kits,1,1,1.0,0
32082,8289,Stuff Packs,16,6,0.375,10
32083,8290,Expansion Packs,16,0,0.0,16
32084,8290,Game Packs,12,0,0.0,12
32085,8290,Kits,11,0,0.0,11
32086,8290,Stuff Packs,20,0,0.0,20
32087,8291,Expansion Packs,12,0,0.0,12
32088,8291,Game Packs,7,0,0.0,7
32089,8291,Kits,4,1,0.25,3
32090,8291,Stuff Packs,10,3,0.3,7
32091,8292,Expansion Packs,14,0,0.0,14
32092,8292,Game Packs,9,0,0.0,9
32093,8292,Kits,3,3,1.0,0
32094,8292,Stuff Packs,12,4,0.3333333333333333,8
32095,8293,Expansion Packs,16,5,0.3125,11
32096,8293,Game Packs,12,8,0.6666666666666666,4
32097,8293,Kits,33,32,0.9696969696969697,1
32098,8293,Stuff Packs,20,17,0.85,3
32099,8294,Game Packs,1,1,1.0,0
32100,8294,Kits,2,2,1.0,0
32101,8294,Stuff Packs,2,2,1.0,0
32102,8295,Expansion Packs,15,0,0.0,15
32103,8295,Game Packs,8,0,0.0,8
32104,8295,Kits,2,0,0.0,2
32105,8295,Stuff Packs,12,0,0.0,12
32106,8296,Expansion Packs,14,0,0.0,14
32107,8296,Game Packs,11,0,0.0,11
32108,8296,Kits,10,3,0.3,7
32109,8296,Stuff Packs,14,3,0.21428571428571427,11
32110,8297,Expansion Packs,10,0,0.0,10
32111,8297,Game Packs,5,0,0.0,5
32112,8297,Kits,6,0,0.0,6
32113,8297,Stuff Packs,13,0,0.0,13
32114,8298,Expansion Packs,16,0,0.0,16
32115,8298,Game Packs,12,0,0.0,12
32116,8298,Kits,24,0,0.0,24
32117,8298,Stuff Packs,20,0,0.0,20
32118,8299,Expansion Packs,10,0,0.0,10
32119,8299,Game Packs,5,0,0.0,5
32120,8299,Kits,2,0,0.0,2
32121,8299,Stuff Packs,1,0,0.0,1
32122,8300,Expansion Packs,15,0,0.0,15
32123,8300,Game Packs,12,0,0.0,12
32124,8300,Stuff Packs,14,1,0.07142857142857142,13
32125,8301,Expansion Packs,4,0,0.0,4
32126,8301,Game Packs,1,0,0.0,1
32127,8301,Stuff Packs,6,2,0.3333333333333333,4
32128,8302,Expansion Packs,15,0,0.0,15
32129,8302,Game Packs,10,0,0.0,10
32130,8302,Kits,25,0,0.0,25
32131,8302,Stuff Packs,19,0,0.0,19
32132,8303,Expansion Packs,14,0,0.0,14
32133,8303,Game Packs,8,0,0.0,8
32134,8303,Kits,3,2,0.6666666666666666,1
32135,8303,Stuff Packs,12,1,0.08333333333333333,11
32136,8304,Expansion Packs,12,0,0.0,12
32137,8304,Game Packs,8,0,0.0,8
32138,8304,Kits,3,1,0.3333333333333333,2
32139,8304,Stuff Packs,11,2,0.18181818181818182,9
32140,8305,Expansion Packs,12,0,0.0,12
32141,8305,Game Packs,9,0,0.0,9
32142,8305,Kits,2,0,0.0,2
32143,8305,Stuff Packs,17,0,0.0,17
32144,8306,Expansion Packs,15,0,0.0,15
32145,8306,Game Packs,2,0,0.0,2
32146,8306,Stuff Packs,3,3,1.0,0
32147,8307,Expansion Packs,8,0,0.0,8
32148,8307,Game Packs,3,0,0.0,3
32149,8307,Kits,1,1,1.0,0
32150,8307,Stuff Packs,10,5,0.5,5
32151,8308,Expansion Packs,6,0,0.0,6
32152,8308,Game Packs,1,0,0.0,1
32153,8308,Stuff Packs,2,1,0.5,1
32154,8309,Expansion Packs,13,0,0.0,13
32155,8309,Game Packs,7,1,0.14285714285714285,6
32156,8309,Kits,6,2,0.3333333333333333,4
32157,8309,Stuff Packs,13,3,0.23076923076923078,10
32158,8310,Expansion Packs,16,0,0.0,16
32159,8310,Game Packs,12,0,0.0,12
32160,8310,Kits,33,1,0.030303030303030304,32
32161,8310,Stuff Packs,20,0,0.0,20
32162,8311,Expansion Packs,16,0,0.0,16
32163,8311,Game Packs,12,0,0.0,12
32164,8311,Kits,32,0,0.0,32
32165,8311,Stuff Packs,20,0,0.0,20
32166,8312,Expansion Packs,15,0,0.0,15
32167,8312,Game Packs,9,0,0.0,9
32168,8312,Kits,9,2,0.2222222222222222,7
32169,8312,Stuff Packs,19,3,0.15789473684210525,16
32170,8313,Expansion Packs,10,0,0.0,10
32171,8313,Game Packs,2,0,0.0,2
32172,8313,Stuff Packs,6,3,0.5,3
32173,8314,Expansion Packs,10,1,0.1,9
32174,8314,Game Packs,6,1,0.16666666666666666,5
32175,8314,Kits,5,2,0.4,3
32176,8314,Stuff Packs,7,3,0.42857142857142855,4
32177,8315,Expansion Packs,15,0,0.0,15
32178,8315,Game Packs,11,0,0.0,11
32179,8315,Kits,3,1,0.3333333333333333,2
32180,8315,Stuff Packs,20,1,0.05,19
32181,8316,Expansion Packs,7,0,0.0,7
32182,8316,Game Packs,5,0,0.0,5
32183,8316,Kits,4,2,0.5,2
32184,8316,Stuff Packs,6,2,0.3333333333333333,4
32185,8317,Expansion Packs,3,0,0.0,3
32186,8317,Kits,1,0,0.0,1
32187,8317,Stuff Packs,3,3,1.0,0
32188,8318,Expansion Packs,5,0,0.0,5
32189,8318,Game Packs,2,0,0.0,2
32190,8318,Kits,2,1,0.5,1
32191,8318,Stuff Packs,3,0,0.0,3
32192,8319,Expansion Packs,8,0,0.0,8
32193,8319,Game Packs,2,0,0.0,2
32194,8319,Stuff Packs,4,1,0.25,3
32195,8320,Expansion Packs,13,0,0.0,13
32196,8320,Game Packs,11,0,0.0,11
32197,8320,Kits,7,2,0.2857142857142857,5
32198,8320,Stuff Packs,12,0,0.0,12
32199,8321,Expansion Packs,16,0,0.0,16
32200,8321,Game Packs,11,0,0.0,11
32201,8321,Kits,33,1,0.030303030303030304,32
32202,8321,Stuff Packs,20,2,0.1,18
32203,8322,Expansion Packs,8,0,0.0,8
32204,8322,Game Packs,5,0,0.0,5
32205,8322,Stuff Packs,9,0,0.0,9
32206,8323,Expansion Packs,16,0,0.0,16
32207,8323,Game Packs,11,0,0.0,11
32208,8323,Kits,19,1,0.05263157894736842,18
32209,8323,Stuff Packs,20,0,0.0,20
32210,8324,Expansion Packs,3,0,0.0,3
32211,8324,Kits,1,1,1.0,0
32212,8324,Stuff Packs,2,2,1.0,0
32213,8325,Expansion Packs,3,0,0.0,3
32214,8325,Game Packs,1,0,0.0,1
32215,8325,Kits,1,1,1.0,0
32216,8325,Stuff Packs,3,2,0.6666666666666666,1
32217,8326,Expansion Packs,13,9,0.6923076923076923,4
32218,8326,Game Packs,6,6,1.0,0
32219,8326,Kits,11,11,1.0,0
32220,8326,Stuff Packs,7,7,1.0,0
32221,8327,Expansion Packs,15,0,0.0,15
32222,8327,Game Packs,12,0,0.0,12
32223,8327,Kits,32,1,0.03125,31
32224,8327,Stuff Packs,20,0,0.0,20
32225,8328,Expansion Packs,16,0,0.0,16
32226,8328,Game Packs,12,0,0.0,12
32227,8328,Kits,33,0,0.0,33
32228,8328,Stuff Packs,20,0,0.0,20
32229,8329,Expansion Packs,15,0,0.0,15
32230,8329,Game Packs,12,0,0.0,12
32231,8329,Kits,24,1,0.041666666666666664,23
32232,8329,Stuff Packs,20,0,0.0,20
32233,8330,Expansion Packs,12,2,0.16666666666666666,10
32234,8330,Game Packs,5,3,0.6,2
32235,8330,Stuff Packs,4,3,0.75,1
32236,8331,Expansion Packs,16,0,0.0,16
32237,8331,Game Packs,12,0,0.0,12
32238,8331,Kits,24,0,0.0,24
32239,8331,Stuff Packs,20,0,0.0,20
32240,8332,Expansion Packs,6,0,0.0,6
32241,8332,Game Packs,3,0,0.0,3
32242,8332,Stuff Packs,5,0,0.0,5
32243,8333,Expansion Packs,16,0,0.0,16
32244,8333,Game Packs,9,0,0.0,9
32245,8333,Kits,2,0,0.0,2
32246,8333,Stuff Packs,10,1,0.1,9
32247,8334,Expansion Packs,2,0,0.0,2
32248,8334,Game Packs,1,0,0.0,1
32249,8334,Kits,1,1,1.0,0
32250,8334,Stuff Packs,2,1,0.5,1
32251,8335,Expansion Packs,12,0,0.0,12
32252,8335,Game Packs,7,0,0.0,7
32253,8335,Kits,1,1,1.0,0
32254,8335,Stuff Packs,7,1,0.14285714285714285,6
32255,8336,Expansion Packs,3,0,0.0,3
32256,8336,Game Packs,2,0,0.0,2
32257,8336,Stuff Packs,2,0,0.0,2
32258,8337,Expansion Packs,15,0,0.0,15
32259,8337,Game Packs,7,0,0.0,7
32260,8337,Kits,14,1,0.07142857142857142,13
32261,8337,Stuff Packs,14,1,0.07142857142857142,13
32262,8338,Expansion Packs,10,0,0.0,10
32263,8338,Game Packs,10,0,0.0,10
32264,8338,Kits,7,1,0.14285714285714285,6
32265,8338,Stuff Packs,16,0,0.0,16
32266,8339,Expansion Packs,16,0,0.0,16
32267,8339,Game Packs,12,0,0.0,12
32268,8339,Kits,25,0,0.0,25
32269,8339,Stuff Packs,20,0,0.0,20
32270,8340,Expansion Packs,16,0,0.0,16
32271,8340,Game Packs,11,0,0.0,11
32272,8340,Kits,17,0,0.0,17
32273,8340,Stuff Packs,20,1,0.05,19
32274,8341,Expansion Packs,16,0,0.0,16
32275,8341,Game Packs,12,0,0.0,12
32276,8341,Kits,26,0,0.0,26
32277,8341,Stuff Packs,20,0,0.0,20
32278,8342,Expansion Packs,12,0,0.0,12
32279,8342,Game Packs,6,0,0.0,6
32280,8342,Kits,5,3,0.6,2
32281,8342,Stuff Packs,11,0,0.0,11
32282,8343,Expansion Packs,16,0,0.0,16
32283,8343,Game Packs,11,0,0.0,11
32284,8343,Kits,18,1,0.05555555555555555,17
32285,8343,Stuff Packs,18,0,0.0,18
32286,8344,Expansion Packs,9,0,0.0,9
32287,8344,Game Packs,3,0,0.0,3
32288,8344,Kits,1,0,0.0,1
32289,8344,Stuff Packs,4,0,0.0,4
32290,8345,Expansion Packs,16,3,0.1875,13
32291,8345,Game Packs,9,1,0.1111111111111111,8
32292,8345,Kits,7,2,0.2857142857142857,5
32293,8345,Stuff Packs,17,3,0.17647058823529413,14
32294,8346,Expansion Packs,16,0,0.0,16
32295,8346,Game Packs,12,0,0.0,12
32296,8346,Kits,33,0,0.0,33
32297,8346,Stuff Packs,20,0,0.0,20
32298,8347,Expansion Packs,15,0,0.0,15
32299,8347,Game Packs,8,0,0.0,8
32300,8347,Kits,4,0,0.0,4
32301,8347,Stuff Packs,6,1,0.16666666666666666,5
32302,8348,Expansion Packs,4,0,0.0,4
32303,8348,Game Packs,2,1,0.5,1
32304,8348,Kits,1,1,1.0,0
32305,8348,Stuff Packs,4,2,0.5,2
32306,8349,Expansion Packs,15,0,0.0,15
32307,8349,Game Packs,6,1,0.16666666666666666,5
32308,8349,Kits,2,2,1.0,0
32309,8349,Stuff Packs,9,4,0.4444444444444444,5
32310,8350,Expansion Packs,8,1,0.125,7
32311,8350,Game Packs,4,1,0.25,3
32312,8350,Kits,2,2,1.0,0
32313,8350,Stuff Packs,5,3,0.6,2
32314,8351,Expansion Packs,11,0,0.0,11
32315,8351,Game Packs,5,0,0.0,5
32316,8351,Stuff Packs,5,2,0.4,3
32317,8352,Expansion Packs,4,0,0.0,4
32318,8352,Game Packs,3,1,0.3333333333333333,2
32319,8352,Kits,2,2,1.0,0
32320,8352,Stuff Packs,6,3,0.5,3
32321,8353,Expansion Packs,16,0,0.0,16
32322,8353,Game Packs,12,0,0.0,12
32323,8353,Kits,33,1,0.030303030303030304,32
32324,8353,Stuff Packs,20,0,0.0,20
32325,8354,Expansion Packs,16,0,0.0,16
32326,8354,Game Packs,12,0,0.0,12
32327,8354,Kits,32,0,0.0,32
32328,8354,Stuff Packs,20,0,0.0,20
32329,8355,Expansion Packs,16,3,0.1875,13
32330,8355,Game Packs,10,2,0.2,8
32331,8355,Kits,12,3,0.25,9
32332,8355,Stuff Packs,18,2,0.1111111111111111,16
32333,8356,Expansion Packs,16,0,0.0,16
32334,8356,Game Packs,11,0,0.0,11
32335,8356,Kits,17,0,0.0,17
32336,8356,Stuff Packs,20,0,0.0,20
32337,8357,Expansion Packs,9,0,0.0,9
32338,8357,Game Packs,5,0,0.0,5
32339,8357,Kits,1,1,1.0,0
32340,8357,Stuff Packs,10,1,0.1,9
32341,8358,Expansion Packs,14,0,0.0,14
32342,8358,Game Packs,4,0,0.0,4
32343,8358,Kits,9,0,0.0,9
32344,8358,Stuff Packs,12,0,0.0,12
32345,8359,Expansion Packs,11,0,0.0,11
32346,8359,Game Packs,3,0,0.0,3
32347,8359,Stuff Packs,5,3,0.6,2
32348,8360,Expansion Packs,4,0,0.0,4
32349,8360,Game Packs,4,0,0.0,4
32350,8360,Kits,6,1,0.16666666666666666,5
32351,8360,Stuff Packs,3,0,0.0,3
32352,8361,Expansion Packs,16,0,0.0,16
32353,8361,Game Packs,11,0,0.0,11
32354,8361,Kits,16,1,0.0625,15
32355,8361,Stuff Packs,20,0,0.0,20
32356,8362,Expansion Packs,16,0,0.0,16
32357,8362,Game Packs,12,0,0.0,12
32358,8362,Kits,33,1,0.030303030303030304,32
32359,8362,Stuff Packs,20,0,0.0,20
32360,8363,Expansion Packs,16,0,0.0,16
32361,8363,Game Packs,12,0,0.0,12
32362,8363,Kits,13,0,0.0,13
32363,8363,Stuff Packs,20,0,0.0,20
32364,8364,Expansion Packs,16,0,0.0,16
32365,8364,Game Packs,11,0,0.0,11
32366,8364,Kits,8,1,0.125,7
32367,8364,Stuff Packs,14,0,0.0,14
32368,8365,Expansion Packs,14,0,0.0,14
32369,8365,Game Packs,12,0,0.0,12
32370,8365,Kits,15,1,0.06666666666666667,14
32371,8365,Stuff Packs,19,0,0.0,19
32372,8366,Expansion Packs,16,0,0.0,16
32373,8366,Game Packs,12,0,0.0,12
32374,8366,Kits,30,2,0.06666666666666667,28
32375,8366,Stuff Packs,17,1,0.058823529411764705,16
32376,8367,Expansion Packs,15,0,0.0,15
32377,8367,Game Packs,11,0,0.0,11
32378,8367,Kits,7,2,0.2857142857142857,5
32379,8367,Stuff Packs,20,0,0.0,20
32380,8368,Expansion Packs,6,0,0.0,6
32381,8368,Game Packs,2,0,0.0,2
32382,8368,Stuff Packs,2,2,1.0,0
32383,8369,Expansion Packs,1,0,0.0,1
32384,8369,Game Packs,3,0,0.0,3
32385,8369,Kits,4,1,0.25,3
32386,8369,Stuff Packs,4,3,0.75,1
32387,8370,Expansion Packs,16,16,1.0,0
32388,8370,Game Packs,12,12,1.0,0
32389,8370,Kits,33,33,1.0,0
32390,8370,Stuff Packs,20,20,1.0,0
32391,8371,Expansion Packs,16,0,0.0,16
32392,8371,Game Packs,12,0,0.0,12
32393,8371,Kits,33,1,0.030303030303030304,32
32394,8371,Stuff Packs,20,0,0.0,20
32395,8372,Expansion Packs,16,0,0.0,16
32396,8372,Game Packs,9,0,0.0,9
32397,8372,Kits,21,1,0.047619047619047616,20
32398,8372,Stuff Packs,16,1,0.0625,15
32399,8373,Expansion Packs,16,0,0.0,16
32400,8373,Game Packs,12,0,0.0,12
32401,8373,Kits,32,6,0.1875,26
32402,8373,Stuff Packs,20,0,0.0,20
32403,8374,Expansion Packs,4,0,0.0,4
32404,8374,Game Packs,3,1,0.3333333333333333,2
32405,8374,Kits,3,3,1.0,0
32406,8374,Stuff Packs,5,2,0.4,3
32407,8375,Expansion Packs,8,8,1.0,0
32408,8375,Game Packs,3,3,1.0,0
32409,8375,Kits,1,1,1.0,0
32410,8375,Stuff Packs,2,2,1.0,0
32411,8376,Expansion Packs,13,0,0.0,13
32412,8376,Game Packs,5,2,0.4,3
32413,8376,Kits,5,3,0.6,2
32414,8376,Stuff Packs,8,3,0.375,5
32415,8377,Expansion Packs,16,0,0.0,16
32416,8377,Game Packs,12,0,0.0,12
32417,8377,Kits,16,0,0.0,16
32418,8377,Stuff Packs,20,0,0.0,20
32419,8378,Expansion Packs,12,0,0.0,12
32420,8378,Game Packs,12,0,0.0,12
32421,8378,Kits,18,0,0.0,18
32422,8378,Stuff Packs,18,0,0.0,18
32423,8379,Expansion Packs,9,0,0.0,9
32424,8379,Game Packs,2,0,0.0,2
32425,8379,Kits,7,0,0.0,7
32426,8379,Stuff Packs,5,0,0.0,5
32427,8380,Expansion Packs,5,0,0.0,5
32428,8380,Game Packs,3,0,0.0,3
32429,8380,Kits,11,1,0.09090909090909091,10
32430,8380,Stuff Packs,5,0,0.0,5
32431,8381,Expansion Packs,15,0,0.0,15
32432,8381,Game Packs,10,0,0.0,10
32433,8381,Kits,1,1,1.0,0
32434,8381,Stuff Packs,20,0,0.0,20
32435,8382,Expansion Packs,8,0,0.0,8
32436,8382,Game Packs,3,1,0.3333333333333333,2
32437,8382,Kits,3,3,1.0,0
32438,8382,Stuff Packs,6,3,0.5,3
32439,8383,Expansion Packs,16,0,0.0,16
32440,8383,Game Packs,5,0,0.0,5
32441,8383,Kits,19,0,0.0,19
32442,8383,Stuff Packs,14,2,0.14285714285714285,12
32443,8384,Expansion Packs,15,0,0.0,15
32444,8384,Game Packs,5,0,0.0,5
32445,8384,Kits,2,0,0.0,2
32446,8384,Stuff Packs,3,0,0.0,3
32447,8385,Expansion Packs,13,0,0.0,13
32448,8385,Game Packs,5,1,0.2,4
32449,8385,Kits,4,4,1.0,0
32450,8385,Stuff Packs,12,4,0.3333333333333333,8
32451,8386,Expansion Packs,14,0,0.0,14
32452,8386,Game Packs,5,0,0.0,5
32453,8386,Kits,5,0,0.0,5
32454,8386,Stuff Packs,10,3,0.3,7
32455,8387,Expansion Packs,15,0,0.0,15
32456,8387,Game Packs,10,0,0.0,10
32457,8387,Kits,4,0,0.0,4
32458,8387,Stuff Packs,7,0,0.0,7
32459,8388,Expansion Packs,3,0,0.0,3
32460,8388,Game Packs,1,0,0.0,1
32461,8388,Stuff Packs,4,3,0.75,1
32462,8389,Expansion Packs,16,0,0.0,16
32463,8389,Game Packs,12,0,0.0,12
32464,8389,Kits,31,1,0.03225806451612903,30
32465,8389,Stuff Packs,20,0,0.0,20
32466,8390,Expansion Packs,13,0,0.0,13
32467,8390,Game Packs,6,0,0.0,6
32468,8390,Kits,4,2,0.5,2
32469,8390,Stuff Packs,12,3,0.25,9
32470,8391,Expansion Packs,16,0,0.0,16
32471,8391,Game Packs,7,3,0.42857142857142855,4
32472,8391,Kits,18,2,0.1111111111111111,16
32473,8391,Stuff Packs,11,6,0.5454545454545454,5
32474,8392,Expansion Packs,6,0,0.0,6
32475,8392,Kits,2,2,1.0,0
32476,8392,Stuff Packs,1,1,1.0,0
32477,8393,Expansion Packs,9,0,0.0,9
32478,8393,Game Packs,5,0,0.0,5
32479,8393,Kits,2,0,0.0,2
32480,8393,Stuff Packs,8,2,0.25,6
32481,8394,Expansion Packs,10,0,0.0,10
32482,8394,Game Packs,2,0,0.0,2
32483,8394,Stuff Packs,3,0,0.0,3
32484,8395,Expansion Packs,7,0,0.0,7
32485,8395,Kits,1,1,1.0,0
32486,8395,Stuff Packs,2,2,1.0,0
32487,8396,Expansion Packs,15,0,0.0,15
32488,8396,Game Packs,12,0,0.0,12
32489,8396,Kits,5,0,0.0,5
32490,8396,Stuff Packs,20,0,0.0,20
32491,8397,Expansion Packs,11,0,0.0,11
32492,8397,Game Packs,4,0,0.0,4
32493,8397,Kits,5,2,0.4,3
32494,8397,Stuff Packs,9,2,0.2222222222222222,7
32495,8398,Expansion Packs,16,4,0.25,12
32496,8398,Game Packs,8,5,0.625,3
32497,8398,Kits,20,4,0.2,16
32498,8398,Stuff Packs,16,7,0.4375,9
32499,8399,Expansion Packs,16,0,0.0,16
32500,8399,Game Packs,9,0,0.0,9
32501,8399,Kits,16,0,0.0,16
32502,8399,Stuff Packs,16,0,0.0,16
32503,8400,Expansion Packs,14,0,0.0,14
32504,8400,Game Packs,9,0,0.0,9
32505,8400,Kits,2,2,1.0,0
32506,8400,Stuff Packs,13,1,0.07692307692307693,12
32507,8401,Expansion Packs,8,0,0.0,8
32508,8401,Game Packs,5,0,0.0,5
32509,8401,Stuff Packs,3,0,0.0,3
32510,8402,Expansion Packs,16,0,0.0,16
32511,8402,Game Packs,12,0,0.0,12
32512,8402,Kits,28,3,0.10714285714285714,25
32513,8402,Stuff Packs,20,2,0.1,18
32514,8403,Expansion Packs,15,0,0.0,15
32515,8403,Game Packs,11,0,0.0,11
32516,8403,Kits,23,0,0.0,23
32517,8403,Stuff Packs,14,0,0.0,14
32518,8404,Expansion Packs,16,0,0.0,16
32519,8404,Game Packs,12,0,0.0,12
32520,8404,Kits,33,0,0.0,33
32521,8404,Stuff Packs,20,0,0.0,20
32522,8405,Expansion Packs,3,0,0.0,3
32523,8405,Game Packs,1,0,0.0,1
32524,8405,Kits,1,1,1.0,0
32525,8405,Stuff Packs,1,0,0.0,1
32526,8406,Expansion Packs,15,0,0.0,15
32527,8406,Game Packs,11,0,0.0,11
32528,8406,Kits,24,1,0.041666666666666664,23
32529,8406,Stuff Packs,20,0,0.0,20
32530,8407,Expansion Packs,14,0,0.0,14
32531,8407,Game Packs,11,0,0.0,11
32532,8407,Kits,17,0,0.0,17
32533,8407,Stuff Packs,14,1,0.07142857142857142,13
32534,8408,Expansion Packs,3,0,0.0,3
32535,8408,Game Packs,2,0,0.0,2
32536,8408,Kits,1,1,1.0,0
32537,8408,Stuff Packs,5,3,0.6,2
32538,8409,Expansion Packs,16,0,0.0,16
32539,8409,Game Packs,12,0,0.0,12
32540,8409,Kits,23,0,0.0,23
32541,8409,Stuff Packs,20,0,0.0,20
32542,8410,Expansion Packs,16,0,0.0,16
32543,8410,Game Packs,11,0,0.0,11
32544,8410,Kits,11,1,0.09090909090909091,10
32545,8410,Stuff Packs,16,0,0.0,16
32546,8411,Expansion Packs,11,0,0.0,11
32547,8411,Game Packs,8,0,0.0,8
32548,8411,Kits,3,0,0.0,3
32549,8411,Stuff Packs,15,0,0.0,15
32550,8412,Expansion Packs,11,0,0.0,11
32551,8412,Game Packs,10,0,0.0,10
32552,8412,Kits,4,1,0.25,3
32553,8412,Stuff Packs,18,0,0.0,18
32554,8413,Expansion Packs,14,0,0.0,14
32555,8413,Game Packs,11,0,0.0,11
32556,8413,Kits,6,1,0.16666666666666666,5
32557,8413,Stuff Packs,19,1,0.05263157894736842,18
32558,8414,Expansion Packs,10,0,0.0,10
32559,8414,Game Packs,2,0,0.0,2
32560,8414,Kits,2,1,0.5,1
32561,8414,Stuff Packs,10,3,0.3,7
32562,8415,Expansion Packs,16,0,0.0,16
32563,8415,Game Packs,12,0,0.0,12
32564,8415,Kits,33,2,0.06060606060606061,31
32565,8415,Stuff Packs,19,0,0.0,19
32566,8416,Expansion Packs,16,0,0.0,16
32567,8416,Game Packs,11,0,0.0,11
32568,8416,Kits,27,1,0.037037037037037035,26
32569,8416,Stuff Packs,20,0,0.0,20
32570,8417,Expansion Packs,16,0,0.0,16
32571,8417,Game Packs,10,0,0.0,10
32572,8417,Kits,4,1,0.25,3
32573,8417,Stuff Packs,11,0,0.0,11
32574,8418,Expansion Packs,8,0,0.0,8
32575,8418,Game Packs,2,0,0.0,2
32576,8418,Kits,1,1,1.0,0
32577,8418,Stuff Packs,4,2,0.5,2
32578,8419,Expansion Packs,13,0,0.0,13
32579,8419,Game Packs,7,0,0.0,7
32580,8419,Kits,4,3,0.75,1
32581,8419,Stuff Packs,15,2,0.13333333333333333,13
32582,8420,Expansion Packs,8,0,0.0,8
32583,8420,Game Packs,4,0,0.0,4
32584,8420,Kits,5,0,0.0,5
32585,8420,Stuff Packs,3,0,0.0,3
32586,8421,Expansion Packs,15,0,0.0,15
32587,8421,Game Packs,10,0,0.0,10
32588,8421,Kits,2,2,1.0,0
32589,8421,Stuff Packs,7,0,0.0,7
32590,8422,Expansion Packs,8,0,0.0,8
32591,8422,Game Packs,4,0,0.0,4
32592,8422,Kits,2,0,0.0,2
32593,8422,Stuff Packs,4,0,0.0,4
32594,8423,Expansion Packs,14,0,0.0,14
32595,8423,Game Packs,10,0,0.0,10
32596,8423,Kits,12,1,0.08333333333333333,11
32597,8423,Stuff Packs,17,1,0.058823529411764705,16
32598,8424,Expansion Packs,11,0,0.0,11
32599,8424,Game Packs,4,2,0.5,2
32600,8424,Kits,2,0,0.0,2
32601,8424,Stuff Packs,8,3,0.375,5
32602,8425,Expansion Packs,16,0,0.0,16
32603,8425,Game Packs,11,0,0.0,11
32604,8425,Kits,16,0,0.0,16
32605,8425,Stuff Packs,18,0,0.0,18
32606,8426,Expansion Packs,5,0,0.0,5
32607,8426,Game Packs,1,0,0.0,1
32608,8426,Stuff Packs,2,0,0.0,2
32609,8427,Expansion Packs,13,0,0.0,13
32610,8427,Game Packs,7,0,0.0,7
32611,8427,Kits,11,1,0.09090909090909091,10
32612,8427,Stuff Packs,16,2,0.125,14
32613,8428,Expansion Packs,16,0,0.0,16
32614,8428,Game Packs,12,0,0.0,12
32615,8428,Kits,10,0,0.0,10
32616,8428,Stuff Packs,17,1,0.058823529411764705,16
32617,8429,Expansion Packs,16,0,0.0,16
32618,8429,Game Packs,12,0,0.0,12
32619,8429,Kits,33,0,0.0,33
32620,8429,Stuff Packs,20,0,0.0,20
32621,8430,Expansion Packs,16,1,0.0625,15
32622,8430,Game Packs,12,0,0.0,12
32623,8430,Kits,33,0,0.0,33
32624,8430,Stuff Packs,20,0,0.0,20
32625,8431,Expansion Packs,6,0,0.0,6
32626,8431,Game Packs,6,0,0.0,6
32627,8431,Kits,10,0,0.0,10
32628,8431,Stuff Packs,9,3,0.3333333333333333,6
32629,8432,Expansion Packs,16,0,0.0,16
32630,8432,Game Packs,11,0,0.0,11
32631,8432,Kits,28,1,0.03571428571428571,27
32632,8432,Stuff Packs,20,0,0.0,20
32633,8433,Expansion Packs,15,0,0.0,15
32634,8433,Game Packs,12,0,0.0,12
32635,8433,Kits,33,0,0.0,33
32636,8433,Stuff Packs,20,0,0.0,20
32637,8434,Expansion Packs,14,0,0.0,14
32638,8434,Game Packs,7,0,0.0,7
32639,8434,Kits,13,0,0.0,13
32640,8434,Stuff Packs,16,1,0.0625,15
32641,8435,Expansion Packs,15,0,0.0,15
32642,8435,Game Packs,6,0,0.0,6
32643,8435,Stuff Packs,11,0,0.0,11
32644,8436,Expansion Packs,16,10,0.625,6
32645,8436,Game Packs,12,7,0.5833333333333334,5
32646,8436,Kits,20,20,1.0,0
32647,8436,Stuff Packs,20,16,0.8,4
32648,8437,Expansion Packs,13,0,0.0,13
32649,8437,Game Packs,4,1,0.25,3
32650,8437,Kits,2,1,0.5,1
32651,8437,Stuff Packs,7,1,0.14285714285714285,6
32652,8438,Expansion Packs,16,0,0.0,16
32653,8438,Game Packs,11,0,0.0,11
32654,8438,Kits,23,0,0.0,23
32655,8438,Stuff Packs,20,0,0.0,20
32656,8439,Expansion Packs,12,0,0.0,12
32657,8439,Game Packs,4,0,0.0,4
32658,8439,Kits,1,0,0.0,1
32659,8439,Stuff Packs,3,1,0.3333333333333333,2
32660,8440,Kits,1,1,1.0,0
32661,8440,Stuff Packs,3,3,1.0,0
32662,8441,Expansion Packs,16,0,0.0,16
32663,8441,Game Packs,11,0,0.0,11
32664,8441,Kits,8,0,0.0,8
32665,8441,Stuff Packs,18,0,0.0,18
32666,8442,Expansion Packs,16,0,0.0,16
32667,8442,Game Packs,12,0,0.0,12
32668,8442,Stuff Packs,20,0,0.0,20
32669,8443,Expansion Packs,16,0,0.0,16
32670,8443,Game Packs,12,0,0.0,12
32671,8443,Kits,13,0,0.0,13
32672,8443,Stuff Packs,18,0,0.0,18
32673,8444,Expansion Packs,16,0,0.0,16
32674,8444,Game Packs,12,1,0.08333333333333333,11
32675,8444,Kits,23,0,0.0,23
32676,8444,Stuff Packs,18,0,0.0,18
32677,8445,Expansion Packs,10,0,0.0,10
32678,8445,Game Packs,6,0,0.0,6
32679,8445,Kits,2,2,1.0,0
32680,8445,Stuff Packs,6,1,0.16666666666666666,5
32681,8446,Stuff Packs,1,1,1.0,0
32682,8447,Expansion Packs,14,0,0.0,14
32683,8447,Game Packs,11,0,0.0,11
32684,8447,Kits,5,2,0.4,3
32685,8447,Stuff Packs,16,0,0.0,16
32686,8448,Expansion Packs,14,0,0.0,14
32687,8448,Game Packs,11,0,0.0,11
32688,8448,Kits,1,1,1.0,0
32689,8448,Stuff Packs,12,0,0.0,12
32690,8449,Expansion Packs,14,0,0.0,14
32691,8449,Game Packs,9,0,0.0,9
32692,8449,Kits,8,0,0.0,8
32693,8449,Stuff Packs,16,0,0.0,16
32694,8450,Expansion Packs,8,0,0.0,8
32695,8450,Game Packs,5,0,0.0,5
32696,8450,Kits,3,0,0.0,3
32697,8450,Stuff Packs,8,2,0.25,6
32698,8451,Expansion Packs,12,0,0.0,12
32699,8451,Game Packs,7,0,0.0,7
32700,8451,Kits,3,1,0.3333333333333333,2
32701,8451,Stuff Packs,15,1,0.06666666666666667,14
32702,8452,Expansion Packs,13,0,0.0,13
32703,8452,Game Packs,6,1,0.16666666666666666,5
32704,8452,Kits,4,3,0.75,1
32705,8452,Stuff Packs,8,3,0.375,5
32706,8453,Expansion Packs,15,0,0.0,15
32707,8453,Game Packs,10,1,0.1,9
32708,8453,Kits,8,2,0.25,6
32709,8453,Stuff Packs,12,3,0.25,9
32710,8454,Expansion Packs,16,0,0.0,16
32711,8454,Game Packs,12,0,0.0,12
32712,8454,Kits,33,0,0.0,33
32713,8454,Stuff Packs,20,0,0.0,20
32714,8455,Kits,1,1,1.0,0
32715,8455,Stuff Packs,3,3,1.0,0
32716,8456,Expansion Packs,12,0,0.0,12
32717,8456,Game Packs,10,0,0.0,10
32718,8456,Kits,5,0,0.0,5
32719,8456,Stuff Packs,14,0,0.0,14
32720,8457,Expansion Packs,16,0,0.0,16
32721,8457,Game Packs,12,0,0.0,12
32722,8457,Stuff Packs,15,1,0.06666666666666667,14
32723,8458,Expansion Packs,6,0,0.0,6
32724,8458,Game Packs,1,0,0.0,1
32725,8458,Kits,1,0,0.0,1
32726,8458,Stuff Packs,6,3,0.5,3
32727,8459,Expansion Packs,4,0,0.0,4
32728,8459,Game Packs,1,0,0.0,1
32729,8459,Stuff Packs,4,3,0.75,1
32730,8460,Expansion Packs,16,0,0.0,16
32731,8460,Game Packs,11,0,0.0,11
32732,8460,Kits,33,1,0.030303030303030304,32
32733,8460,Stuff Packs,20,0,0.0,20
32734,8461,Expansion Packs,16,0,0.0,16
32735,8461,Game Packs,11,0,0.0,11
32736,8461,Kits,25,1,0.04,24
32737,8461,Stuff Packs,16,1,0.0625,15
32738,8462,Expansion Packs,16,0,0.0,16
32739,8462,Game Packs,10,0,0.0,10
32740,8462,Kits,2,2,1.0,0
32741,8462,Stuff Packs,10,1,0.1,9
32742,8463,Expansion Packs,11,0,0.0,11
32743,8463,Game Packs,9,0,0.0,9
32744,8463,Stuff Packs,19,0,0.0,19
32745,8464,Expansion Packs,10,0,0.0,10
32746,8464,Game Packs,5,0,0.0,5
32747,8464,Kits,4,0,0.0,4
32748,8464,Stuff Packs,9,0,0.0,9
32749,8465,Expansion Packs,16,0,0.0,16
32750,8465,Game Packs,12,0,0.0,12
32751,8465,Kits,33,0,0.0,33
32752,8465,Stuff Packs,20,0,0.0,20
32753,8466,Expansion Packs,14,0,0.0,14
32754,8466,Game Packs,9,0,0.0,9
32755,8466,Kits,2,1,0.5,1
32756,8466,Stuff Packs,15,2,0.13333333333333333,13
32757,8467,Expansion Packs,16,0,0.0,16
32758,8467,Game Packs,12,0,0.0,12
32759,8467,Kits,33,1,0.030303030303030304,32
32760,8467,Stuff Packs,20,0,0.0,20
32761,8468,Kits,2,2,1.0,0
32762,8468,Stuff Packs,3,3,1.0,0
32763,8469,Expansion Packs,15,0,0.0,15
32764,8469,Game Packs,11,0,0.0,11
32765,8469,Kits,13,1,0.07692307692307693,12
32766,8469,Stuff Packs,19,0,0.0,19
32767,8470,Expansion Packs,16,0,0.0,16
32768,8470,Game Packs,11,0,0.0,11
32769,8470,Kits,6,1,0.16666666666666666,5
32770,8470,Stuff Packs,12,0,0.0,12
32771,8471,Expansion Packs,3,0,0.0,3
32772,8471,Game Packs,2,1,0.5,1
32773,8471,Kits,1,1,1.0,0
32774,8471,Stuff Packs,5,3,0.6,2
32775,8472,Expansion Packs,15,0,0.0,15
32776,8472,Game Packs,10,0,0.0,10
32777,8472,Kits,2,2,1.0,0
32778,8472,Stuff Packs,14,0,0.0,14
32779,8473,Expansion Packs,13,0,0.0,13
32780,8473,Game Packs,4,1,0.25,3
32781,8473,Kits,11,3,0.2727272727272727,8
32782,8473,Stuff Packs,10,4,0.4,6
32783,8474,Expansion Packs,14,0,0.0,14
32784,8474,Game Packs,11,0,0.0,11
32785,8474,Kits,5,3,0.6,2
32786,8474,Stuff Packs,18,2,0.1111111111111111,16
32787,8475,Expansion Packs,13,0,0.0,13
32788,8475,Game Packs,9,1,0.1111111111111111,8
32789,8475,Kits,4,1,0.25,3
32790,8475,Stuff Packs,14,3,0.21428571428571427,11
32791,8476,Expansion Packs,11,0,0.0,11
32792,8476,Game Packs,3,1,0.3333333333333333,2
32793,8476,Stuff Packs,8,4,0.5,4
32794,8477,Expansion Packs,15,0,0.0,15
32795,8477,Game Packs,11,0,0.0,11
32796,8477,Kits,17,2,0.11764705882352941,15
32797,8477,Stuff Packs,20,0,0.0,20
32798,8478,Expansion Packs,16,0,0.0,16
32799,8478,Game Packs,11,0,0.0,11
32800,8478,Kits,17,1,0.058823529411764705,16
32801,8478,Stuff Packs,20,0,0.0,20
32802,8479,Expansion Packs,8,0,0.0,8
32803,8479,Game Packs,4,1,0.25,3
32804,8479,Kits,2,1,0.5,1
32805,8479,Stuff Packs,5,1,0.2,4
32806,8480,Expansion Packs,16,0,0.0,16
32807,8480,Game Packs,12,0,0.0,12
32808,8480,Kits,18,0,0.0,18
32809,8480,Stuff Packs,20,0,0.0,20
32810,8481,Expansion Packs,16,0,0.0,16
32811,8481,Game Packs,12,0,0.0,12
32812,8481,Kits,14,1,0.07142857142857142,13
32813,8481,Stuff Packs,20,0,0.0,20
32814,8482,Expansion Packs,8,0,0.0,8
32815,8482,Game Packs,4,0,0.0,4
32816,8482,Kits,4,1,0.25,3
32817,8482,Stuff Packs,4,0,0.0,4
32818,8483,Expansion Packs,16,0,0.0,16
32819,8483,Game Packs,12,0,0.0,12
32820,8483,Kits,16,1,0.0625,15
32821,8483,Stuff Packs,20,0,0.0,20
32822,8484,Expansion Packs,16,0,0.0,16
32823,8484,Game Packs,6,0,0.0,6
32824,8484,Kits,7,2,0.2857142857142857,5
32825,8484,Stuff Packs,11,3,0.2727272727272727,8
32826,8485,Expansion Packs,15,0,0.0,15
32827,8485,Game Packs,11,1,0.09090909090909091,10
32828,8485,Kits,11,2,0.18181818181818182,9
32829,8485,Stuff Packs,20,1,0.05,19
32830,8486,Kits,1,1,1.0,0
32831,8486,Stuff Packs,1,1,1.0,0
32832,8487,Expansion Packs,13,0,0.0,13
32833,8487,Game Packs,7,0,0.0,7
32834,8487,Kits,5,1,0.2,4
32835,8487,Stuff Packs,14,1,0.07142857142857142,13
32836,8488,Expansion Packs,7,0,0.0,7
32837,8488,Game Packs,4,0,0.0,4
32838,8488,Kits,1,1,1.0,0
32839,8488,Stuff Packs,2,1,0.5,1
32840,8489,Expansion Packs,1,1,1.0,0
32841,8489,Stuff Packs,1,0,0.0,1
32842,8490,Expansion Packs,16,0,0.0,16
32843,8490,Game Packs,11,0,0.0,11
32844,8490,Kits,9,1,0.1111111111111111,8
32845,8490,Stuff Packs,11,2,0.18181818181818182,9
32846,8491,Expansion Packs,1,0,0.0,1
32847,8491,Kits,2,0,0.0,2
32848,8491,Stuff Packs,4,2,0.5,2
32849,8492,Expansion Packs,3,0,0.0,3
32850,8492,Game Packs,2,0,0.0,2
32851,8492,Stuff Packs,3,0,0.0,3
32852,8493,Expansion Packs,15,0,0.0,15
32853,8493,Game Packs,12,0,0.0,12
32854,8493,Kits,16,1,0.0625,15
32855,8493,Stuff Packs,20,0,0.0,20
32856,8494,Expansion Packs,16,0,0.0,16
32857,8494,Game Packs,12,2,0.16666666666666666,10
32858,8494,Kits,25,2,0.08,23
32859,8494,Stuff Packs,17,2,0.11764705882352941,15
32860,8495,Expansion Packs,6,0,0.0,6
32861,8495,Game Packs,5,0,0.0,5
32862,8495,Kits,1,1,1.0,0
32863,8495,Stuff Packs,2,0,0.0,2
32864,8496,Kits,1,0,0.0,1
32865,8497,Expansion Packs,16,0,0.0,16
32866,8497,Game Packs,9,0,0.0,9
32867,8497,Kits,24,1,0.041666666666666664,23
32868,8497,Stuff Packs,15,0,0.0,15
32869,8498,Expansion Packs,12,0,0.0,12
32870,8498,Game Packs,8,0,0.0,8
32871,8498,Kits,5,1,0.2,4
32872,8498,Stuff Packs,13,2,0.15384615384615385,11
32873,8499,Expansion Packs,16,0,0.0,16
32874,8499,Game Packs,10,0,0.0,10
32875,8499,Kits,12,1,0.08333333333333333,11
32876,8499,Stuff Packs,13,2,0.15384615384615385,11
32877,8500,Expansion Packs,7,0,0.0,7
32878,8500,Game Packs,4,0,0.0,4
32879,8500,Kits,4,1,0.25,3
32880,8500,Stuff Packs,10,3,0.3,7
32881,8501,Expansion Packs,16,0,0.0,16
32882,8501,Game Packs,7,0,0.0,7
32883,8501,Kits,10,1,0.1,9
32884,8501,Stuff Packs,11,1,0.09090909090909091,10
32885,8502,Expansion Packs,10,0,0.0,10
32886,8502,Game Packs,7,0,0.0,7
32887,8502,Kits,9,0,0.0,9
32888,8502,Stuff Packs,12,0,0.0,12
32889,8503,Expansion Packs,16,0,0.0,16
32890,8503,Game Packs,8,0,0.0,8
32891,8503,Kits,2,2,1.0,0
32892,8503,Stuff Packs,13,1,0.07692307692307693,12
32893,8504,Expansion Packs,10,0,0.0,10
32894,8504,Game Packs,7,0,0.0,7
32895,8504,Stuff Packs,6,0,0.0,6
32896,8505,Expansion Packs,5,0,0.0,5
32897,8505,Game Packs,1,0,0.0,1
32898,8505,Kits,3,1,0.3333333333333333,2
32899,8505,Stuff Packs,1,0,0.0,1
32900,8506,Expansion Packs,7,0,0.0,7
32901,8506,Game Packs,3,1,0.3333333333333333,2
32902,8506,Kits,2,2,1.0,0
32903,8506,Stuff Packs,5,4,0.8,1
32904,8507,Expansion Packs,10,0,0.0,10
32905,8507,Game Packs,6,0,0.0,6
32906,8507,Kits,3,2,0.6666666666666666,1
32907,8507,Stuff Packs,10,2,0.2,8
32908,8508,Expansion Packs,16,0,0.0,16
32909,8508,Game Packs,12,0,0.0,12
32910,8508,Kits,33,0,0.0,33
32911,8508,Stuff Packs,20,0,0.0,20
32912,8509,Expansion Packs,3,0,0.0,3
32913,8509,Game Packs,1,0,0.0,1
32914,8509,Stuff Packs,5,3,0.6,2
32915,8510,Expansion Packs,14,0,0.0,14
32916,8510,Game Packs,3,0,0.0,3
32917,8510,Kits,15,1,0.06666666666666667,14
32918,8510,Stuff Packs,7,0,0.0,7
32919,8511,Expansion Packs,15,0,0.0,15
32920,8511,Game Packs,9,0,0.0,9
32921,8511,Kits,7,1,0.14285714285714285,6
32922,8511,Stuff Packs,12,0,0.0,12
32923,8512,Expansion Packs,11,0,0.0,11
32924,8512,Game Packs,6,0,0.0,6
32925,8512,Kits,1,1,1.0,0
32926,8512,Stuff Packs,10,0,0.0,10
32927,8513,Expansion Packs,2,0,0.0,2
32928,8513,Game Packs,1,0,0.0,1
32929,8513,Kits,2,1,0.5,1
32930,8513,Stuff Packs,3,0,0.0,3
32931,8514,Expansion Packs,2,0,0.0,2
32932,8514,Game Packs,1,0,0.0,1
32933,8514,Kits,1,0,0.0,1
32934,8514,Stuff Packs,2,0,0.0,2
32935,8515,Expansion Packs,10,0,0.0,10
32936,8515,Game Packs,2,0,0.0,2
32937,8515,Stuff Packs,1,0,0.0,1
32938,8516,Expansion Packs,15,0,0.0,15
32939,8516,Game Packs,11,0,0.0,11
32940,8516,Kits,14,1,0.07142857142857142,13
32941,8516,Stuff Packs,18,0,0.0,18
32942,8517,Expansion Packs,9,0,0.0,9
32943,8517,Game Packs,4,0,0.0,4
32944,8517,Kits,2,2,1.0,0
32945,8517,Stuff Packs,7,2,0.2857142857142857,5
32946,8518,Expansion Packs,9,2,0.2222222222222222,7
32947,8518,Game Packs,6,2,0.3333333333333333,4
32948,8518,Kits,2,0,0.0,2
32949,8518,Stuff Packs,3,0,0.0,3
32950,8519,Expansion Packs,14,0,0.0,14
32951,8519,Game Packs,8,0,0.0,8
32952,8519,Kits,2,2,1.0,0
32953,8519,Stuff Packs,15,1,0.06666666666666667,14
32954,8520,Expansion Packs,13,0,0.0,13
32955,8520,Game Packs,6,0,0.0,6
32956,8520,Kits,2,1,0.5,1
32957,8520,Stuff Packs,13,2,0.15384615384615385,11
32958,8521,Expansion Packs,15,0,0.0,15
32959,8521,Game Packs,9,0,0.0,9
32960,8521,Kits,15,0,0.0,15
32961,8521,Stuff Packs,11,0,0.0,11
32962,8522,Expansion Packs,8,0,0.0,8
32963,8522,Game Packs,2,0,0.0,2
32964,8522,Kits,5,0,0.0,5
32965,8522,Stuff Packs,8,2,0.25,6
32966,8523,Expansion Packs,16,0,0.0,16
32967,8523,Game Packs,12,0,0.0,12
32968,8523,Kits,25,1,0.04,24
32969,8523,Stuff Packs,20,0,0.0,20
32970,8524,Expansion Packs,2,1,0.5,1
32971,8524,Kits,1,0,0.0,1
32972,8524,Stuff Packs,3,2,0.6666666666666666,1
32973,8525,Expansion Packs,11,0,0.0,11
32974,8525,Game Packs,10,0,0.0,10
32975,8525,Stuff Packs,14,0,0.0,14
32976,8526,Expansion Packs,16,0,0.0,16
32977,8526,Game Packs,10,0,0.0,10
32978,8526,Kits,4,1,0.25,3
32979,8526,Stuff Packs,11,3,0.2727272727272727,8
32980,8527,Expansion Packs,10,0,0.0,10
32981,8527,Game Packs,2,1,0.5,1
32982,8527,Kits,4,1,0.25,3
32983,8527,Stuff Packs,5,2,0.4,3
32984,8528,Expansion Packs,13,0,0.0,13
32985,8528,Game Packs,7,0,0.0,7
32986,8528,Kits,10,1,0.1,9
32987,8528,Stuff Packs,14,2,0.14285714285714285,12
32988,8529,Expansion Packs,11,0,0.0,11
32989,8529,Game Packs,5,0,0.0,5
32990,8529,Kits,2,1,0.5,1
32991,8529,Stuff Packs,7,1,0.14285714285714285,6
32992,8530,Expansion Packs,6,0,0.0,6
32993,8530,Game Packs,3,0,0.0,3
32994,8530,Stuff Packs,5,0,0.0,5
32995,8531,Expansion Packs,15,0,0.0,15
32996,8531,Game Packs,9,0,0.0,9
32997,8531,Kits,2,0,0.0,2
32998,8531,Stuff Packs,9,0,0.0,9
32999,8532,Expansion Packs,9,0,0.0,9
33000,8532,Game Packs,5,0,0.0,5
33001,8532,Kits,2,2,1.0,0
33002,8532,Stuff Packs,7,2,0.2857142857142857,5
33003,8533,Expansion Packs,14,1,0.07142857142857142,13
33004,8533,Game Packs,6,1,0.16666666666666666,5
33005,8533,Kits,1,0,0.0,1
33006,8533,Stuff Packs,5,1,0.2,4
33007,8534,Expansion Packs,10,0,0.0,10
33008,8534,Game Packs,4,1,0.25,3
33009,8534,Kits,30,1,0.03333333333333333,29
33010,8534,Stuff Packs,17,0,0.0,17
33011,8535,Expansion Packs,8,0,0.0,8
33012,8535,Game Packs,4,2,0.5,2
33013,8535,Kits,1,1,1.0,0
33014,8535,Stuff Packs,9,3,0.3333333333333333,6
33015,8536,Expansion Packs,10,0,0.0,10
33016,8536,Game Packs,6,0,0.0,6
33017,8536,Stuff Packs,7,4,0.5714285714285714,3
33018,8537,Expansion Packs,9,0,0.0,9
33019,8537,Game Packs,5,0,0.0,5
33020,8537,Kits,9,0,0.0,9
33021,8537,Stuff Packs,13,0,0.0,13
33022,8538,Expansion Packs,14,0,0.0,14
33023,8538,Game Packs,6,0,0.0,6
33024,8538,Kits,13,1,0.07692307692307693,12
33025,8538,Stuff Packs,10,0,0.0,10
33026,8539,Expansion Packs,16,0,0.0,16
33027,8539,Game Packs,11,0,0.0,11
33028,8539,Kits,33,1,0.030303030303030304,32
33029,8539,Stuff Packs,20,0,0.0,20
33030,8540,Expansion Packs,15,0,0.0,15
33031,8540,Game Packs,6,0,0.0,6
33032,8540,Kits,7,0,0.0,7
33033,8540,Stuff Packs,17,0,0.0,17
33034,8541,Expansion Packs,14,0,0.0,14
33035,8541,Game Packs,11,0,0.0,11
33036,8541,Kits,2,1,0.5,1
33037,8541,Stuff Packs,10,1,0.1,9
33038,8542,Expansion Packs,16,0,0.0,16
33039,8542,Game Packs,10,0,0.0,10
33040,8542,Kits,12,2,0.16666666666666666,10
33041,8542,Stuff Packs,15,2,0.13333333333333333,13
33042,8543,Expansion Packs,16,0,0.0,16
33043,8543,Game Packs,11,0,0.0,11
33044,8543,Kits,25,0,0.0,25
33045,8543,Stuff Packs,20,1,0.05,19
33046,8544,Expansion Packs,16,0,0.0,16
33047,8544,Game Packs,11,0,0.0,11
33048,8544,Kits,3,1,0.3333333333333333,2
33049,8544,Stuff Packs,17,1,0.058823529411764705,16
33050,8545,Expansion Packs,15,0,0.0,15
33051,8545,Game Packs,4,0,0.0,4
33052,8545,Kits,2,2,1.0,0
33053,8545,Stuff Packs,13,1,0.07692307692307693,12
33054,8546,Expansion Packs,6,0,0.0,6
33055,8546,Game Packs,4,1,0.25,3
33056,8546,Kits,7,3,0.42857142857142855,4
33057,8546,Stuff Packs,9,4,0.4444444444444444,5
33058,8547,Expansion Packs,16,0,0.0,16
33059,8547,Game Packs,12,0,0.0,12
33060,8547,Kits,25,1,0.04,24
33061,8547,Stuff Packs,20,0,0.0,20
33062,8548,Expansion Packs,15,0,0.0,15
33063,8548,Game Packs,11,0,0.0,11
33064,8548,Kits,15,1,0.06666666666666667,14
33065,8548,Stuff Packs,19,0,0.0,19
33066,8549,Expansion Packs,16,0,0.0,16
33067,8549,Game Packs,12,0,0.0,12
33068,8549,Kits,33,0,0.0,33
33069,8549,Stuff Packs,20,0,0.0,20
33070,8550,Expansion Packs,15,0,0.0,15
33071,8550,Game Packs,11,0,0.0,11
33072,8550,Kits,9,1,0.1111111111111111,8
33073,8550,Stuff Packs,19,0,0.0,19
33074,8551,Expansion Packs,16,0,0.0,16
33075,8551,Game Packs,12,0,0.0,12
33076,8551,Kits,14,2,0.14285714285714285,12
33077,8551,Stuff Packs,20,0,0.0,20
33078,8552,Expansion Packs,16,0,0.0,16
33079,8552,Game Packs,4,0,0.0,4
33080,8552,Kits,7,1,0.14285714285714285,6
33081,8552,Stuff Packs,11,2,0.18181818181818182,9
33082,8553,Expansion Packs,16,0,0.0,16
33083,8553,Game Packs,12,0,0.0,12
33084,8553,Kits,33,0,0.0,33
33085,8553,Stuff Packs,20,0,0.0,20
33086,8554,Expansion Packs,12,0,0.0,12
33087,8554,Game Packs,5,0,0.0,5
33088,8554,Kits,13,1,0.07692307692307693,12
33089,8554,Stuff Packs,14,1,0.07142857142857142,13
33090,8555,Expansion Packs,10,0,0.0,10
33091,8555,Game Packs,9,0,0.0,9
33092,8555,Kits,3,3,1.0,0
33093,8555,Stuff Packs,12,4,0.3333333333333333,8
33094,8556,Expansion Packs,16,0,0.0,16
33095,8556,Game Packs,12,0,0.0,12
33096,8556,Kits,25,0,0.0,25
33097,8556,Stuff Packs,20,0,0.0,20
33098,8557,Expansion Packs,5,0,0.0,5
33099,8557,Game Packs,2,1,0.5,1
33100,8557,Kits,2,1,0.5,1
33101,8557,Stuff Packs,5,3,0.6,2
33102,8558,Expansion Packs,15,0,0.0,15
33103,8558,Game Packs,8,1,0.125,7
33104,8558,Kits,7,0,0.0,7
33105,8558,Stuff Packs,5,1,0.2,4
33106,8559,Expansion Packs,10,0,0.0,10
33107,8559,Game Packs,5,0,0.0,5
33108,8559,Kits,6,0,0.0,6
33109,8559,Stuff Packs,11,1,0.09090909090909091,10
33110,8560,Expansion Packs,16,0,0.0,16
33111,8560,Game Packs,11,0,0.0,11
33112,8560,Kits,20,0,0.0,20
33113,8560,Stuff Packs,17,0,0.0,17
33114,8561,Expansion Packs,16,1,0.0625,15
33115,8561,Game Packs,10,0,0.0,10
33116,8561,Kits,33,1,0.030303030303030304,32
33117,8561,Stuff Packs,19,0,0.0,19
33118,8562,Expansion Packs,2,0,0.0,2
33119,8562,Kits,1,1,1.0,0
33120,8562,Stuff Packs,1,0,0.0,1
33121,8563,Expansion Packs,16,0,0.0,16
33122,8563,Game Packs,11,0,0.0,11
33123,8563,Kits,2,1,0.5,1
33124,8563,Stuff Packs,17,0,0.0,17
33125,8564,Expansion Packs,16,0,0.0,16
33126,8564,Game Packs,11,0,0.0,11
33127,8564,Kits,1,0,0.0,1
33128,8564,Stuff Packs,12,2,0.16666666666666666,10
33129,8565,Expansion Packs,7,4,0.5714285714285714,3
33130,8565,Game Packs,6,4,0.6666666666666666,2
33131,8565,Kits,10,10,1.0,0
33132,8565,Stuff Packs,17,13,0.7647058823529411,4
33133,8566,Expansion Packs,13,0,0.0,13
33134,8566,Game Packs,8,0,0.0,8
33135,8566,Kits,6,1,0.16666666666666666,5
33136,8566,Stuff Packs,13,1,0.07692307692307693,12
33137,8567,Expansion Packs,14,0,0.0,14
33138,8567,Game Packs,3,0,0.0,3
33139,8567,Kits,3,1,0.3333333333333333,2
33140,8567,Stuff Packs,6,3,0.5,3
33141,8568,Kits,2,2,1.0,0
33142,8568,Stuff Packs,3,3,1.0,0
33143,8569,Expansion Packs,7,0,0.0,7
33144,8569,Game Packs,2,0,0.0,2
33145,8569,Kits,1,1,1.0,0
33146,8569,Stuff Packs,5,2,0.4,3
33147,8570,Expansion Packs,16,0,0.0,16
33148,8570,Game Packs,12,0,0.0,12
33149,8570,Kits,8,1,0.125,7
33150,8570,Stuff Packs,19,1,0.05263157894736842,18
33151,8571,Expansion Packs,11,0,0.0,11
33152,8571,Game Packs,6,0,0.0,6
33153,8571,Kits,7,1,0.14285714285714285,6
33154,8571,Stuff Packs,8,2,0.25,6
33155,8572,Expansion Packs,16,0,0.0,16
33156,8572,Game Packs,11,0,0.0,11
33157,8572,Kits,4,0,0.0,4
33158,8572,Stuff Packs,15,0,0.0,15
33159,8573,Expansion Packs,15,0,0.0,15
33160,8573,Game Packs,12,0,0.0,12
33161,8573,Kits,16,0,0.0,16
33162,8573,Stuff Packs,17,0,0.0,17
33163,8574,Expansion Packs,16,0,0.0,16
33164,8574,Game Packs,9,0,0.0,9
33165,8574,Kits,10,1,0.1,9
33166,8574,Stuff Packs,16,3,0.1875,13
33167,8575,Expansion Packs,12,0,0.0,12
33168,8575,Game Packs,8,0,0.0,8
33169,8575,Kits,6,1,0.16666666666666666,5
33170,8575,Stuff Packs,11,2,0.18181818181818182,9
33171,8576,Expansion Packs,16,0,0.0,16
33172,8576,Game Packs,8,1,0.125,7
33173,8576,Kits,26,1,0.038461538461538464,25
33174,8576,Stuff Packs,19,2,0.10526315789473684,17
33175,8577,Expansion Packs,10,0,0.0,10
33176,8577,Game Packs,3,0,0.0,3
33177,8577,Kits,3,1,0.3333333333333333,2
33178,8577,Stuff Packs,7,2,0.2857142857142857,5
33179,8578,Expansion Packs,16,0,0.0,16
33180,8578,Game Packs,7,0,0.0,7
33181,8578,Kits,5,0,0.0,5
33182,8578,Stuff Packs,12,4,0.3333333333333333,8
33183,8579,Expansion Packs,16,0,0.0,16
33184,8579,Game Packs,12,0,0.0,12
33185,8579,Kits,33,1,0.030303030303030304,32
33186,8579,Stuff Packs,20,0,0.0,20
33187,8580,Expansion Packs,7,0,0.0,7
33188,8580,Game Packs,6,1,0.16666666666666666,5
33189,8580,Kits,6,2,0.3333333333333333,4
33190,8580,Stuff Packs,9,4,0.4444444444444444,5
33191,8581,Expansion Packs,14,0,0.0,14
33192,8581,Game Packs,12,0,0.0,12
33193,8581,Kits,8,2,0.25,6
33194,8581,Stuff Packs,14,0,0.0,14
33195,8582,Expansion Packs,16,0,0.0,16
33196,8582,Game Packs,12,1,0.08333333333333333,11
33197,8582,Kits,15,1,0.06666666666666667,14
33198,8582,Stuff Packs,20,0,0.0,20
33199,8583,Expansion Packs,14,0,0.0,14
33200,8583,Game Packs,2,0,0.0,2
33201,8583,Kits,1,1,1.0,0
33202,8583,Stuff Packs,6,3,0.5,3
33203,8584,Expansion Packs,12,0,0.0,12
33204,8584,Game Packs,6,0,0.0,6
33205,8584,Stuff Packs,6,0,0.0,6
33206,8585,Expansion Packs,16,0,0.0,16
33207,8585,Game Packs,11,0,0.0,11
33208,8585,Kits,7,1,0.14285714285714285,6
33209,8585,Stuff Packs,14,2,0.14285714285714285,12
33210,8586,Expansion Packs,14,0,0.0,14
33211,8586,Game Packs,11,0,0.0,11
33212,8586,Kits,10,0,0.0,10
33213,8586,Stuff Packs,9,0,0.0,9
33214,8587,Expansion Packs,16,0,0.0,16
33215,8587,Game Packs,12,0,0.0,12
33216,8587,Kits,33,0,0.0,33
33217,8587,Stuff Packs,20,0,0.0,20
33218,8588,Expansion Packs,16,0,0.0,16
33219,8588,Game Packs,10,0,0.0,10
33220,8588,Kits,20,0,0.0,20
33221,8588,Stuff Packs,20,1,0.05,19
33222,8589,Expansion Packs,15,0,0.0,15
33223,8589,Game Packs,12,0,0.0,12
33224,8589,Kits,9,0,0.0,9
33225,8589,Stuff Packs,17,0,0.0,17
33226,8590,Expansion Packs,14,0,0.0,14
33227,8590,Game Packs,8,0,0.0,8
33228,8590,Kits,9,2,0.2222222222222222,7
33229,8590,Stuff Packs,13,1,0.07692307692307693,12
33230,8591,Expansion Packs,16,0,0.0,16
33231,8591,Game Packs,11,0,0.0,11
33232,8591,Kits,16,1,0.0625,15
33233,8591,Stuff Packs,20,0,0.0,20
33234,8592,Expansion Packs,11,0,0.0,11
33235,8592,Game Packs,6,0,0.0,6
33236,8592,Kits,15,2,0.13333333333333333,13
33237,8592,Stuff Packs,15,0,0.0,15
33238,8593,Expansion Packs,16,0,0.0,16
33239,8593,Game Packs,11,0,0.0,11
33240,8593,Kits,14,2,0.14285714285714285,12
33241,8593,Stuff Packs,14,3,0.21428571428571427,11
33242,8594,Expansion Packs,16,0,0.0,16
33243,8594,Game Packs,10,0,0.0,10
33244,8594,Kits,16,0,0.0,16
33245,8594,Stuff Packs,14,1,0.07142857142857142,13
33246,8595,Expansion Packs,16,0,0.0,16
33247,8595,Game Packs,12,0,0.0,12
33248,8595,Kits,33,3,0.09090909090909091,30
33249,8595,Stuff Packs,20,0,0.0,20
33250,8596,Expansion Packs,7,0,0.0,7
33251,8596,Game Packs,1,0,0.0,1
33252,8596,Stuff Packs,2,1,0.5,1
33253,8597,Expansion Packs,4,0,0.0,4
33254,8597,Game Packs,2,1,0.5,1
33255,8597,Kits,3,2,0.6666666666666666,1
33256,8597,Stuff Packs,7,3,0.42857142857142855,4
33257,8598,Expansion Packs,5,0,0.0,5
33258,8598,Game Packs,2,0,0.0,2
33259,8598,Kits,11,1,0.09090909090909091,10
33260,8598,Stuff Packs,12,3,0.25,9
33261,8599,Expansion Packs,15,0,0.0,15
33262,8599,Game Packs,7,1,0.14285714285714285,6
33263,8599,Kits,23,1,0.043478260869565216,22
33264,8599,Stuff Packs,15,3,0.2,12
33265,8600,Expansion Packs,15,0,0.0,15
33266,8600,Game Packs,9,0,0.0,9
33267,8600,Kits,5,0,0.0,5
33268,8600,Stuff Packs,17,2,0.11764705882352941,15
33269,8601,Expansion Packs,8,0,0.0,8
33270,8601,Game Packs,3,1,0.3333333333333333,2
33271,8601,Kits,2,2,1.0,0
33272,8601,Stuff Packs,5,2,0.4,3
33273,8602,Expansion Packs,16,0,0.0,16
33274,8602,Game Packs,11,0,0.0,11
33275,8602,Kits,33,0,0.0,33
33276,8602,Stuff Packs,19,0,0.0,19
33277,8603,Expansion Packs,7,0,0.0,7
33278,8603,Game Packs,3,0,0.0,3
33279,8603,Stuff Packs,4,2,0.5,2
33280,8604,Expansion Packs,6,0,0.0,6
33281,8604,Game Packs,3,1,0.3333333333333333,2
33282,8604,Kits,2,1,0.5,1
33283,8604,Stuff Packs,7,3,0.42857142857142855,4
33284,8605,Expansion Packs,14,0,0.0,14
33285,8605,Game Packs,5,0,0.0,5
33286,8605,Kits,11,0,0.0,11
33287,8605,Stuff Packs,10,2,0.2,8
33288,8606,Expansion Packs,16,0,0.0,16
33289,8606,Game Packs,9,1,0.1111111111111111,8
33290,8606,Kits,10,2,0.2,8
33291,8606,Stuff Packs,12,4,0.3333333333333333,8
33292,8607,Expansion Packs,16,16,1.0,0
33293,8607,Game Packs,12,10,0.8333333333333334,2
33294,8607,Kits,33,31,0.9393939393939394,2
33295,8607,Stuff Packs,20,16,0.8,4
33296,8608,Expansion Packs,4,0,0.0,4
33297,8608,Game Packs,2,0,0.0,2
33298,8608,Kits,1,0,0.0,1
33299,8608,Stuff Packs,2,0,0.0,2
33300,8609,Expansion Packs,15,0,0.0,15
33301,8609,Game Packs,12,0,0.0,12
33302,8609,Kits,11,1,0.09090909090909091,10
33303,8609,Stuff Packs,20,0,0.0,20
33304,8610,Expansion Packs,12,0,0.0,12
33305,8610,Game Packs,10,0,0.0,10
33306,8610,Kits,8,4,0.5,4
33307,8610,Stuff Packs,17,2,0.11764705882352941,15
33308,8611,Expansion Packs,16,0,0.0,16
33309,8611,Game Packs,12,1,0.08333333333333333,11
33310,8611,Kits,20,1,0.05,19
33311,8611,Stuff Packs,19,1,0.05263157894736842,18
33312,8612,Expansion Packs,13,0,0.0,13
33313,8612,Game Packs,10,0,0.0,10
33314,8612,Kits,3,0,0.0,3
33315,8612,Stuff Packs,8,1,0.125,7
33316,8613,Expansion Packs,16,0,0.0,16
33317,8613,Game Packs,12,0,0.0,12
33318,8613,Kits,33,2,0.06060606060606061,31
33319,8613,Stuff Packs,20,0,0.0,20
33320,8614,Expansion Packs,15,0,0.0,15
33321,8614,Game Packs,12,0,0.0,12
33322,8614,Kits,18,2,0.1111111111111111,16
33323,8614,Stuff Packs,20,0,0.0,20
33324,8615,Expansion Packs,16,0,0.0,16
33325,8615,Game Packs,12,0,0.0,12
33326,8615,Kits,33,1,0.030303030303030304,32
33327,8615,Stuff Packs,20,1,0.05,19
33328,8616,Expansion Packs,4,0,0.0,4
33329,8616,Game Packs,1,0,0.0,1
33330,8616,Kits,1,1,1.0,0
33331,8616,Stuff Packs,1,0,0.0,1
33332,8617,Expansion Packs,13,0,0.0,13
33333,8617,Game Packs,11,0,0.0,11
33334,8617,Kits,9,0,0.0,9
33335,8617,Stuff Packs,9,0,0.0,9
33336,8618,Expansion Packs,16,0,0.0,16
33337,8618,Game Packs,11,0,0.0,11
33338,8618,Kits,7,0,0.0,7
33339,8618,Stuff Packs,6,0,0.0,6
33340,8619,Expansion Packs,16,0,0.0,16
33341,8619,Game Packs,10,0,0.0,10
33342,8619,Kits,15,0,0.0,15
33343,8619,Stuff Packs,17,0,0.0,17
33344,8620,Expansion Packs,11,0,0.0,11
33345,8620,Game Packs,5,0,0.0,5
33346,8620,Kits,11,2,0.18181818181818182,9
33347,8620,Stuff Packs,8,2,0.25,6
33348,8621,Expansion Packs,16,0,0.0,16
33349,8621,Game Packs,12,0,0.0,12
33350,8621,Kits,20,1,0.05,19
33351,8621,Stuff Packs,20,1,0.05,19
33352,8622,Expansion Packs,12,0,0.0,12
33353,8622,Game Packs,9,0,0.0,9
33354,8622,Kits,2,0,0.0,2
33355,8622,Stuff Packs,13,3,0.23076923076923078,10
33356,8623,Expansion Packs,14,0,0.0,14
33357,8623,Game Packs,9,0,0.0,9
33358,8623,Kits,6,1,0.16666666666666666,5
33359,8623,Stuff Packs,18,0,0.0,18
33360,8624,Expansion Packs,15,0,0.0,15
33361,8624,Game Packs,6,1,0.16666666666666666,5
33362,8624,Kits,3,1,0.3333333333333333,2
33363,8624,Stuff Packs,6,3,0.5,3
33364,8625,Expansion Packs,8,0,0.0,8
33365,8625,Game Packs,2,0,0.0,2
33366,8625,Stuff Packs,2,0,0.0,2
33367,8626,Expansion Packs,16,0,0.0,16
33368,8626,Game Packs,12,0,0.0,12
33369,8626,Kits,33,1,0.030303030303030304,32
33370,8626,Stuff Packs,20,0,0.0,20
33371,8627,Expansion Packs,11,0,0.0,11
33372,8627,Game Packs,7,0,0.0,7
33373,8627,Kits,3,3,1.0,0
33374,8627,Stuff Packs,9,3,0.3333333333333333,6
33375,8628,Expansion Packs,5,0,0.0,5
33376,8628,Game Packs,2,0,0.0,2
33377,8628,Kits,2,2,1.0,0
33378,8628,Stuff Packs,3,1,0.3333333333333333,2
33379,8629,Expansion Packs,15,0,0.0,15
33380,8629,Game Packs,11,1,0.09090909090909091,10
33381,8629,Kits,15,15,1.0,0
33382,8629,Stuff Packs,19,3,0.15789473684210525,16
33383,8630,Expansion Packs,13,0,0.0,13
33384,8630,Game Packs,7,0,0.0,7
33385,8630,Kits,5,3,0.6,2
33386,8630,Stuff Packs,11,4,0.36363636363636365,7
33387,8631,Expansion Packs,16,0,0.0,16
33388,8631,Game Packs,12,0,0.0,12
33389,8631,Kits,22,1,0.045454545454545456,21
33390,8631,Stuff Packs,20,0,0.0,20
33391,8632,Expansion Packs,10,1,0.1,9
33392,8632,Game Packs,4,0,0.0,4
33393,8632,Kits,2,1,0.5,1
33394,8632,Stuff Packs,7,1,0.14285714285714285,6
33395,8633,Expansion Packs,11,0,0.0,11
33396,8633,Game Packs,3,0,0.0,3
33397,8633,Kits,3,2,0.6666666666666666,1
33398,8633,Stuff Packs,6,3,0.5,3
33399,8634,Expansion Packs,16,0,0.0,16
33400,8634,Game Packs,12,0,0.0,12
33401,8634,Kits,26,0,0.0,26
33402,8634,Stuff Packs,20,0,0.0,20
33403,8635,Expansion Packs,12,0,0.0,12
33404,8635,Game Packs,1,0,0.0,1
33405,8635,Kits,1,1,1.0,0
33406,8635,Stuff Packs,4,1,0.25,3
33407,8636,Expansion Packs,8,0,0.0,8
33408,8636,Game Packs,3,0,0.0,3
33409,8636,Kits,2,0,0.0,2
33410,8636,Stuff Packs,4,1,0.25,3
33411,8637,Expansion Packs,11,0,0.0,11
33412,8637,Game Packs,7,0,0.0,7
33413,8637,Kits,3,0,0.0,3
33414,8637,Stuff Packs,7,0,0.0,7
33415,8638,Expansion Packs,5,0,0.0,5
33416,8638,Game Packs,1,1,1.0,0
33417,8638,Kits,4,3,0.75,1
33418,8638,Stuff Packs,4,4,1.0,0
33419,8639,Expansion Packs,16,0,0.0,16
33420,8639,Game Packs,12,0,0.0,12
33421,8639,Kits,32,0,0.0,32
33422,8639,Stuff Packs,20,0,0.0,20
33423,8640,Expansion Packs,15,0,0.0,15
33424,8640,Game Packs,10,1,0.1,9
33425,8640,Kits,16,1,0.0625,15
33426,8640,Stuff Packs,20,0,0.0,20
33427,8641,Expansion Packs,16,0,0.0,16
33428,8641,Game Packs,12,0,0.0,12
33429,8641,Kits,33,0,0.0,33
33430,8641,Stuff Packs,20,3,0.15,17
33431,8642,Expansion Packs,12,0,0.0,12
33432,8642,Game Packs,7,1,0.14285714285714285,6
33433,8642,Kits,5,1,0.2,4
33434,8642,Stuff Packs,10,0,0.0,10
33435,8643,Expansion Packs,3,0,0.0,3
33436,8643,Game Packs,3,1,0.3333333333333333,2
33437,8643,Kits,3,0,0.0,3
33438,8643,Stuff Packs,7,3,0.42857142857142855,4
33439,8644,Expansion Packs,12,0,0.0,12
33440,8644,Game Packs,6,1,0.16666666666666666,5
33441,8644,Stuff Packs,6,2,0.3333333333333333,4
33442,8645,Expansion Packs,16,0,0.0,16
33443,8645,Game Packs,12,0,0.0,12
33444,8645,Kits,11,2,0.18181818181818182,9
33445,8645,Stuff Packs,18,0,0.0,18
33446,8646,Expansion Packs,13,0,0.0,13
33447,8646,Game Packs,9,0,0.0,9
33448,8646,Kits,7,2,0.2857142857142857,5
33449,8646,Stuff Packs,17,1,0.058823529411764705,16
33450,8647,Expansion Packs,14,0,0.0,14
33451,8647,Game Packs,7,0,0.0,7
33452,8647,Kits,2,0,0.0,2
33453,8647,Stuff Packs,5,0,0.0,5
33454,8648,Expansion Packs,14,0,0.0,14
33455,8648,Game Packs,8,0,0.0,8
33456,8648,Kits,2,1,0.5,1
33457,8648,Stuff Packs,18,0,0.0,18
33458,8649,Expansion Packs,11,0,0.0,11
33459,8649,Game Packs,5,0,0.0,5
33460,8649,Kits,3,0,0.0,3
33461,8649,Stuff Packs,8,0,0.0,8
33462,8650,Expansion Packs,16,0,0.0,16
33463,8650,Game Packs,11,0,0.0,11
33464,8650,Kits,23,3,0.13043478260869565,20
33465,8650,Stuff Packs,20,1,0.05,19
33466,8651,Expansion Packs,11,0,0.0,11
33467,8651,Game Packs,3,0,0.0,3
33468,8651,Stuff Packs,7,0,0.0,7
33469,8652,Expansion Packs,7,0,0.0,7
33470,8652,Game Packs,2,0,0.0,2
33471,8652,Kits,2,2,1.0,0
33472,8652,Stuff Packs,6,3,0.5,3
33473,8653,Expansion Packs,1,0,0.0,1
33474,8653,Game Packs,4,0,0.0,4
33475,8653,Kits,1,0,0.0,1
33476,8653,Stuff Packs,3,2,0.6666666666666666,1
33477,8654,Expansion Packs,15,0,0.0,15
33478,8654,Game Packs,10,0,0.0,10
33479,8654,Kits,2,2,1.0,0
33480,8654,Stuff Packs,9,0,0.0,9
33481,8655,Expansion Packs,11,0,0.0,11
33482,8655,Game Packs,2,0,0.0,2
33483,8655,Stuff Packs,4,0,0.0,4
33484,8656,Expansion Packs,8,0,0.0,8
33485,8656,Game Packs,2,0,0.0,2
33486,8656,Kits,3,0,0.0,3
33487,8656,Stuff Packs,14,3,0.21428571428571427,11
33488,8657,Expansion Packs,10,0,0.0,10
33489,8657,Game Packs,4,0,0.0,4
33490,8657,Kits,11,1,0.09090909090909091,10
33491,8657,Stuff Packs,7,1,0.14285714285714285,6
33492,8658,Expansion Packs,12,0,0.0,12
33493,8658,Game Packs,4,0,0.0,4
33494,8658,Kits,1,1,1.0,0
33495,8658,Stuff Packs,9,1,0.1111111111111111,8
33496,8659,Expansion Packs,7,0,0.0,7
33497,8659,Game Packs,2,0,0.0,2
33498,8659,Stuff Packs,5,2,0.4,3
33499,8660,Expansion Packs,16,0,0.0,16
33500,8660,Game Packs,12,0,0.0,12
33501,8660,Kits,6,0,0.0,6
33502,8660,Stuff Packs,18,0,0.0,18
33503,8661,Expansion Packs,9,0,0.0,9
33504,8661,Game Packs,3,0,0.0,3
33505,8661,Stuff Packs,3,1,0.3333333333333333,2
33506,8662,Expansion Packs,8,0,0.0,8
33507,8662,Game Packs,7,0,0.0,7
33508,8662,Stuff Packs,16,0,0.0,16
33509,8663,Expansion Packs,4,0,0.0,4
33510,8663,Game Packs,6,0,0.0,6
33511,8663,Kits,1,1,1.0,0
33512,8663,Stuff Packs,10,3,0.3,7
33513,8664,Expansion Packs,5,1,0.2,4
33514,8664,Game Packs,1,0,0.0,1
33515,8664,Stuff Packs,4,2,0.5,2
33516,8665,Expansion Packs,16,0,0.0,16
33517,8665,Game Packs,12,0,0.0,12
33518,8665,Kits,24,0,0.0,24
33519,8665,Stuff Packs,19,0,0.0,19
33520,8666,Expansion Packs,16,0,0.0,16
33521,8666,Game Packs,12,0,0.0,12
33522,8666,Kits,33,0,0.0,33
33523,8666,Stuff Packs,20,1,0.05,19
33524,8667,Expansion Packs,9,0,0.0,9
33525,8667,Game Packs,4,0,0.0,4
33526,8667,Kits,2,2,1.0,0
33527,8667,Stuff Packs,4,2,0.5,2
33528,8668,Expansion Packs,7,0,0.0,7
33529,8668,Game Packs,1,0,0.0,1
33530,8668,Kits,3,0,0.0,3
33531,8668,Stuff Packs,3,0,0.0,3
33532,8669,Expansion Packs,16,0,0.0,16
33533,8669,Game Packs,12,0,0.0,12
33534,8669,Kits,19,0,0.0,19
33535,8669,Stuff Packs,20,1,0.05,19
33536,8670,Expansion Packs,15,4,0.26666666666666666,11
33537,8670,Game Packs,12,5,0.4166666666666667,7
33538,8670,Kits,29,13,0.4482758620689655,16
33539,8670,Stuff Packs,20,7,0.35,13
33540,8671,Expansion Packs,9,0,0.0,9
33541,8671,Game Packs,3,0,0.0,3
33542,8671,Kits,3,2,0.6666666666666666,1
33543,8671,Stuff Packs,8,1,0.125,7
33544,8672,Expansion Packs,16,0,0.0,16
33545,8672,Game Packs,12,0,0.0,12
33546,8672,Kits,27,3,0.1111111111111111,24
33547,8672,Stuff Packs,20,0,0.0,20
33548,8673,Expansion Packs,15,1,0.06666666666666667,14
33549,8673,Game Packs,8,0,0.0,8
33550,8673,Kits,10,2,0.2,8
33551,8673,Stuff Packs,8,1,0.125,7
33552,8674,Expansion Packs,10,0,0.0,10
33553,8674,Game Packs,6,0,0.0,6
33554,8674,Kits,2,1,0.5,1
33555,8674,Stuff Packs,8,3,0.375,5
33556,8675,Expansion Packs,14,0,0.0,14
33557,8675,Game Packs,9,0,0.0,9
33558,8675,Kits,8,1,0.125,7
33559,8675,Stuff Packs,16,0,0.0,16
33560,8676,Expansion Packs,5,0,0.0,5
33561,8676,Stuff Packs,1,0,0.0,1
33562,8677,Expansion Packs,16,16,1.0,0
33563,8677,Game Packs,12,12,1.0,0
33564,8677,Kits,33,33,1.0,0
33565,8677,Stuff Packs,20,20,1.0,0
33566,8678,Expansion Packs,16,0,0.0,16
33567,8678,Game Packs,11,0,0.0,11
33568,8678,Kits,18,0,0.0,18
33569,8678,Stuff Packs,20,0,0.0,20
33570,8679,Expansion Packs,12,0,0.0,12
33571,8679,Game Packs,10,0,0.0,10
33572,8679,Kits,5,1,0.2,4
33573,8679,Stuff Packs,15,0,0.0,15
33574,8680,Expansion Packs,13,0,0.0,13
33575,8680,Game Packs,6,0,0.0,6
33576,8680,Kits,1,0,0.0,1
33577,8680,Stuff Packs,8,2,0.25,6
33578,8681,Expansion Packs,14,0,0.0,14
33579,8681,Game Packs,9,0,0.0,9
33580,8681,Kits,4,1,0.25,3
33581,8681,Stuff Packs,18,0,0.0,18
33582,8682,Expansion Packs,16,0,0.0,16
33583,8682,Game Packs,8,1,0.125,7
33584,8682,Kits,13,2,0.15384615384615385,11
33585,8682,Stuff Packs,19,4,0.21052631578947367,15
33586,8683,Expansion Packs,16,0,0.0,16
33587,8683,Game Packs,12,0,0.0,12
33588,8683,Kits,19,0,0.0,19
33589,8683,Stuff Packs,19,2,0.10526315789473684,17
33590,8684,Expansion Packs,15,0,0.0,15
33591,8684,Game Packs,10,0,0.0,10
33592,8684,Kits,15,0,0.0,15
33593,8684,Stuff Packs,17,0,0.0,17
33594,8685,Expansion Packs,15,0,0.0,15
33595,8685,Game Packs,11,0,0.0,11
33596,8685,Kits,20,0,0.0,20
33597,8685,Stuff Packs,16,3,0.1875,13
33598,8686,Expansion Packs,11,0,0.0,11
33599,8686,Game Packs,4,0,0.0,4
33600,8686,Stuff Packs,7,1,0.14285714285714285,6
33601,8687,Expansion Packs,6,1,0.16666666666666666,5
33602,8687,Game Packs,1,0,0.0,1
33603,8687,Stuff Packs,6,2,0.3333333333333333,4
33604,8688,Expansion Packs,16,0,0.0,16
33605,8688,Game Packs,12,0,0.0,12
33606,8688,Kits,26,1,0.038461538461538464,25
33607,8688,Stuff Packs,20,0,0.0,20
33608,8689,Expansion Packs,15,1,0.06666666666666667,14
33609,8689,Game Packs,10,0,0.0,10
33610,8689,Kits,12,2,0.16666666666666666,10
33611,8689,Stuff Packs,12,2,0.16666666666666666,10
33612,8690,Expansion Packs,5,0,0.0,5
33613,8690,Game Packs,6,1,0.16666666666666666,5
33614,8690,Kits,5,3,0.6,2
33615,8690,Stuff Packs,4,2,0.5,2
33616,8691,Expansion Packs,16,0,0.0,16
33617,8691,Game Packs,12,0,0.0,12
33618,8691,Kits,29,0,0.0,29
33619,8691,Stuff Packs,20,0,0.0,20
33620,8692,Expansion Packs,16,0,0.0,16
33621,8692,Game Packs,10,0,0.0,10
33622,8692,Kits,4,2,0.5,2
33623,8692,Stuff Packs,18,0,0.0,18
33624,8693,Expansion Packs,13,0,0.0,13
33625,8693,Game Packs,4,0,0.0,4
33626,8693,Kits,5,0,0.0,5
33627,8693,Stuff Packs,8,5,0.625,3
33628,8694,Expansion Packs,16,0,0.0,16
33629,8694,Game Packs,11,0,0.0,11
33630,8694,Kits,24,1,0.041666666666666664,23
33631,8694,Stuff Packs,20,0,0.0,20
33632,8695,Expansion Packs,15,0,0.0,15
33633,8695,Game Packs,10,0,0.0,10
33634,8695,Kits,2,2,1.0,0
33635,8695,Stuff Packs,13,2,0.15384615384615385,11
33636,8696,Expansion Packs,16,0,0.0,16
33637,8696,Game Packs,9,0,0.0,9
33638,8696,Kits,3,1,0.3333333333333333,2
33639,8696,Stuff Packs,12,0,0.0,12
33640,8697,Expansion Packs,12,0,0.0,12
33641,8697,Game Packs,9,0,0.0,9
33642,8697,Kits,1,0,0.0,1
33643,8697,Stuff Packs,7,2,0.2857142857142857,5
33644,8698,Expansion Packs,16,0,0.0,16
33645,8698,Game Packs,10,0,0.0,10
33646,8698,Kits,15,2,0.13333333333333333,13
33647,8698,Stuff Packs,16,0,0.0,16
33648,8699,Expansion Packs,16,0,0.0,16
33649,8699,Game Packs,10,0,0.0,10
33650,8699,Kits,13,0,0.0,13
33651,8699,Stuff Packs,20,0,0.0,20
33652,8700,Expansion Packs,15,0,0.0,15
33653,8700,Game Packs,11,0,0.0,11
33654,8700,Kits,4,0,0.0,4
33655,8700,Stuff Packs,10,4,0.4,6
33656,8701,Expansion Packs,15,0,0.0,15
33657,8701,Game Packs,9,0,0.0,9
33658,8701,Kits,8,1,0.125,7
33659,8701,Stuff Packs,17,1,0.058823529411764705,16
33660,8702,Expansion Packs,12,0,0.0,12
33661,8702,Game Packs,6,0,0.0,6
33662,8702,Stuff Packs,9,0,0.0,9
33663,8703,Expansion Packs,16,0,0.0,16
33664,8703,Game Packs,11,0,0.0,11
33665,8703,Kits,9,1,0.1111111111111111,8
33666,8703,Stuff Packs,20,2,0.1,18
33667,8704,Expansion Packs,7,0,0.0,7
33668,8704,Game Packs,3,1,0.3333333333333333,2
33669,8704,Kits,4,3,0.75,1
33670,8704,Stuff Packs,5,3,0.6,2
33671,8705,Expansion Packs,16,0,0.0,16
33672,8705,Game Packs,12,1,0.08333333333333333,11
33673,8705,Kits,33,0,0.0,33
33674,8705,Stuff Packs,20,1,0.05,19
33675,8706,Expansion Packs,10,0,0.0,10
33676,8706,Game Packs,7,0,0.0,7
33677,8706,Stuff Packs,12,0,0.0,12
33678,8707,Expansion Packs,16,0,0.0,16
33679,8707,Game Packs,11,0,0.0,11
33680,8707,Kits,16,0,0.0,16
33681,8707,Stuff Packs,15,0,0.0,15
33682,8708,Expansion Packs,16,0,0.0,16
33683,8708,Game Packs,12,0,0.0,12
33684,8708,Kits,33,0,0.0,33
33685,8708,Stuff Packs,20,2,0.1,18
33686,8709,Expansion Packs,16,0,0.0,16
33687,8709,Game Packs,11,0,0.0,11
33688,8709,Kits,33,1,0.030303030303030304,32
33689,8709,Stuff Packs,20,2,0.1,18
33690,8710,Expansion Packs,2,2,1.0,0
33691,8710,Kits,1,1,1.0,0
33692,8710,Stuff Packs,1,1,1.0,0
33693,8711,Expansion Packs,10,0,0.0,10
33694,8711,Game Packs,9,0,0.0,9
33695,8711,Stuff Packs,17,0,0.0,17
33696,8712,Expansion Packs,14,2,0.14285714285714285,12
33697,8712,Game Packs,11,0,0.0,11
33698,8712,Kits,20,0,0.0,20
33699,8712,Stuff Packs,14,0,0.0,14
33700,8713,Expansion Packs,12,0,0.0,12
33701,8713,Game Packs,8,0,0.0,8
33702,8713,Kits,5,2,0.4,3
33703,8713,Stuff Packs,10,0,0.0,10
33704,8714,Expansion Packs,2,0,0.0,2
33705,8714,Game Packs,1,0,0.0,1
33706,8714,Kits,2,0,0.0,2
33707,8714,Stuff Packs,5,0,0.0,5
33708,8715,Expansion Packs,14,0,0.0,14
33709,8715,Game Packs,11,0,0.0,11
33710,8715,Kits,14,0,0.0,14
33711,8715,Stuff Packs,18,0,0.0,18
33712,8716,Expansion Packs,16,0,0.0,16
33713,8716,Game Packs,11,0,0.0,11
33714,8716,Kits,25,0,0.0,25
33715,8716,Stuff Packs,20,0,0.0,20
33716,8717,Expansion Packs,6,0,0.0,6
33717,8717,Game Packs,4,1,0.25,3
33718,8717,Stuff Packs,5,0,0.0,5
33719,8718,Expansion Packs,16,0,0.0,16
33720,8718,Game Packs,12,0,0.0,12
33721,8718,Kits,33,1,0.030303030303030304,32
33722,8718,Stuff Packs,20,0,0.0,20
33723,8719,Expansion Packs,8,0,0.0,8
33724,8719,Game Packs,4,0,0.0,4
33725,8719,Kits,1,0,0.0,1
33726,8719,Stuff Packs,3,0,0.0,3
33727,8720,Expansion Packs,13,0,0.0,13
33728,8720,Game Packs,5,1,0.2,4
33729,8720,Kits,1,1,1.0,0
33730,8720,Stuff Packs,6,2,0.3333333333333333,4
33731,8721,Game Packs,1,1,1.0,0
33732,8721,Kits,2,2,1.0,0
33733,8721,Stuff Packs,4,4,1.0,0
33734,8722,Expansion Packs,16,0,0.0,16
33735,8722,Game Packs,11,0,0.0,11
33736,8722,Kits,33,1,0.030303030303030304,32
33737,8722,Stuff Packs,20,0,0.0,20
33738,8723,Expansion Packs,16,0,0.0,16
33739,8723,Game Packs,12,0,0.0,12
33740,8723,Kits,33,1,0.030303030303030304,32
33741,8723,Stuff Packs,20,0,0.0,20
33742,8724,Expansion Packs,15,0,0.0,15
33743,8724,Game Packs,8,0,0.0,8
33744,8724,Kits,2,0,0.0,2
33745,8724,Stuff Packs,9,3,0.3333333333333333,6
33746,8725,Expansion Packs,10,0,0.0,10
33747,8725,Game Packs,4,2,0.5,2
33748,8725,Kits,3,3,1.0,0
33749,8725,Stuff Packs,9,4,0.4444444444444444,5
33750,8726,Expansion Packs,9,0,0.0,9
33751,8726,Game Packs,4,0,0.0,4
33752,8726,Stuff Packs,6,2,0.3333333333333333,4
33753,8727,Expansion Packs,9,0,0.0,9
33754,8727,Game Packs,7,0,0.0,7
33755,8727,Kits,1,0,0.0,1
33756,8727,Stuff Packs,7,0,0.0,7
33757,8728,Expansion Packs,13,12,0.9230769230769231,1
33758,8728,Game Packs,10,10,1.0,0
33759,8728,Kits,9,2,0.2222222222222222,7
33760,8728,Stuff Packs,17,17,1.0,0
33761,8729,Expansion Packs,10,0,0.0,10
33762,8729,Game Packs,3,0,0.0,3
33763,8729,Kits,2,2,1.0,0
33764,8729,Stuff Packs,5,2,0.4,3
33765,8730,Expansion Packs,16,0,0.0,16
33766,8730,Game Packs,11,0,0.0,11
33767,8730,Kits,2,2,1.0,0
33768,8730,Stuff Packs,20,0,0.0,20
33769,8731,Expansion Packs,12,0,0.0,12
33770,8731,Game Packs,4,0,0.0,4
33771,8731,Kits,2,1,0.5,1
33772,8731,Stuff Packs,6,2,0.3333333333333333,4
33773,8732,Expansion Packs,16,0,0.0,16
33774,8732,Game Packs,12,0,0.0,12
33775,8732,Kits,33,0,0.0,33
33776,8732,Stuff Packs,20,0,0.0,20
33777,8733,Expansion Packs,15,0,0.0,15
33778,8733,Game Packs,7,0,0.0,7
33779,8733,Kits,4,1,0.25,3
33780,8733,Stuff Packs,12,2,0.16666666666666666,10
33781,8734,Expansion Packs,15,0,0.0,15
33782,8734,Game Packs,9,0,0.0,9
33783,8734,Kits,2,0,0.0,2
33784,8734,Stuff Packs,8,0,0.0,8
33785,8735,Expansion Packs,15,0,0.0,15
33786,8735,Game Packs,12,0,0.0,12
33787,8735,Kits,26,0,0.0,26
33788,8735,Stuff Packs,20,0,0.0,20
33789,8736,Expansion Packs,16,16,1.0,0
33790,8736,Game Packs,12,12,1.0,0
33791,8736,Kits,33,33,1.0,0
33792,8736,Stuff Packs,20,20,1.0,0
33793,8737,Expansion Packs,11,0,0.0,11
33794,8737,Game Packs,4,0,0.0,4
33795,8737,Stuff Packs,5,2,0.4,3
33796,8738,Expansion Packs,14,0,0.0,14
33797,8738,Game Packs,10,0,0.0,10
33798,8738,Kits,7,1,0.14285714285714285,6
33799,8738,Stuff Packs,7,0,0.0,7
33800,8739,Expansion Packs,12,0,0.0,12
33801,8739,Game Packs,4,0,0.0,4
33802,8739,Kits,2,2,1.0,0
33803,8739,Stuff Packs,6,2,0.3333333333333333,4
33804,8740,Expansion Packs,13,0,0.0,13
33805,8740,Game Packs,10,0,0.0,10
33806,8740,Kits,2,2,1.0,0
33807,8740,Stuff Packs,17,1,0.058823529411764705,16
33808,8741,Expansion Packs,13,0,0.0,13
33809,8741,Game Packs,6,0,0.0,6
33810,8741,Kits,7,1,0.14285714285714285,6
33811,8741,Stuff Packs,15,1,0.06666666666666667,14
33812,8742,Expansion Packs,11,0,0.0,11
33813,8742,Game Packs,9,0,0.0,9
33814,8742,Kits,6,1,0.16666666666666666,5
33815,8742,Stuff Packs,12,2,0.16666666666666666,10
33816,8743,Expansion Packs,16,0,0.0,16
33817,8743,Game Packs,8,0,0.0,8
33818,8743,Kits,14,2,0.14285714285714285,12
33819,8743,Stuff Packs,13,1,0.07692307692307693,12
33820,8744,Expansion Packs,12,0,0.0,12
33821,8744,Game Packs,6,0,0.0,6
33822,8744,Kits,5,2,0.4,3
33823,8744,Stuff Packs,12,5,0.4166666666666667,7
33824,8745,Expansion Packs,9,0,0.0,9
33825,8745,Game Packs,8,0,0.0,8
33826,8745,Stuff Packs,9,1,0.1111111111111111,8
33827,8746,Expansion Packs,11,0,0.0,11
33828,8746,Game Packs,3,1,0.3333333333333333,2
33829,8746,Kits,3,2,0.6666666666666666,1
33830,8746,Stuff Packs,6,4,0.6666666666666666,2
33831,8747,Expansion Packs,16,0,0.0,16
33832,8747,Game Packs,12,0,0.0,12
33833,8747,Kits,33,1,0.030303030303030304,32
33834,8747,Stuff Packs,20,0,0.0,20
33835,8748,Expansion Packs,12,0,0.0,12
33836,8748,Game Packs,5,0,0.0,5
33837,8748,Kits,1,1,1.0,0
33838,8748,Stuff Packs,9,2,0.2222222222222222,7
33839,8749,Expansion Packs,15,0,0.0,15
33840,8749,Game Packs,11,0,0.0,11
33841,8749,Kits,18,0,0.0,18
33842,8749,Stuff Packs,20,0,0.0,20
33843,8750,Expansion Packs,10,0,0.0,10
33844,8750,Game Packs,8,0,0.0,8
33845,8750,Kits,2,1,0.5,1
33846,8750,Stuff Packs,10,2,0.2,8
33847,8751,Expansion Packs,3,0,0.0,3
33848,8751,Game Packs,3,0,0.0,3
33849,8751,Kits,3,2,0.6666666666666666,1
33850,8751,Stuff Packs,8,3,0.375,5
33851,8752,Expansion Packs,13,0,0.0,13
33852,8752,Game Packs,11,0,0.0,11
33853,8752,Kits,4,1,0.25,3
33854,8752,Stuff Packs,18,2,0.1111111111111111,16
33855,8753,Expansion Packs,3,0,0.0,3
33856,8753,Kits,1,1,1.0,0
33857,8753,Stuff Packs,4,3,0.75,1
33858,8754,Expansion Packs,9,0,0.0,9
33859,8754,Game Packs,3,0,0.0,3
33860,8754,Stuff Packs,3,0,0.0,3
33861,8755,Expansion Packs,16,0,0.0,16
33862,8755,Game Packs,12,0,0.0,12
33863,8755,Kits,33,2,0.06060606060606061,31
33864,8755,Stuff Packs,20,0,0.0,20
33865,8756,Expansion Packs,15,0,0.0,15
33866,8756,Game Packs,12,0,0.0,12
33867,8756,Kits,21,1,0.047619047619047616,20
33868,8756,Stuff Packs,20,0,0.0,20
33869,8757,Expansion Packs,15,0,0.0,15
33870,8757,Game Packs,12,0,0.0,12
33871,8757,Kits,13,2,0.15384615384615385,11
33872,8757,Stuff Packs,20,0,0.0,20
33873,8758,Expansion Packs,8,0,0.0,8
33874,8758,Game Packs,2,0,0.0,2
33875,8758,Stuff Packs,8,2,0.25,6
33876,8759,Expansion Packs,16,1,0.0625,15
33877,8759,Game Packs,11,0,0.0,11
33878,8759,Kits,13,1,0.07692307692307693,12
33879,8759,Stuff Packs,11,2,0.18181818181818182,9
33880,8760,Expansion Packs,9,0,0.0,9
33881,8760,Game Packs,8,0,0.0,8
33882,8760,Kits,1,1,1.0,0
33883,8760,Stuff Packs,16,0,0.0,16
33884,8761,Expansion Packs,16,0,0.0,16
33885,8761,Game Packs,12,0,0.0,12
33886,8761,Kits,28,1,0.03571428571428571,27
33887,8761,Stuff Packs,20,0,0.0,20
33888,8762,Expansion Packs,14,0,0.0,14
33889,8762,Game Packs,8,0,0.0,8
33890,8762,Stuff Packs,3,0,0.0,3
33891,8763,Expansion Packs,16,0,0.0,16
33892,8763,Game Packs,11,0,0.0,11
33893,8763,Kits,9,0,0.0,9
33894,8763,Stuff Packs,20,0,0.0,20
33895,8764,Expansion Packs,16,15,0.9375,1
33896,8764,Game Packs,12,12,1.0,0
33897,8764,Kits,33,33,1.0,0
33898,8764,Stuff Packs,20,17,0.85,3
33899,8765,Expansion Packs,3,0,0.0,3
33900,8765,Kits,3,0,0.0,3
33901,8765,Stuff Packs,5,2,0.4,3
33902,8766,Expansion Packs,7,0,0.0,7
33903,8766,Game Packs,4,0,0.0,4
33904,8766,Kits,3,2,0.6666666666666666,1
33905,8766,Stuff Packs,5,3,0.6,2
33906,8767,Expansion Packs,16,0,0.0,16
33907,8767,Game Packs,11,0,0.0,11
33908,8767,Kits,32,0,0.0,32
33909,8767,Stuff Packs,18,0,0.0,18
33910,8768,Expansion Packs,7,0,0.0,7
33911,8768,Game Packs,5,0,0.0,5
33912,8768,Kits,13,0,0.0,13
33913,8768,Stuff Packs,7,0,0.0,7
33914,8769,Expansion Packs,15,0,0.0,15
33915,8769,Game Packs,6,0,0.0,6
33916,8769,Kits,7,2,0.2857142857142857,5
33917,8769,Stuff Packs,6,2,0.3333333333333333,4
33918,8770,Expansion Packs,9,0,0.0,9
33919,8770,Game Packs,4,0,0.0,4
33920,8770,Kits,1,1,1.0,0
33921,8770,Stuff Packs,7,2,0.2857142857142857,5
33922,8771,Expansion Packs,16,0,0.0,16
33923,8771,Game Packs,9,0,0.0,9
33924,8771,Kits,3,3,1.0,0
33925,8771,Stuff Packs,14,4,0.2857142857142857,10
33926,8772,Expansion Packs,11,0,0.0,11
33927,8772,Game Packs,3,0,0.0,3
33928,8772,Kits,5,1,0.2,4
33929,8772,Stuff Packs,4,1,0.25,3
33930,8773,Expansion Packs,5,0,0.0,5
33931,8773,Game Packs,2,0,0.0,2
33932,8773,Kits,1,0,0.0,1
33933,8773,Stuff Packs,3,0,0.0,3
33934,8774,Expansion Packs,2,0,0.0,2
33935,8774,Game Packs,2,0,0.0,2
33936,8774,Kits,4,0,0.0,4
33937,8774,Stuff Packs,4,0,0.0,4
33938,8775,Expansion Packs,7,0,0.0,7
33939,8775,Game Packs,3,0,0.0,3
33940,8775,Kits,1,0,0.0,1
33941,8775,Stuff Packs,5,1,0.2,4
33942,8776,Expansion Packs,16,0,0.0,16
33943,8776,Game Packs,12,0,0.0,12
33944,8776,Kits,21,0,0.0,21
33945,8776,Stuff Packs,20,0,0.0,20
33946,8777,Expansion Packs,16,1,0.0625,15
33947,8777,Game Packs,12,0,0.0,12
33948,8777,Kits,33,0,0.0,33
33949,8777,Stuff Packs,20,1,0.05,19
33950,8778,Expansion Packs,16,0,0.0,16
33951,8778,Game Packs,10,0,0.0,10
33952,8778,Kits,4,1,0.25,3
33953,8778,Stuff Packs,20,0,0.0,20
33954,8779,Expansion Packs,16,0,0.0,16
33955,8779,Game Packs,12,0,0.0,12
33956,8779,Kits,29,1,0.034482758620689655,28
33957,8779,Stuff Packs,20,0,0.0,20
33958,8780,Expansion Packs,7,0,0.0,7
33959,8780,Game Packs,3,0,0.0,3
33960,8780,Kits,2,1,0.5,1
33961,8780,Stuff Packs,4,1,0.25,3
33962,8781,Expansion Packs,16,0,0.0,16
33963,8781,Game Packs,12,0,0.0,12
33964,8781,Kits,31,1,0.03225806451612903,30
33965,8781,Stuff Packs,20,0,0.0,20
33966,8782,Expansion Packs,10,0,0.0,10
33967,8782,Game Packs,6,0,0.0,6
33968,8782,Kits,5,1,0.2,4
33969,8782,Stuff Packs,13,3,0.23076923076923078,10
33970,8783,Expansion Packs,9,0,0.0,9
33971,8783,Game Packs,6,1,0.16666666666666666,5
33972,8783,Kits,6,0,0.0,6
33973,8783,Stuff Packs,9,2,0.2222222222222222,7
33974,8784,Expansion Packs,14,0,0.0,14
33975,8784,Game Packs,7,0,0.0,7
33976,8784,Kits,11,1,0.09090909090909091,10
33977,8784,Stuff Packs,11,4,0.36363636363636365,7
33978,8785,Expansion Packs,6,0,0.0,6
33979,8785,Game Packs,2,0,0.0,2
33980,8785,Kits,2,2,1.0,0
33981,8785,Stuff Packs,2,2,1.0,0
33982,8786,Expansion Packs,16,0,0.0,16
33983,8786,Game Packs,12,0,0.0,12
33984,8786,Kits,33,1,0.030303030303030304,32
33985,8786,Stuff Packs,20,0,0.0,20
33986,8787,Expansion Packs,14,0,0.0,14
33987,8787,Game Packs,10,0,0.0,10
33988,8787,Kits,19,1,0.05263157894736842,18
33989,8787,Stuff Packs,16,0,0.0,16
33990,8788,Expansion Packs,9,1,0.1111111111111111,8
33991,8788,Game Packs,2,0,0.0,2
33992,8788,Kits,2,1,0.5,1
33993,8788,Stuff Packs,2,0,0.0,2
33994,8789,Expansion Packs,16,0,0.0,16
33995,8789,Game Packs,8,0,0.0,8
33996,8789,Kits,18,0,0.0,18
33997,8789,Stuff Packs,14,3,0.21428571428571427,11
33998,8790,Expansion Packs,13,0,0.0,13
33999,8790,Game Packs,9,0,0.0,9
34000,8790,Stuff Packs,10,2,0.2,8
34001,8791,Expansion Packs,13,0,0.0,13
34002,8791,Game Packs,9,1,0.1111111111111111,8
34003,8791,Kits,3,3,1.0,0
34004,8791,Stuff Packs,14,4,0.2857142857142857,10
34005,8792,Expansion Packs,5,0,0.0,5
34006,8792,Game Packs,2,1,0.5,1
34007,8792,Kits,2,2,1.0,0
34008,8792,Stuff Packs,1,1,1.0,0
34009,8793,Expansion Packs,16,0,0.0,16
34010,8793,Game Packs,11,0,0.0,11
34011,8793,Kits,22,1,0.045454545454545456,21
34012,8793,Stuff Packs,14,0,0.0,14
34013,8794,Expansion Packs,16,0,0.0,16
34014,8794,Game Packs,10,0,0.0,10
34015,8794,Kits,10,0,0.0,10
34016,8794,Stuff Packs,20,0,0.0,20
34017,8795,Expansion Packs,15,0,0.0,15
34018,8795,Game Packs,10,0,0.0,10
34019,8795,Kits,8,1,0.125,7
34020,8795,Stuff Packs,13,3,0.23076923076923078,10
34021,8796,Expansion Packs,16,0,0.0,16
34022,8796,Game Packs,8,1,0.125,7
34023,8796,Kits,14,2,0.14285714285714285,12
34024,8796,Stuff Packs,18,3,0.16666666666666666,15
34025,8797,Expansion Packs,11,0,0.0,11
34026,8797,Game Packs,6,0,0.0,6
34027,8797,Kits,1,0,0.0,1
34028,8797,Stuff Packs,12,0,0.0,12
34029,8798,Expansion Packs,3,0,0.0,3
34030,8798,Game Packs,1,0,0.0,1
34031,8798,Kits,1,1,1.0,0
34032,8798,Stuff Packs,2,2,1.0,0
34033,8799,Expansion Packs,16,0,0.0,16
34034,8799,Game Packs,12,0,0.0,12
34035,8799,Kits,33,0,0.0,33
34036,8799,Stuff Packs,20,0,0.0,20
34037,8800,Kits,1,1,1.0,0
34038,8800,Stuff Packs,3,2,0.6666666666666666,1
34039,8801,Expansion Packs,16,0,0.0,16
34040,8801,Game Packs,12,0,0.0,12
34041,8801,Kits,30,1,0.03333333333333333,29
34042,8801,Stuff Packs,19,0,0.0,19
34043,8802,Expansion Packs,16,0,0.0,16
34044,8802,Game Packs,12,0,0.0,12
34045,8802,Kits,33,0,0.0,33
34046,8802,Stuff Packs,20,0,0.0,20
34047,8803,Expansion Packs,6,1,0.16666666666666666,5
34048,8803,Game Packs,2,0,0.0,2
34049,8803,Kits,1,0,0.0,1
34050,8803,Stuff Packs,2,1,0.5,1
34051,8804,Expansion Packs,16,0,0.0,16
34052,8804,Game Packs,12,1,0.08333333333333333,11
34053,8804,Kits,33,0,0.0,33
34054,8804,Stuff Packs,20,0,0.0,20
34055,8805,Expansion Packs,14,0,0.0,14
34056,8805,Game Packs,12,0,0.0,12
34057,8805,Kits,15,1,0.06666666666666667,14
34058,8805,Stuff Packs,19,1,0.05263157894736842,18
34059,8806,Expansion Packs,11,0,0.0,11
34060,8806,Game Packs,8,0,0.0,8
34061,8806,Kits,2,2,1.0,0
34062,8806,Stuff Packs,14,2,0.14285714285714285,12
34063,8807,Expansion Packs,15,0,0.0,15
34064,8807,Game Packs,11,0,0.0,11
34065,8807,Kits,20,1,0.05,19
34066,8807,Stuff Packs,17,2,0.11764705882352941,15
34067,8808,Expansion Packs,5,0,0.0,5
34068,8808,Game Packs,1,1,1.0,0
34069,8808,Kits,7,2,0.2857142857142857,5
34070,8808,Stuff Packs,5,1,0.2,4
34071,8809,Expansion Packs,16,3,0.1875,13
34072,8809,Game Packs,12,2,0.16666666666666666,10
34073,8809,Kits,33,4,0.12121212121212122,29
34074,8809,Stuff Packs,20,10,0.5,10
34075,8810,Expansion Packs,15,0,0.0,15
34076,8810,Game Packs,6,0,0.0,6
34077,8810,Kits,4,2,0.5,2
34078,8810,Stuff Packs,10,3,0.3,7
34079,8811,Expansion Packs,15,0,0.0,15
34080,8811,Game Packs,11,0,0.0,11
34081,8811,Kits,15,1,0.06666666666666667,14
34082,8811,Stuff Packs,19,0,0.0,19
34083,8812,Expansion Packs,9,0,0.0,9
34084,8812,Game Packs,3,1,0.3333333333333333,2
34085,8812,Kits,3,1,0.3333333333333333,2
34086,8812,Stuff Packs,6,3,0.5,3
34087,8813,Expansion Packs,16,0,0.0,16
34088,8813,Game Packs,11,0,0.0,11
34089,8813,Kits,17,1,0.058823529411764705,16
34090,8813,Stuff Packs,18,1,0.05555555555555555,17
34091,8814,Expansion Packs,16,0,0.0,16
34092,8814,Game Packs,8,0,0.0,8
34093,8814,Kits,4,1,0.25,3
34094,8814,Stuff Packs,11,2,0.18181818181818182,9
34095,8815,Expansion Packs,13,0,0.0,13
34096,8815,Game Packs,3,0,0.0,3
34097,8815,Kits,1,0,0.0,1
34098,8815,Stuff Packs,9,1,0.1111111111111111,8
34099,8816,Expansion Packs,9,1,0.1111111111111111,8
34100,8816,Game Packs,3,0,0.0,3
34101,8816,Kits,4,0,0.0,4
34102,8816,Stuff Packs,2,0,0.0,2
34103,8817,Expansion Packs,16,0,0.0,16
34104,8817,Game Packs,9,0,0.0,9
34105,8817,Kits,33,0,0.0,33
34106,8817,Stuff Packs,17,1,0.058823529411764705,16
34107,8818,Expansion Packs,16,0,0.0,16
34108,8818,Game Packs,12,0,0.0,12
34109,8818,Kits,33,2,0.06060606060606061,31
34110,8818,Stuff Packs,20,1,0.05,19
34111,8819,Expansion Packs,14,0,0.0,14
34112,8819,Game Packs,11,0,0.0,11
34113,8819,Kits,6,0,0.0,6
34114,8819,Stuff Packs,17,0,0.0,17
34115,8820,Expansion Packs,3,0,0.0,3
34116,8820,Game Packs,1,0,0.0,1
34117,8820,Kits,2,1,0.5,1
34118,8820,Stuff Packs,4,2,0.5,2
34119,8821,Expansion Packs,12,0,0.0,12
34120,8821,Game Packs,6,1,0.16666666666666666,5
34121,8821,Stuff Packs,7,2,0.2857142857142857,5
34122,8822,Expansion Packs,16,8,0.5,8
34123,8822,Game Packs,12,9,0.75,3
34124,8822,Kits,33,33,1.0,0
34125,8822,Stuff Packs,20,17,0.85,3
34126,8823,Expansion Packs,16,0,0.0,16
34127,8823,Game Packs,12,0,0.0,12
34128,8823,Kits,33,0,0.0,33
34129,8823,Stuff Packs,20,0,0.0,20
34130,8824,Expansion Packs,9,0,0.0,9
34131,8824,Game Packs,3,0,0.0,3
34132,8824,Kits,1,1,1.0,0
34133,8824,Stuff Packs,8,3,0.375,5
34134,8825,Expansion Packs,15,0,0.0,15
34135,8825,Game Packs,11,0,0.0,11
34136,8825,Kits,16,1,0.0625,15
34137,8825,Stuff Packs,20,2,0.1,18
34138,8826,Expansion Packs,13,0,0.0,13
34139,8826,Game Packs,8,0,0.0,8
34140,8826,Kits,2,1,0.5,1
34141,8826,Stuff Packs,9,2,0.2222222222222222,7
34142,8827,Expansion Packs,8,0,0.0,8
34143,8827,Game Packs,4,0,0.0,4
34144,8827,Kits,2,2,1.0,0
34145,8827,Stuff Packs,9,3,0.3333333333333333,6
34146,8828,Expansion Packs,16,0,0.0,16
34147,8828,Game Packs,12,0,0.0,12
34148,8828,Kits,33,0,0.0,33
34149,8828,Stuff Packs,20,0,0.0,20
34150,8829,Expansion Packs,8,0,0.0,8
34151,8829,Game Packs,1,0,0.0,1
34152,8830,Expansion Packs,13,0,0.0,13
34153,8830,Game Packs,11,0,0.0,11
34154,8830,Kits,6,2,0.3333333333333333,4
34155,8830,Stuff Packs,12,2,0.16666666666666666,10
34156,8831,Expansion Packs,14,0,0.0,14
34157,8831,Game Packs,11,0,0.0,11
34158,8831,Kits,14,1,0.07142857142857142,13
34159,8831,Stuff Packs,13,0,0.0,13
34160,8832,Expansion Packs,16,0,0.0,16
34161,8832,Game Packs,11,1,0.09090909090909091,10
34162,8832,Kits,15,1,0.06666666666666667,14
34163,8832,Stuff Packs,20,2,0.1,18
34164,8833,Expansion Packs,16,0,0.0,16
34165,8833,Game Packs,12,0,0.0,12
34166,8833,Kits,33,0,0.0,33
34167,8833,Stuff Packs,20,0,0.0,20
34168,8834,Expansion Packs,14,12,0.8571428571428571,2
34169,8834,Game Packs,8,8,1.0,0
34170,8834,Kits,10,0,0.0,10
34171,8834,Stuff Packs,18,18,1.0,0
34172,8835,Expansion Packs,16,0,0.0,16
34173,8835,Game Packs,12,0,0.0,12
34174,8835,Kits,28,2,0.07142857142857142,26
34175,8835,Stuff Packs,20,0,0.0,20
34176,8836,Expansion Packs,15,0,0.0,15
34177,8836,Game Packs,11,1,0.09090909090909091,10
34178,8836,Kits,10,1,0.1,9
34179,8836,Stuff Packs,20,1,0.05,19
34180,8837,Expansion Packs,11,0,0.0,11
34181,8837,Game Packs,2,0,0.0,2
34182,8837,Stuff Packs,4,1,0.25,3
34183,8838,Expansion Packs,16,0,0.0,16
34184,8838,Game Packs,12,0,0.0,12
34185,8838,Kits,33,0,0.0,33
34186,8838,Stuff Packs,20,0,0.0,20
34187,8839,Expansion Packs,7,0,0.0,7
34188,8839,Game Packs,2,0,0.0,2
34189,8840,Expansion Packs,14,0,0.0,14
34190,8840,Game Packs,7,0,0.0,7
34191,8840,Kits,11,0,0.0,11
34192,8840,Stuff Packs,9,0,0.0,9
34193,8841,Expansion Packs,16,0,0.0,16
34194,8841,Game Packs,12,0,0.0,12
34195,8841,Kits,21,1,0.047619047619047616,20
34196,8841,Stuff Packs,20,7,0.35,13
34197,8842,Expansion Packs,16,0,0.0,16
34198,8842,Game Packs,12,0,0.0,12
34199,8842,Kits,20,0,0.0,20
34200,8842,Stuff Packs,17,0,0.0,17
34201,8843,Expansion Packs,15,0,0.0,15
34202,8843,Game Packs,7,0,0.0,7
34203,8843,Kits,4,3,0.75,1
34204,8843,Stuff Packs,9,3,0.3333333333333333,6
34205,8844,Expansion Packs,12,0,0.0,12
34206,8844,Game Packs,7,0,0.0,7
34207,8844,Kits,1,0,0.0,1
34208,8844,Stuff Packs,8,1,0.125,7
34209,8845,Expansion Packs,4,0,0.0,4
34210,8845,Game Packs,1,0,0.0,1
34211,8845,Stuff Packs,1,0,0.0,1
34212,8846,Expansion Packs,15,1,0.06666666666666667,14
34213,8846,Game Packs,7,1,0.14285714285714285,6
34214,8846,Kits,12,0,0.0,12
34215,8846,Stuff Packs,10,0,0.0,10
34216,8847,Expansion Packs,7,0,0.0,7
34217,8847,Game Packs,1,0,0.0,1
34218,8848,Expansion Packs,13,0,0.0,13
34219,8848,Game Packs,8,0,0.0,8
34220,8848,Kits,5,1,0.2,4
34221,8848,Stuff Packs,12,1,0.08333333333333333,11
34222,8849,Expansion Packs,6,0,0.0,6
34223,8849,Game Packs,1,0,0.0,1
34224,8849,Stuff Packs,1,0,0.0,1
34225,8850,Expansion Packs,10,0,0.0,10
34226,8850,Game Packs,7,1,0.14285714285714285,6
34227,8850,Kits,3,2,0.6666666666666666,1
34228,8850,Stuff Packs,11,2,0.18181818181818182,9
34229,8851,Expansion Packs,16,0,0.0,16
34230,8851,Game Packs,12,0,0.0,12
34231,8851,Kits,33,1,0.030303030303030304,32
34232,8851,Stuff Packs,20,2,0.1,18
34233,8852,Expansion Packs,15,0,0.0,15
34234,8852,Game Packs,11,0,0.0,11
34235,8852,Kits,21,0,0.0,21
34236,8852,Stuff Packs,20,0,0.0,20
34237,8853,Expansion Packs,15,1,0.06666666666666667,14
34238,8853,Game Packs,5,0,0.0,5
34239,8853,Kits,5,1,0.2,4
34240,8853,Stuff Packs,4,1,0.25,3
34241,8854,Expansion Packs,3,0,0.0,3
34242,8854,Kits,1,1,1.0,0
34243,8854,Stuff Packs,1,1,1.0,0
34244,8855,Expansion Packs,16,0,0.0,16
34245,8855,Game Packs,12,0,0.0,12
34246,8855,Kits,33,1,0.030303030303030304,32
34247,8855,Stuff Packs,20,0,0.0,20
34248,8856,Game Packs,2,0,0.0,2
34249,8856,Stuff Packs,1,0,0.0,1
34250,8857,Expansion Packs,6,0,0.0,6
34251,8857,Game Packs,1,1,1.0,0
34252,8857,Kits,4,3,0.75,1
34253,8857,Stuff Packs,5,4,0.8,1
34254,8858,Expansion Packs,1,0,0.0,1
34255,8858,Kits,1,1,1.0,0
34256,8859,Expansion Packs,2,0,0.0,2
34257,8859,Game Packs,2,1,0.5,1
34258,8859,Kits,6,3,0.5,3
34259,8859,Stuff Packs,6,4,0.6666666666666666,2
34260,8860,Expansion Packs,15,0,0.0,15
34261,8860,Game Packs,12,0,0.0,12
34262,8860,Kits,9,2,0.2222222222222222,7
34263,8860,Stuff Packs,10,2,0.2,8
34264,8861,Expansion Packs,3,0,0.0,3
34265,8861,Game Packs,3,1,0.3333333333333333,2
34266,8861,Kits,2,2,1.0,0
34267,8861,Stuff Packs,4,4,1.0,0
34268,8862,Expansion Packs,15,0,0.0,15
34269,8862,Game Packs,12,0,0.0,12
34270,8862,Kits,26,1,0.038461538461538464,25
34271,8862,Stuff Packs,19,1,0.05263157894736842,18
34272,8863,Expansion Packs,6,0,0.0,6
34273,8863,Game Packs,1,0,0.0,1
34274,8863,Stuff Packs,2,0,0.0,2
34275,8864,Expansion Packs,15,0,0.0,15
34276,8864,Game Packs,8,0,0.0,8
34277,8864,Kits,7,0,0.0,7
34278,8864,Stuff Packs,8,0,0.0,8
34279,8865,Expansion Packs,10,0,0.0,10
34280,8865,Game Packs,5,0,0.0,5
34281,8865,Kits,3,3,1.0,0
34282,8865,Stuff Packs,6,3,0.5,3
34283,8866,Expansion Packs,16,0,0.0,16
34284,8866,Game Packs,7,0,0.0,7
34285,8866,Kits,13,2,0.15384615384615385,11
34286,8866,Stuff Packs,15,1,0.06666666666666667,14
34287,8867,Expansion Packs,16,0,0.0,16
34288,8867,Game Packs,12,0,0.0,12
34289,8867,Kits,33,0,0.0,33
34290,8867,Stuff Packs,20,0,0.0,20
34291,8868,Expansion Packs,14,0,0.0,14
34292,8868,Game Packs,10,0,0.0,10
34293,8868,Kits,4,2,0.5,2
34294,8868,Stuff Packs,17,0,0.0,17
34295,8869,Expansion Packs,16,0,0.0,16
34296,8869,Game Packs,10,0,0.0,10
34297,8869,Kits,26,1,0.038461538461538464,25
34298,8869,Stuff Packs,17,0,0.0,17
34299,8870,Expansion Packs,16,0,0.0,16
34300,8870,Game Packs,11,0,0.0,11
34301,8870,Kits,11,1,0.09090909090909091,10
34302,8870,Stuff Packs,20,0,0.0,20
34303,8871,Expansion Packs,16,0,0.0,16
34304,8871,Game Packs,12,0,0.0,12
34305,8871,Kits,5,2,0.4,3
34306,8871,Stuff Packs,20,0,0.0,20
34307,8872,Expansion Packs,16,1,0.0625,15
34308,8872,Game Packs,7,0,0.0,7
34309,8872,Kits,9,2,0.2222222222222222,7
34310,8872,Stuff Packs,12,1,0.08333333333333333,11
34311,8873,Expansion Packs,14,0,0.0,14
34312,8873,Game Packs,9,0,0.0,9
34313,8873,Kits,9,0,0.0,9
34314,8873,Stuff Packs,11,2,0.18181818181818182,9
34315,8874,Expansion Packs,16,0,0.0,16
34316,8874,Game Packs,12,0,0.0,12
34317,8874,Kits,33,1,0.030303030303030304,32
34318,8874,Stuff Packs,20,0,0.0,20
34319,8875,Expansion Packs,14,0,0.0,14
34320,8875,Game Packs,5,1,0.2,4
34321,8875,Kits,8,2,0.25,6
34322,8875,Stuff Packs,12,3,0.25,9
34323,8876,Expansion Packs,6,0,0.0,6
34324,8876,Game Packs,1,0,0.0,1
34325,8876,Kits,3,0,0.0,3
34326,8876,Stuff Packs,3,0,0.0,3
34327,8877,Expansion Packs,13,0,0.0,13
34328,8877,Game Packs,10,0,0.0,10
34329,8877,Kits,3,2,0.6666666666666666,1
34330,8877,Stuff Packs,14,0,0.0,14
34331,8878,Expansion Packs,16,0,0.0,16
34332,8878,Game Packs,12,0,0.0,12
34333,8878,Kits,27,0,0.0,27
34334,8878,Stuff Packs,20,0,0.0,20
34335,8879,Expansion Packs,13,0,0.0,13
34336,8879,Game Packs,10,0,0.0,10
34337,8879,Kits,3,0,0.0,3
34338,8879,Stuff Packs,17,0,0.0,17
34339,8880,Expansion Packs,16,0,0.0,16
34340,8880,Game Packs,11,0,0.0,11
34341,8880,Kits,20,0,0.0,20
34342,8880,Stuff Packs,20,0,0.0,20
34343,8881,Expansion Packs,15,0,0.0,15
34344,8881,Game Packs,9,0,0.0,9
34345,8881,Kits,4,3,0.75,1
34346,8881,Stuff Packs,12,1,0.08333333333333333,11
34347,8882,Expansion Packs,15,0,0.0,15
34348,8882,Game Packs,12,0,0.0,12
34349,8882,Kits,4,1,0.25,3
34350,8882,Stuff Packs,20,0,0.0,20
34351,8883,Expansion Packs,6,0,0.0,6
34352,8883,Game Packs,3,0,0.0,3
34353,8883,Kits,3,1,0.3333333333333333,2
34354,8883,Stuff Packs,5,3,0.6,2
34355,8884,Expansion Packs,1,0,0.0,1
34356,8884,Game Packs,1,0,0.0,1
34357,8884,Kits,1,0,0.0,1
34358,8884,Stuff Packs,1,0,0.0,1
34359,8885,Expansion Packs,5,0,0.0,5
34360,8885,Game Packs,2,0,0.0,2
34361,8885,Kits,2,1,0.5,1
34362,8885,Stuff Packs,5,3,0.6,2
34363,8886,Expansion Packs,10,0,0.0,10
34364,8886,Game Packs,1,0,0.0,1
34365,8886,Stuff Packs,3,1,0.3333333333333333,2
34366,8887,Expansion Packs,16,0,0.0,16
34367,8887,Game Packs,12,0,0.0,12
34368,8887,Kits,23,1,0.043478260869565216,22
34369,8887,Stuff Packs,20,0,0.0,20
34370,8888,Expansion Packs,16,2,0.125,14
34371,8888,Game Packs,11,1,0.09090909090909091,10
34372,8888,Kits,21,0,0.0,21
34373,8888,Stuff Packs,20,0,0.0,20
34374,8889,Expansion Packs,16,0,0.0,16
34375,8889,Game Packs,12,0,0.0,12
34376,8889,Kits,33,0,0.0,33
34377,8889,Stuff Packs,20,0,0.0,20
34378,8890,Expansion Packs,16,0,0.0,16
34379,8890,Game Packs,11,0,0.0,11
34380,8890,Kits,22,0,0.0,22
34381,8890,Stuff Packs,19,0,0.0,19
34382,8891,Expansion Packs,16,0,0.0,16
34383,8891,Game Packs,12,0,0.0,12
34384,8891,Kits,33,0,0.0,33
34385,8891,Stuff Packs,20,0,0.0,20
34386,8892,Expansion Packs,9,0,0.0,9
34387,8892,Game Packs,9,0,0.0,9
34388,8892,Kits,1,0,0.0,1
34389,8892,Stuff Packs,8,0,0.0,8
34390,8893,Expansion Packs,11,0,0.0,11
34391,8893,Game Packs,8,0,0.0,8
34392,8893,Kits,3,1,0.3333333333333333,2
34393,8893,Stuff Packs,10,2,0.2,8
34394,8894,Expansion Packs,14,0,0.0,14
34395,8894,Game Packs,6,0,0.0,6
34396,8894,Kits,3,1,0.3333333333333333,2
34397,8894,Stuff Packs,12,1,0.08333333333333333,11
34398,8895,Expansion Packs,16,0,0.0,16
34399,8895,Game Packs,12,0,0.0,12
34400,8895,Kits,3,2,0.6666666666666666,1
34401,8895,Stuff Packs,20,2,0.1,18
34402,8896,Expansion Packs,16,0,0.0,16
34403,8896,Game Packs,12,0,0.0,12
34404,8896,Kits,29,1,0.034482758620689655,28
34405,8896,Stuff Packs,20,0,0.0,20
34406,8897,Expansion Packs,16,0,0.0,16
34407,8897,Game Packs,12,0,0.0,12
34408,8897,Kits,32,1,0.03125,31
34409,8897,Stuff Packs,20,0,0.0,20
34410,8898,Expansion Packs,3,0,0.0,3
34411,8898,Game Packs,3,0,0.0,3
34412,8898,Kits,7,1,0.14285714285714285,6
34413,8898,Stuff Packs,6,3,0.5,3
34414,8899,Expansion Packs,12,0,0.0,12
34415,8899,Game Packs,2,0,0.0,2
34416,8899,Kits,5,1,0.2,4
34417,8899,Stuff Packs,9,2,0.2222222222222222,7
34418,8900,Expansion Packs,14,7,0.5,7
34419,8900,Game Packs,11,6,0.5454545454545454,5
34420,8900,Kits,9,1,0.1111111111111111,8
34421,8900,Stuff Packs,20,7,0.35,13
34422,8901,Expansion Packs,16,0,0.0,16
34423,8901,Game Packs,12,0,0.0,12
34424,8901,Kits,29,0,0.0,29
34425,8901,Stuff Packs,20,0,0.0,20
34426,8902,Expansion Packs,15,0,0.0,15
34427,8902,Game Packs,8,1,0.125,7
34428,8902,Kits,16,1,0.0625,15
34429,8902,Stuff Packs,16,2,0.125,14
34430,8903,Expansion Packs,11,0,0.0,11
34431,8903,Game Packs,5,1,0.2,4
34432,8903,Kits,5,2,0.4,3
34433,8903,Stuff Packs,9,4,0.4444444444444444,5
34434,8904,Expansion Packs,4,0,0.0,4
34435,8904,Game Packs,6,0,0.0,6
34436,8904,Kits,1,1,1.0,0
34437,8904,Stuff Packs,4,0,0.0,4
34438,8905,Expansion Packs,16,0,0.0,16
34439,8905,Game Packs,11,0,0.0,11
34440,8905,Kits,3,3,1.0,0
34441,8905,Stuff Packs,15,3,0.2,12
34442,8906,Kits,11,0,0.0,11
34443,8906,Stuff Packs,3,0,0.0,3
34444,8907,Expansion Packs,15,0,0.0,15
34445,8907,Game Packs,10,0,0.0,10
34446,8907,Kits,2,2,1.0,0
34447,8907,Stuff Packs,13,1,0.07692307692307693,12
34448,8908,Expansion Packs,16,9,0.5625,7
34449,8908,Game Packs,12,4,0.3333333333333333,8
34450,8908,Kits,33,28,0.8484848484848485,5
34451,8908,Stuff Packs,20,6,0.3,14
34452,8909,Expansion Packs,16,0,0.0,16
34453,8909,Game Packs,12,0,0.0,12
34454,8909,Kits,1,0,0.0,1
34455,8909,Stuff Packs,18,1,0.05555555555555555,17
34456,8910,Expansion Packs,15,0,0.0,15
34457,8910,Game Packs,11,0,0.0,11
34458,8910,Kits,19,0,0.0,19
34459,8910,Stuff Packs,19,0,0.0,19
34460,8911,Expansion Packs,16,0,0.0,16
34461,8911,Game Packs,12,0,0.0,12
34462,8911,Kits,18,1,0.05555555555555555,17
34463,8911,Stuff Packs,19,0,0.0,19
34464,8912,Expansion Packs,16,0,0.0,16
34465,8912,Game Packs,10,0,0.0,10
34466,8912,Kits,3,2,0.6666666666666666,1
34467,8912,Stuff Packs,12,1,0.08333333333333333,11
34468,8913,Expansion Packs,3,0,0.0,3
34469,8913,Stuff Packs,2,0,0.0,2
34470,8914,Expansion Packs,6,0,0.0,6
34471,8914,Game Packs,3,0,0.0,3
34472,8914,Kits,1,0,0.0,1
34473,8914,Stuff Packs,7,2,0.2857142857142857,5
34474,8915,Expansion Packs,14,0,0.0,14
34475,8915,Game Packs,9,0,0.0,9
34476,8915,Kits,8,1,0.125,7
34477,8915,Stuff Packs,16,1,0.0625,15
34478,8916,Expansion Packs,15,0,0.0,15
34479,8916,Game Packs,10,0,0.0,10
34480,8916,Kits,16,2,0.125,14
34481,8916,Stuff Packs,18,0,0.0,18
34482,8917,Expansion Packs,16,0,0.0,16
34483,8917,Game Packs,11,0,0.0,11
34484,8917,Kits,21,2,0.09523809523809523,19
34485,8917,Stuff Packs,20,0,0.0,20
34486,8918,Expansion Packs,12,0,0.0,12
34487,8918,Game Packs,8,0,0.0,8
34488,8918,Kits,11,1,0.09090909090909091,10
34489,8918,Stuff Packs,8,0,0.0,8
34490,8919,Expansion Packs,6,0,0.0,6
34491,8919,Game Packs,3,1,0.3333333333333333,2
34492,8919,Kits,4,3,0.75,1
34493,8919,Stuff Packs,8,2,0.25,6
34494,8920,Expansion Packs,16,0,0.0,16
34495,8920,Game Packs,9,0,0.0,9
34496,8920,Kits,13,2,0.15384615384615385,11
34497,8920,Stuff Packs,19,0,0.0,19
34498,8921,Expansion Packs,16,0,0.0,16
34499,8921,Game Packs,12,0,0.0,12
34500,8921,Kits,33,1,0.030303030303030304,32
34501,8921,Stuff Packs,20,0,0.0,20
34502,8922,Expansion Packs,16,0,0.0,16
34503,8922,Game Packs,12,0,0.0,12
34504,8922,Kits,33,0,0.0,33
34505,8922,Stuff Packs,20,0,0.0,20
34506,8923,Expansion Packs,15,0,0.0,15
34507,8923,Game Packs,8,0,0.0,8
34508,8923,Kits,1,0,0.0,1
34509,8923,Stuff Packs,6,1,0.16666666666666666,5
34510,8924,Expansion Packs,5,0,0.0,5
34511,8924,Game Packs,1,0,0.0,1
34512,8924,Kits,4,2,0.5,2
34513,8924,Stuff Packs,5,3,0.6,2
34514,8925,Expansion Packs,7,0,0.0,7
34515,8925,Game Packs,2,0,0.0,2
34516,8926,Expansion Packs,15,0,0.0,15
34517,8926,Game Packs,12,0,0.0,12
34518,8926,Kits,32,0,0.0,32
34519,8926,Stuff Packs,20,0,0.0,20
34520,8927,Expansion Packs,16,0,0.0,16
34521,8927,Game Packs,8,1,0.125,7
34522,8927,Kits,2,2,1.0,0
34523,8927,Stuff Packs,10,4,0.4,6
34524,8928,Expansion Packs,16,0,0.0,16
34525,8928,Game Packs,10,1,0.1,9
34526,8928,Kits,2,0,0.0,2
34527,8928,Stuff Packs,16,1,0.0625,15
34528,8929,Expansion Packs,13,0,0.0,13
34529,8929,Game Packs,3,0,0.0,3
34530,8929,Stuff Packs,3,0,0.0,3
34531,8930,Expansion Packs,14,0,0.0,14
34532,8930,Game Packs,6,0,0.0,6
34533,8930,Kits,8,0,0.0,8
34534,8930,Stuff Packs,11,0,0.0,11
34535,8931,Expansion Packs,8,0,0.0,8
34536,8931,Game Packs,11,1,0.09090909090909091,10
34537,8931,Kits,24,4,0.16666666666666666,20
34538,8931,Stuff Packs,14,4,0.2857142857142857,10
34539,8932,Expansion Packs,9,0,0.0,9
34540,8932,Game Packs,5,1,0.2,4
34541,8932,Kits,5,1,0.2,4
34542,8932,Stuff Packs,7,0,0.0,7
34543,8933,Expansion Packs,16,0,0.0,16
34544,8933,Game Packs,11,0,0.0,11
34545,8933,Kits,13,2,0.15384615384615385,11
34546,8933,Stuff Packs,17,0,0.0,17
34547,8934,Expansion Packs,11,0,0.0,11
34548,8934,Game Packs,3,0,0.0,3
34549,8934,Stuff Packs,7,3,0.42857142857142855,4
34550,8935,Expansion Packs,8,0,0.0,8
34551,8935,Game Packs,5,0,0.0,5
34552,8935,Kits,1,1,1.0,0
34553,8935,Stuff Packs,10,1,0.1,9
34554,8936,Expansion Packs,5,0,0.0,5
34555,8936,Game Packs,1,1,1.0,0
34556,8936,Stuff Packs,6,6,1.0,0
34557,8937,Expansion Packs,5,0,0.0,5
34558,8937,Game Packs,2,0,0.0,2
34559,8937,Kits,2,2,1.0,0
34560,8937,Stuff Packs,5,2,0.4,3
34561,8938,Expansion Packs,14,0,0.0,14
34562,8938,Game Packs,10,0,0.0,10
34563,8938,Kits,1,0,0.0,1
34564,8938,Stuff Packs,10,3,0.3,7
34565,8939,Expansion Packs,9,0,0.0,9
34566,8939,Game Packs,6,0,0.0,6
34567,8939,Kits,24,1,0.041666666666666664,23
34568,8939,Stuff Packs,13,0,0.0,13
34569,8940,Expansion Packs,16,0,0.0,16
34570,8940,Game Packs,12,0,0.0,12
34571,8940,Kits,33,0,0.0,33
34572,8940,Stuff Packs,20,0,0.0,20
34573,8941,Expansion Packs,13,1,0.07692307692307693,12
34574,8941,Game Packs,9,0,0.0,9
34575,8941,Kits,3,2,0.6666666666666666,1
34576,8941,Stuff Packs,8,0,0.0,8
34577,8942,Expansion Packs,16,0,0.0,16
34578,8942,Game Packs,11,0,0.0,11
34579,8942,Kits,18,1,0.05555555555555555,17
34580,8942,Stuff Packs,20,0,0.0,20
34581,8943,Expansion Packs,11,0,0.0,11
34582,8943,Game Packs,10,0,0.0,10
34583,8943,Kits,2,1,0.5,1
34584,8943,Stuff Packs,10,1,0.1,9
34585,8944,Expansion Packs,15,0,0.0,15
34586,8944,Game Packs,11,0,0.0,11
34587,8944,Kits,2,1,0.5,1
34588,8944,Stuff Packs,17,1,0.058823529411764705,16
34589,8945,Expansion Packs,4,1,0.25,3
34590,8945,Kits,2,2,1.0,0
34591,8945,Stuff Packs,2,2,1.0,0
34592,8946,Expansion Packs,16,0,0.0,16
34593,8946,Game Packs,9,0,0.0,9
34594,8946,Kits,17,0,0.0,17
34595,8946,Stuff Packs,13,0,0.0,13
34596,8947,Expansion Packs,11,0,0.0,11
34597,8947,Game Packs,4,0,0.0,4
34598,8947,Kits,3,0,0.0,3
34599,8947,Stuff Packs,6,2,0.3333333333333333,4
34600,8948,Expansion Packs,13,0,0.0,13
34601,8948,Game Packs,7,0,0.0,7
34602,8948,Kits,10,1,0.1,9
34603,8948,Stuff Packs,14,1,0.07142857142857142,13
34604,8949,Expansion Packs,13,0,0.0,13
34605,8949,Game Packs,7,1,0.14285714285714285,6
34606,8949,Kits,7,3,0.42857142857142855,4
34607,8949,Stuff Packs,9,4,0.4444444444444444,5
34608,8950,Expansion Packs,15,0,0.0,15
34609,8950,Game Packs,8,0,0.0,8
34610,8950,Kits,23,0,0.0,23
34611,8950,Stuff Packs,19,0,0.0,19
34612,8951,Expansion Packs,9,0,0.0,9
34613,8951,Game Packs,7,0,0.0,7
34614,8951,Kits,2,2,1.0,0
34615,8951,Stuff Packs,9,2,0.2222222222222222,7
34616,8952,Expansion Packs,15,0,0.0,15
34617,8952,Game Packs,11,0,0.0,11
34618,8952,Kits,1,0,0.0,1
34619,8952,Stuff Packs,17,0,0.0,17
34620,8953,Expansion Packs,14,0,0.0,14
34621,8953,Game Packs,11,0,0.0,11
34622,8953,Kits,12,3,0.25,9
34623,8953,Stuff Packs,20,2,0.1,18
34624,8954,Expansion Packs,16,0,0.0,16
34625,8954,Game Packs,11,0,0.0,11
34626,8954,Kits,17,1,0.058823529411764705,16
34627,8954,Stuff Packs,20,1,0.05,19
34628,8955,Expansion Packs,8,0,0.0,8
34629,8955,Game Packs,5,0,0.0,5
34630,8955,Kits,1,1,1.0,0
34631,8955,Stuff Packs,9,4,0.4444444444444444,5
34632,8956,Expansion Packs,16,0,0.0,16
34633,8956,Game Packs,12,0,0.0,12
34634,8956,Kits,31,0,0.0,31
34635,8956,Stuff Packs,19,0,0.0,19
34636,8957,Expansion Packs,13,1,0.07692307692307693,12
34637,8957,Game Packs,8,0,0.0,8
34638,8957,Kits,5,1,0.2,4
34639,8957,Stuff Packs,16,1,0.0625,15
34640,8958,Expansion Packs,16,0,0.0,16
34641,8958,Game Packs,12,0,0.0,12
34642,8958,Kits,33,0,0.0,33
34643,8958,Stuff Packs,20,0,0.0,20
34644,8959,Expansion Packs,16,0,0.0,16
34645,8959,Game Packs,12,0,0.0,12
34646,8959,Kits,18,0,0.0,18
34647,8959,Stuff Packs,20,0,0.0,20
34648,8960,Expansion Packs,16,0,0.0,16
34649,8960,Game Packs,11,1,0.09090909090909091,10
34650,8960,Kits,11,2,0.18181818181818182,9
34651,8960,Stuff Packs,17,4,0.23529411764705882,13
34652,8961,Expansion Packs,8,0,0.0,8
34653,8961,Game Packs,4,1,0.25,3
34654,8961,Kits,3,3,1.0,0
34655,8961,Stuff Packs,8,4,0.5,4
34656,8962,Expansion Packs,12,0,0.0,12
34657,8962,Game Packs,9,0,0.0,9
34658,8962,Kits,3,1,0.3333333333333333,2
34659,8962,Stuff Packs,8,5,0.625,3
34660,8963,Expansion Packs,15,0,0.0,15
34661,8963,Game Packs,11,0,0.0,11
34662,8963,Kits,14,1,0.07142857142857142,13
34663,8963,Stuff Packs,18,1,0.05555555555555555,17
34664,8964,Expansion Packs,2,0,0.0,2
34665,8964,Game Packs,2,0,0.0,2
34666,8964,Kits,5,3,0.6,2
34667,8964,Stuff Packs,4,0,0.0,4
34668,8965,Expansion Packs,15,0,0.0,15
34669,8965,Game Packs,12,0,0.0,12
34670,8965,Kits,21,2,0.09523809523809523,19
34671,8965,Stuff Packs,20,0,0.0,20
34672,8966,Expansion Packs,16,0,0.0,16
34673,8966,Game Packs,12,0,0.0,12
34674,8966,Kits,32,0,0.0,32
34675,8966,Stuff Packs,20,0,0.0,20
34676,8967,Expansion Packs,4,0,0.0,4
34677,8967,Game Packs,2,0,0.0,2
34678,8967,Kits,4,1,0.25,3
34679,8967,Stuff Packs,5,3,0.6,2
34680,8968,Expansion Packs,5,0,0.0,5
34681,8968,Game Packs,5,0,0.0,5
34682,8968,Stuff Packs,4,0,0.0,4
34683,8969,Expansion Packs,12,0,0.0,12
34684,8969,Game Packs,10,1,0.1,9
34685,8969,Stuff Packs,11,1,0.09090909090909091,10
34686,8970,Expansion Packs,15,0,0.0,15
34687,8970,Game Packs,10,0,0.0,10
34688,8970,Kits,12,0,0.0,12
34689,8970,Stuff Packs,14,0,0.0,14
34690,8971,Expansion Packs,16,1,0.0625,15
34691,8971,Game Packs,10,0,0.0,10
34692,8971,Kits,16,0,0.0,16
34693,8971,Stuff Packs,12,1,0.08333333333333333,11
34694,8972,Expansion Packs,16,0,0.0,16
34695,8972,Game Packs,12,0,0.0,12
34696,8972,Kits,33,1,0.030303030303030304,32
34697,8972,Stuff Packs,20,0,0.0,20
34698,8973,Expansion Packs,12,1,0.08333333333333333,11
34699,8973,Game Packs,6,0,0.0,6
34700,8973,Kits,4,1,0.25,3
34701,8973,Stuff Packs,12,1,0.08333333333333333,11
34702,8974,Expansion Packs,3,0,0.0,3
34703,8974,Game Packs,1,0,0.0,1
34704,8974,Kits,2,0,0.0,2
34705,8974,Stuff Packs,1,0,0.0,1
34706,8975,Expansion Packs,16,0,0.0,16
34707,8975,Game Packs,6,1,0.16666666666666666,5
34708,8975,Kits,2,2,1.0,0
34709,8975,Stuff Packs,11,3,0.2727272727272727,8
34710,8976,Expansion Packs,16,1,0.0625,15
34711,8976,Game Packs,11,0,0.0,11
34712,8976,Kits,20,0,0.0,20
34713,8976,Stuff Packs,20,0,0.0,20
34714,8977,Expansion Packs,16,0,0.0,16
34715,8977,Game Packs,12,0,0.0,12
34716,8977,Kits,33,0,0.0,33
34717,8977,Stuff Packs,20,0,0.0,20
34718,8978,Expansion Packs,8,0,0.0,8
34719,8978,Game Packs,4,0,0.0,4
34720,8978,Kits,2,1,0.5,1
34721,8978,Stuff Packs,4,2,0.5,2
34722,8979,Expansion Packs,15,0,0.0,15
34723,8979,Game Packs,11,0,0.0,11
34724,8979,Kits,8,0,0.0,8
34725,8979,Stuff Packs,18,0,0.0,18
34726,8980,Expansion Packs,14,0,0.0,14
34727,8980,Game Packs,10,0,0.0,10
34728,8980,Kits,11,1,0.09090909090909091,10
34729,8980,Stuff Packs,15,0,0.0,15
34730,8981,Expansion Packs,9,0,0.0,9
34731,8981,Game Packs,4,0,0.0,4
34732,8981,Stuff Packs,7,2,0.2857142857142857,5
34733,8982,Expansion Packs,15,0,0.0,15
34734,8982,Game Packs,8,0,0.0,8
34735,8982,Kits,11,0,0.0,11
34736,8982,Stuff Packs,10,0,0.0,10
34737,8983,Expansion Packs,7,0,0.0,7
34738,8983,Game Packs,3,0,0.0,3
34739,8983,Kits,1,1,1.0,0
34740,8983,Stuff Packs,6,3,0.5,3
34741,8984,Expansion Packs,16,0,0.0,16
34742,8984,Game Packs,12,0,0.0,12
34743,8984,Kits,30,0,0.0,30
34744,8984,Stuff Packs,20,0,0.0,20
34745,8985,Kits,1,1,1.0,0
34746,8986,Expansion Packs,16,0,0.0,16
34747,8986,Game Packs,12,0,0.0,12
34748,8986,Kits,20,2,0.1,18
34749,8986,Stuff Packs,17,1,0.058823529411764705,16
34750,8987,Expansion Packs,10,0,0.0,10
34751,8987,Game Packs,9,0,0.0,9
34752,8987,Kits,6,0,0.0,6
34753,8987,Stuff Packs,8,0,0.0,8
34754,8988,Expansion Packs,16,0,0.0,16
34755,8988,Game Packs,12,0,0.0,12
34756,8988,Kits,33,0,0.0,33
34757,8988,Stuff Packs,20,0,0.0,20
34758,8989,Expansion Packs,16,0,0.0,16
34759,8989,Game Packs,10,0,0.0,10
34760,8989,Kits,16,1,0.0625,15
34761,8989,Stuff Packs,14,4,0.2857142857142857,10
34762,8990,Expansion Packs,11,0,0.0,11
34763,8990,Game Packs,2,1,0.5,1
34764,8990,Kits,5,1,0.2,4
34765,8990,Stuff Packs,7,3,0.42857142857142855,4
34766,8991,Expansion Packs,15,0,0.0,15
34767,8991,Game Packs,12,0,0.0,12
34768,8991,Kits,14,0,0.0,14
34769,8991,Stuff Packs,19,0,0.0,19
34770,8992,Expansion Packs,15,0,0.0,15
34771,8992,Game Packs,11,0,0.0,11
34772,8992,Kits,22,1,0.045454545454545456,21
34773,8992,Stuff Packs,19,0,0.0,19
34774,8993,Expansion Packs,16,0,0.0,16
34775,8993,Game Packs,12,0,0.0,12
34776,8993,Kits,33,0,0.0,33
34777,8993,Stuff Packs,20,0,0.0,20
34778,8994,Expansion Packs,15,0,0.0,15
34779,8994,Game Packs,10,0,0.0,10
34780,8994,Kits,2,1,0.5,1
34781,8994,Stuff Packs,13,3,0.23076923076923078,10
34782,8995,Expansion Packs,13,0,0.0,13
34783,8995,Game Packs,10,0,0.0,10
34784,8995,Kits,1,0,0.0,1
34785,8995,Stuff Packs,12,0,0.0,12
34786,8996,Expansion Packs,16,0,0.0,16
34787,8996,Game Packs,12,0,0.0,12
34788,8996,Kits,15,0,0.0,15
34789,8996,Stuff Packs,18,1,0.05555555555555555,17
34790,8997,Expansion Packs,12,0,0.0,12
34791,8997,Game Packs,7,0,0.0,7
34792,8997,Kits,1,0,0.0,1
34793,8997,Stuff Packs,10,5,0.5,5
34794,8998,Expansion Packs,8,0,0.0,8
34795,8998,Game Packs,5,1,0.2,4
34796,8998,Kits,3,3,1.0,0
34797,8998,Stuff Packs,9,4,0.4444444444444444,5
34798,8999,Expansion Packs,10,0,0.0,10
34799,8999,Game Packs,3,0,0.0,3
34800,8999,Stuff Packs,3,0,0.0,3
34801,9000,Expansion Packs,14,7,0.5,7
34802,9000,Game Packs,8,4,0.5,4
34803,9000,Kits,8,0,0.0,8
34804,9000,Stuff Packs,16,5,0.3125,11
34805,9001,Expansion Packs,13,0,0.0,13
34806,9001,Game Packs,4,0,0.0,4
34807,9001,Kits,15,1,0.06666666666666667,14
34808,9001,Stuff Packs,12,2,0.16666666666666666,10
34809,9002,Expansion Packs,4,0,0.0,4
34810,9002,Game Packs,4,0,0.0,4
34811,9002,Kits,2,1,0.5,1
34812,9002,Stuff Packs,6,0,0.0,6
34813,9003,Expansion Packs,15,0,0.0,15
34814,9003,Game Packs,12,0,0.0,12
34815,9003,Kits,5,1,0.2,4
34816,9003,Stuff Packs,20,0,0.0,20
34817,9004,Expansion Packs,16,0,0.0,16
34818,9004,Game Packs,10,0,0.0,10
34819,9004,Kits,27,1,0.037037037037037035,26
34820,9004,Stuff Packs,19,0,0.0,19
34821,9005,Expansion Packs,16,0,0.0,16
34822,9005,Game Packs,12,0,0.0,12
34823,9005,Kits,33,0,0.0,33
34824,9005,Stuff Packs,20,0,0.0,20
34825,9006,Expansion Packs,8,0,0.0,8
34826,9006,Game Packs,6,0,0.0,6
34827,9006,Stuff Packs,2,0,0.0,2
34828,9007,Expansion Packs,13,0,0.0,13
34829,9007,Game Packs,9,0,0.0,9
34830,9007,Kits,3,1,0.3333333333333333,2
34831,9007,Stuff Packs,10,2,0.2,8
34832,9008,Expansion Packs,16,0,0.0,16
34833,9008,Game Packs,12,0,0.0,12
34834,9008,Kits,18,3,0.16666666666666666,15
34835,9008,Stuff Packs,20,0,0.0,20
34836,9009,Expansion Packs,16,0,0.0,16
34837,9009,Game Packs,12,0,0.0,12
34838,9009,Kits,23,1,0.043478260869565216,22
34839,9009,Stuff Packs,20,4,0.2,16
34840,9010,Expansion Packs,7,0,0.0,7
34841,9010,Game Packs,4,0,0.0,4
34842,9010,Kits,6,0,0.0,6
34843,9010,Stuff Packs,6,0,0.0,6
34844,9011,Expansion Packs,15,0,0.0,15
34845,9011,Game Packs,12,0,0.0,12
34846,9011,Kits,21,0,0.0,21
34847,9011,Stuff Packs,20,0,0.0,20
34848,9012,Expansion Packs,14,0,0.0,14
34849,9012,Game Packs,10,0,0.0,10
34850,9012,Kits,8,2,0.25,6
34851,9012,Stuff Packs,8,2,0.25,6
34852,9013,Expansion Packs,6,0,0.0,6
34853,9013,Game Packs,3,0,0.0,3
34854,9013,Stuff Packs,3,0,0.0,3
34855,9014,Expansion Packs,16,0,0.0,16
34856,9014,Game Packs,11,0,0.0,11
34857,9014,Kits,14,0,0.0,14
34858,9014,Stuff Packs,20,0,0.0,20
34859,9015,Expansion Packs,14,0,0.0,14
34860,9015,Game Packs,11,0,0.0,11
34861,9015,Kits,1,1,1.0,0
34862,9015,Stuff Packs,16,0,0.0,16
34863,9016,Expansion Packs,12,0,0.0,12
34864,9016,Game Packs,10,0,0.0,10
34865,9016,Kits,3,0,0.0,3
34866,9016,Stuff Packs,14,2,0.14285714285714285,12
34867,9017,Expansion Packs,16,0,0.0,16
34868,9017,Game Packs,11,0,0.0,11
34869,9017,Kits,9,3,0.3333333333333333,6
34870,9017,Stuff Packs,18,0,0.0,18
34871,9018,Expansion Packs,3,0,0.0,3
34872,9018,Game Packs,2,0,0.0,2
34873,9018,Kits,1,0,0.0,1
34874,9018,Stuff Packs,2,0,0.0,2
34875,9019,Expansion Packs,6,0,0.0,6
34876,9019,Game Packs,4,0,0.0,4
34877,9019,Stuff Packs,5,0,0.0,5
34878,9020,Expansion Packs,12,0,0.0,12
34879,9020,Game Packs,3,1,0.3333333333333333,2
34880,9020,Kits,2,1,0.5,1
34881,9020,Stuff Packs,7,5,0.7142857142857143,2
34882,9021,Expansion Packs,14,0,0.0,14
34883,9021,Game Packs,6,0,0.0,6
34884,9021,Kits,6,1,0.16666666666666666,5
34885,9021,Stuff Packs,8,1,0.125,7
34886,9022,Expansion Packs,9,0,0.0,9
34887,9022,Game Packs,3,0,0.0,3
34888,9022,Kits,6,0,0.0,6
34889,9022,Stuff Packs,10,0,0.0,10
34890,9023,Expansion Packs,12,0,0.0,12
34891,9023,Game Packs,6,0,0.0,6
34892,9023,Kits,10,0,0.0,10
34893,9023,Stuff Packs,17,1,0.058823529411764705,16
34894,9024,Expansion Packs,7,0,0.0,7
34895,9024,Game Packs,3,0,0.0,3
34896,9024,Stuff Packs,3,0,0.0,3
34897,9025,Expansion Packs,13,0,0.0,13
34898,9025,Game Packs,6,0,0.0,6
34899,9025,Kits,11,2,0.18181818181818182,9
34900,9025,Stuff Packs,10,2,0.2,8
34901,9026,Expansion Packs,16,0,0.0,16
34902,9026,Game Packs,12,1,0.08333333333333333,11
34903,9026,Kits,21,2,0.09523809523809523,19
34904,9026,Stuff Packs,14,1,0.07142857142857142,13
34905,9027,Expansion Packs,15,0,0.0,15
34906,9027,Game Packs,12,0,0.0,12
34907,9027,Kits,22,1,0.045454545454545456,21
34908,9027,Stuff Packs,19,0,0.0,19
34909,9028,Expansion Packs,15,0,0.0,15
34910,9028,Game Packs,8,0,0.0,8
34911,9028,Kits,9,3,0.3333333333333333,6
34912,9028,Stuff Packs,13,1,0.07692307692307693,12
34913,9029,Expansion Packs,16,0,0.0,16
34914,9029,Game Packs,11,0,0.0,11
34915,9029,Kits,24,2,0.08333333333333333,22
34916,9029,Stuff Packs,17,1,0.058823529411764705,16
34917,9030,Expansion Packs,16,0,0.0,16
34918,9030,Game Packs,11,2,0.18181818181818182,9
34919,9030,Kits,20,1,0.05,19
34920,9030,Stuff Packs,20,0,0.0,20
34921,9031,Expansion Packs,11,0,0.0,11
34922,9031,Game Packs,9,0,0.0,9
34923,9031,Kits,2,2,1.0,0
34924,9031,Stuff Packs,18,0,0.0,18
34925,9032,Expansion Packs,5,0,0.0,5
34926,9032,Game Packs,3,0,0.0,3
34927,9032,Kits,1,1,1.0,0
34928,9032,Stuff Packs,7,3,0.42857142857142855,4
34929,9033,Expansion Packs,14,0,0.0,14
34930,9033,Game Packs,8,0,0.0,8
34931,9033,Kits,11,1,0.09090909090909091,10
34932,9033,Stuff Packs,11,3,0.2727272727272727,8
34933,9034,Expansion Packs,15,0,0.0,15
34934,9034,Game Packs,12,0,0.0,12
34935,9034,Kits,23,1,0.043478260869565216,22
34936,9034,Stuff Packs,20,0,0.0,20
34937,9035,Expansion Packs,4,0,0.0,4
34938,9035,Game Packs,3,0,0.0,3
34939,9035,Kits,1,1,1.0,0
34940,9035,Stuff Packs,4,0,0.0,4
34941,9036,Expansion Packs,14,0,0.0,14
34942,9036,Game Packs,12,0,0.0,12
34943,9036,Kits,2,2,1.0,0
34944,9036,Stuff Packs,17,2,0.11764705882352941,15
34945,9037,Expansion Packs,4,0,0.0,4
34946,9037,Game Packs,2,0,0.0,2
34947,9037,Kits,3,1,0.3333333333333333,2
34948,9037,Stuff Packs,3,1,0.3333333333333333,2
34949,9038,Expansion Packs,15,8,0.5333333333333333,7
34950,9038,Game Packs,12,11,0.9166666666666666,1
34951,9038,Kits,23,23,1.0,0
34952,9038,Stuff Packs,19,19,1.0,0
34953,9039,Expansion Packs,15,0,0.0,15
34954,9039,Game Packs,12,0,0.0,12
34955,9039,Kits,33,1,0.030303030303030304,32
34956,9039,Stuff Packs,20,0,0.0,20
34957,9040,Expansion Packs,10,0,0.0,10
34958,9040,Game Packs,6,0,0.0,6
34959,9040,Kits,3,3,1.0,0
34960,9040,Stuff Packs,9,3,0.3333333333333333,6
34961,9041,Expansion Packs,15,0,0.0,15
34962,9041,Game Packs,12,0,0.0,12
34963,9041,Kits,6,3,0.5,3
34964,9041,Stuff Packs,14,2,0.14285714285714285,12
34965,9042,Expansion Packs,16,0,0.0,16
34966,9042,Game Packs,10,0,0.0,10
34967,9042,Kits,13,2,0.15384615384615385,11
34968,9042,Stuff Packs,17,0,0.0,17
34969,9043,Expansion Packs,16,0,0.0,16
34970,9043,Game Packs,10,0,0.0,10
34971,9043,Kits,17,1,0.058823529411764705,16
34972,9043,Stuff Packs,19,0,0.0,19
34973,9044,Expansion Packs,16,0,0.0,16
34974,9044,Game Packs,12,0,0.0,12
34975,9044,Kits,18,0,0.0,18
34976,9044,Stuff Packs,20,0,0.0,20
34977,9045,Expansion Packs,16,0,0.0,16
34978,9045,Game Packs,11,1,0.09090909090909091,10
34979,9045,Kits,12,1,0.08333333333333333,11
34980,9045,Stuff Packs,18,1,0.05555555555555555,17
34981,9046,Expansion Packs,6,0,0.0,6
34982,9046,Game Packs,3,0,0.0,3
34983,9046,Kits,2,1,0.5,1
34984,9046,Stuff Packs,7,2,0.2857142857142857,5
34985,9047,Expansion Packs,13,0,0.0,13
34986,9047,Game Packs,5,0,0.0,5
34987,9047,Kits,1,1,1.0,0
34988,9047,Stuff Packs,8,0,0.0,8
34989,9048,Expansion Packs,15,0,0.0,15
34990,9048,Game Packs,9,1,0.1111111111111111,8
34991,9048,Kits,7,1,0.14285714285714285,6
34992,9048,Stuff Packs,9,3,0.3333333333333333,6
34993,9049,Expansion Packs,16,0,0.0,16
34994,9049,Game Packs,12,0,0.0,12
34995,9049,Kits,33,0,0.0,33
34996,9049,Stuff Packs,20,1,0.05,19
34997,9050,Expansion Packs,11,0,0.0,11
34998,9050,Game Packs,4,0,0.0,4
34999,9050,Kits,4,0,0.0,4
35000,9050,Stuff Packs,10,1,0.1,9
35001,9051,Expansion Packs,10,0,0.0,10
35002,9051,Game Packs,4,1,0.25,3
35003,9051,Kits,4,2,0.5,2
35004,9051,Stuff Packs,11,6,0.5454545454545454,5
35005,9052,Expansion Packs,16,0,0.0,16
35006,9052,Game Packs,12,1,0.08333333333333333,11
35007,9052,Kits,30,0,0.0,30
35008,9052,Stuff Packs,18,0,0.0,18
35009,9053,Expansion Packs,7,0,0.0,7
35010,9053,Game Packs,1,0,0.0,1
35011,9053,Kits,4,0,0.0,4
35012,9053,Stuff Packs,6,1,0.16666666666666666,5
35013,9054,Expansion Packs,16,0,0.0,16
35014,9054,Game Packs,12,0,0.0,12
35015,9054,Kits,33,0,0.0,33
35016,9054,Stuff Packs,20,0,0.0,20
35017,9055,Expansion Packs,11,0,0.0,11
35018,9055,Game Packs,6,0,0.0,6
35019,9055,Kits,1,1,1.0,0
35020,9055,Stuff Packs,8,0,0.0,8
35021,9056,Expansion Packs,16,0,0.0,16
35022,9056,Game Packs,12,0,0.0,12
35023,9056,Kits,20,0,0.0,20
35024,9056,Stuff Packs,19,0,0.0,19
35025,9057,Expansion Packs,16,3,0.1875,13
35026,9057,Game Packs,12,3,0.25,9
35027,9057,Kits,30,1,0.03333333333333333,29
35028,9057,Stuff Packs,20,8,0.4,12
35029,9058,Expansion Packs,15,0,0.0,15
35030,9058,Game Packs,10,0,0.0,10
35031,9058,Kits,2,1,0.5,1
35032,9058,Stuff Packs,10,1,0.1,9
35033,9059,Expansion Packs,14,0,0.0,14
35034,9059,Game Packs,8,0,0.0,8
35035,9059,Kits,6,1,0.16666666666666666,5
35036,9059,Stuff Packs,8,3,0.375,5
35037,9060,Expansion Packs,16,0,0.0,16
35038,9060,Game Packs,8,0,0.0,8
35039,9060,Kits,2,1,0.5,1
35040,9060,Stuff Packs,14,2,0.14285714285714285,12
35041,9061,Expansion Packs,5,0,0.0,5
35042,9061,Game Packs,2,0,0.0,2
35043,9061,Stuff Packs,3,3,1.0,0
35044,9062,Expansion Packs,4,0,0.0,4
35045,9062,Game Packs,3,0,0.0,3
35046,9062,Kits,2,2,1.0,0
35047,9062,Stuff Packs,5,3,0.6,2
35048,9063,Expansion Packs,16,0,0.0,16
35049,9063,Game Packs,12,0,0.0,12
35050,9063,Kits,33,0,0.0,33
35051,9063,Stuff Packs,20,0,0.0,20
35052,9064,Expansion Packs,11,0,0.0,11
35053,9064,Game Packs,6,0,0.0,6
35054,9064,Kits,6,3,0.5,3
35055,9064,Stuff Packs,13,3,0.23076923076923078,10
35056,9065,Expansion Packs,10,0,0.0,10
35057,9065,Game Packs,4,1,0.25,3
35058,9065,Kits,4,3,0.75,1
35059,9065,Stuff Packs,7,4,0.5714285714285714,3
35060,9066,Expansion Packs,16,0,0.0,16
35061,9066,Game Packs,7,0,0.0,7
35062,9066,Kits,2,2,1.0,0
35063,9066,Stuff Packs,10,2,0.2,8
35064,9067,Expansion Packs,16,0,0.0,16
35065,9067,Game Packs,12,0,0.0,12
35066,9067,Kits,3,2,0.6666666666666666,1
35067,9067,Stuff Packs,18,0,0.0,18
35068,9068,Expansion Packs,16,0,0.0,16
35069,9068,Game Packs,11,0,0.0,11
35070,9068,Kits,6,2,0.3333333333333333,4
35071,9068,Stuff Packs,13,2,0.15384615384615385,11
35072,9069,Expansion Packs,14,0,0.0,14
35073,9069,Game Packs,4,1,0.25,3
35074,9069,Kits,5,3,0.6,2
35075,9069,Stuff Packs,9,3,0.3333333333333333,6
35076,9070,Expansion Packs,16,0,0.0,16
35077,9070,Game Packs,12,0,0.0,12
35078,9070,Kits,22,0,0.0,22
35079,9070,Stuff Packs,18,0,0.0,18
35080,9071,Expansion Packs,16,0,0.0,16
35081,9071,Game Packs,12,0,0.0,12
35082,9071,Kits,33,0,0.0,33
35083,9071,Stuff Packs,20,0,0.0,20
35084,9072,Expansion Packs,16,0,0.0,16
35085,9072,Game Packs,12,0,0.0,12
35086,9072,Kits,33,0,0.0,33
35087,9072,Stuff Packs,20,0,0.0,20
35088,9073,Expansion Packs,8,0,0.0,8
35089,9073,Game Packs,6,0,0.0,6
35090,9073,Kits,3,0,0.0,3
35091,9073,Stuff Packs,3,0,0.0,3
35092,9074,Expansion Packs,12,0,0.0,12
35093,9074,Game Packs,5,1,0.2,4
35094,9074,Stuff Packs,8,0,0.0,8
35095,9075,Expansion Packs,16,0,0.0,16
35096,9075,Game Packs,12,0,0.0,12
35097,9075,Kits,33,0,0.0,33
35098,9075,Stuff Packs,20,0,0.0,20
35099,9076,Expansion Packs,7,0,0.0,7
35100,9076,Game Packs,3,0,0.0,3
35101,9076,Stuff Packs,3,0,0.0,3
35102,9077,Expansion Packs,15,0,0.0,15
35103,9077,Game Packs,10,0,0.0,10
35104,9077,Kits,3,2,0.6666666666666666,1
35105,9077,Stuff Packs,6,3,0.5,3
35106,9078,Expansion Packs,4,1,0.25,3
35107,9078,Game Packs,2,0,0.0,2
35108,9078,Kits,2,0,0.0,2
35109,9078,Stuff Packs,2,0,0.0,2
35110,9079,Expansion Packs,16,0,0.0,16
35111,9079,Game Packs,9,0,0.0,9
35112,9079,Kits,3,0,0.0,3
35113,9079,Stuff Packs,17,0,0.0,17
35114,9080,Expansion Packs,14,1,0.07142857142857142,13
35115,9080,Game Packs,10,0,0.0,10
35116,9080,Kits,3,0,0.0,3
35117,9080,Stuff Packs,10,0,0.0,10
35118,9081,Expansion Packs,16,0,0.0,16
35119,9081,Game Packs,11,0,0.0,11
35120,9081,Kits,11,0,0.0,11
35121,9081,Stuff Packs,20,0,0.0,20
35122,9082,Expansion Packs,12,0,0.0,12
35123,9082,Game Packs,8,0,0.0,8
35124,9082,Kits,3,0,0.0,3
35125,9082,Stuff Packs,6,0,0.0,6
35126,9083,Expansion Packs,6,0,0.0,6
35127,9083,Game Packs,3,0,0.0,3
35128,9083,Kits,2,1,0.5,1
35129,9083,Stuff Packs,2,0,0.0,2
35130,9084,Expansion Packs,6,5,0.8333333333333334,1
35131,9084,Stuff Packs,2,2,1.0,0
35132,9085,Expansion Packs,16,0,0.0,16
35133,9085,Game Packs,11,0,0.0,11
35134,9085,Kits,10,1,0.1,9
35135,9085,Stuff Packs,19,0,0.0,19
35136,9086,Expansion Packs,11,0,0.0,11
35137,9086,Game Packs,5,0,0.0,5
35138,9086,Stuff Packs,3,3,1.0,0
35139,9087,Expansion Packs,15,0,0.0,15
35140,9087,Game Packs,10,1,0.1,9
35141,9087,Kits,3,1,0.3333333333333333,2
35142,9087,Stuff Packs,18,0,0.0,18
35143,9088,Expansion Packs,13,0,0.0,13
35144,9088,Game Packs,3,0,0.0,3
35145,9088,Stuff Packs,5,0,0.0,5
35146,9089,Expansion Packs,16,0,0.0,16
35147,9089,Game Packs,9,0,0.0,9
35148,9089,Kits,3,3,1.0,0
35149,9089,Stuff Packs,16,4,0.25,12
35150,9090,Expansion Packs,10,0,0.0,10
35151,9090,Game Packs,6,1,0.16666666666666666,5
35152,9090,Stuff Packs,8,2,0.25,6
35153,9091,Expansion Packs,16,0,0.0,16
35154,9091,Game Packs,12,0,0.0,12
35155,9091,Kits,17,1,0.058823529411764705,16
35156,9091,Stuff Packs,20,0,0.0,20
35157,9092,Expansion Packs,2,0,0.0,2
35158,9092,Game Packs,1,0,0.0,1
35159,9092,Kits,1,1,1.0,0
35160,9092,Stuff Packs,4,3,0.75,1
35161,9093,Expansion Packs,16,0,0.0,16
35162,9093,Game Packs,9,0,0.0,9
35163,9093,Kits,19,1,0.05263157894736842,18
35164,9093,Stuff Packs,17,1,0.058823529411764705,16
35165,9094,Expansion Packs,16,0,0.0,16
35166,9094,Game Packs,10,0,0.0,10
35167,9094,Kits,1,0,0.0,1
35168,9094,Stuff Packs,4,0,0.0,4
35169,9095,Expansion Packs,1,0,0.0,1
35170,9095,Game Packs,5,0,0.0,5
35171,9095,Stuff Packs,16,0,0.0,16
35172,9096,Expansion Packs,15,0,0.0,15
35173,9096,Game Packs,9,0,0.0,9
35174,9096,Kits,4,1,0.25,3
35175,9096,Stuff Packs,14,0,0.0,14
35176,9097,Expansion Packs,16,0,0.0,16
35177,9097,Game Packs,12,0,0.0,12
35178,9097,Kits,33,0,0.0,33
35179,9097,Stuff Packs,20,0,0.0,20
35180,9098,Expansion Packs,13,0,0.0,13
35181,9098,Game Packs,3,0,0.0,3
35182,9098,Kits,3,1,0.3333333333333333,2
35183,9098,Stuff Packs,9,1,0.1111111111111111,8
35184,9099,Expansion Packs,14,0,0.0,14
35185,9099,Game Packs,11,0,0.0,11
35186,9099,Kits,12,2,0.16666666666666666,10
35187,9099,Stuff Packs,20,1,0.05,19
35188,9100,Stuff Packs,1,1,1.0,0
35189,9101,Expansion Packs,8,0,0.0,8
35190,9101,Game Packs,1,0,0.0,1
35191,9101,Kits,2,2,1.0,0
35192,9101,Stuff Packs,4,1,0.25,3
35193,9102,Expansion Packs,12,0,0.0,12
35194,9102,Game Packs,8,0,0.0,8
35195,9102,Kits,3,1,0.3333333333333333,2
35196,9102,Stuff Packs,9,2,0.2222222222222222,7
35197,9103,Expansion Packs,14,0,0.0,14
35198,9103,Game Packs,6,0,0.0,6
35199,9103,Kits,4,1,0.25,3
35200,9103,Stuff Packs,10,2,0.2,8
35201,9104,Expansion Packs,15,0,0.0,15
35202,9104,Game Packs,12,0,0.0,12
35203,9104,Kits,28,0,0.0,28
35204,9104,Stuff Packs,20,0,0.0,20
35205,9105,Expansion Packs,16,2,0.125,14
35206,9105,Game Packs,9,1,0.1111111111111111,8
35207,9105,Kits,6,2,0.3333333333333333,4
35208,9105,Stuff Packs,19,3,0.15789473684210525,16
35209,9106,Expansion Packs,16,0,0.0,16
35210,9106,Game Packs,12,0,0.0,12
35211,9106,Kits,33,1,0.030303030303030304,32
35212,9106,Stuff Packs,20,0,0.0,20
35213,9107,Expansion Packs,16,0,0.0,16
35214,9107,Game Packs,11,0,0.0,11
35215,9107,Kits,5,1,0.2,4
35216,9107,Stuff Packs,17,0,0.0,17
35217,9108,Expansion Packs,16,0,0.0,16
35218,9108,Game Packs,12,0,0.0,12
35219,9108,Kits,32,1,0.03125,31
35220,9108,Stuff Packs,20,0,0.0,20
35221,9109,Expansion Packs,16,0,0.0,16
35222,9109,Game Packs,12,0,0.0,12
35223,9109,Kits,19,0,0.0,19
35224,9109,Stuff Packs,20,1,0.05,19
35225,9110,Expansion Packs,4,0,0.0,4
35226,9110,Game Packs,3,0,0.0,3
35227,9110,Kits,1,1,1.0,0
35228,9110,Stuff Packs,4,0,0.0,4
35229,9111,Expansion Packs,16,0,0.0,16
35230,9111,Game Packs,12,0,0.0,12
35231,9111,Stuff Packs,9,1,0.1111111111111111,8
35232,9112,Expansion Packs,12,0,0.0,12
35233,9112,Game Packs,9,0,0.0,9
35234,9112,Kits,4,3,0.75,1
35235,9112,Stuff Packs,8,3,0.375,5
35236,9113,Expansion Packs,8,0,0.0,8
35237,9113,Game Packs,2,0,0.0,2
35238,9113,Kits,2,2,1.0,0
35239,9113,Stuff Packs,7,5,0.7142857142857143,2
35240,9114,Expansion Packs,16,0,0.0,16
35241,9114,Game Packs,11,0,0.0,11
35242,9114,Stuff Packs,15,0,0.0,15
35243,9115,Expansion Packs,7,0,0.0,7
35244,9115,Game Packs,3,0,0.0,3
35245,9115,Kits,5,1,0.2,4
35246,9115,Stuff Packs,7,2,0.2857142857142857,5
35247,9116,Expansion Packs,8,1,0.125,7
35248,9116,Game Packs,4,0,0.0,4
35249,9116,Kits,4,0,0.0,4
35250,9116,Stuff Packs,6,2,0.3333333333333333,4
35251,9117,Expansion Packs,10,0,0.0,10
35252,9117,Game Packs,5,0,0.0,5
35253,9117,Kits,12,0,0.0,12
35254,9117,Stuff Packs,14,0,0.0,14
35255,9118,Expansion Packs,3,0,0.0,3
35256,9118,Game Packs,1,1,1.0,0
35257,9118,Kits,3,2,0.6666666666666666,1
35258,9118,Stuff Packs,2,2,1.0,0
35259,9119,Expansion Packs,14,0,0.0,14
35260,9119,Game Packs,8,0,0.0,8
35261,9119,Stuff Packs,1,1,1.0,0
35262,9120,Expansion Packs,16,0,0.0,16
35263,9120,Game Packs,12,0,0.0,12
35264,9120,Kits,33,1,0.030303030303030304,32
35265,9120,Stuff Packs,20,0,0.0,20
35266,9121,Expansion Packs,16,0,0.0,16
35267,9121,Game Packs,7,0,0.0,7
35268,9121,Kits,9,1,0.1111111111111111,8
35269,9121,Stuff Packs,12,0,0.0,12
35270,9122,Expansion Packs,10,0,0.0,10
35271,9122,Game Packs,7,0,0.0,7
35272,9122,Kits,11,1,0.09090909090909091,10
35273,9122,Stuff Packs,14,1,0.07142857142857142,13
35274,9123,Expansion Packs,6,0,0.0,6
35275,9123,Game Packs,2,0,0.0,2
35276,9123,Kits,4,0,0.0,4
35277,9123,Stuff Packs,10,0,0.0,10
35278,9124,Expansion Packs,6,0,0.0,6
35279,9124,Game Packs,3,1,0.3333333333333333,2
35280,9124,Kits,3,3,1.0,0
35281,9124,Stuff Packs,6,3,0.5,3
35282,9125,Expansion Packs,15,0,0.0,15
35283,9125,Game Packs,12,0,0.0,12
35284,9125,Kits,22,0,0.0,22
35285,9125,Stuff Packs,20,0,0.0,20
35286,9126,Expansion Packs,16,0,0.0,16
35287,9126,Game Packs,12,0,0.0,12
35288,9126,Kits,33,0,0.0,33
35289,9126,Stuff Packs,20,0,0.0,20
35290,9127,Expansion Packs,16,0,0.0,16
35291,9127,Game Packs,12,2,0.16666666666666666,10
35292,9127,Kits,33,11,0.3333333333333333,22
35293,9127,Stuff Packs,20,9,0.45,11
35294,9128,Expansion Packs,16,0,0.0,16
35295,9128,Game Packs,10,1,0.1,9
35296,9128,Kits,2,2,1.0,0
35297,9128,Stuff Packs,11,6,0.5454545454545454,5
35298,9129,Expansion Packs,8,0,0.0,8
35299,9129,Game Packs,7,0,0.0,7
35300,9129,Kits,4,1,0.25,3
35301,9129,Stuff Packs,6,0,0.0,6
35302,9130,Expansion Packs,16,0,0.0,16
35303,9130,Game Packs,10,0,0.0,10
35304,9130,Kits,4,2,0.5,2
35305,9130,Stuff Packs,18,1,0.05555555555555555,17
35306,9131,Expansion Packs,16,0,0.0,16
35307,9131,Game Packs,4,1,0.25,3
35308,9131,Kits,3,0,0.0,3
35309,9131,Stuff Packs,4,0,0.0,4
35310,9132,Expansion Packs,12,0,0.0,12
35311,9132,Game Packs,7,0,0.0,7
35312,9132,Kits,5,4,0.8,1
35313,9132,Stuff Packs,8,3,0.375,5
35314,9133,Expansion Packs,15,0,0.0,15
35315,9133,Game Packs,7,0,0.0,7
35316,9133,Kits,5,3,0.6,2
35317,9133,Stuff Packs,13,3,0.23076923076923078,10
35318,9134,Expansion Packs,16,0,0.0,16
35319,9134,Game Packs,12,0,0.0,12
35320,9134,Kits,33,0,0.0,33
35321,9134,Stuff Packs,20,0,0.0,20
35322,9135,Expansion Packs,16,0,0.0,16
35323,9135,Game Packs,12,0,0.0,12
35324,9135,Kits,31,1,0.03225806451612903,30
35325,9135,Stuff Packs,20,0,0.0,20
35326,9136,Expansion Packs,16,16,1.0,0
35327,9136,Game Packs,12,12,1.0,0
35328,9136,Kits,33,33,1.0,0
35329,9136,Stuff Packs,20,18,0.9,2
35330,9137,Expansion Packs,14,0,0.0,14
35331,9137,Game Packs,6,0,0.0,6
35332,9137,Kits,2,0,0.0,2
35333,9137,Stuff Packs,5,0,0.0,5
35334,9138,Expansion Packs,6,0,0.0,6
35335,9138,Game Packs,5,0,0.0,5
35336,9138,Kits,10,0,0.0,10
35337,9138,Stuff Packs,7,0,0.0,7
35338,9139,Expansion Packs,15,0,0.0,15
35339,9139,Game Packs,6,0,0.0,6
35340,9139,Kits,9,1,0.1111111111111111,8
35341,9139,Stuff Packs,14,0,0.0,14
35342,9140,Expansion Packs,16,0,0.0,16
35343,9140,Game Packs,12,1,0.08333333333333333,11
35344,9140,Kits,33,0,0.0,33
35345,9140,Stuff Packs,20,2,0.1,18
35346,9141,Expansion Packs,14,0,0.0,14
35347,9141,Game Packs,5,0,0.0,5
35348,9141,Kits,1,0,0.0,1
35349,9141,Stuff Packs,7,2,0.2857142857142857,5
35350,9142,Expansion Packs,13,0,0.0,13
35351,9142,Game Packs,8,0,0.0,8
35352,9142,Kits,4,1,0.25,3
35353,9142,Stuff Packs,8,2,0.25,6
35354,9143,Expansion Packs,11,0,0.0,11
35355,9143,Game Packs,3,1,0.3333333333333333,2
35356,9143,Stuff Packs,7,3,0.42857142857142855,4
35357,9144,Expansion Packs,16,0,0.0,16
35358,9144,Game Packs,10,0,0.0,10
35359,9144,Kits,22,0,0.0,22
35360,9144,Stuff Packs,19,1,0.05263157894736842,18
35361,9145,Expansion Packs,9,0,0.0,9
35362,9145,Game Packs,5,1,0.2,4
35363,9145,Kits,11,2,0.18181818181818182,9
35364,9145,Stuff Packs,10,4,0.4,6
35365,9146,Expansion Packs,16,0,0.0,16
35366,9146,Game Packs,12,0,0.0,12
35367,9146,Kits,1,0,0.0,1
35368,9146,Stuff Packs,20,0,0.0,20
35369,9147,Expansion Packs,1,0,0.0,1
35370,9147,Game Packs,1,0,0.0,1
35371,9147,Kits,2,0,0.0,2
35372,9147,Stuff Packs,1,0,0.0,1
35373,9148,Expansion Packs,12,0,0.0,12
35374,9148,Game Packs,9,0,0.0,9
35375,9148,Kits,9,2,0.2222222222222222,7
35376,9148,Stuff Packs,13,1,0.07692307692307693,12
35377,9149,Expansion Packs,15,0,0.0,15
35378,9149,Game Packs,11,0,0.0,11
35379,9149,Kits,9,1,0.1111111111111111,8
35380,9149,Stuff Packs,18,0,0.0,18
35381,9150,Expansion Packs,13,0,0.0,13
35382,9150,Game Packs,9,0,0.0,9
35383,9150,Kits,10,2,0.2,8
35384,9150,Stuff Packs,18,1,0.05555555555555555,17
35385,9151,Expansion Packs,14,0,0.0,14
35386,9151,Game Packs,11,0,0.0,11
35387,9151,Kits,10,1,0.1,9
35388,9151,Stuff Packs,19,0,0.0,19
35389,9152,Expansion Packs,16,0,0.0,16
35390,9152,Game Packs,12,0,0.0,12
35391,9152,Kits,31,0,0.0,31
35392,9152,Stuff Packs,20,0,0.0,20
35393,9153,Expansion Packs,15,0,0.0,15
35394,9153,Game Packs,8,1,0.125,7
35395,9153,Kits,5,2,0.4,3
35396,9153,Stuff Packs,12,2,0.16666666666666666,10
35397,9154,Expansion Packs,6,0,0.0,6
35398,9154,Game Packs,5,0,0.0,5
35399,9154,Kits,1,1,1.0,0
35400,9154,Stuff Packs,8,0,0.0,8
35401,9155,Expansion Packs,15,0,0.0,15
35402,9155,Game Packs,12,0,0.0,12
35403,9155,Kits,5,1,0.2,4
35404,9155,Stuff Packs,17,0,0.0,17
35405,9156,Expansion Packs,16,0,0.0,16
35406,9156,Game Packs,12,0,0.0,12
35407,9156,Kits,23,0,0.0,23
35408,9156,Stuff Packs,20,0,0.0,20
35409,9157,Expansion Packs,9,0,0.0,9
35410,9157,Game Packs,9,0,0.0,9
35411,9157,Kits,1,0,0.0,1
35412,9157,Stuff Packs,15,2,0.13333333333333333,13
35413,9158,Expansion Packs,2,0,0.0,2
35414,9158,Kits,15,0,0.0,15
35415,9158,Stuff Packs,1,0,0.0,1
35416,9159,Expansion Packs,12,0,0.0,12
35417,9159,Game Packs,9,0,0.0,9
35418,9159,Kits,2,1,0.5,1
35419,9159,Stuff Packs,11,2,0.18181818181818182,9
35420,9160,Expansion Packs,10,1,0.1,9
35421,9160,Game Packs,4,0,0.0,4
35422,9160,Kits,3,1,0.3333333333333333,2
35423,9160,Stuff Packs,9,2,0.2222222222222222,7
35424,9161,Expansion Packs,11,0,0.0,11
35425,9161,Game Packs,7,0,0.0,7
35426,9161,Kits,4,1,0.25,3
35427,9161,Stuff Packs,7,3,0.42857142857142855,4
35428,9162,Expansion Packs,16,0,0.0,16
35429,9162,Game Packs,12,0,0.0,12
35430,9162,Kits,33,0,0.0,33
35431,9162,Stuff Packs,20,0,0.0,20
35432,9163,Expansion Packs,16,0,0.0,16
35433,9163,Game Packs,12,0,0.0,12
35434,9163,Kits,33,0,0.0,33
35435,9163,Stuff Packs,20,0,0.0,20
35436,9164,Expansion Packs,16,0,0.0,16
35437,9164,Game Packs,12,0,0.0,12
35438,9164,Kits,10,1,0.1,9
35439,9164,Stuff Packs,17,0,0.0,17
35440,9165,Expansion Packs,12,0,0.0,12
35441,9165,Game Packs,5,0,0.0,5
35442,9165,Kits,22,0,0.0,22
35443,9165,Stuff Packs,8,0,0.0,8
35444,9166,Expansion Packs,13,0,0.0,13
35445,9166,Game Packs,8,0,0.0,8
35446,9166,Kits,2,2,1.0,0
35447,9166,Stuff Packs,15,0,0.0,15
35448,9167,Expansion Packs,10,0,0.0,10
35449,9167,Game Packs,3,1,0.3333333333333333,2
35450,9167,Kits,3,3,1.0,0
35451,9167,Stuff Packs,5,4,0.8,1
35452,9168,Expansion Packs,4,0,0.0,4
35453,9168,Kits,2,0,0.0,2
35454,9168,Stuff Packs,4,2,0.5,2
35455,9169,Expansion Packs,13,11,0.8461538461538461,2
35456,9169,Game Packs,4,4,1.0,0
35457,9169,Kits,3,1,0.3333333333333333,2
35458,9169,Stuff Packs,6,6,1.0,0
35459,9170,Kits,1,1,1.0,0
35460,9170,Stuff Packs,3,3,1.0,0
35461,9171,Expansion Packs,7,1,0.14285714285714285,6
35462,9171,Game Packs,2,0,0.0,2
35463,9171,Kits,1,1,1.0,0
35464,9171,Stuff Packs,7,2,0.2857142857142857,5
35465,9172,Expansion Packs,7,0,0.0,7
35466,9172,Game Packs,5,0,0.0,5
35467,9172,Kits,3,1,0.3333333333333333,2
35468,9172,Stuff Packs,11,1,0.09090909090909091,10
35469,9173,Expansion Packs,15,0,0.0,15
35470,9173,Game Packs,8,0,0.0,8
35471,9173,Kits,3,0,0.0,3
35472,9173,Stuff Packs,19,0,0.0,19
35473,9174,Expansion Packs,16,0,0.0,16
35474,9174,Game Packs,12,0,0.0,12
35475,9174,Kits,28,0,0.0,28
35476,9174,Stuff Packs,20,0,0.0,20
35477,9175,Expansion Packs,8,0,0.0,8
35478,9175,Game Packs,6,0,0.0,6
35479,9175,Kits,10,0,0.0,10
35480,9175,Stuff Packs,7,0,0.0,7
35481,9176,Expansion Packs,13,0,0.0,13
35482,9176,Game Packs,10,0,0.0,10
35483,9176,Kits,17,1,0.058823529411764705,16
35484,9176,Stuff Packs,19,1,0.05263157894736842,18
35485,9177,Expansion Packs,15,0,0.0,15
35486,9177,Game Packs,12,0,0.0,12
35487,9177,Kits,25,0,0.0,25
35488,9177,Stuff Packs,20,1,0.05,19
35489,9178,Expansion Packs,16,0,0.0,16
35490,9178,Game Packs,12,1,0.08333333333333333,11
35491,9178,Kits,33,3,0.09090909090909091,30
35492,9178,Stuff Packs,20,1,0.05,19
35493,9179,Expansion Packs,2,0,0.0,2
35494,9179,Game Packs,1,0,0.0,1
35495,9179,Kits,1,1,1.0,0
35496,9179,Stuff Packs,2,1,0.5,1
35497,9180,Expansion Packs,9,0,0.0,9
35498,9180,Game Packs,8,0,0.0,8
35499,9180,Kits,11,1,0.09090909090909091,10
35500,9180,Stuff Packs,10,3,0.3,7
35501,9181,Expansion Packs,16,0,0.0,16
35502,9181,Game Packs,11,0,0.0,11
35503,9181,Kits,26,0,0.0,26
35504,9181,Stuff Packs,20,0,0.0,20
35505,9182,Expansion Packs,14,0,0.0,14
35506,9182,Game Packs,10,0,0.0,10
35507,9182,Kits,2,1,0.5,1
35508,9182,Stuff Packs,12,1,0.08333333333333333,11
35509,9183,Expansion Packs,16,1,0.0625,15
35510,9183,Game Packs,12,0,0.0,12
35511,9183,Kits,28,0,0.0,28
35512,9183,Stuff Packs,20,0,0.0,20
35513,9184,Expansion Packs,16,0,0.0,16
35514,9184,Game Packs,12,0,0.0,12
35515,9184,Kits,21,0,0.0,21
35516,9184,Stuff Packs,20,0,0.0,20
35517,9185,Expansion Packs,6,0,0.0,6
35518,9185,Game Packs,2,0,0.0,2
35519,9185,Kits,5,1,0.2,4
35520,9185,Stuff Packs,7,2,0.2857142857142857,5
35521,9186,Expansion Packs,15,0,0.0,15
35522,9186,Game Packs,11,0,0.0,11
35523,9186,Kits,3,0,0.0,3
35524,9186,Stuff Packs,18,0,0.0,18
35525,9187,Expansion Packs,14,0,0.0,14
35526,9187,Game Packs,10,0,0.0,10
35527,9187,Kits,9,1,0.1111111111111111,8
35528,9187,Stuff Packs,15,0,0.0,15
35529,9188,Expansion Packs,16,0,0.0,16
35530,9188,Game Packs,11,0,0.0,11
35531,9188,Kits,19,1,0.05263157894736842,18
35532,9188,Stuff Packs,20,0,0.0,20
35533,9189,Expansion Packs,14,1,0.07142857142857142,13
35534,9189,Game Packs,9,0,0.0,9
35535,9189,Kits,1,0,0.0,1
35536,9189,Stuff Packs,14,0,0.0,14
35537,9190,Expansion Packs,16,0,0.0,16
35538,9190,Game Packs,12,0,0.0,12
35539,9190,Kits,33,0,0.0,33
35540,9190,Stuff Packs,20,0,0.0,20
35541,9191,Expansion Packs,16,0,0.0,16
35542,9191,Game Packs,12,0,0.0,12
35543,9191,Kits,15,0,0.0,15
35544,9191,Stuff Packs,16,0,0.0,16
35545,9192,Expansion Packs,12,0,0.0,12
35546,9192,Game Packs,8,0,0.0,8
35547,9192,Kits,1,1,1.0,0
35548,9192,Stuff Packs,15,1,0.06666666666666667,14
35549,9193,Expansion Packs,9,0,0.0,9
35550,9193,Game Packs,6,0,0.0,6
35551,9193,Stuff Packs,9,0,0.0,9
35552,9194,Expansion Packs,12,0,0.0,12
35553,9194,Game Packs,6,1,0.16666666666666666,5
35554,9194,Kits,18,0,0.0,18
35555,9194,Stuff Packs,18,0,0.0,18
35556,9195,Expansion Packs,16,0,0.0,16
35557,9195,Game Packs,12,0,0.0,12
35558,9195,Kits,33,1,0.030303030303030304,32
35559,9195,Stuff Packs,20,0,0.0,20
35560,9196,Expansion Packs,11,0,0.0,11
35561,9196,Game Packs,4,0,0.0,4
35562,9196,Kits,9,0,0.0,9
35563,9196,Stuff Packs,17,0,0.0,17
35564,9197,Expansion Packs,14,0,0.0,14
35565,9197,Game Packs,1,1,1.0,0
35566,9197,Kits,3,3,1.0,0
35567,9197,Stuff Packs,4,4,1.0,0
35568,9198,Expansion Packs,16,0,0.0,16
35569,9198,Game Packs,12,0,0.0,12
35570,9198,Kits,30,2,0.06666666666666667,28
35571,9198,Stuff Packs,20,0,0.0,20
35572,9199,Expansion Packs,14,0,0.0,14
35573,9199,Game Packs,10,0,0.0,10
35574,9199,Kits,8,1,0.125,7
35575,9199,Stuff Packs,18,2,0.1111111111111111,16
35576,9200,Expansion Packs,11,0,0.0,11
35577,9200,Game Packs,1,0,0.0,1
35578,9200,Kits,2,0,0.0,2
35579,9200,Stuff Packs,5,0,0.0,5
35580,9201,Expansion Packs,16,0,0.0,16
35581,9201,Game Packs,12,0,0.0,12
35582,9201,Kits,33,0,0.0,33
35583,9201,Stuff Packs,20,0,0.0,20
35584,9202,Expansion Packs,13,0,0.0,13
35585,9202,Game Packs,5,0,0.0,5
35586,9202,Kits,3,1,0.3333333333333333,2
35587,9202,Stuff Packs,10,3,0.3,7
35588,9203,Expansion Packs,7,0,0.0,7
35589,9203,Game Packs,4,0,0.0,4
35590,9203,Kits,2,2,1.0,0
35591,9203,Stuff Packs,8,3,0.375,5
35592,9204,Expansion Packs,13,0,0.0,13
35593,9204,Game Packs,9,0,0.0,9
35594,9204,Kits,7,1,0.14285714285714285,6
35595,9204,Stuff Packs,17,0,0.0,17
35596,9205,Expansion Packs,7,0,0.0,7
35597,9205,Game Packs,5,0,0.0,5
35598,9205,Kits,8,1,0.125,7
35599,9205,Stuff Packs,8,1,0.125,7
35600,9206,Expansion Packs,16,0,0.0,16
35601,9206,Game Packs,12,0,0.0,12
35602,9206,Kits,33,0,0.0,33
35603,9206,Stuff Packs,20,0,0.0,20
35604,9207,Expansion Packs,16,0,0.0,16
35605,9207,Game Packs,4,0,0.0,4
35606,9207,Kits,7,0,0.0,7
35607,9207,Stuff Packs,6,0,0.0,6
35608,9208,Expansion Packs,16,0,0.0,16
35609,9208,Game Packs,10,0,0.0,10
35610,9208,Kits,18,0,0.0,18
35611,9208,Stuff Packs,20,0,0.0,20
35612,9209,Expansion Packs,14,0,0.0,14
35613,9209,Game Packs,11,0,0.0,11
35614,9209,Kits,6,0,0.0,6
35615,9209,Stuff Packs,9,1,0.1111111111111111,8
35616,9210,Expansion Packs,7,0,0.0,7
35617,9210,Game Packs,2,0,0.0,2
35618,9210,Kits,1,1,1.0,0
35619,9210,Stuff Packs,3,2,0.6666666666666666,1
35620,9211,Expansion Packs,11,0,0.0,11
35621,9211,Game Packs,6,0,0.0,6
35622,9211,Kits,3,2,0.6666666666666666,1
35623,9211,Stuff Packs,9,2,0.2222222222222222,7
35624,9212,Expansion Packs,16,0,0.0,16
35625,9212,Game Packs,7,0,0.0,7
35626,9212,Kits,8,0,0.0,8
35627,9212,Stuff Packs,11,0,0.0,11
35628,9213,Expansion Packs,6,0,0.0,6
35629,9213,Game Packs,2,0,0.0,2
35630,9213,Kits,7,0,0.0,7
35631,9213,Stuff Packs,4,1,0.25,3
35632,9214,Expansion Packs,16,0,0.0,16
35633,9214,Game Packs,10,0,0.0,10
35634,9214,Kits,20,0,0.0,20
35635,9214,Stuff Packs,17,0,0.0,17
35636,9215,Expansion Packs,8,0,0.0,8
35637,9215,Game Packs,4,1,0.25,3
35638,9215,Stuff Packs,2,0,0.0,2
35639,9216,Expansion Packs,14,0,0.0,14
35640,9216,Game Packs,7,0,0.0,7
35641,9216,Kits,7,1,0.14285714285714285,6
35642,9216,Stuff Packs,10,1,0.1,9
35643,9217,Expansion Packs,13,0,0.0,13
35644,9217,Game Packs,11,0,0.0,11
35645,9217,Kits,5,0,0.0,5
35646,9217,Stuff Packs,7,0,0.0,7
35647,9218,Expansion Packs,16,0,0.0,16
35648,9218,Game Packs,12,0,0.0,12
35649,9218,Kits,32,1,0.03125,31
35650,9218,Stuff Packs,20,0,0.0,20
35651,9219,Expansion Packs,5,0,0.0,5
35652,9219,Game Packs,1,0,0.0,1
35653,9219,Stuff Packs,2,0,0.0,2
35654,9220,Expansion Packs,16,0,0.0,16
35655,9220,Game Packs,12,0,0.0,12
35656,9220,Kits,33,1,0.030303030303030304,32
35657,9220,Stuff Packs,20,0,0.0,20
35658,9221,Expansion Packs,3,0,0.0,3
35659,9221,Game Packs,2,0,0.0,2
35660,9221,Stuff Packs,1,0,0.0,1
35661,9222,Expansion Packs,15,0,0.0,15
35662,9222,Game Packs,12,0,0.0,12
35663,9222,Kits,23,0,0.0,23
35664,9222,Stuff Packs,18,0,0.0,18
35665,9223,Expansion Packs,14,0,0.0,14
35666,9223,Game Packs,7,0,0.0,7
35667,9223,Kits,12,1,0.08333333333333333,11
35668,9223,Stuff Packs,16,1,0.0625,15
35669,9224,Expansion Packs,11,0,0.0,11
35670,9224,Game Packs,12,0,0.0,12
35671,9224,Stuff Packs,18,0,0.0,18
35672,9225,Expansion Packs,16,0,0.0,16
35673,9225,Game Packs,12,0,0.0,12
35674,9225,Kits,33,0,0.0,33
35675,9225,Stuff Packs,20,0,0.0,20
35676,9226,Expansion Packs,16,0,0.0,16
35677,9226,Game Packs,12,0,0.0,12
35678,9226,Kits,30,0,0.0,30
35679,9226,Stuff Packs,20,0,0.0,20
35680,9227,Expansion Packs,15,0,0.0,15
35681,9227,Game Packs,8,0,0.0,8
35682,9227,Kits,10,3,0.3,7
35683,9227,Stuff Packs,17,2,0.11764705882352941,15
35684,9228,Expansion Packs,3,0,0.0,3
35685,9228,Kits,3,0,0.0,3
35686,9229,Expansion Packs,16,0,0.0,16
35687,9229,Game Packs,10,1,0.1,9
35688,9229,Kits,26,3,0.11538461538461539,23
35689,9229,Stuff Packs,18,1,0.05555555555555555,17
35690,9230,Expansion Packs,16,0,0.0,16
35691,9230,Game Packs,12,0,0.0,12
35692,9230,Kits,33,0,0.0,33
35693,9230,Stuff Packs,20,0,0.0,20
35694,9231,Expansion Packs,16,0,0.0,16
35695,9231,Game Packs,12,0,0.0,12
35696,9231,Kits,33,0,0.0,33
35697,9231,Stuff Packs,20,0,0.0,20
35698,9232,Expansion Packs,15,0,0.0,15
35699,9232,Game Packs,8,0,0.0,8
35700,9232,Kits,5,1,0.2,4
35701,9232,Stuff Packs,14,0,0.0,14
35702,9233,Expansion Packs,7,0,0.0,7
35703,9233,Game Packs,3,0,0.0,3
35704,9233,Kits,7,2,0.2857142857142857,5
35705,9233,Stuff Packs,9,2,0.2222222222222222,7
35706,9234,Expansion Packs,9,0,0.0,9
35707,9234,Game Packs,5,0,0.0,5
35708,9234,Kits,1,1,1.0,0
35709,9234,Stuff Packs,7,3,0.42857142857142855,4
35710,9235,Expansion Packs,16,0,0.0,16
35711,9235,Game Packs,12,0,0.0,12
35712,9235,Kits,33,0,0.0,33
35713,9235,Stuff Packs,20,0,0.0,20
35714,9236,Expansion Packs,16,0,0.0,16
35715,9236,Game Packs,10,0,0.0,10
35716,9236,Kits,19,0,0.0,19
35717,9236,Stuff Packs,18,0,0.0,18
35718,9237,Expansion Packs,16,0,0.0,16
35719,9237,Game Packs,10,0,0.0,10
35720,9237,Kits,1,1,1.0,0
35721,9237,Stuff Packs,9,2,0.2222222222222222,7
35722,9238,Expansion Packs,16,0,0.0,16
35723,9238,Game Packs,12,0,0.0,12
35724,9238,Kits,33,0,0.0,33
35725,9238,Stuff Packs,20,0,0.0,20
35726,9239,Expansion Packs,13,0,0.0,13
35727,9239,Game Packs,10,1,0.1,9
35728,9239,Kits,3,0,0.0,3
35729,9239,Stuff Packs,7,0,0.0,7
35730,9240,Expansion Packs,7,0,0.0,7
35731,9240,Game Packs,7,0,0.0,7
35732,9240,Kits,2,2,1.0,0
35733,9240,Stuff Packs,4,3,0.75,1
35734,9241,Expansion Packs,16,16,1.0,0
35735,9241,Game Packs,12,12,1.0,0
35736,9241,Kits,33,33,1.0,0
35737,9241,Stuff Packs,20,20,1.0,0
35738,9242,Expansion Packs,13,0,0.0,13
35739,9242,Game Packs,11,0,0.0,11
35740,9242,Kits,5,1,0.2,4
35741,9242,Stuff Packs,14,0,0.0,14
35742,9243,Expansion Packs,16,1,0.0625,15
35743,9243,Game Packs,12,0,0.0,12
35744,9243,Kits,33,1,0.030303030303030304,32
35745,9243,Stuff Packs,20,0,0.0,20
35746,9244,Expansion Packs,16,0,0.0,16
35747,9244,Game Packs,12,0,0.0,12
35748,9244,Kits,18,1,0.05555555555555555,17
35749,9244,Stuff Packs,20,0,0.0,20
35750,9245,Expansion Packs,16,0,0.0,16
35751,9245,Game Packs,12,0,0.0,12
35752,9245,Kits,33,0,0.0,33
35753,9245,Stuff Packs,20,0,0.0,20
35754,9246,Expansion Packs,15,0,0.0,15
35755,9246,Game Packs,7,0,0.0,7
35756,9246,Kits,3,1,0.3333333333333333,2
35757,9246,Stuff Packs,6,0,0.0,6
35758,9247,Expansion Packs,11,0,0.0,11
35759,9247,Game Packs,4,0,0.0,4
35760,9247,Kits,7,1,0.14285714285714285,6
35761,9247,Stuff Packs,10,0,0.0,10
35762,9248,Expansion Packs,7,0,0.0,7
35763,9248,Game Packs,3,0,0.0,3
35764,9248,Kits,3,0,0.0,3
35765,9248,Stuff Packs,2,0,0.0,2
35766,9249,Expansion Packs,14,0,0.0,14
35767,9249,Game Packs,10,0,0.0,10
35768,9249,Kits,2,1,0.5,1
35769,9249,Stuff Packs,15,0,0.0,15
35770,9250,Expansion Packs,2,1,0.5,1
35771,9250,Game Packs,1,0,0.0,1
35772,9250,Kits,1,1,1.0,0
35773,9250,Stuff Packs,2,1,0.5,1
35774,9251,Expansion Packs,16,10,0.625,6
35775,9251,Game Packs,12,9,0.75,3
35776,9251,Kits,33,32,0.9696969696969697,1
35777,9251,Stuff Packs,20,17,0.85,3
35778,9252,Expansion Packs,16,0,0.0,16
35779,9252,Game Packs,11,0,0.0,11
35780,9252,Kits,26,1,0.038461538461538464,25
35781,9252,Stuff Packs,11,1,0.09090909090909091,10
35782,9253,Expansion Packs,16,0,0.0,16
35783,9253,Game Packs,12,0,0.0,12
35784,9253,Kits,33,0,0.0,33
35785,9253,Stuff Packs,20,0,0.0,20
35786,9254,Expansion Packs,13,0,0.0,13
35787,9254,Game Packs,11,0,0.0,11
35788,9254,Kits,6,3,0.5,3
35789,9254,Stuff Packs,15,2,0.13333333333333333,13
35790,9255,Expansion Packs,6,0,0.0,6
35791,9255,Game Packs,3,0,0.0,3
35792,9255,Kits,10,0,0.0,10
35793,9255,Stuff Packs,10,0,0.0,10
35794,9256,Expansion Packs,16,0,0.0,16
35795,9256,Game Packs,11,0,0.0,11
35796,9256,Kits,6,0,0.0,6
35797,9256,Stuff Packs,7,0,0.0,7
35798,9257,Expansion Packs,16,0,0.0,16
35799,9257,Game Packs,11,0,0.0,11
35800,9257,Stuff Packs,18,0,0.0,18
35801,9258,Expansion Packs,16,0,0.0,16
35802,9258,Game Packs,11,0,0.0,11
35803,9258,Kits,7,1,0.14285714285714285,6
35804,9258,Stuff Packs,15,0,0.0,15
35805,9259,Expansion Packs,13,0,0.0,13
35806,9259,Game Packs,3,0,0.0,3
35807,9259,Kits,1,0,0.0,1
35808,9259,Stuff Packs,3,0,0.0,3
35809,9260,Expansion Packs,6,0,0.0,6
35810,9260,Game Packs,4,1,0.25,3
35811,9260,Kits,3,3,1.0,0
35812,9260,Stuff Packs,8,2,0.25,6
35813,9261,Expansion Packs,5,0,0.0,5
35814,9262,Expansion Packs,11,0,0.0,11
35815,9262,Game Packs,9,0,0.0,9
35816,9262,Kits,1,1,1.0,0
35817,9262,Stuff Packs,8,1,0.125,7
35818,9263,Expansion Packs,15,0,0.0,15
35819,9263,Game Packs,9,0,0.0,9
35820,9263,Kits,6,0,0.0,6
35821,9263,Stuff Packs,13,0,0.0,13
35822,9264,Expansion Packs,6,0,0.0,6
35823,9264,Game Packs,2,0,0.0,2
35824,9264,Stuff Packs,5,0,0.0,5
35825,9265,Expansion Packs,8,0,0.0,8
35826,9265,Game Packs,4,0,0.0,4
35827,9265,Kits,2,1,0.5,1
35828,9265,Stuff Packs,4,2,0.5,2
35829,9266,Expansion Packs,15,0,0.0,15
35830,9266,Game Packs,11,0,0.0,11
35831,9266,Kits,15,0,0.0,15
35832,9266,Stuff Packs,20,0,0.0,20
35833,9267,Expansion Packs,15,0,0.0,15
35834,9267,Game Packs,8,1,0.125,7
35835,9267,Kits,10,0,0.0,10
35836,9267,Stuff Packs,7,0,0.0,7
35837,9268,Expansion Packs,16,0,0.0,16
35838,9268,Game Packs,7,0,0.0,7
35839,9268,Kits,11,0,0.0,11
35840,9268,Stuff Packs,11,0,0.0,11
35841,9269,Expansion Packs,11,0,0.0,11
35842,9269,Game Packs,6,1,0.16666666666666666,5
35843,9269,Kits,2,2,1.0,0
35844,9269,Stuff Packs,8,3,0.375,5
35845,9270,Expansion Packs,4,0,0.0,4
35846,9270,Game Packs,2,0,0.0,2
35847,9270,Kits,3,0,0.0,3
35848,9270,Stuff Packs,4,0,0.0,4
35849,9271,Expansion Packs,10,0,0.0,10
35850,9271,Game Packs,4,0,0.0,4
35851,9271,Kits,5,0,0.0,5
35852,9271,Stuff Packs,4,1,0.25,3
35853,9272,Expansion Packs,15,0,0.0,15
35854,9272,Game Packs,11,0,0.0,11
35855,9272,Kits,26,1,0.038461538461538464,25
35856,9272,Stuff Packs,20,1,0.05,19
35857,9273,Expansion Packs,14,0,0.0,14
35858,9273,Game Packs,10,0,0.0,10
35859,9273,Kits,15,2,0.13333333333333333,13
35860,9273,Stuff Packs,16,2,0.125,14
35861,9274,Expansion Packs,16,0,0.0,16
35862,9274,Game Packs,12,0,0.0,12
35863,9274,Kits,31,0,0.0,31
35864,9274,Stuff Packs,20,0,0.0,20
35865,9275,Expansion Packs,16,0,0.0,16
35866,9275,Game Packs,12,0,0.0,12
35867,9275,Kits,33,0,0.0,33
35868,9275,Stuff Packs,20,0,0.0,20
35869,9276,Expansion Packs,16,0,0.0,16
35870,9276,Game Packs,11,0,0.0,11
35871,9276,Kits,5,1,0.2,4
35872,9276,Stuff Packs,7,2,0.2857142857142857,5
35873,9277,Expansion Packs,8,0,0.0,8
35874,9277,Game Packs,4,0,0.0,4
35875,9277,Kits,4,0,0.0,4
35876,9277,Stuff Packs,2,0,0.0,2
35877,9278,Expansion Packs,16,0,0.0,16
35878,9278,Game Packs,11,0,0.0,11
35879,9278,Kits,19,0,0.0,19
35880,9278,Stuff Packs,20,0,0.0,20
35881,9279,Expansion Packs,14,0,0.0,14
35882,9279,Game Packs,11,0,0.0,11
35883,9279,Kits,4,1,0.25,3
35884,9279,Stuff Packs,14,4,0.2857142857142857,10
35885,9280,Expansion Packs,13,1,0.07692307692307693,12
35886,9280,Game Packs,5,1,0.2,4
35887,9280,Kits,7,3,0.42857142857142855,4
35888,9280,Stuff Packs,8,4,0.5,4
35889,9281,Expansion Packs,16,0,0.0,16
35890,9281,Game Packs,12,0,0.0,12
35891,9281,Kits,13,1,0.07692307692307693,12
35892,9281,Stuff Packs,20,0,0.0,20
35893,9282,Expansion Packs,16,0,0.0,16
35894,9282,Game Packs,12,0,0.0,12
35895,9282,Kits,33,0,0.0,33
35896,9282,Stuff Packs,20,0,0.0,20
35897,9283,Expansion Packs,14,0,0.0,14
35898,9283,Game Packs,11,0,0.0,11
35899,9283,Kits,3,3,1.0,0
35900,9283,Stuff Packs,20,0,0.0,20
35901,9284,Expansion Packs,16,0,0.0,16
35902,9284,Game Packs,12,1,0.08333333333333333,11
35903,9284,Kits,33,0,0.0,33
35904,9284,Stuff Packs,20,1,0.05,19
35905,9285,Expansion Packs,14,0,0.0,14
35906,9285,Game Packs,9,0,0.0,9
35907,9285,Kits,3,1,0.3333333333333333,2
35908,9285,Stuff Packs,7,1,0.14285714285714285,6
35909,9286,Expansion Packs,16,0,0.0,16
35910,9286,Game Packs,11,0,0.0,11
35911,9286,Kits,3,1,0.3333333333333333,2
35912,9286,Stuff Packs,20,0,0.0,20
35913,9287,Expansion Packs,16,0,0.0,16
35914,9287,Game Packs,11,0,0.0,11
35915,9287,Kits,20,0,0.0,20
35916,9287,Stuff Packs,18,0,0.0,18
35917,9288,Expansion Packs,16,0,0.0,16
35918,9288,Game Packs,12,0,0.0,12
35919,9288,Kits,33,0,0.0,33
35920,9288,Stuff Packs,20,0,0.0,20
35921,9289,Expansion Packs,12,0,0.0,12
35922,9289,Game Packs,10,0,0.0,10
35923,9289,Stuff Packs,12,0,0.0,12
35924,9290,Expansion Packs,15,0,0.0,15
35925,9290,Game Packs,12,0,0.0,12
35926,9290,Kits,33,0,0.0,33
35927,9290,Stuff Packs,20,0,0.0,20
35928,9291,Expansion Packs,7,0,0.0,7
35929,9291,Game Packs,3,0,0.0,3
35930,9291,Kits,2,0,0.0,2
35931,9291,Stuff Packs,9,1,0.1111111111111111,8
35932,9292,Expansion Packs,16,0,0.0,16
35933,9292,Game Packs,12,0,0.0,12
35934,9292,Kits,33,1,0.030303030303030304,32
35935,9292,Stuff Packs,20,0,0.0,20
35936,9293,Expansion Packs,14,0,0.0,14
35937,9293,Game Packs,9,0,0.0,9
35938,9293,Kits,9,1,0.1111111111111111,8
35939,9293,Stuff Packs,18,1,0.05555555555555555,17
35940,9294,Expansion Packs,15,0,0.0,15
35941,9294,Game Packs,12,0,0.0,12
35942,9294,Kits,7,1,0.14285714285714285,6
35943,9294,Stuff Packs,17,1,0.058823529411764705,16
35944,9295,Expansion Packs,14,0,0.0,14
35945,9295,Game Packs,9,0,0.0,9
35946,9295,Kits,23,1,0.043478260869565216,22
35947,9295,Stuff Packs,16,2,0.125,14
35948,9296,Expansion Packs,10,0,0.0,10
35949,9296,Game Packs,4,1,0.25,3
35950,9296,Kits,3,2,0.6666666666666666,1
35951,9296,Stuff Packs,8,3,0.375,5
35952,9297,Expansion Packs,5,0,0.0,5
35953,9297,Game Packs,2,0,0.0,2
35954,9297,Kits,2,2,1.0,0
35955,9297,Stuff Packs,4,3,0.75,1
35956,9298,Expansion Packs,14,0,0.0,14
35957,9298,Game Packs,10,0,0.0,10
35958,9298,Kits,11,1,0.09090909090909091,10
35959,9298,Stuff Packs,14,1,0.07142857142857142,13
35960,9299,Expansion Packs,8,0,0.0,8
35961,9299,Game Packs,5,0,0.0,5
35962,9299,Stuff Packs,1,0,0.0,1
35963,9300,Expansion Packs,10,0,0.0,10
35964,9300,Game Packs,5,0,0.0,5
35965,9300,Stuff Packs,5,0,0.0,5
35966,9301,Expansion Packs,9,0,0.0,9
35967,9301,Game Packs,2,0,0.0,2
35968,9301,Stuff Packs,3,1,0.3333333333333333,2
35969,9302,Expansion Packs,10,0,0.0,10
35970,9302,Game Packs,6,0,0.0,6
35971,9302,Kits,3,2,0.6666666666666666,1
35972,9302,Stuff Packs,8,3,0.375,5
35973,9303,Expansion Packs,1,0,0.0,1
35974,9303,Game Packs,1,1,1.0,0
35975,9303,Kits,1,1,1.0,0
35976,9303,Stuff Packs,4,4,1.0,0
35977,9304,Expansion Packs,8,0,0.0,8
35978,9304,Game Packs,2,0,0.0,2
35979,9304,Kits,1,1,1.0,0
35980,9304,Stuff Packs,4,0,0.0,4
35981,9305,Expansion Packs,9,0,0.0,9
35982,9305,Game Packs,3,0,0.0,3
35983,9305,Kits,2,1,0.5,1
35984,9305,Stuff Packs,5,3,0.6,2
35985,9306,Expansion Packs,16,0,0.0,16
35986,9306,Game Packs,11,0,0.0,11
35987,9306,Kits,13,0,0.0,13
35988,9306,Stuff Packs,15,1,0.06666666666666667,14
35989,9307,Expansion Packs,2,0,0.0,2
35990,9307,Game Packs,1,0,0.0,1
35991,9307,Kits,1,1,1.0,0
35992,9307,Stuff Packs,2,1,0.5,1
35993,9308,Expansion Packs,10,0,0.0,10
35994,9308,Game Packs,6,0,0.0,6
35995,9308,Kits,1,0,0.0,1
35996,9308,Stuff Packs,9,1,0.1111111111111111,8
35997,9309,Expansion Packs,14,0,0.0,14
35998,9309,Game Packs,7,0,0.0,7
35999,9309,Kits,16,1,0.0625,15
36000,9309,Stuff Packs,15,0,0.0,15
36001,9310,Expansion Packs,16,0,0.0,16
36002,9310,Game Packs,10,0,0.0,10
36003,9310,Kits,17,2,0.11764705882352941,15
36004,9310,Stuff Packs,14,2,0.14285714285714285,12
36005,9311,Expansion Packs,13,0,0.0,13
36006,9311,Game Packs,7,0,0.0,7
36007,9311,Kits,3,1,0.3333333333333333,2
36008,9311,Stuff Packs,11,3,0.2727272727272727,8
36009,9312,Expansion Packs,14,0,0.0,14
36010,9312,Game Packs,12,0,0.0,12
36011,9312,Kits,23,0,0.0,23
36012,9312,Stuff Packs,17,0,0.0,17
36013,9313,Expansion Packs,16,0,0.0,16
36014,9313,Game Packs,12,0,0.0,12
36015,9313,Kits,33,1,0.030303030303030304,32
36016,9313,Stuff Packs,20,0,0.0,20
36017,9314,Expansion Packs,16,0,0.0,16
36018,9314,Game Packs,12,0,0.0,12
36019,9314,Kits,33,0,0.0,33
36020,9314,Stuff Packs,20,0,0.0,20
36021,9315,Expansion Packs,15,0,0.0,15
36022,9315,Game Packs,8,0,0.0,8
36023,9315,Kits,5,1,0.2,4
36024,9315,Stuff Packs,12,0,0.0,12
36025,9316,Expansion Packs,8,0,0.0,8
36026,9316,Game Packs,6,0,0.0,6
36027,9316,Kits,9,0,0.0,9
36028,9316,Stuff Packs,9,0,0.0,9
36029,9317,Expansion Packs,9,0,0.0,9
36030,9317,Game Packs,4,0,0.0,4
36031,9317,Kits,6,2,0.3333333333333333,4
36032,9317,Stuff Packs,3,1,0.3333333333333333,2
36033,9318,Expansion Packs,7,0,0.0,7
36034,9318,Game Packs,4,0,0.0,4
36035,9318,Stuff Packs,12,1,0.08333333333333333,11
36036,9319,Expansion Packs,2,0,0.0,2
36037,9319,Game Packs,3,0,0.0,3
36038,9319,Kits,1,0,0.0,1
36039,9319,Stuff Packs,2,0,0.0,2
36040,9320,Expansion Packs,16,0,0.0,16
36041,9320,Game Packs,12,0,0.0,12
36042,9320,Kits,33,0,0.0,33
36043,9320,Stuff Packs,20,0,0.0,20
36044,9321,Expansion Packs,5,0,0.0,5
36045,9321,Game Packs,2,1,0.5,1
36046,9321,Kits,2,2,1.0,0
36047,9321,Stuff Packs,3,3,1.0,0
36048,9322,Expansion Packs,15,0,0.0,15
36049,9322,Game Packs,10,0,0.0,10
36050,9322,Kits,6,0,0.0,6
36051,9322,Stuff Packs,16,0,0.0,16
36052,9323,Expansion Packs,12,0,0.0,12
36053,9323,Game Packs,9,0,0.0,9
36054,9323,Kits,5,1,0.2,4
36055,9323,Stuff Packs,18,0,0.0,18
36056,9324,Expansion Packs,11,0,0.0,11
36057,9324,Game Packs,1,0,0.0,1
36058,9324,Stuff Packs,2,1,0.5,1
36059,9325,Expansion Packs,9,0,0.0,9
36060,9325,Game Packs,4,0,0.0,4
36061,9325,Kits,3,2,0.6666666666666666,1
36062,9325,Stuff Packs,6,2,0.3333333333333333,4
36063,9326,Expansion Packs,2,0,0.0,2
36064,9326,Kits,1,0,0.0,1
36065,9326,Stuff Packs,1,0,0.0,1
36066,9327,Expansion Packs,16,0,0.0,16
36067,9327,Game Packs,12,0,0.0,12
36068,9327,Kits,22,1,0.045454545454545456,21
36069,9327,Stuff Packs,20,0,0.0,20
36070,9328,Expansion Packs,16,0,0.0,16
36071,9328,Game Packs,11,0,0.0,11
36072,9328,Kits,16,0,0.0,16
36073,9328,Stuff Packs,20,1,0.05,19
36074,9329,Expansion Packs,10,0,0.0,10
36075,9329,Game Packs,3,0,0.0,3
36076,9329,Stuff Packs,4,0,0.0,4
36077,9330,Expansion Packs,15,0,0.0,15
36078,9330,Game Packs,8,0,0.0,8
36079,9330,Kits,3,1,0.3333333333333333,2
36080,9330,Stuff Packs,7,1,0.14285714285714285,6
36081,9331,Expansion Packs,7,0,0.0,7
36082,9331,Game Packs,5,0,0.0,5
36083,9331,Stuff Packs,5,0,0.0,5
36084,9332,Expansion Packs,16,0,0.0,16
36085,9332,Game Packs,11,0,0.0,11
36086,9332,Kits,32,1,0.03125,31
36087,9332,Stuff Packs,20,0,0.0,20
36088,9333,Expansion Packs,16,0,0.0,16
36089,9333,Game Packs,6,0,0.0,6
36090,9333,Kits,4,1,0.25,3
36091,9333,Stuff Packs,7,0,0.0,7
36092,9334,Expansion Packs,13,0,0.0,13
36093,9334,Game Packs,11,0,0.0,11
36094,9334,Kits,10,1,0.1,9
36095,9334,Stuff Packs,17,0,0.0,17
36096,9335,Expansion Packs,16,0,0.0,16
36097,9335,Game Packs,10,1,0.1,9
36098,9335,Kits,17,2,0.11764705882352941,15
36099,9335,Stuff Packs,15,2,0.13333333333333333,13
36100,9336,Expansion Packs,14,0,0.0,14
36101,9336,Game Packs,9,0,0.0,9
36102,9336,Stuff Packs,6,3,0.5,3
36103,9337,Expansion Packs,6,0,0.0,6
36104,9337,Game Packs,5,1,0.2,4
36105,9337,Kits,8,0,0.0,8
36106,9337,Stuff Packs,5,3,0.6,2
36107,9338,Expansion Packs,16,0,0.0,16
36108,9338,Game Packs,9,0,0.0,9
36109,9338,Kits,2,2,1.0,0
36110,9338,Stuff Packs,16,1,0.0625,15
36111,9339,Expansion Packs,10,0,0.0,10
36112,9339,Game Packs,4,0,0.0,4
36113,9339,Kits,3,1,0.3333333333333333,2
36114,9339,Stuff Packs,3,0,0.0,3
36115,9340,Expansion Packs,15,0,0.0,15
36116,9340,Game Packs,11,0,0.0,11
36117,9340,Kits,2,1,0.5,1
36118,9340,Stuff Packs,10,1,0.1,9
36119,9341,Expansion Packs,13,0,0.0,13
36120,9341,Game Packs,10,0,0.0,10
36121,9341,Kits,3,3,1.0,0
36122,9341,Stuff Packs,16,1,0.0625,15
36123,9342,Expansion Packs,16,0,0.0,16
36124,9342,Game Packs,12,0,0.0,12
36125,9342,Kits,8,0,0.0,8
36126,9342,Stuff Packs,20,2,0.1,18
36127,9343,Expansion Packs,6,0,0.0,6
36128,9343,Game Packs,1,0,0.0,1
36129,9343,Kits,2,1,0.5,1
36130,9343,Stuff Packs,4,3,0.75,1
36131,9344,Expansion Packs,16,0,0.0,16
36132,9344,Game Packs,12,0,0.0,12
36133,9344,Kits,30,0,0.0,30
36134,9344,Stuff Packs,20,0,0.0,20
36135,9345,Expansion Packs,16,0,0.0,16
36136,9345,Game Packs,12,0,0.0,12
36137,9345,Kits,33,0,0.0,33
36138,9345,Stuff Packs,20,0,0.0,20
36139,9346,Expansion Packs,16,0,0.0,16
36140,9346,Game Packs,12,0,0.0,12
36141,9346,Kits,33,0,0.0,33
36142,9346,Stuff Packs,20,0,0.0,20
36143,9347,Expansion Packs,16,0,0.0,16
36144,9347,Game Packs,12,0,0.0,12
36145,9347,Kits,31,1,0.03225806451612903,30
36146,9347,Stuff Packs,20,0,0.0,20
36147,9348,Expansion Packs,10,0,0.0,10
36148,9348,Game Packs,5,1,0.2,4
36149,9348,Kits,6,1,0.16666666666666666,5
36150,9348,Stuff Packs,8,3,0.375,5
36151,9349,Expansion Packs,13,0,0.0,13
36152,9349,Game Packs,4,0,0.0,4
36153,9349,Kits,6,1,0.16666666666666666,5
36154,9349,Stuff Packs,7,2,0.2857142857142857,5
36155,9350,Expansion Packs,16,0,0.0,16
36156,9350,Game Packs,10,0,0.0,10
36157,9350,Kits,12,2,0.16666666666666666,10
36158,9350,Stuff Packs,18,0,0.0,18
36159,9351,Expansion Packs,6,0,0.0,6
36160,9351,Game Packs,4,0,0.0,4
36161,9351,Kits,2,0,0.0,2
36162,9351,Stuff Packs,6,0,0.0,6
36163,9352,Expansion Packs,16,0,0.0,16
36164,9352,Game Packs,12,0,0.0,12
36165,9352,Kits,19,1,0.05263157894736842,18
36166,9352,Stuff Packs,20,0,0.0,20
36167,9353,Expansion Packs,7,0,0.0,7
36168,9353,Stuff Packs,1,0,0.0,1
36169,9354,Expansion Packs,5,0,0.0,5
36170,9354,Game Packs,2,0,0.0,2
36171,9354,Kits,2,2,1.0,0
36172,9354,Stuff Packs,4,3,0.75,1
36173,9355,Expansion Packs,12,0,0.0,12
36174,9355,Game Packs,9,0,0.0,9
36175,9355,Kits,1,0,0.0,1
36176,9355,Stuff Packs,16,0,0.0,16
36177,9356,Expansion Packs,16,0,0.0,16
36178,9356,Game Packs,12,0,0.0,12
36179,9356,Kits,33,1,0.030303030303030304,32
36180,9356,Stuff Packs,20,0,0.0,20
36181,9357,Expansion Packs,12,0,0.0,12
36182,9357,Game Packs,8,0,0.0,8
36183,9357,Kits,9,4,0.4444444444444444,5
36184,9357,Stuff Packs,14,1,0.07142857142857142,13
36185,9358,Expansion Packs,16,0,0.0,16
36186,9358,Game Packs,12,0,0.0,12
36187,9358,Kits,33,0,0.0,33
36188,9358,Stuff Packs,20,0,0.0,20
36189,9359,Expansion Packs,16,0,0.0,16
36190,9359,Game Packs,10,1,0.1,9
36191,9359,Kits,17,1,0.058823529411764705,16
36192,9359,Stuff Packs,18,0,0.0,18
36193,9360,Expansion Packs,15,0,0.0,15
36194,9360,Game Packs,9,0,0.0,9
36195,9360,Kits,5,1,0.2,4
36196,9360,Stuff Packs,13,2,0.15384615384615385,11
36197,9361,Expansion Packs,1,0,0.0,1
36198,9361,Game Packs,1,0,0.0,1
36199,9361,Kits,3,0,0.0,3
36200,9361,Stuff Packs,1,0,0.0,1
36201,9362,Expansion Packs,15,0,0.0,15
36202,9362,Game Packs,11,0,0.0,11
36203,9362,Kits,17,1,0.058823529411764705,16
36204,9362,Stuff Packs,20,0,0.0,20
36205,9363,Expansion Packs,10,0,0.0,10
36206,9363,Game Packs,7,0,0.0,7
36207,9363,Kits,2,1,0.5,1
36208,9363,Stuff Packs,10,3,0.3,7
36209,9364,Expansion Packs,13,0,0.0,13
36210,9364,Game Packs,6,0,0.0,6
36211,9364,Kits,6,3,0.5,3
36212,9364,Stuff Packs,6,3,0.5,3
36213,9365,Expansion Packs,13,0,0.0,13
36214,9365,Game Packs,3,0,0.0,3
36215,9365,Kits,3,2,0.6666666666666666,1
36216,9365,Stuff Packs,9,3,0.3333333333333333,6
36217,9366,Expansion Packs,14,0,0.0,14
36218,9366,Game Packs,6,1,0.16666666666666666,5
36219,9366,Kits,8,1,0.125,7
36220,9366,Stuff Packs,12,0,0.0,12
36221,9367,Expansion Packs,16,0,0.0,16
36222,9367,Game Packs,12,0,0.0,12
36223,9367,Kits,18,0,0.0,18
36224,9367,Stuff Packs,20,1,0.05,19
36225,9368,Expansion Packs,14,0,0.0,14
36226,9368,Game Packs,6,1,0.16666666666666666,5
36227,9368,Kits,5,3,0.6,2
36228,9368,Stuff Packs,8,4,0.5,4
36229,9369,Expansion Packs,4,0,0.0,4
36230,9369,Game Packs,3,1,0.3333333333333333,2
36231,9369,Kits,4,2,0.5,2
36232,9369,Stuff Packs,7,3,0.42857142857142855,4
36233,9370,Expansion Packs,16,0,0.0,16
36234,9370,Game Packs,12,0,0.0,12
36235,9370,Kits,33,0,0.0,33
36236,9370,Stuff Packs,20,0,0.0,20
36237,9371,Expansion Packs,14,0,0.0,14
36238,9371,Game Packs,11,0,0.0,11
36239,9371,Kits,1,0,0.0,1
36240,9371,Stuff Packs,19,0,0.0,19
36241,9372,Expansion Packs,12,0,0.0,12
36242,9372,Game Packs,7,0,0.0,7
36243,9372,Kits,5,0,0.0,5
36244,9372,Stuff Packs,8,0,0.0,8
36245,9373,Expansion Packs,16,2,0.125,14
36246,9373,Game Packs,12,1,0.08333333333333333,11
36247,9373,Kits,33,1,0.030303030303030304,32
36248,9373,Stuff Packs,20,3,0.15,17
36249,9374,Expansion Packs,9,0,0.0,9
36250,9374,Game Packs,5,0,0.0,5
36251,9374,Stuff Packs,10,0,0.0,10
36252,9375,Expansion Packs,1,0,0.0,1
36253,9375,Kits,1,1,1.0,0
36254,9375,Stuff Packs,4,4,1.0,0
36255,9376,Expansion Packs,15,7,0.4666666666666667,8
36256,9376,Game Packs,10,8,0.8,2
36257,9376,Kits,13,2,0.15384615384615385,11
36258,9376,Stuff Packs,15,13,0.8666666666666667,2
36259,9377,Expansion Packs,15,0,0.0,15
36260,9377,Game Packs,11,0,0.0,11
36261,9377,Kits,23,0,0.0,23
36262,9377,Stuff Packs,19,0,0.0,19
36263,9378,Expansion Packs,13,0,0.0,13
36264,9378,Game Packs,7,0,0.0,7
36265,9378,Kits,1,1,1.0,0
36266,9378,Stuff Packs,11,0,0.0,11
36267,9379,Expansion Packs,6,0,0.0,6
36268,9379,Game Packs,2,0,0.0,2
36269,9379,Kits,2,1,0.5,1
36270,9379,Stuff Packs,3,2,0.6666666666666666,1
36271,9380,Expansion Packs,15,0,0.0,15
36272,9380,Game Packs,11,0,0.0,11
36273,9380,Kits,17,1,0.058823529411764705,16
36274,9380,Stuff Packs,18,0,0.0,18
36275,9381,Expansion Packs,7,0,0.0,7
36276,9381,Game Packs,2,0,0.0,2
36277,9381,Kits,2,2,1.0,0
36278,9381,Stuff Packs,3,2,0.6666666666666666,1
36279,9382,Expansion Packs,6,0,0.0,6
36280,9382,Game Packs,4,1,0.25,3
36281,9382,Kits,3,3,1.0,0
36282,9382,Stuff Packs,4,4,1.0,0
36283,9383,Expansion Packs,16,3,0.1875,13
36284,9383,Game Packs,12,0,0.0,12
36285,9383,Kits,33,0,0.0,33
36286,9383,Stuff Packs,20,2,0.1,18
36287,9384,Expansion Packs,10,0,0.0,10
36288,9384,Game Packs,8,0,0.0,8
36289,9384,Kits,2,2,1.0,0
36290,9384,Stuff Packs,10,0,0.0,10
36291,9385,Expansion Packs,6,0,0.0,6
36292,9385,Game Packs,3,0,0.0,3
36293,9385,Kits,3,1,0.3333333333333333,2
36294,9385,Stuff Packs,7,3,0.42857142857142855,4
36295,9386,Expansion Packs,14,0,0.0,14
36296,9386,Game Packs,8,0,0.0,8
36297,9386,Kits,9,1,0.1111111111111111,8
36298,9386,Stuff Packs,5,0,0.0,5
36299,9387,Expansion Packs,8,0,0.0,8
36300,9387,Game Packs,3,0,0.0,3
36301,9387,Kits,1,0,0.0,1
36302,9388,Expansion Packs,6,0,0.0,6
36303,9388,Game Packs,1,0,0.0,1
36304,9389,Expansion Packs,15,0,0.0,15
36305,9389,Game Packs,10,0,0.0,10
36306,9389,Kits,4,0,0.0,4
36307,9389,Stuff Packs,18,0,0.0,18
36308,9390,Expansion Packs,11,0,0.0,11
36309,9390,Game Packs,6,0,0.0,6
36310,9390,Kits,2,2,1.0,0
36311,9390,Stuff Packs,11,2,0.18181818181818182,9
36312,9391,Expansion Packs,16,0,0.0,16
36313,9391,Game Packs,12,2,0.16666666666666666,10
36314,9391,Kits,33,2,0.06060606060606061,31
36315,9391,Stuff Packs,20,4,0.2,16
36316,9392,Expansion Packs,16,0,0.0,16
36317,9392,Game Packs,12,0,0.0,12
36318,9392,Kits,33,0,0.0,33
36319,9392,Stuff Packs,20,0,0.0,20
36320,9393,Expansion Packs,16,0,0.0,16
36321,9393,Game Packs,12,0,0.0,12
36322,9393,Kits,33,1,0.030303030303030304,32
36323,9393,Stuff Packs,20,0,0.0,20
36324,9394,Expansion Packs,14,14,1.0,0
36325,9394,Game Packs,11,11,1.0,0
36326,9394,Kits,18,18,1.0,0
36327,9394,Stuff Packs,19,19,1.0,0
36328,9395,Expansion Packs,16,0,0.0,16
36329,9395,Game Packs,12,0,0.0,12
36330,9395,Kits,33,1,0.030303030303030304,32
36331,9395,Stuff Packs,20,0,0.0,20
36332,9396,Expansion Packs,4,0,0.0,4
36333,9396,Game Packs,3,0,0.0,3
36334,9396,Stuff Packs,1,0,0.0,1
36335,9397,Expansion Packs,16,0,0.0,16
36336,9397,Game Packs,9,0,0.0,9
36337,9397,Kits,12,3,0.25,9
36338,9397,Stuff Packs,9,2,0.2222222222222222,7
36339,9398,Expansion Packs,2,0,0.0,2
36340,9398,Game Packs,2,1,0.5,1
36341,9398,Kits,2,2,1.0,0
36342,9398,Stuff Packs,4,3,0.75,1
36343,9399,Expansion Packs,9,0,0.0,9
36344,9399,Game Packs,4,0,0.0,4
36345,9399,Stuff Packs,9,1,0.1111111111111111,8
36346,9400,Expansion Packs,16,0,0.0,16
36347,9400,Game Packs,7,0,0.0,7
36348,9400,Kits,4,1,0.25,3
36349,9400,Stuff Packs,13,3,0.23076923076923078,10
36350,9401,Expansion Packs,8,7,0.875,1
36351,9401,Game Packs,3,3,1.0,0
36352,9401,Kits,7,1,0.14285714285714285,6
36353,9401,Stuff Packs,3,3,1.0,0
36354,9402,Expansion Packs,16,0,0.0,16
36355,9402,Game Packs,12,0,0.0,12
36356,9402,Kits,33,0,0.0,33
36357,9402,Stuff Packs,20,0,0.0,20
36358,9403,Expansion Packs,2,0,0.0,2
36359,9403,Game Packs,2,1,0.5,1
36360,9403,Kits,2,2,1.0,0
36361,9403,Stuff Packs,6,4,0.6666666666666666,2
36362,9404,Expansion Packs,5,0,0.0,5
36363,9404,Game Packs,2,0,0.0,2
36364,9404,Kits,2,0,0.0,2
36365,9404,Stuff Packs,3,1,0.3333333333333333,2
36366,9405,Expansion Packs,11,0,0.0,11
36367,9405,Game Packs,8,0,0.0,8
36368,9405,Kits,11,0,0.0,11
36369,9405,Stuff Packs,14,1,0.07142857142857142,13
36370,9406,Expansion Packs,15,0,0.0,15
36371,9406,Game Packs,12,0,0.0,12
36372,9406,Kits,19,0,0.0,19
36373,9406,Stuff Packs,20,0,0.0,20
36374,9407,Expansion Packs,10,0,0.0,10
36375,9407,Game Packs,9,0,0.0,9
36376,9407,Kits,5,2,0.4,3
36377,9407,Stuff Packs,15,0,0.0,15
36378,9408,Expansion Packs,2,0,0.0,2
36379,9408,Game Packs,2,0,0.0,2
36380,9408,Kits,4,0,0.0,4
36381,9408,Stuff Packs,2,0,0.0,2
36382,9409,Expansion Packs,16,0,0.0,16
36383,9409,Game Packs,7,0,0.0,7
36384,9409,Kits,10,0,0.0,10
36385,9409,Stuff Packs,10,1,0.1,9
36386,9410,Expansion Packs,14,0,0.0,14
36387,9410,Game Packs,6,0,0.0,6
36388,9410,Kits,4,1,0.25,3
36389,9410,Stuff Packs,4,1,0.25,3
36390,9411,Expansion Packs,16,0,0.0,16
36391,9411,Game Packs,12,0,0.0,12
36392,9411,Kits,33,1,0.030303030303030304,32
36393,9411,Stuff Packs,20,0,0.0,20
36394,9412,Expansion Packs,9,0,0.0,9
36395,9412,Game Packs,4,0,0.0,4
36396,9412,Kits,1,0,0.0,1
36397,9412,Stuff Packs,2,0,0.0,2
36398,9413,Expansion Packs,5,0,0.0,5
36399,9413,Game Packs,1,0,0.0,1
36400,9413,Kits,2,1,0.5,1
36401,9413,Stuff Packs,4,2,0.5,2
36402,9414,Expansion Packs,15,0,0.0,15
36403,9414,Game Packs,11,0,0.0,11
36404,9414,Kits,25,2,0.08,23
36405,9414,Stuff Packs,19,0,0.0,19
36406,9415,Expansion Packs,16,2,0.125,14
36407,9415,Game Packs,12,4,0.3333333333333333,8
36408,9415,Kits,33,3,0.09090909090909091,30
36409,9415,Stuff Packs,20,2,0.1,18
36410,9416,Expansion Packs,16,1,0.0625,15
36411,9416,Game Packs,12,0,0.0,12
36412,9416,Kits,33,0,0.0,33
36413,9416,Stuff Packs,20,0,0.0,20
36414,9417,Expansion Packs,10,0,0.0,10
36415,9417,Game Packs,3,0,0.0,3
36416,9417,Kits,7,2,0.2857142857142857,5
36417,9417,Stuff Packs,8,1,0.125,7
36418,9418,Expansion Packs,7,0,0.0,7
36419,9418,Game Packs,3,0,0.0,3
36420,9418,Kits,1,0,0.0,1
36421,9418,Stuff Packs,3,1,0.3333333333333333,2
36422,9419,Expansion Packs,16,1,0.0625,15
36423,9419,Game Packs,10,0,0.0,10
36424,9419,Kits,7,2,0.2857142857142857,5
36425,9419,Stuff Packs,14,3,0.21428571428571427,11
36426,9420,Expansion Packs,14,0,0.0,14
36427,9420,Game Packs,11,1,0.09090909090909091,10
36428,9420,Kits,7,1,0.14285714285714285,6
36429,9420,Stuff Packs,14,3,0.21428571428571427,11
36430,9421,Expansion Packs,16,0,0.0,16
36431,9421,Game Packs,11,0,0.0,11
36432,9421,Kits,33,1,0.030303030303030304,32
36433,9421,Stuff Packs,20,0,0.0,20
36434,9422,Expansion Packs,7,0,0.0,7
36435,9422,Game Packs,9,0,0.0,9
36436,9422,Kits,1,0,0.0,1
36437,9422,Stuff Packs,4,0,0.0,4
36438,9423,Expansion Packs,5,0,0.0,5
36439,9423,Kits,2,2,1.0,0
36440,9423,Stuff Packs,3,1,0.3333333333333333,2
36441,9424,Expansion Packs,13,0,0.0,13
36442,9424,Game Packs,6,0,0.0,6
36443,9424,Kits,10,0,0.0,10
36444,9424,Stuff Packs,8,0,0.0,8
36445,9425,Expansion Packs,16,0,0.0,16
36446,9425,Game Packs,12,0,0.0,12
36447,9425,Kits,21,1,0.047619047619047616,20
36448,9425,Stuff Packs,20,1,0.05,19
36449,9426,Expansion Packs,10,0,0.0,10
36450,9426,Game Packs,8,0,0.0,8
36451,9426,Kits,1,0,0.0,1
36452,9426,Stuff Packs,17,0,0.0,17
36453,9427,Expansion Packs,11,0,0.0,11
36454,9427,Game Packs,8,0,0.0,8
36455,9427,Kits,2,2,1.0,0
36456,9427,Stuff Packs,14,2,0.14285714285714285,12
36457,9428,Expansion Packs,2,0,0.0,2
36458,9428,Game Packs,3,0,0.0,3
36459,9428,Kits,8,0,0.0,8
36460,9428,Stuff Packs,10,3,0.3,7
36461,9429,Expansion Packs,9,0,0.0,9
36462,9429,Game Packs,5,0,0.0,5
36463,9429,Kits,7,1,0.14285714285714285,6
36464,9429,Stuff Packs,9,2,0.2222222222222222,7
36465,9430,Expansion Packs,15,0,0.0,15
36466,9430,Game Packs,10,0,0.0,10
36467,9430,Kits,11,2,0.18181818181818182,9
36468,9430,Stuff Packs,20,1,0.05,19
36469,9431,Expansion Packs,16,0,0.0,16
36470,9431,Game Packs,12,0,0.0,12
36471,9431,Kits,28,0,0.0,28
36472,9431,Stuff Packs,20,0,0.0,20
36473,9432,Expansion Packs,15,0,0.0,15
36474,9432,Game Packs,11,0,0.0,11
36475,9432,Kits,14,1,0.07142857142857142,13
36476,9432,Stuff Packs,18,0,0.0,18
36477,9433,Expansion Packs,16,0,0.0,16
36478,9433,Game Packs,12,0,0.0,12
36479,9433,Kits,28,0,0.0,28
36480,9433,Stuff Packs,20,0,0.0,20
36481,9434,Expansion Packs,13,0,0.0,13
36482,9434,Game Packs,9,0,0.0,9
36483,9434,Kits,1,0,0.0,1
36484,9434,Stuff Packs,12,0,0.0,12
36485,9435,Expansion Packs,15,0,0.0,15
36486,9435,Game Packs,12,0,0.0,12
36487,9435,Kits,25,1,0.04,24
36488,9435,Stuff Packs,19,0,0.0,19
36489,9436,Expansion Packs,8,0,0.0,8
36490,9436,Game Packs,3,0,0.0,3
36491,9436,Kits,1,1,1.0,0
36492,9436,Stuff Packs,7,1,0.14285714285714285,6
36493,9437,Expansion Packs,3,0,0.0,3
36494,9437,Game Packs,2,0,0.0,2
36495,9437,Stuff Packs,5,3,0.6,2
36496,9438,Expansion Packs,11,0,0.0,11
36497,9438,Game Packs,7,0,0.0,7
36498,9438,Kits,8,1,0.125,7
36499,9438,Stuff Packs,7,1,0.14285714285714285,6
36500,9439,Expansion Packs,16,0,0.0,16
36501,9439,Game Packs,11,0,0.0,11
36502,9439,Kits,30,3,0.1,27
36503,9439,Stuff Packs,20,0,0.0,20
36504,9440,Expansion Packs,10,0,0.0,10
36505,9440,Game Packs,7,0,0.0,7
36506,9440,Kits,5,0,0.0,5
36507,9440,Stuff Packs,9,0,0.0,9
36508,9441,Expansion Packs,10,0,0.0,10
36509,9441,Game Packs,6,0,0.0,6
36510,9441,Kits,3,3,1.0,0
36511,9441,Stuff Packs,9,4,0.4444444444444444,5
36512,9442,Expansion Packs,9,0,0.0,9
36513,9442,Game Packs,5,0,0.0,5
36514,9442,Stuff Packs,5,1,0.2,4
36515,9443,Expansion Packs,14,0,0.0,14
36516,9443,Game Packs,8,0,0.0,8
36517,9443,Stuff Packs,13,0,0.0,13
36518,9444,Expansion Packs,7,0,0.0,7
36519,9444,Game Packs,4,0,0.0,4
36520,9444,Kits,11,2,0.18181818181818182,9
36521,9444,Stuff Packs,10,3,0.3,7
36522,9445,Expansion Packs,16,0,0.0,16
36523,9445,Game Packs,11,0,0.0,11
36524,9445,Kits,25,1,0.04,24
36525,9445,Stuff Packs,20,1,0.05,19
36526,9446,Expansion Packs,16,0,0.0,16
36527,9446,Game Packs,12,0,0.0,12
36528,9446,Kits,33,0,0.0,33
36529,9446,Stuff Packs,20,0,0.0,20
36530,9447,Expansion Packs,16,0,0.0,16
36531,9447,Game Packs,12,0,0.0,12
36532,9447,Kits,33,0,0.0,33
36533,9447,Stuff Packs,20,0,0.0,20
36534,9448,Expansion Packs,16,0,0.0,16
36535,9448,Game Packs,11,0,0.0,11
36536,9448,Kits,9,2,0.2222222222222222,7
36537,9448,Stuff Packs,19,0,0.0,19
36538,9449,Expansion Packs,5,0,0.0,5
36539,9449,Game Packs,2,0,0.0,2
36540,9449,Stuff Packs,2,0,0.0,2
36541,9450,Expansion Packs,1,0,0.0,1
36542,9450,Kits,2,2,1.0,0
36543,9450,Stuff Packs,3,3,1.0,0
36544,9451,Expansion Packs,16,0,0.0,16
36545,9451,Game Packs,12,0,0.0,12
36546,9451,Kits,30,0,0.0,30
36547,9451,Stuff Packs,20,0,0.0,20
36548,9452,Expansion Packs,15,0,0.0,15
36549,9452,Game Packs,8,0,0.0,8
36550,9452,Kits,9,0,0.0,9
36551,9452,Stuff Packs,6,0,0.0,6
36552,9453,Expansion Packs,7,0,0.0,7
36553,9453,Game Packs,2,0,0.0,2
36554,9453,Kits,2,2,1.0,0
36555,9453,Stuff Packs,5,2,0.4,3
36556,9454,Expansion Packs,16,0,0.0,16
36557,9454,Game Packs,12,0,0.0,12
36558,9454,Kits,31,1,0.03225806451612903,30
36559,9454,Stuff Packs,20,0,0.0,20
36560,9455,Expansion Packs,6,0,0.0,6
36561,9455,Game Packs,3,0,0.0,3
36562,9455,Kits,3,1,0.3333333333333333,2
36563,9455,Stuff Packs,7,2,0.2857142857142857,5
36564,9456,Expansion Packs,16,0,0.0,16
36565,9456,Game Packs,10,0,0.0,10
36566,9456,Kits,30,0,0.0,30
36567,9456,Stuff Packs,20,0,0.0,20
36568,9457,Expansion Packs,16,0,0.0,16
36569,9457,Game Packs,12,0,0.0,12
36570,9457,Kits,10,1,0.1,9
36571,9457,Stuff Packs,20,1,0.05,19
36572,9458,Expansion Packs,8,0,0.0,8
36573,9458,Game Packs,4,0,0.0,4
36574,9458,Kits,3,1,0.3333333333333333,2
36575,9458,Stuff Packs,8,3,0.375,5
36576,9459,Expansion Packs,16,0,0.0,16
36577,9459,Game Packs,10,0,0.0,10
36578,9459,Kits,27,1,0.037037037037037035,26
36579,9459,Stuff Packs,19,0,0.0,19
36580,9460,Expansion Packs,6,0,0.0,6
36581,9460,Game Packs,4,1,0.25,3
36582,9460,Kits,3,3,1.0,0
36583,9460,Stuff Packs,7,4,0.5714285714285714,3
36584,9461,Expansion Packs,4,0,0.0,4
36585,9461,Kits,1,1,1.0,0
36586,9461,Stuff Packs,3,1,0.3333333333333333,2
36587,9462,Expansion Packs,2,0,0.0,2
36588,9462,Game Packs,1,0,0.0,1
36589,9462,Kits,2,2,1.0,0
36590,9462,Stuff Packs,5,3,0.6,2
36591,9463,Expansion Packs,16,0,0.0,16
36592,9463,Game Packs,12,0,0.0,12
36593,9463,Kits,33,1,0.030303030303030304,32
36594,9463,Stuff Packs,20,0,0.0,20
36595,9464,Expansion Packs,16,0,0.0,16
36596,9464,Game Packs,11,0,0.0,11
36597,9464,Kits,21,0,0.0,21
36598,9464,Stuff Packs,20,0,0.0,20
36599,9465,Expansion Packs,11,0,0.0,11
36600,9465,Game Packs,3,0,0.0,3
36601,9465,Kits,3,2,0.6666666666666666,1
36602,9465,Stuff Packs,9,2,0.2222222222222222,7
36603,9466,Expansion Packs,1,0,0.0,1
36604,9466,Kits,1,1,1.0,0
36605,9466,Stuff Packs,1,1,1.0,0
36606,9467,Expansion Packs,15,0,0.0,15
36607,9467,Game Packs,12,0,0.0,12
36608,9467,Kits,20,0,0.0,20
36609,9467,Stuff Packs,20,1,0.05,19
36610,9468,Expansion Packs,14,0,0.0,14
36611,9468,Game Packs,6,0,0.0,6
36612,9468,Kits,6,0,0.0,6
36613,9468,Stuff Packs,11,0,0.0,11
36614,9469,Expansion Packs,13,0,0.0,13
36615,9469,Game Packs,5,0,0.0,5
36616,9469,Kits,1,0,0.0,1
36617,9469,Stuff Packs,10,0,0.0,10
36618,9470,Expansion Packs,14,1,0.07142857142857142,13
36619,9470,Game Packs,10,0,0.0,10
36620,9470,Kits,2,1,0.5,1
36621,9470,Stuff Packs,20,0,0.0,20
36622,9471,Expansion Packs,16,0,0.0,16
36623,9471,Game Packs,11,0,0.0,11
36624,9471,Kits,13,1,0.07692307692307693,12
36625,9471,Stuff Packs,18,1,0.05555555555555555,17
36626,9472,Expansion Packs,15,0,0.0,15
36627,9472,Game Packs,10,0,0.0,10
36628,9472,Kits,7,1,0.14285714285714285,6
36629,9472,Stuff Packs,10,0,0.0,10
36630,9473,Expansion Packs,14,0,0.0,14
36631,9473,Game Packs,5,0,0.0,5
36632,9473,Stuff Packs,6,1,0.16666666666666666,5
36633,9474,Expansion Packs,5,0,0.0,5
36634,9474,Game Packs,2,0,0.0,2
36635,9474,Kits,2,2,1.0,0
36636,9474,Stuff Packs,7,1,0.14285714285714285,6
36637,9475,Expansion Packs,15,0,0.0,15
36638,9475,Game Packs,10,0,0.0,10
36639,9475,Kits,1,0,0.0,1
36640,9475,Stuff Packs,17,0,0.0,17
36641,9476,Expansion Packs,4,0,0.0,4
36642,9476,Game Packs,4,0,0.0,4
36643,9476,Stuff Packs,6,0,0.0,6
36644,9477,Expansion Packs,5,0,0.0,5
36645,9477,Game Packs,6,0,0.0,6
36646,9477,Kits,2,2,1.0,0
36647,9477,Stuff Packs,9,2,0.2222222222222222,7
36648,9478,Expansion Packs,16,0,0.0,16
36649,9478,Game Packs,12,0,0.0,12
36650,9478,Kits,32,0,0.0,32
36651,9478,Stuff Packs,20,0,0.0,20
36652,9479,Expansion Packs,10,0,0.0,10
36653,9479,Game Packs,4,0,0.0,4
36654,9479,Stuff Packs,5,2,0.4,3
36655,9480,Expansion Packs,13,0,0.0,13
36656,9480,Game Packs,10,0,0.0,10
36657,9480,Kits,3,0,0.0,3
36658,9480,Stuff Packs,13,1,0.07692307692307693,12
36659,9481,Expansion Packs,16,0,0.0,16
36660,9481,Game Packs,12,0,0.0,12
36661,9481,Kits,33,1,0.030303030303030304,32
36662,9481,Stuff Packs,20,1,0.05,19
36663,9482,Expansion Packs,16,0,0.0,16
36664,9482,Game Packs,11,0,0.0,11
36665,9482,Kits,21,1,0.047619047619047616,20
36666,9482,Stuff Packs,14,0,0.0,14
36667,9483,Expansion Packs,8,0,0.0,8
36668,9483,Game Packs,5,0,0.0,5
36669,9483,Kits,2,0,0.0,2
36670,9483,Stuff Packs,7,3,0.42857142857142855,4
36671,9484,Expansion Packs,16,0,0.0,16
36672,9484,Game Packs,12,0,0.0,12
36673,9484,Kits,17,3,0.17647058823529413,14
36674,9484,Stuff Packs,20,0,0.0,20
36675,9485,Expansion Packs,10,0,0.0,10
36676,9485,Game Packs,2,0,0.0,2
36677,9485,Kits,6,0,0.0,6
36678,9485,Stuff Packs,5,3,0.6,2
36679,9486,Expansion Packs,14,0,0.0,14
36680,9486,Game Packs,4,0,0.0,4
36681,9486,Kits,2,2,1.0,0
36682,9486,Stuff Packs,6,2,0.3333333333333333,4
36683,9487,Expansion Packs,16,0,0.0,16
36684,9487,Game Packs,11,0,0.0,11
36685,9487,Kits,2,2,1.0,0
36686,9487,Stuff Packs,17,0,0.0,17
36687,9488,Expansion Packs,8,0,0.0,8
36688,9488,Game Packs,4,1,0.25,3
36689,9488,Kits,5,2,0.4,3
36690,9488,Stuff Packs,11,4,0.36363636363636365,7
36691,9489,Expansion Packs,16,0,0.0,16
36692,9489,Game Packs,12,0,0.0,12
36693,9489,Kits,33,0,0.0,33
36694,9489,Stuff Packs,20,0,0.0,20
36695,9490,Expansion Packs,16,0,0.0,16
36696,9490,Game Packs,12,0,0.0,12
36697,9490,Kits,33,0,0.0,33
36698,9490,Stuff Packs,20,0,0.0,20
36699,9491,Expansion Packs,16,0,0.0,16
36700,9491,Game Packs,11,1,0.09090909090909091,10
36701,9491,Kits,6,1,0.16666666666666666,5
36702,9491,Stuff Packs,11,3,0.2727272727272727,8
36703,9492,Expansion Packs,16,0,0.0,16
36704,9492,Game Packs,9,0,0.0,9
36705,9492,Kits,15,0,0.0,15
36706,9492,Stuff Packs,19,2,0.10526315789473684,17
36707,9493,Expansion Packs,16,0,0.0,16
36708,9493,Game Packs,9,0,0.0,9
36709,9493,Kits,9,1,0.1111111111111111,8
36710,9493,Stuff Packs,12,0,0.0,12
36711,9494,Expansion Packs,16,0,0.0,16
36712,9494,Game Packs,11,0,0.0,11
36713,9494,Kits,12,0,0.0,12
36714,9494,Stuff Packs,18,3,0.16666666666666666,15
36715,9495,Expansion Packs,9,0,0.0,9
36716,9495,Game Packs,2,0,0.0,2
36717,9495,Kits,1,1,1.0,0
36718,9495,Stuff Packs,4,0,0.0,4
36719,9496,Expansion Packs,15,0,0.0,15
36720,9496,Game Packs,11,0,0.0,11
36721,9496,Kits,11,0,0.0,11
36722,9496,Stuff Packs,19,0,0.0,19
36723,9497,Expansion Packs,16,0,0.0,16
36724,9497,Game Packs,10,0,0.0,10
36725,9497,Kits,6,1,0.16666666666666666,5
36726,9497,Stuff Packs,12,0,0.0,12
36727,9498,Expansion Packs,5,0,0.0,5
36728,9498,Game Packs,2,0,0.0,2
36729,9498,Kits,1,1,1.0,0
36730,9498,Stuff Packs,4,3,0.75,1
36731,9499,Expansion Packs,16,0,0.0,16
36732,9499,Game Packs,12,0,0.0,12
36733,9499,Kits,10,1,0.1,9
36734,9499,Stuff Packs,20,1,0.05,19
36735,9500,Expansion Packs,8,0,0.0,8
36736,9500,Game Packs,4,0,0.0,4
36737,9500,Kits,5,1,0.2,4
36738,9500,Stuff Packs,9,0,0.0,9
36739,9501,Expansion Packs,15,0,0.0,15
36740,9501,Game Packs,11,0,0.0,11
36741,9501,Kits,2,2,1.0,0
36742,9501,Stuff Packs,9,0,0.0,9
36743,9502,Expansion Packs,12,0,0.0,12
36744,9502,Game Packs,4,0,0.0,4
36745,9502,Kits,11,2,0.18181818181818182,9
36746,9502,Stuff Packs,8,3,0.375,5
36747,9503,Expansion Packs,14,0,0.0,14
36748,9503,Game Packs,6,0,0.0,6
36749,9503,Kits,9,1,0.1111111111111111,8
36750,9503,Stuff Packs,11,3,0.2727272727272727,8
36751,9504,Expansion Packs,14,0,0.0,14
36752,9504,Game Packs,7,0,0.0,7
36753,9504,Kits,2,2,1.0,0
36754,9504,Stuff Packs,11,1,0.09090909090909091,10
36755,9505,Expansion Packs,16,0,0.0,16
36756,9505,Game Packs,12,0,0.0,12
36757,9505,Kits,33,0,0.0,33
36758,9505,Stuff Packs,20,0,0.0,20
36759,9506,Expansion Packs,10,0,0.0,10
36760,9506,Game Packs,6,1,0.16666666666666666,5
36761,9506,Kits,3,2,0.6666666666666666,1
36762,9506,Stuff Packs,9,2,0.2222222222222222,7
36763,9507,Expansion Packs,16,0,0.0,16
36764,9507,Game Packs,10,0,0.0,10
36765,9507,Kits,23,1,0.043478260869565216,22
36766,9507,Stuff Packs,15,0,0.0,15
36767,9508,Expansion Packs,16,1,0.0625,15
36768,9508,Game Packs,8,1,0.125,7
36769,9508,Kits,7,3,0.42857142857142855,4
36770,9508,Stuff Packs,12,4,0.3333333333333333,8
36771,9509,Expansion Packs,10,0,0.0,10
36772,9509,Game Packs,6,0,0.0,6
36773,9509,Kits,11,1,0.09090909090909091,10
36774,9509,Stuff Packs,5,1,0.2,4
36775,9510,Expansion Packs,16,0,0.0,16
36776,9510,Game Packs,10,0,0.0,10
36777,9510,Kits,4,1,0.25,3
36778,9510,Stuff Packs,16,3,0.1875,13
36779,9511,Expansion Packs,6,0,0.0,6
36780,9511,Game Packs,6,2,0.3333333333333333,4
36781,9511,Kits,7,1,0.14285714285714285,6
36782,9511,Stuff Packs,7,2,0.2857142857142857,5
36783,9512,Expansion Packs,11,0,0.0,11
36784,9512,Game Packs,9,0,0.0,9
36785,9512,Kits,3,1,0.3333333333333333,2
36786,9512,Stuff Packs,9,1,0.1111111111111111,8
36787,9513,Expansion Packs,14,0,0.0,14
36788,9513,Game Packs,6,0,0.0,6
36789,9513,Kits,4,0,0.0,4
36790,9513,Stuff Packs,10,1,0.1,9
36791,9514,Expansion Packs,13,0,0.0,13
36792,9514,Game Packs,8,1,0.125,7
36793,9514,Kits,2,2,1.0,0
36794,9514,Stuff Packs,10,5,0.5,5
36795,9515,Expansion Packs,11,0,0.0,11
36796,9515,Game Packs,6,0,0.0,6
36797,9515,Kits,3,1,0.3333333333333333,2
36798,9515,Stuff Packs,10,2,0.2,8
36799,9516,Expansion Packs,2,0,0.0,2
36800,9516,Game Packs,3,0,0.0,3
36801,9516,Kits,4,2,0.5,2
36802,9516,Stuff Packs,5,1,0.2,4
36803,9517,Expansion Packs,14,0,0.0,14
36804,9517,Game Packs,12,0,0.0,12
36805,9517,Kits,7,0,0.0,7
36806,9517,Stuff Packs,17,0,0.0,17
36807,9518,Expansion Packs,10,0,0.0,10
36808,9518,Game Packs,3,1,0.3333333333333333,2
36809,9518,Kits,3,3,1.0,0
36810,9518,Stuff Packs,8,4,0.5,4
36811,9519,Expansion Packs,5,2,0.4,3
36812,9519,Game Packs,1,0,0.0,1
36813,9519,Stuff Packs,1,0,0.0,1
36814,9520,Expansion Packs,10,0,0.0,10
36815,9520,Game Packs,6,0,0.0,6
36816,9520,Kits,2,2,1.0,0
36817,9520,Stuff Packs,8,1,0.125,7
36818,9521,Expansion Packs,16,0,0.0,16
36819,9521,Game Packs,12,0,0.0,12
36820,9521,Kits,30,1,0.03333333333333333,29
36821,9521,Stuff Packs,20,0,0.0,20
36822,9522,Expansion Packs,16,0,0.0,16
36823,9522,Game Packs,12,0,0.0,12
36824,9522,Kits,33,0,0.0,33
36825,9522,Stuff Packs,20,0,0.0,20
36826,9523,Expansion Packs,12,0,0.0,12
36827,9523,Game Packs,5,0,0.0,5
36828,9523,Kits,2,1,0.5,1
36829,9523,Stuff Packs,5,1,0.2,4
36830,9524,Expansion Packs,12,0,0.0,12
36831,9524,Game Packs,6,0,0.0,6
36832,9524,Kits,11,0,0.0,11
36833,9524,Stuff Packs,11,0,0.0,11
36834,9525,Expansion Packs,3,0,0.0,3
36835,9525,Game Packs,1,0,0.0,1
36836,9525,Kits,1,1,1.0,0
36837,9525,Stuff Packs,4,3,0.75,1
36838,9526,Expansion Packs,10,0,0.0,10
36839,9526,Game Packs,5,0,0.0,5
36840,9526,Kits,3,3,1.0,0
36841,9526,Stuff Packs,7,4,0.5714285714285714,3
36842,9527,Expansion Packs,16,0,0.0,16
36843,9527,Game Packs,12,0,0.0,12
36844,9527,Kits,33,1,0.030303030303030304,32
36845,9527,Stuff Packs,20,0,0.0,20
36846,9528,Expansion Packs,16,0,0.0,16
36847,9528,Game Packs,12,0,0.0,12
36848,9528,Kits,33,1,0.030303030303030304,32
36849,9528,Stuff Packs,20,0,0.0,20
36850,9529,Expansion Packs,16,0,0.0,16
36851,9529,Game Packs,12,0,0.0,12
36852,9529,Kits,33,0,0.0,33
36853,9529,Stuff Packs,20,0,0.0,20
36854,9530,Expansion Packs,12,0,0.0,12
36855,9530,Game Packs,8,0,0.0,8
36856,9530,Kits,5,1,0.2,4
36857,9530,Stuff Packs,8,1,0.125,7
36858,9531,Expansion Packs,15,5,0.3333333333333333,10
36859,9531,Game Packs,7,7,1.0,0
36860,9531,Kits,3,0,0.0,3
36861,9531,Stuff Packs,9,7,0.7777777777777778,2
36862,9532,Expansion Packs,16,0,0.0,16
36863,9532,Game Packs,12,1,0.08333333333333333,11
36864,9532,Kits,4,2,0.5,2
36865,9532,Stuff Packs,20,1,0.05,19
36866,9533,Expansion Packs,14,0,0.0,14
36867,9533,Game Packs,4,0,0.0,4
36868,9534,Game Packs,2,1,0.5,1
36869,9534,Kits,2,2,1.0,0
36870,9534,Stuff Packs,4,4,1.0,0
36871,9535,Game Packs,1,0,0.0,1
36872,9535,Stuff Packs,2,2,1.0,0
36873,9536,Expansion Packs,15,0,0.0,15
36874,9536,Game Packs,12,0,0.0,12
36875,9536,Kits,9,1,0.1111111111111111,8
36876,9536,Stuff Packs,20,1,0.05,19
36877,9537,Expansion Packs,13,0,0.0,13
36878,9537,Game Packs,9,0,0.0,9
36879,9537,Kits,3,2,0.6666666666666666,1
36880,9537,Stuff Packs,17,1,0.058823529411764705,16
36881,9538,Expansion Packs,16,0,0.0,16
36882,9538,Game Packs,12,0,0.0,12
36883,9538,Kits,23,1,0.043478260869565216,22
36884,9538,Stuff Packs,18,0,0.0,18
36885,9539,Expansion Packs,16,0,0.0,16
36886,9539,Game Packs,12,0,0.0,12
36887,9539,Kits,29,1,0.034482758620689655,28
36888,9539,Stuff Packs,20,0,0.0,20
36889,9540,Expansion Packs,16,0,0.0,16
36890,9540,Game Packs,11,0,0.0,11
36891,9540,Kits,3,2,0.6666666666666666,1
36892,9540,Stuff Packs,15,1,0.06666666666666667,14
36893,9541,Expansion Packs,7,0,0.0,7
36894,9541,Game Packs,4,0,0.0,4
36895,9541,Kits,5,1,0.2,4
36896,9541,Stuff Packs,5,1,0.2,4
36897,9542,Expansion Packs,6,0,0.0,6
36898,9542,Game Packs,6,0,0.0,6
36899,9542,Kits,2,1,0.5,1
36900,9542,Stuff Packs,11,3,0.2727272727272727,8
36901,9543,Expansion Packs,13,0,0.0,13
36902,9543,Game Packs,8,1,0.125,7
36903,9543,Kits,6,3,0.5,3
36904,9543,Stuff Packs,11,4,0.36363636363636365,7
36905,9544,Expansion Packs,14,0,0.0,14
36906,9544,Game Packs,5,2,0.4,3
36907,9544,Kits,6,2,0.3333333333333333,4
36908,9544,Stuff Packs,9,3,0.3333333333333333,6
36909,9545,Expansion Packs,14,0,0.0,14
36910,9545,Game Packs,10,0,0.0,10
36911,9545,Kits,16,1,0.0625,15
36912,9545,Stuff Packs,19,2,0.10526315789473684,17
36913,9546,Expansion Packs,10,0,0.0,10
36914,9546,Game Packs,6,0,0.0,6
36915,9546,Kits,2,2,1.0,0
36916,9546,Stuff Packs,5,1,0.2,4
36917,9547,Expansion Packs,14,0,0.0,14
36918,9547,Game Packs,7,0,0.0,7
36919,9547,Kits,6,2,0.3333333333333333,4
36920,9547,Stuff Packs,13,1,0.07692307692307693,12
36921,9548,Expansion Packs,16,0,0.0,16
36922,9548,Game Packs,12,0,0.0,12
36923,9548,Kits,33,1,0.030303030303030304,32
36924,9548,Stuff Packs,20,0,0.0,20
36925,9549,Expansion Packs,15,0,0.0,15
36926,9549,Game Packs,11,0,0.0,11
36927,9549,Kits,16,1,0.0625,15
36928,9549,Stuff Packs,20,1,0.05,19
36929,9550,Expansion Packs,16,0,0.0,16
36930,9550,Game Packs,12,0,0.0,12
36931,9550,Kits,20,0,0.0,20
36932,9550,Stuff Packs,20,0,0.0,20
36933,9551,Expansion Packs,14,0,0.0,14
36934,9551,Game Packs,11,0,0.0,11
36935,9551,Kits,9,0,0.0,9
36936,9551,Stuff Packs,13,0,0.0,13
36937,9552,Expansion Packs,15,0,0.0,15
36938,9552,Game Packs,10,0,0.0,10
36939,9552,Kits,11,1,0.09090909090909091,10
36940,9552,Stuff Packs,14,0,0.0,14
36941,9553,Expansion Packs,11,0,0.0,11
36942,9553,Game Packs,5,0,0.0,5
36943,9553,Kits,3,3,1.0,0
36944,9553,Stuff Packs,5,3,0.6,2
36945,9554,Expansion Packs,16,0,0.0,16
36946,9554,Game Packs,12,0,0.0,12
36947,9554,Kits,13,1,0.07692307692307693,12
36948,9554,Stuff Packs,16,2,0.125,14
36949,9555,Expansion Packs,3,0,0.0,3
36950,9555,Game Packs,2,0,0.0,2
36951,9555,Kits,2,2,1.0,0
36952,9555,Stuff Packs,5,0,0.0,5
36953,9556,Expansion Packs,15,0,0.0,15
36954,9556,Game Packs,9,0,0.0,9
36955,9556,Stuff Packs,9,1,0.1111111111111111,8
36956,9557,Expansion Packs,8,0,0.0,8
36957,9557,Game Packs,2,0,0.0,2
36958,9557,Kits,1,1,1.0,0
36959,9557,Stuff Packs,5,1,0.2,4
36960,9558,Expansion Packs,6,0,0.0,6
36961,9558,Game Packs,7,0,0.0,7
36962,9558,Kits,4,1,0.25,3
36963,9558,Stuff Packs,11,0,0.0,11
36964,9559,Expansion Packs,13,0,0.0,13
36965,9559,Game Packs,7,0,0.0,7
36966,9559,Kits,5,1,0.2,4
36967,9559,Stuff Packs,12,1,0.08333333333333333,11
36968,9560,Expansion Packs,5,0,0.0,5
36969,9560,Game Packs,4,0,0.0,4
36970,9560,Kits,9,0,0.0,9
36971,9560,Stuff Packs,4,0,0.0,4
36972,9561,Expansion Packs,16,0,0.0,16
36973,9561,Game Packs,12,0,0.0,12
36974,9561,Kits,33,0,0.0,33
36975,9561,Stuff Packs,20,0,0.0,20
36976,9562,Expansion Packs,15,0,0.0,15
36977,9562,Game Packs,6,0,0.0,6
36978,9562,Kits,11,1,0.09090909090909091,10
36979,9562,Stuff Packs,12,2,0.16666666666666666,10
36980,9563,Expansion Packs,15,0,0.0,15
36981,9563,Game Packs,11,1,0.09090909090909091,10
36982,9563,Kits,3,1,0.3333333333333333,2
36983,9563,Stuff Packs,11,3,0.2727272727272727,8
36984,9564,Expansion Packs,16,0,0.0,16
36985,9564,Game Packs,12,0,0.0,12
36986,9564,Kits,33,0,0.0,33
36987,9564,Stuff Packs,20,0,0.0,20
36988,9565,Expansion Packs,11,0,0.0,11
36989,9565,Game Packs,3,0,0.0,3
36990,9565,Kits,1,1,1.0,0
36991,9565,Stuff Packs,5,2,0.4,3
36992,9566,Expansion Packs,16,0,0.0,16
36993,9566,Game Packs,7,1,0.14285714285714285,6
36994,9566,Kits,2,2,1.0,0
36995,9566,Stuff Packs,11,3,0.2727272727272727,8
36996,9567,Expansion Packs,16,0,0.0,16
36997,9567,Game Packs,12,0,0.0,12
36998,9567,Kits,33,0,0.0,33
36999,9567,Stuff Packs,20,0,0.0,20
37000,9568,Expansion Packs,15,0,0.0,15
37001,9568,Game Packs,12,0,0.0,12
37002,9568,Kits,17,0,0.0,17
37003,9568,Stuff Packs,20,0,0.0,20
37004,9569,Expansion Packs,16,0,0.0,16
37005,9569,Game Packs,12,0,0.0,12
37006,9569,Kits,31,1,0.03225806451612903,30
37007,9569,Stuff Packs,20,0,0.0,20
37008,9570,Expansion Packs,16,0,0.0,16
37009,9570,Game Packs,12,0,0.0,12
37010,9570,Kits,33,0,0.0,33
37011,9570,Stuff Packs,20,0,0.0,20
37012,9571,Expansion Packs,15,0,0.0,15
37013,9571,Game Packs,11,0,0.0,11
37014,9571,Kits,14,0,0.0,14
37015,9571,Stuff Packs,16,0,0.0,16
37016,9572,Expansion Packs,15,0,0.0,15
37017,9572,Game Packs,12,1,0.08333333333333333,11
37018,9572,Kits,23,3,0.13043478260869565,20
37019,9572,Stuff Packs,20,0,0.0,20
37020,9573,Expansion Packs,12,0,0.0,12
37021,9573,Game Packs,9,0,0.0,9
37022,9573,Kits,6,1,0.16666666666666666,5
37023,9573,Stuff Packs,12,1,0.08333333333333333,11
37024,9574,Expansion Packs,9,0,0.0,9
37025,9574,Game Packs,3,0,0.0,3
37026,9574,Stuff Packs,8,4,0.5,4
37027,9575,Expansion Packs,14,0,0.0,14
37028,9575,Game Packs,7,0,0.0,7
37029,9575,Kits,7,2,0.2857142857142857,5
37030,9575,Stuff Packs,12,0,0.0,12
37031,9576,Expansion Packs,10,0,0.0,10
37032,9576,Game Packs,2,1,0.5,1
37033,9576,Kits,3,2,0.6666666666666666,1
37034,9576,Stuff Packs,2,1,0.5,1
37035,9577,Expansion Packs,16,0,0.0,16
37036,9577,Game Packs,12,0,0.0,12
37037,9577,Kits,33,0,0.0,33
37038,9577,Stuff Packs,20,0,0.0,20
37039,9578,Expansion Packs,15,0,0.0,15
37040,9578,Game Packs,10,0,0.0,10
37041,9578,Kits,14,0,0.0,14
37042,9578,Stuff Packs,16,0,0.0,16
37043,9579,Expansion Packs,14,0,0.0,14
37044,9579,Game Packs,12,0,0.0,12
37045,9579,Kits,20,1,0.05,19
37046,9579,Stuff Packs,20,0,0.0,20
37047,9580,Expansion Packs,13,0,0.0,13
37048,9580,Game Packs,5,0,0.0,5
37049,9580,Kits,1,0,0.0,1
37050,9580,Stuff Packs,9,1,0.1111111111111111,8
37051,9581,Expansion Packs,16,0,0.0,16
37052,9581,Game Packs,12,0,0.0,12
37053,9581,Kits,31,1,0.03225806451612903,30
37054,9581,Stuff Packs,20,0,0.0,20
37055,9582,Expansion Packs,15,0,0.0,15
37056,9582,Game Packs,10,0,0.0,10
37057,9582,Kits,10,1,0.1,9
37058,9582,Stuff Packs,18,0,0.0,18
37059,9583,Expansion Packs,6,0,0.0,6
37060,9583,Game Packs,5,0,0.0,5
37061,9583,Kits,5,0,0.0,5
37062,9583,Stuff Packs,6,2,0.3333333333333333,4
37063,9584,Expansion Packs,6,0,0.0,6
37064,9584,Game Packs,2,0,0.0,2
37065,9584,Stuff Packs,2,0,0.0,2
37066,9585,Expansion Packs,9,0,0.0,9
37067,9585,Game Packs,4,0,0.0,4
37068,9585,Kits,7,0,0.0,7
37069,9585,Stuff Packs,6,0,0.0,6
37070,9586,Expansion Packs,10,0,0.0,10
37071,9586,Game Packs,8,0,0.0,8
37072,9586,Kits,1,1,1.0,0
37073,9586,Stuff Packs,10,3,0.3,7
37074,9587,Expansion Packs,16,0,0.0,16
37075,9587,Game Packs,12,0,0.0,12
37076,9587,Kits,33,0,0.0,33
37077,9587,Stuff Packs,20,0,0.0,20
37078,9588,Expansion Packs,16,0,0.0,16
37079,9588,Game Packs,12,0,0.0,12
37080,9588,Stuff Packs,20,0,0.0,20
37081,9589,Expansion Packs,16,0,0.0,16
37082,9589,Game Packs,12,0,0.0,12
37083,9589,Kits,25,2,0.08,23
37084,9589,Stuff Packs,20,0,0.0,20
37085,9590,Expansion Packs,16,0,0.0,16
37086,9590,Game Packs,12,0,0.0,12
37087,9590,Kits,31,0,0.0,31
37088,9590,Stuff Packs,20,0,0.0,20
37089,9591,Expansion Packs,16,0,0.0,16
37090,9591,Game Packs,10,0,0.0,10
37091,9591,Kits,5,1,0.2,4
37092,9591,Stuff Packs,11,0,0.0,11
37093,9592,Expansion Packs,16,0,0.0,16
37094,9592,Game Packs,12,0,0.0,12
37095,9592,Kits,22,2,0.09090909090909091,20
37096,9592,Stuff Packs,15,0,0.0,15
37097,9593,Expansion Packs,16,0,0.0,16
37098,9593,Game Packs,8,0,0.0,8
37099,9593,Kits,4,1,0.25,3
37100,9593,Stuff Packs,13,1,0.07692307692307693,12
37101,9594,Expansion Packs,14,0,0.0,14
37102,9594,Game Packs,6,0,0.0,6
37103,9594,Kits,1,1,1.0,0
37104,9594,Stuff Packs,8,3,0.375,5
37105,9595,Expansion Packs,16,0,0.0,16
37106,9595,Game Packs,12,0,0.0,12
37107,9595,Kits,33,1,0.030303030303030304,32
37108,9595,Stuff Packs,20,1,0.05,19
37109,9596,Expansion Packs,15,0,0.0,15
37110,9596,Game Packs,12,0,0.0,12
37111,9596,Kits,21,0,0.0,21
37112,9596,Stuff Packs,20,0,0.0,20
37113,9597,Expansion Packs,5,0,0.0,5
37114,9597,Game Packs,2,0,0.0,2
37115,9597,Kits,2,2,1.0,0
37116,9597,Stuff Packs,5,3,0.6,2
37117,9598,Expansion Packs,14,0,0.0,14
37118,9598,Game Packs,12,0,0.0,12
37119,9598,Kits,6,3,0.5,3
37120,9598,Stuff Packs,19,1,0.05263157894736842,18
37121,9599,Expansion Packs,3,0,0.0,3
37122,9599,Stuff Packs,4,3,0.75,1
37123,9600,Expansion Packs,15,0,0.0,15
37124,9600,Game Packs,8,0,0.0,8
37125,9600,Stuff Packs,1,0,0.0,1
37126,9601,Expansion Packs,12,0,0.0,12
37127,9601,Game Packs,5,0,0.0,5
37128,9601,Kits,2,2,1.0,0
37129,9601,Stuff Packs,9,3,0.3333333333333333,6
37130,9602,Expansion Packs,16,0,0.0,16
37131,9602,Game Packs,12,2,0.16666666666666666,10
37132,9602,Kits,23,2,0.08695652173913043,21
37133,9602,Stuff Packs,20,1,0.05,19
37134,9603,Expansion Packs,16,0,0.0,16
37135,9603,Game Packs,12,0,0.0,12
37136,9603,Kits,33,0,0.0,33
37137,9603,Stuff Packs,20,0,0.0,20
37138,9604,Expansion Packs,16,0,0.0,16
37139,9604,Game Packs,12,0,0.0,12
37140,9604,Kits,31,1,0.03225806451612903,30
37141,9604,Stuff Packs,19,0,0.0,19
37142,9605,Expansion Packs,16,0,0.0,16
37143,9605,Game Packs,12,0,0.0,12
37144,9605,Kits,33,0,0.0,33
37145,9605,Stuff Packs,20,0,0.0,20
37146,9606,Expansion Packs,14,0,0.0,14
37147,9606,Game Packs,12,0,0.0,12
37148,9606,Kits,5,0,0.0,5
37149,9606,Stuff Packs,18,0,0.0,18
37150,9607,Expansion Packs,16,0,0.0,16
37151,9607,Game Packs,12,0,0.0,12
37152,9607,Kits,31,0,0.0,31
37153,9607,Stuff Packs,20,0,0.0,20
37154,9608,Expansion Packs,5,0,0.0,5
37155,9608,Game Packs,2,0,0.0,2
37156,9608,Kits,1,1,1.0,0
37157,9608,Stuff Packs,6,0,0.0,6
37158,9609,Expansion Packs,14,0,0.0,14
37159,9609,Game Packs,10,0,0.0,10
37160,9609,Kits,2,0,0.0,2
37161,9609,Stuff Packs,9,2,0.2222222222222222,7
37162,9610,Expansion Packs,11,0,0.0,11
37163,9610,Game Packs,8,0,0.0,8
37164,9610,Stuff Packs,4,1,0.25,3
37165,9611,Expansion Packs,13,0,0.0,13
37166,9611,Game Packs,8,0,0.0,8
37167,9611,Kits,5,2,0.4,3
37168,9611,Stuff Packs,10,4,0.4,6
37169,9612,Expansion Packs,16,0,0.0,16
37170,9612,Game Packs,12,0,0.0,12
37171,9612,Kits,26,1,0.038461538461538464,25
37172,9612,Stuff Packs,20,0,0.0,20
37173,9613,Expansion Packs,16,0,0.0,16
37174,9613,Game Packs,12,0,0.0,12
37175,9613,Kits,33,1,0.030303030303030304,32
37176,9613,Stuff Packs,20,0,0.0,20
37177,9614,Expansion Packs,10,0,0.0,10
37178,9614,Game Packs,4,0,0.0,4
37179,9614,Kits,2,2,1.0,0
37180,9614,Stuff Packs,6,3,0.5,3
37181,9615,Expansion Packs,15,0,0.0,15
37182,9615,Game Packs,10,0,0.0,10
37183,9615,Kits,3,2,0.6666666666666666,1
37184,9615,Stuff Packs,17,0,0.0,17
37185,9616,Expansion Packs,16,3,0.1875,13
37186,9616,Game Packs,11,2,0.18181818181818182,9
37187,9616,Kits,33,28,0.8484848484848485,5
37188,9616,Stuff Packs,20,4,0.2,16
37189,9617,Expansion Packs,13,0,0.0,13
37190,9617,Game Packs,8,0,0.0,8
37191,9617,Kits,2,2,1.0,0
37192,9617,Stuff Packs,9,4,0.4444444444444444,5
37193,9618,Expansion Packs,14,0,0.0,14
37194,9618,Game Packs,6,0,0.0,6
37195,9618,Kits,5,0,0.0,5
37196,9618,Stuff Packs,5,2,0.4,3
37197,9619,Expansion Packs,14,0,0.0,14
37198,9619,Game Packs,9,0,0.0,9
37199,9619,Kits,1,1,1.0,0
37200,9619,Stuff Packs,7,1,0.14285714285714285,6
37201,9620,Expansion Packs,14,0,0.0,14
37202,9620,Game Packs,10,0,0.0,10
37203,9620,Stuff Packs,17,1,0.058823529411764705,16
37204,9621,Expansion Packs,12,0,0.0,12
37205,9621,Game Packs,10,0,0.0,10
37206,9621,Kits,11,1,0.09090909090909091,10
37207,9621,Stuff Packs,13,0,0.0,13
37208,9622,Expansion Packs,16,0,0.0,16
37209,9622,Game Packs,11,0,0.0,11
37210,9622,Kits,17,1,0.058823529411764705,16
37211,9622,Stuff Packs,20,1,0.05,19
37212,9623,Expansion Packs,16,0,0.0,16
37213,9623,Game Packs,11,0,0.0,11
37214,9623,Kits,32,0,0.0,32
37215,9623,Stuff Packs,15,0,0.0,15
37216,9624,Expansion Packs,16,0,0.0,16
37217,9624,Game Packs,12,0,0.0,12
37218,9624,Kits,33,0,0.0,33
37219,9624,Stuff Packs,20,0,0.0,20
37220,9625,Expansion Packs,16,0,0.0,16
37221,9625,Game Packs,12,0,0.0,12
37222,9625,Kits,30,0,0.0,30
37223,9625,Stuff Packs,20,0,0.0,20
37224,9626,Expansion Packs,16,0,0.0,16
37225,9626,Game Packs,9,0,0.0,9
37226,9626,Kits,12,2,0.16666666666666666,10
37227,9626,Stuff Packs,13,3,0.23076923076923078,10
37228,9627,Expansion Packs,12,0,0.0,12
37229,9627,Game Packs,9,0,0.0,9
37230,9627,Kits,6,1,0.16666666666666666,5
37231,9627,Stuff Packs,11,0,0.0,11
37232,9628,Expansion Packs,16,0,0.0,16
37233,9628,Game Packs,12,0,0.0,12
37234,9628,Kits,33,0,0.0,33
37235,9628,Stuff Packs,20,0,0.0,20
37236,9629,Expansion Packs,16,0,0.0,16
37237,9629,Game Packs,12,1,0.08333333333333333,11
37238,9629,Kits,26,1,0.038461538461538464,25
37239,9629,Stuff Packs,15,2,0.13333333333333333,13
37240,9630,Expansion Packs,11,0,0.0,11
37241,9630,Game Packs,9,0,0.0,9
37242,9630,Kits,9,0,0.0,9
37243,9630,Stuff Packs,13,1,0.07692307692307693,12
37244,9631,Expansion Packs,16,0,0.0,16
37245,9631,Game Packs,12,0,0.0,12
37246,9631,Kits,19,1,0.05263157894736842,18
37247,9631,Stuff Packs,20,0,0.0,20
37248,9632,Expansion Packs,16,0,0.0,16
37249,9632,Game Packs,11,0,0.0,11
37250,9632,Kits,1,1,1.0,0
37251,9632,Stuff Packs,20,0,0.0,20
37252,9633,Expansion Packs,16,0,0.0,16
37253,9633,Game Packs,12,0,0.0,12
37254,9633,Kits,33,0,0.0,33
37255,9633,Stuff Packs,20,0,0.0,20
37256,9634,Expansion Packs,11,0,0.0,11
37257,9634,Game Packs,6,1,0.16666666666666666,5
37258,9634,Kits,3,2,0.6666666666666666,1
37259,9634,Stuff Packs,12,3,0.25,9
37260,9635,Expansion Packs,16,0,0.0,16
37261,9635,Game Packs,5,0,0.0,5
37262,9635,Stuff Packs,9,0,0.0,9
37263,9636,Expansion Packs,14,0,0.0,14
37264,9636,Game Packs,7,0,0.0,7
37265,9636,Stuff Packs,9,1,0.1111111111111111,8
37266,9637,Expansion Packs,16,0,0.0,16
37267,9637,Game Packs,12,0,0.0,12
37268,9637,Kits,26,1,0.038461538461538464,25
37269,9637,Stuff Packs,20,0,0.0,20
37270,9638,Expansion Packs,16,0,0.0,16
37271,9638,Game Packs,11,0,0.0,11
37272,9638,Kits,8,0,0.0,8
37273,9638,Stuff Packs,20,0,0.0,20
37274,9639,Expansion Packs,16,0,0.0,16
37275,9639,Game Packs,12,0,0.0,12
37276,9639,Kits,11,0,0.0,11
37277,9639,Stuff Packs,18,0,0.0,18
37278,9640,Expansion Packs,16,0,0.0,16
37279,9640,Game Packs,12,0,0.0,12
37280,9640,Kits,19,1,0.05263157894736842,18
37281,9640,Stuff Packs,20,0,0.0,20
37282,9641,Expansion Packs,11,0,0.0,11
37283,9641,Game Packs,1,0,0.0,1
37284,9641,Stuff Packs,5,2,0.4,3
37285,9642,Expansion Packs,16,0,0.0,16
37286,9642,Game Packs,11,0,0.0,11
37287,9642,Kits,8,1,0.125,7
37288,9642,Stuff Packs,13,2,0.15384615384615385,11
37289,9643,Expansion Packs,10,0,0.0,10
37290,9643,Game Packs,6,0,0.0,6
37291,9643,Kits,1,1,1.0,0
37292,9643,Stuff Packs,5,0,0.0,5
37293,9644,Game Packs,1,1,1.0,0
37294,9644,Kits,3,3,1.0,0
37295,9644,Stuff Packs,5,4,0.8,1
37296,9645,Expansion Packs,10,0,0.0,10
37297,9645,Game Packs,4,0,0.0,4
37298,9645,Stuff Packs,1,0,0.0,1
37299,9646,Expansion Packs,16,0,0.0,16
37300,9646,Game Packs,12,0,0.0,12
37301,9646,Kits,28,0,0.0,28
37302,9646,Stuff Packs,20,0,0.0,20
37303,9647,Expansion Packs,15,0,0.0,15
37304,9647,Game Packs,5,0,0.0,5
37305,9647,Kits,4,2,0.5,2
37306,9647,Stuff Packs,9,1,0.1111111111111111,8
37307,9648,Expansion Packs,16,0,0.0,16
37308,9648,Game Packs,12,0,0.0,12
37309,9648,Kits,30,0,0.0,30
37310,9648,Stuff Packs,20,0,0.0,20
37311,9649,Expansion Packs,16,0,0.0,16
37312,9649,Game Packs,10,0,0.0,10
37313,9649,Kits,12,0,0.0,12
37314,9649,Stuff Packs,14,0,0.0,14
37315,9650,Expansion Packs,15,0,0.0,15
37316,9650,Game Packs,8,0,0.0,8
37317,9650,Kits,2,1,0.5,1
37318,9650,Stuff Packs,18,1,0.05555555555555555,17
37319,9651,Expansion Packs,7,0,0.0,7
37320,9651,Game Packs,4,0,0.0,4
37321,9651,Kits,1,1,1.0,0
37322,9651,Stuff Packs,3,0,0.0,3
37323,9652,Expansion Packs,7,0,0.0,7
37324,9652,Game Packs,3,0,0.0,3
37325,9652,Kits,1,0,0.0,1
37326,9652,Stuff Packs,3,2,0.6666666666666666,1
37327,9653,Expansion Packs,2,0,0.0,2
37328,9653,Stuff Packs,1,1,1.0,0
37329,9654,Expansion Packs,15,0,0.0,15
37330,9654,Game Packs,7,0,0.0,7
37331,9654,Kits,11,1,0.09090909090909091,10
37332,9654,Stuff Packs,14,2,0.14285714285714285,12
37333,9655,Expansion Packs,4,0,0.0,4
37334,9655,Game Packs,4,0,0.0,4
37335,9655,Stuff Packs,2,0,0.0,2
37336,9656,Expansion Packs,14,0,0.0,14
37337,9656,Game Packs,11,0,0.0,11
37338,9656,Kits,13,1,0.07692307692307693,12
37339,9656,Stuff Packs,14,3,0.21428571428571427,11
37340,9657,Expansion Packs,16,0,0.0,16
37341,9657,Game Packs,10,0,0.0,10
37342,9657,Kits,15,2,0.13333333333333333,13
37343,9657,Stuff Packs,18,3,0.16666666666666666,15
37344,9658,Expansion Packs,14,1,0.07142857142857142,13
37345,9658,Game Packs,12,0,0.0,12
37346,9658,Kits,15,0,0.0,15
37347,9658,Stuff Packs,20,0,0.0,20
37348,9659,Expansion Packs,13,0,0.0,13
37349,9659,Game Packs,6,1,0.16666666666666666,5
37350,9659,Kits,1,1,1.0,0
37351,9659,Stuff Packs,6,4,0.6666666666666666,2
37352,9660,Expansion Packs,10,0,0.0,10
37353,9660,Game Packs,3,0,0.0,3
37354,9660,Kits,2,0,0.0,2
37355,9660,Stuff Packs,4,0,0.0,4
37356,9661,Expansion Packs,16,0,0.0,16
37357,9661,Game Packs,12,0,0.0,12
37358,9661,Kits,29,0,0.0,29
37359,9661,Stuff Packs,20,0,0.0,20
37360,9662,Expansion Packs,16,0,0.0,16
37361,9662,Game Packs,11,0,0.0,11
37362,9662,Kits,24,0,0.0,24
37363,9662,Stuff Packs,20,0,0.0,20
37364,9663,Expansion Packs,1,1,1.0,0
37365,9663,Stuff Packs,3,3,1.0,0
37366,9664,Expansion Packs,16,0,0.0,16
37367,9664,Game Packs,12,0,0.0,12
37368,9664,Kits,24,0,0.0,24
37369,9664,Stuff Packs,20,0,0.0,20
37370,9665,Expansion Packs,16,0,0.0,16
37371,9665,Game Packs,12,0,0.0,12
37372,9665,Kits,33,0,0.0,33
37373,9665,Stuff Packs,20,0,0.0,20
37374,9666,Expansion Packs,3,0,0.0,3
37375,9666,Stuff Packs,4,0,0.0,4
37376,9667,Expansion Packs,13,0,0.0,13
37377,9667,Game Packs,4,0,0.0,4
37378,9667,Kits,2,2,1.0,0
37379,9667,Stuff Packs,9,0,0.0,9
37380,9668,Expansion Packs,3,0,0.0,3
37381,9669,Expansion Packs,10,0,0.0,10
37382,9669,Game Packs,7,0,0.0,7
37383,9669,Stuff Packs,7,0,0.0,7
37384,9670,Expansion Packs,15,0,0.0,15
37385,9670,Game Packs,12,0,0.0,12
37386,9670,Kits,3,0,0.0,3
37387,9670,Stuff Packs,20,0,0.0,20
37388,9671,Expansion Packs,14,0,0.0,14
37389,9671,Game Packs,8,0,0.0,8
37390,9671,Kits,9,1,0.1111111111111111,8
37391,9671,Stuff Packs,14,1,0.07142857142857142,13
37392,9672,Expansion Packs,15,0,0.0,15
37393,9672,Game Packs,11,0,0.0,11
37394,9672,Kits,18,1,0.05555555555555555,17
37395,9672,Stuff Packs,14,1,0.07142857142857142,13
37396,9673,Expansion Packs,13,0,0.0,13
37397,9673,Game Packs,8,0,0.0,8
37398,9673,Kits,2,0,0.0,2
37399,9673,Stuff Packs,17,0,0.0,17
37400,9674,Expansion Packs,14,0,0.0,14
37401,9674,Game Packs,12,0,0.0,12
37402,9674,Kits,9,1,0.1111111111111111,8
37403,9674,Stuff Packs,18,0,0.0,18
37404,9675,Expansion Packs,15,0,0.0,15
37405,9675,Game Packs,7,0,0.0,7
37406,9675,Kits,5,0,0.0,5
37407,9675,Stuff Packs,11,0,0.0,11
37408,9676,Expansion Packs,11,0,0.0,11
37409,9676,Game Packs,3,0,0.0,3
37410,9676,Kits,2,1,0.5,1
37411,9676,Stuff Packs,5,3,0.6,2
37412,9677,Expansion Packs,13,0,0.0,13
37413,9677,Game Packs,5,0,0.0,5
37414,9677,Kits,4,0,0.0,4
37415,9677,Stuff Packs,5,0,0.0,5
37416,9678,Expansion Packs,12,0,0.0,12
37417,9678,Game Packs,5,0,0.0,5
37418,9678,Kits,6,1,0.16666666666666666,5
37419,9678,Stuff Packs,11,4,0.36363636363636365,7
37420,9679,Expansion Packs,5,0,0.0,5
37421,9679,Game Packs,1,0,0.0,1
37422,9679,Stuff Packs,1,0,0.0,1
37423,9680,Expansion Packs,16,0,0.0,16
37424,9680,Game Packs,12,1,0.08333333333333333,11
37425,9680,Kits,33,1,0.030303030303030304,32
37426,9680,Stuff Packs,20,0,0.0,20
37427,9681,Expansion Packs,16,0,0.0,16
37428,9681,Game Packs,12,0,0.0,12
37429,9681,Kits,33,0,0.0,33
37430,9681,Stuff Packs,20,0,0.0,20
37431,9682,Expansion Packs,16,0,0.0,16
37432,9682,Game Packs,12,0,0.0,12
37433,9682,Kits,33,0,0.0,33
37434,9682,Stuff Packs,20,0,0.0,20
37435,9683,Expansion Packs,16,0,0.0,16
37436,9683,Game Packs,12,0,0.0,12
37437,9683,Kits,33,0,0.0,33
37438,9683,Stuff Packs,20,1,0.05,19
37439,9684,Expansion Packs,9,0,0.0,9
37440,9684,Game Packs,1,0,0.0,1
37441,9684,Kits,1,1,1.0,0
37442,9684,Stuff Packs,1,0,0.0,1
37443,9685,Expansion Packs,16,0,0.0,16
37444,9685,Game Packs,12,0,0.0,12
37445,9685,Kits,25,0,0.0,25
37446,9685,Stuff Packs,18,3,0.16666666666666666,15
37447,9686,Expansion Packs,11,0,0.0,11
37448,9686,Game Packs,2,0,0.0,2
37449,9686,Kits,2,0,0.0,2
37450,9686,Stuff Packs,2,0,0.0,2
37451,9687,Expansion Packs,16,0,0.0,16
37452,9687,Game Packs,12,0,0.0,12
37453,9687,Kits,33,0,0.0,33
37454,9687,Stuff Packs,20,0,0.0,20
37455,9688,Expansion Packs,16,0,0.0,16
37456,9688,Game Packs,12,0,0.0,12
37457,9688,Kits,33,0,0.0,33
37458,9688,Stuff Packs,20,0,0.0,20
37459,9689,Expansion Packs,16,0,0.0,16
37460,9689,Game Packs,12,0,0.0,12
37461,9689,Kits,33,1,0.030303030303030304,32
37462,9689,Stuff Packs,20,0,0.0,20
37463,9690,Expansion Packs,8,0,0.0,8
37464,9690,Game Packs,3,0,0.0,3
37465,9690,Kits,2,1,0.5,1
37466,9690,Stuff Packs,4,3,0.75,1
37467,9691,Expansion Packs,6,0,0.0,6
37468,9691,Kits,1,1,1.0,0
37469,9691,Stuff Packs,4,3,0.75,1
37470,9692,Expansion Packs,15,0,0.0,15
37471,9692,Game Packs,12,0,0.0,12
37472,9692,Kits,16,1,0.0625,15
37473,9692,Stuff Packs,19,0,0.0,19
37474,9693,Expansion Packs,15,0,0.0,15
37475,9693,Game Packs,9,0,0.0,9
37476,9693,Kits,13,0,0.0,13
37477,9693,Stuff Packs,10,0,0.0,10
37478,9694,Expansion Packs,15,0,0.0,15
37479,9694,Game Packs,9,0,0.0,9
37480,9694,Kits,8,0,0.0,8
37481,9694,Stuff Packs,17,0,0.0,17
37482,9695,Expansion Packs,12,0,0.0,12
37483,9695,Game Packs,11,0,0.0,11
37484,9695,Kits,7,1,0.14285714285714285,6
37485,9695,Stuff Packs,18,0,0.0,18
37486,9696,Expansion Packs,14,1,0.07142857142857142,13
37487,9696,Game Packs,9,0,0.0,9
37488,9696,Kits,2,1,0.5,1
37489,9696,Stuff Packs,4,0,0.0,4
37490,9697,Expansion Packs,10,0,0.0,10
37491,9697,Game Packs,5,0,0.0,5
37492,9697,Kits,8,0,0.0,8
37493,9697,Stuff Packs,7,1,0.14285714285714285,6
37494,9698,Expansion Packs,15,0,0.0,15
37495,9698,Game Packs,12,1,0.08333333333333333,11
37496,9698,Kits,14,1,0.07142857142857142,13
37497,9698,Stuff Packs,20,1,0.05,19
37498,9699,Expansion Packs,16,0,0.0,16
37499,9699,Game Packs,12,0,0.0,12
37500,9699,Kits,33,0,0.0,33
37501,9699,Stuff Packs,20,0,0.0,20
37502,9700,Expansion Packs,11,0,0.0,11
37503,9700,Game Packs,6,0,0.0,6
37504,9700,Kits,8,1,0.125,7
37505,9700,Stuff Packs,8,0,0.0,8
37506,9701,Expansion Packs,9,1,0.1111111111111111,8
37507,9701,Game Packs,3,0,0.0,3
37508,9701,Kits,4,0,0.0,4
37509,9701,Stuff Packs,10,1,0.1,9
37510,9702,Expansion Packs,15,0,0.0,15
37511,9702,Game Packs,11,0,0.0,11
37512,9702,Kits,10,1,0.1,9
37513,9702,Stuff Packs,20,0,0.0,20
37514,9703,Expansion Packs,1,0,0.0,1
37515,9703,Game Packs,3,1,0.3333333333333333,2
37516,9703,Stuff Packs,2,1,0.5,1
37517,9704,Expansion Packs,16,0,0.0,16
37518,9704,Game Packs,10,0,0.0,10
37519,9704,Kits,15,0,0.0,15
37520,9704,Stuff Packs,16,0,0.0,16
37521,9705,Expansion Packs,8,0,0.0,8
37522,9705,Game Packs,3,0,0.0,3
37523,9705,Stuff Packs,5,1,0.2,4
37524,9706,Expansion Packs,10,0,0.0,10
37525,9706,Game Packs,6,0,0.0,6
37526,9706,Kits,14,0,0.0,14
37527,9706,Stuff Packs,15,2,0.13333333333333333,13
37528,9707,Expansion Packs,15,0,0.0,15
37529,9707,Game Packs,9,0,0.0,9
37530,9707,Kits,10,0,0.0,10
37531,9707,Stuff Packs,16,0,0.0,16
37532,9708,Expansion Packs,16,0,0.0,16
37533,9708,Game Packs,12,0,0.0,12
37534,9708,Kits,33,0,0.0,33
37535,9708,Stuff Packs,20,0,0.0,20
37536,9709,Expansion Packs,7,0,0.0,7
37537,9709,Game Packs,3,0,0.0,3
37538,9709,Kits,1,1,1.0,0
37539,9709,Stuff Packs,3,2,0.6666666666666666,1
37540,9710,Expansion Packs,16,0,0.0,16
37541,9710,Game Packs,12,0,0.0,12
37542,9710,Kits,18,0,0.0,18
37543,9710,Stuff Packs,20,0,0.0,20
37544,9711,Expansion Packs,16,0,0.0,16
37545,9711,Game Packs,12,0,0.0,12
37546,9711,Kits,22,1,0.045454545454545456,21
37547,9711,Stuff Packs,20,0,0.0,20
37548,9712,Expansion Packs,8,0,0.0,8
37549,9712,Game Packs,5,0,0.0,5
37550,9712,Stuff Packs,7,0,0.0,7
37551,9713,Expansion Packs,16,0,0.0,16
37552,9713,Game Packs,12,0,0.0,12
37553,9713,Kits,31,0,0.0,31
37554,9713,Stuff Packs,20,1,0.05,19
37555,9714,Expansion Packs,15,0,0.0,15
37556,9714,Game Packs,12,0,0.0,12
37557,9714,Kits,3,1,0.3333333333333333,2
37558,9714,Stuff Packs,18,0,0.0,18
37559,9715,Expansion Packs,16,0,0.0,16
37560,9715,Game Packs,12,0,0.0,12
37561,9715,Kits,33,1,0.030303030303030304,32
37562,9715,Stuff Packs,20,0,0.0,20
37563,9716,Expansion Packs,16,0,0.0,16
37564,9716,Game Packs,8,1,0.125,7
37565,9716,Kits,5,1,0.2,4
37566,9716,Stuff Packs,10,2,0.2,8
37567,9717,Expansion Packs,6,0,0.0,6
37568,9717,Game Packs,1,0,0.0,1
37569,9717,Kits,2,0,0.0,2
37570,9717,Stuff Packs,1,0,0.0,1
37571,9718,Expansion Packs,16,0,0.0,16
37572,9718,Game Packs,11,0,0.0,11
37573,9718,Kits,3,1,0.3333333333333333,2
37574,9718,Stuff Packs,14,0,0.0,14
37575,9719,Expansion Packs,12,0,0.0,12
37576,9719,Game Packs,6,0,0.0,6
37577,9719,Kits,6,1,0.16666666666666666,5
37578,9719,Stuff Packs,16,0,0.0,16
37579,9720,Expansion Packs,7,0,0.0,7
37580,9720,Stuff Packs,2,0,0.0,2
37581,9721,Expansion Packs,13,0,0.0,13
37582,9721,Game Packs,9,1,0.1111111111111111,8
37583,9721,Kits,4,2,0.5,2
37584,9721,Stuff Packs,19,2,0.10526315789473684,17
37585,9722,Expansion Packs,12,0,0.0,12
37586,9722,Game Packs,7,0,0.0,7
37587,9722,Kits,1,0,0.0,1
37588,9722,Stuff Packs,3,0,0.0,3
37589,9723,Expansion Packs,15,0,0.0,15
37590,9723,Game Packs,9,0,0.0,9
37591,9723,Kits,3,3,1.0,0
37592,9723,Stuff Packs,14,2,0.14285714285714285,12
37593,9724,Expansion Packs,16,0,0.0,16
37594,9724,Game Packs,12,0,0.0,12
37595,9724,Kits,33,0,0.0,33
37596,9724,Stuff Packs,20,0,0.0,20
37597,9725,Expansion Packs,16,0,0.0,16
37598,9725,Game Packs,8,0,0.0,8
37599,9725,Kits,6,1,0.16666666666666666,5
37600,9725,Stuff Packs,18,2,0.1111111111111111,16
37601,9726,Expansion Packs,16,0,0.0,16
37602,9726,Game Packs,12,0,0.0,12
37603,9726,Kits,33,1,0.030303030303030304,32
37604,9726,Stuff Packs,20,0,0.0,20
37605,9727,Expansion Packs,13,0,0.0,13
37606,9727,Game Packs,8,0,0.0,8
37607,9727,Kits,11,2,0.18181818181818182,9
37608,9727,Stuff Packs,13,3,0.23076923076923078,10
37609,9728,Expansion Packs,5,0,0.0,5
37610,9728,Game Packs,4,0,0.0,4
37611,9728,Kits,2,1,0.5,1
37612,9728,Stuff Packs,6,3,0.5,3
37613,9729,Expansion Packs,9,0,0.0,9
37614,9729,Game Packs,5,0,0.0,5
37615,9729,Kits,11,1,0.09090909090909091,10
37616,9729,Stuff Packs,14,1,0.07142857142857142,13
37617,9730,Expansion Packs,16,0,0.0,16
37618,9730,Game Packs,10,0,0.0,10
37619,9730,Kits,11,1,0.09090909090909091,10
37620,9730,Stuff Packs,19,0,0.0,19
37621,9731,Expansion Packs,7,0,0.0,7
37622,9731,Game Packs,6,1,0.16666666666666666,5
37623,9731,Kits,14,1,0.07142857142857142,13
37624,9731,Stuff Packs,10,2,0.2,8
37625,9732,Expansion Packs,16,0,0.0,16
37626,9732,Game Packs,12,0,0.0,12
37627,9732,Kits,33,1,0.030303030303030304,32
37628,9732,Stuff Packs,20,0,0.0,20
37629,9733,Expansion Packs,16,3,0.1875,13
37630,9733,Game Packs,12,1,0.08333333333333333,11
37631,9733,Kits,26,1,0.038461538461538464,25
37632,9733,Stuff Packs,19,2,0.10526315789473684,17
37633,9734,Expansion Packs,7,0,0.0,7
37634,9734,Game Packs,5,0,0.0,5
37635,9734,Kits,2,0,0.0,2
37636,9734,Stuff Packs,7,3,0.42857142857142855,4
37637,9735,Expansion Packs,16,0,0.0,16
37638,9735,Game Packs,12,0,0.0,12
37639,9735,Kits,33,0,0.0,33
37640,9735,Stuff Packs,20,0,0.0,20
37641,9736,Expansion Packs,16,0,0.0,16
37642,9736,Game Packs,12,0,0.0,12
37643,9736,Kits,31,0,0.0,31
37644,9736,Stuff Packs,20,0,0.0,20
37645,9737,Expansion Packs,15,0,0.0,15
37646,9737,Game Packs,12,0,0.0,12
37647,9737,Kits,28,0,0.0,28
37648,9737,Stuff Packs,20,0,0.0,20
37649,9738,Expansion Packs,15,0,0.0,15
37650,9738,Game Packs,10,0,0.0,10
37651,9738,Kits,3,2,0.6666666666666666,1
37652,9738,Stuff Packs,18,1,0.05555555555555555,17
37653,9739,Expansion Packs,2,0,0.0,2
37654,9739,Kits,1,1,1.0,0
37655,9740,Expansion Packs,11,0,0.0,11
37656,9740,Game Packs,7,0,0.0,7
37657,9740,Kits,2,2,1.0,0
37658,9740,Stuff Packs,10,1,0.1,9
37659,9741,Expansion Packs,16,0,0.0,16
37660,9741,Game Packs,11,0,0.0,11
37661,9741,Kits,26,0,0.0,26
37662,9741,Stuff Packs,20,0,0.0,20
37663,9742,Expansion Packs,15,0,0.0,15
37664,9742,Game Packs,11,0,0.0,11
37665,9742,Kits,12,1,0.08333333333333333,11
37666,9742,Stuff Packs,16,1,0.0625,15
37667,9743,Expansion Packs,14,0,0.0,14
37668,9743,Game Packs,10,0,0.0,10
37669,9743,Kits,17,1,0.058823529411764705,16
37670,9743,Stuff Packs,20,0,0.0,20
37671,9744,Expansion Packs,16,0,0.0,16
37672,9744,Game Packs,11,0,0.0,11
37673,9744,Kits,9,2,0.2222222222222222,7
37674,9744,Stuff Packs,20,0,0.0,20
37675,9745,Expansion Packs,13,0,0.0,13
37676,9745,Game Packs,9,0,0.0,9
37677,9745,Kits,15,0,0.0,15
37678,9745,Stuff Packs,20,0,0.0,20
37679,9746,Expansion Packs,3,0,0.0,3
37680,9746,Game Packs,3,0,0.0,3
37681,9746,Stuff Packs,2,0,0.0,2
37682,9747,Expansion Packs,16,0,0.0,16
37683,9747,Game Packs,12,0,0.0,12
37684,9747,Kits,31,0,0.0,31
37685,9747,Stuff Packs,20,0,0.0,20
37686,9748,Expansion Packs,5,0,0.0,5
37687,9748,Game Packs,5,0,0.0,5
37688,9748,Kits,12,1,0.08333333333333333,11
37689,9748,Stuff Packs,6,1,0.16666666666666666,5
37690,9749,Expansion Packs,10,0,0.0,10
37691,9749,Game Packs,2,0,0.0,2
37692,9749,Kits,1,0,0.0,1
37693,9749,Stuff Packs,4,1,0.25,3
37694,9750,Expansion Packs,16,0,0.0,16
37695,9750,Game Packs,12,0,0.0,12
37696,9750,Kits,33,0,0.0,33
37697,9750,Stuff Packs,20,0,0.0,20
37698,9751,Expansion Packs,16,0,0.0,16
37699,9751,Game Packs,10,0,0.0,10
37700,9751,Kits,2,2,1.0,0
37701,9751,Stuff Packs,18,1,0.05555555555555555,17
37702,9752,Expansion Packs,15,0,0.0,15
37703,9752,Game Packs,8,0,0.0,8
37704,9752,Kits,6,2,0.3333333333333333,4
37705,9752,Stuff Packs,18,1,0.05555555555555555,17
37706,9753,Expansion Packs,12,0,0.0,12
37707,9753,Game Packs,7,1,0.14285714285714285,6
37708,9753,Kits,3,3,1.0,0
37709,9753,Stuff Packs,8,4,0.5,4
37710,9754,Expansion Packs,16,0,0.0,16
37711,9754,Game Packs,12,0,0.0,12
37712,9754,Kits,33,0,0.0,33
37713,9754,Stuff Packs,20,5,0.25,15
37714,9755,Expansion Packs,8,0,0.0,8
37715,9755,Game Packs,3,0,0.0,3
37716,9755,Stuff Packs,4,0,0.0,4
37717,9756,Expansion Packs,16,0,0.0,16
37718,9756,Game Packs,12,0,0.0,12
37719,9756,Kits,14,0,0.0,14
37720,9756,Stuff Packs,18,0,0.0,18
37721,9757,Expansion Packs,12,0,0.0,12
37722,9757,Game Packs,5,0,0.0,5
37723,9757,Kits,4,1,0.25,3
37724,9757,Stuff Packs,14,4,0.2857142857142857,10
37725,9758,Expansion Packs,16,0,0.0,16
37726,9758,Game Packs,9,0,0.0,9
37727,9758,Kits,22,0,0.0,22
37728,9758,Stuff Packs,18,0,0.0,18
37729,9759,Expansion Packs,14,0,0.0,14
37730,9759,Game Packs,12,0,0.0,12
37731,9759,Kits,9,2,0.2222222222222222,7
37732,9759,Stuff Packs,20,0,0.0,20
37733,9760,Expansion Packs,16,0,0.0,16
37734,9760,Game Packs,12,1,0.08333333333333333,11
37735,9760,Kits,22,0,0.0,22
37736,9760,Stuff Packs,19,2,0.10526315789473684,17
37737,9761,Expansion Packs,2,0,0.0,2
37738,9761,Game Packs,2,0,0.0,2
37739,9761,Stuff Packs,1,0,0.0,1
37740,9762,Expansion Packs,14,0,0.0,14
37741,9762,Game Packs,5,0,0.0,5
37742,9762,Kits,10,2,0.2,8
37743,9762,Stuff Packs,8,1,0.125,7
37744,9763,Expansion Packs,9,0,0.0,9
37745,9763,Game Packs,2,0,0.0,2
37746,9763,Stuff Packs,6,1,0.16666666666666666,5
37747,9764,Expansion Packs,15,0,0.0,15
37748,9764,Game Packs,9,1,0.1111111111111111,8
37749,9764,Kits,10,3,0.3,7
37750,9764,Stuff Packs,15,1,0.06666666666666667,14
37751,9765,Expansion Packs,14,0,0.0,14
37752,9765,Game Packs,10,0,0.0,10
37753,9765,Stuff Packs,19,0,0.0,19
37754,9766,Expansion Packs,16,0,0.0,16
37755,9766,Game Packs,12,0,0.0,12
37756,9766,Kits,30,1,0.03333333333333333,29
37757,9766,Stuff Packs,19,2,0.10526315789473684,17
37758,9767,Expansion Packs,14,0,0.0,14
37759,9767,Game Packs,11,0,0.0,11
37760,9767,Kits,18,0,0.0,18
37761,9767,Stuff Packs,20,0,0.0,20
37762,9768,Expansion Packs,11,0,0.0,11
37763,9768,Game Packs,1,0,0.0,1
37764,9768,Kits,7,0,0.0,7
37765,9768,Stuff Packs,5,0,0.0,5
37766,9769,Expansion Packs,16,0,0.0,16
37767,9769,Game Packs,12,0,0.0,12
37768,9769,Kits,26,2,0.07692307692307693,24
37769,9769,Stuff Packs,20,0,0.0,20
37770,9770,Expansion Packs,6,0,0.0,6
37771,9770,Game Packs,1,0,0.0,1
37772,9770,Kits,1,1,1.0,0
37773,9770,Stuff Packs,3,2,0.6666666666666666,1
37774,9771,Expansion Packs,14,0,0.0,14
37775,9771,Game Packs,11,0,0.0,11
37776,9771,Kits,33,1,0.030303030303030304,32
37777,9771,Stuff Packs,20,0,0.0,20
37778,9772,Expansion Packs,9,0,0.0,9
37779,9772,Game Packs,5,0,0.0,5
37780,9772,Stuff Packs,7,1,0.14285714285714285,6
37781,9773,Expansion Packs,16,0,0.0,16
37782,9773,Game Packs,12,0,0.0,12
37783,9773,Kits,4,0,0.0,4
37784,9773,Stuff Packs,20,0,0.0,20
37785,9774,Expansion Packs,16,0,0.0,16
37786,9774,Game Packs,11,0,0.0,11
37787,9774,Kits,22,0,0.0,22
37788,9774,Stuff Packs,20,0,0.0,20
37789,9775,Expansion Packs,16,0,0.0,16
37790,9775,Game Packs,11,0,0.0,11
37791,9775,Kits,20,2,0.1,18
37792,9775,Stuff Packs,20,0,0.0,20
37793,9776,Expansion Packs,16,1,0.0625,15
37794,9776,Game Packs,10,0,0.0,10
37795,9776,Kits,9,1,0.1111111111111111,8
37796,9776,Stuff Packs,18,0,0.0,18
37797,9777,Expansion Packs,16,1,0.0625,15
37798,9777,Game Packs,9,0,0.0,9
37799,9777,Kits,14,2,0.14285714285714285,12
37800,9777,Stuff Packs,14,1,0.07142857142857142,13
37801,9778,Expansion Packs,7,0,0.0,7
37802,9778,Game Packs,3,0,0.0,3
37803,9778,Kits,1,1,1.0,0
37804,9778,Stuff Packs,4,2,0.5,2
37805,9779,Expansion Packs,10,0,0.0,10
37806,9779,Game Packs,5,0,0.0,5
37807,9779,Kits,8,0,0.0,8
37808,9779,Stuff Packs,8,3,0.375,5
37809,9780,Expansion Packs,7,0,0.0,7
37810,9780,Game Packs,5,0,0.0,5
37811,9780,Kits,7,0,0.0,7
37812,9780,Stuff Packs,11,0,0.0,11
37813,9781,Expansion Packs,10,0,0.0,10
37814,9781,Game Packs,4,1,0.25,3
37815,9781,Kits,3,1,0.3333333333333333,2
37816,9781,Stuff Packs,8,3,0.375,5
37817,9782,Expansion Packs,16,0,0.0,16
37818,9782,Game Packs,10,0,0.0,10
37819,9782,Kits,19,0,0.0,19
37820,9782,Stuff Packs,17,0,0.0,17
37821,9783,Expansion Packs,6,0,0.0,6
37822,9783,Game Packs,6,1,0.16666666666666666,5
37823,9783,Kits,1,1,1.0,0
37824,9783,Stuff Packs,11,3,0.2727272727272727,8
37825,9784,Expansion Packs,4,0,0.0,4
37826,9784,Game Packs,2,1,0.5,1
37827,9784,Kits,3,3,1.0,0
37828,9784,Stuff Packs,5,4,0.8,1
37829,9785,Expansion Packs,16,0,0.0,16
37830,9785,Game Packs,12,0,0.0,12
37831,9785,Kits,28,0,0.0,28
37832,9785,Stuff Packs,20,0,0.0,20
37833,9786,Expansion Packs,16,0,0.0,16
37834,9786,Game Packs,12,0,0.0,12
37835,9786,Kits,33,2,0.06060606060606061,31
37836,9786,Stuff Packs,20,0,0.0,20
37837,9787,Expansion Packs,13,0,0.0,13
37838,9787,Game Packs,10,0,0.0,10
37839,9787,Kits,1,0,0.0,1
37840,9787,Stuff Packs,6,0,0.0,6
37841,9788,Expansion Packs,16,0,0.0,16
37842,9788,Game Packs,12,0,0.0,12
37843,9788,Kits,27,1,0.037037037037037035,26
37844,9788,Stuff Packs,20,0,0.0,20
37845,9789,Expansion Packs,11,0,0.0,11
37846,9789,Game Packs,7,0,0.0,7
37847,9789,Kits,11,1,0.09090909090909091,10
37848,9789,Stuff Packs,14,1,0.07142857142857142,13
37849,9790,Expansion Packs,16,0,0.0,16
37850,9790,Game Packs,12,0,0.0,12
37851,9790,Kits,33,0,0.0,33
37852,9790,Stuff Packs,20,0,0.0,20
37853,9791,Expansion Packs,12,2,0.16666666666666666,10
37854,9791,Game Packs,12,0,0.0,12
37855,9791,Kits,12,0,0.0,12
37856,9791,Stuff Packs,18,0,0.0,18
37857,9792,Expansion Packs,16,0,0.0,16
37858,9792,Game Packs,12,1,0.08333333333333333,11
37859,9792,Kits,33,0,0.0,33
37860,9792,Stuff Packs,20,0,0.0,20
37861,9793,Expansion Packs,16,0,0.0,16
37862,9793,Game Packs,12,0,0.0,12
37863,9793,Kits,5,0,0.0,5
37864,9793,Stuff Packs,20,3,0.15,17
37865,9794,Expansion Packs,15,0,0.0,15
37866,9794,Game Packs,9,0,0.0,9
37867,9794,Kits,4,1,0.25,3
37868,9794,Stuff Packs,10,2,0.2,8
37869,9795,Expansion Packs,15,0,0.0,15
37870,9795,Game Packs,10,0,0.0,10
37871,9795,Kits,19,0,0.0,19
37872,9795,Stuff Packs,16,0,0.0,16
37873,9796,Expansion Packs,15,0,0.0,15
37874,9796,Game Packs,11,2,0.18181818181818182,9
37875,9796,Kits,15,3,0.2,12
37876,9796,Stuff Packs,16,3,0.1875,13
37877,9797,Expansion Packs,16,0,0.0,16
37878,9797,Game Packs,12,0,0.0,12
37879,9797,Kits,33,0,0.0,33
37880,9797,Stuff Packs,20,0,0.0,20
37881,9798,Expansion Packs,11,0,0.0,11
37882,9798,Game Packs,9,0,0.0,9
37883,9798,Kits,6,0,0.0,6
37884,9798,Stuff Packs,8,0,0.0,8
37885,9799,Expansion Packs,16,4,0.25,12
37886,9799,Game Packs,12,9,0.75,3
37887,9799,Kits,10,0,0.0,10
37888,9799,Stuff Packs,19,11,0.5789473684210527,8
37889,9800,Expansion Packs,16,0,0.0,16
37890,9800,Game Packs,12,0,0.0,12
37891,9800,Kits,28,0,0.0,28
37892,9800,Stuff Packs,20,0,0.0,20
37893,9801,Expansion Packs,9,2,0.2222222222222222,7
37894,9801,Game Packs,3,0,0.0,3
37895,9801,Kits,2,0,0.0,2
37896,9801,Stuff Packs,5,2,0.4,3
37897,9802,Expansion Packs,4,0,0.0,4
37898,9802,Game Packs,4,1,0.25,3
37899,9802,Kits,2,2,1.0,0
37900,9802,Stuff Packs,4,3,0.75,1
37901,9803,Expansion Packs,16,0,0.0,16
37902,9803,Game Packs,11,0,0.0,11
37903,9803,Kits,23,1,0.043478260869565216,22
37904,9803,Stuff Packs,20,0,0.0,20
37905,9804,Expansion Packs,16,0,0.0,16
37906,9804,Game Packs,12,0,0.0,12
37907,9804,Kits,31,1,0.03225806451612903,30
37908,9804,Stuff Packs,20,0,0.0,20
37909,9805,Expansion Packs,9,0,0.0,9
37910,9805,Game Packs,4,0,0.0,4
37911,9805,Stuff Packs,6,1,0.16666666666666666,5
37912,9806,Expansion Packs,16,0,0.0,16
37913,9806,Game Packs,11,2,0.18181818181818182,9
37914,9806,Kits,15,2,0.13333333333333333,13
37915,9806,Stuff Packs,14,1,0.07142857142857142,13
37916,9807,Expansion Packs,16,0,0.0,16
37917,9807,Game Packs,10,1,0.1,9
37918,9807,Kits,20,1,0.05,19
37919,9807,Stuff Packs,15,0,0.0,15
37920,9808,Expansion Packs,15,0,0.0,15
37921,9808,Game Packs,9,0,0.0,9
37922,9808,Kits,22,0,0.0,22
37923,9808,Stuff Packs,18,0,0.0,18
37924,9809,Expansion Packs,14,0,0.0,14
37925,9809,Game Packs,4,0,0.0,4
37926,9809,Kits,5,2,0.4,3
37927,9809,Stuff Packs,10,1,0.1,9
37928,9810,Expansion Packs,11,0,0.0,11
37929,9810,Game Packs,5,0,0.0,5
37930,9810,Kits,9,2,0.2222222222222222,7
37931,9810,Stuff Packs,11,3,0.2727272727272727,8
37932,9811,Expansion Packs,16,0,0.0,16
37933,9811,Game Packs,12,0,0.0,12
37934,9811,Kits,33,0,0.0,33
37935,9811,Stuff Packs,20,0,0.0,20
37936,9812,Expansion Packs,8,0,0.0,8
37937,9812,Game Packs,6,0,0.0,6
37938,9812,Kits,2,1,0.5,1
37939,9812,Stuff Packs,7,2,0.2857142857142857,5
37940,9813,Expansion Packs,13,0,0.0,13
37941,9813,Game Packs,7,0,0.0,7
37942,9813,Kits,1,1,1.0,0
37943,9813,Stuff Packs,10,3,0.3,7
37944,9814,Expansion Packs,7,0,0.0,7
37945,9814,Game Packs,3,0,0.0,3
37946,9814,Kits,2,2,1.0,0
37947,9814,Stuff Packs,3,3,1.0,0
37948,9815,Expansion Packs,14,0,0.0,14
37949,9815,Game Packs,10,1,0.1,9
37950,9815,Kits,6,0,0.0,6
37951,9815,Stuff Packs,8,2,0.25,6
37952,9816,Expansion Packs,14,0,0.0,14
37953,9816,Game Packs,4,0,0.0,4
37954,9816,Kits,3,0,0.0,3
37955,9816,Stuff Packs,5,2,0.4,3
37956,9817,Expansion Packs,16,0,0.0,16
37957,9817,Game Packs,11,0,0.0,11
37958,9817,Kits,12,1,0.08333333333333333,11
37959,9817,Stuff Packs,14,2,0.14285714285714285,12
37960,9818,Expansion Packs,9,0,0.0,9
37961,9818,Game Packs,5,0,0.0,5
37962,9818,Kits,19,0,0.0,19
37963,9818,Stuff Packs,10,0,0.0,10
37964,9819,Expansion Packs,16,0,0.0,16
37965,9819,Game Packs,10,0,0.0,10
37966,9819,Kits,10,2,0.2,8
37967,9819,Stuff Packs,15,1,0.06666666666666667,14
37968,9820,Expansion Packs,15,0,0.0,15
37969,9820,Game Packs,12,0,0.0,12
37970,9820,Kits,28,1,0.03571428571428571,27
37971,9820,Stuff Packs,20,0,0.0,20
37972,9821,Expansion Packs,16,0,0.0,16
37973,9821,Game Packs,9,0,0.0,9
37974,9821,Kits,13,1,0.07692307692307693,12
37975,9821,Stuff Packs,14,2,0.14285714285714285,12
37976,9822,Expansion Packs,15,0,0.0,15
37977,9822,Game Packs,10,0,0.0,10
37978,9822,Kits,7,0,0.0,7
37979,9822,Stuff Packs,15,1,0.06666666666666667,14
37980,9823,Expansion Packs,16,0,0.0,16
37981,9823,Game Packs,11,0,0.0,11
37982,9823,Kits,22,1,0.045454545454545456,21
37983,9823,Stuff Packs,20,0,0.0,20
37984,9824,Expansion Packs,16,0,0.0,16
37985,9824,Game Packs,12,0,0.0,12
37986,9824,Kits,11,1,0.09090909090909091,10
37987,9824,Stuff Packs,20,0,0.0,20
37988,9825,Expansion Packs,11,0,0.0,11
37989,9825,Game Packs,5,1,0.2,4
37990,9825,Kits,4,4,1.0,0
37991,9825,Stuff Packs,8,2,0.25,6
37992,9826,Expansion Packs,12,0,0.0,12
37993,9826,Game Packs,2,0,0.0,2
37994,9826,Stuff Packs,3,1,0.3333333333333333,2
37995,9827,Expansion Packs,15,0,0.0,15
37996,9827,Game Packs,10,0,0.0,10
37997,9827,Kits,14,1,0.07142857142857142,13
37998,9827,Stuff Packs,11,3,0.2727272727272727,8
37999,9828,Expansion Packs,12,0,0.0,12
38000,9828,Game Packs,3,0,0.0,3
38001,9828,Kits,8,1,0.125,7
38002,9828,Stuff Packs,6,1,0.16666666666666666,5
38003,9829,Expansion Packs,15,0,0.0,15
38004,9829,Game Packs,7,0,0.0,7
38005,9829,Kits,5,1,0.2,4
38006,9829,Stuff Packs,11,1,0.09090909090909091,10
38007,9830,Expansion Packs,12,0,0.0,12
38008,9830,Game Packs,9,0,0.0,9
38009,9830,Kits,15,0,0.0,15
38010,9830,Stuff Packs,7,1,0.14285714285714285,6
38011,9831,Expansion Packs,11,0,0.0,11
38012,9831,Game Packs,10,0,0.0,10
38013,9831,Kits,1,0,0.0,1
38014,9831,Stuff Packs,10,1,0.1,9
38015,9832,Expansion Packs,15,0,0.0,15
38016,9832,Game Packs,12,0,0.0,12
38017,9832,Kits,24,0,0.0,24
38018,9832,Stuff Packs,20,0,0.0,20
38019,9833,Expansion Packs,16,0,0.0,16
38020,9833,Game Packs,12,0,0.0,12
38021,9833,Kits,5,0,0.0,5
38022,9833,Stuff Packs,20,1,0.05,19
38023,9834,Expansion Packs,11,1,0.09090909090909091,10
38024,9834,Game Packs,3,0,0.0,3
38025,9834,Stuff Packs,4,1,0.25,3
38026,9835,Expansion Packs,16,0,0.0,16
38027,9835,Game Packs,11,0,0.0,11
38028,9835,Kits,12,2,0.16666666666666666,10
38029,9835,Stuff Packs,20,2,0.1,18
38030,9836,Expansion Packs,14,0,0.0,14
38031,9836,Game Packs,6,0,0.0,6
38032,9836,Kits,3,1,0.3333333333333333,2
38033,9836,Stuff Packs,12,0,0.0,12
38034,9837,Expansion Packs,16,0,0.0,16
38035,9837,Game Packs,11,0,0.0,11
38036,9837,Kits,23,1,0.043478260869565216,22
38037,9837,Stuff Packs,20,0,0.0,20
38038,9838,Expansion Packs,16,0,0.0,16
38039,9838,Game Packs,11,0,0.0,11
38040,9838,Kits,13,1,0.07692307692307693,12
38041,9838,Stuff Packs,15,0,0.0,15
38042,9839,Expansion Packs,16,0,0.0,16
38043,9839,Game Packs,12,0,0.0,12
38044,9839,Kits,26,0,0.0,26
38045,9839,Stuff Packs,19,1,0.05263157894736842,18
38046,9840,Expansion Packs,16,1,0.0625,15
38047,9840,Game Packs,11,0,0.0,11
38048,9840,Kits,15,0,0.0,15
38049,9840,Stuff Packs,18,1,0.05555555555555555,17
38050,9841,Expansion Packs,16,0,0.0,16
38051,9841,Game Packs,12,0,0.0,12
38052,9841,Kits,27,2,0.07407407407407407,25
38053,9841,Stuff Packs,20,0,0.0,20
38054,9842,Expansion Packs,15,0,0.0,15
38055,9842,Game Packs,7,0,0.0,7
38056,9842,Kits,8,2,0.25,6
38057,9842,Stuff Packs,13,1,0.07692307692307693,12
38058,9843,Expansion Packs,15,0,0.0,15
38059,9843,Game Packs,11,0,0.0,11
38060,9843,Kits,13,0,0.0,13
38061,9843,Stuff Packs,15,0,0.0,15
38062,9844,Expansion Packs,3,0,0.0,3
38063,9844,Kits,1,1,1.0,0
38064,9844,Stuff Packs,4,2,0.5,2
38065,9845,Expansion Packs,11,0,0.0,11
38066,9845,Game Packs,6,0,0.0,6
38067,9845,Kits,1,1,1.0,0
38068,9845,Stuff Packs,8,3,0.375,5
38069,9846,Expansion Packs,16,0,0.0,16
38070,9846,Game Packs,11,0,0.0,11
38071,9846,Kits,16,0,0.0,16
38072,9846,Stuff Packs,19,0,0.0,19
38073,9847,Expansion Packs,13,0,0.0,13
38074,9847,Game Packs,10,0,0.0,10
38075,9847,Stuff Packs,18,0,0.0,18
38076,9848,Expansion Packs,2,0,0.0,2
38077,9848,Game Packs,1,0,0.0,1
38078,9848,Kits,2,2,1.0,0
38079,9848,Stuff Packs,5,3,0.6,2
38080,9849,Expansion Packs,14,0,0.0,14
38081,9849,Game Packs,9,0,0.0,9
38082,9849,Kits,3,0,0.0,3
38083,9849,Stuff Packs,13,0,0.0,13
38084,9850,Expansion Packs,16,0,0.0,16
38085,9850,Game Packs,9,0,0.0,9
38086,9850,Kits,3,2,0.6666666666666666,1
38087,9850,Stuff Packs,18,0,0.0,18
38088,9851,Expansion Packs,16,0,0.0,16
38089,9851,Game Packs,8,0,0.0,8
38090,9851,Kits,27,0,0.0,27
38091,9851,Stuff Packs,17,0,0.0,17
38092,9852,Expansion Packs,14,0,0.0,14
38093,9852,Game Packs,10,0,0.0,10
38094,9852,Kits,12,1,0.08333333333333333,11
38095,9852,Stuff Packs,19,0,0.0,19
38096,9853,Expansion Packs,7,0,0.0,7
38097,9853,Game Packs,2,1,0.5,1
38098,9853,Kits,3,3,1.0,0
38099,9853,Stuff Packs,8,3,0.375,5
38100,9854,Expansion Packs,13,0,0.0,13
38101,9854,Game Packs,10,0,0.0,10
38102,9854,Kits,3,1,0.3333333333333333,2
38103,9854,Stuff Packs,18,2,0.1111111111111111,16
38104,9855,Expansion Packs,4,0,0.0,4
38105,9855,Game Packs,5,0,0.0,5
38106,9855,Kits,5,2,0.4,3
38107,9855,Stuff Packs,6,3,0.5,3
38108,9856,Expansion Packs,16,0,0.0,16
38109,9856,Game Packs,11,0,0.0,11
38110,9856,Kits,12,1,0.08333333333333333,11
38111,9856,Stuff Packs,19,1,0.05263157894736842,18
38112,9857,Expansion Packs,7,0,0.0,7
38113,9857,Game Packs,4,0,0.0,4
38114,9857,Kits,2,1,0.5,1
38115,9857,Stuff Packs,7,0,0.0,7
38116,9858,Expansion Packs,15,0,0.0,15
38117,9858,Game Packs,9,0,0.0,9
38118,9858,Kits,7,1,0.14285714285714285,6
38119,9858,Stuff Packs,15,10,0.6666666666666666,5
38120,9859,Expansion Packs,10,0,0.0,10
38121,9859,Game Packs,1,0,0.0,1
38122,9859,Stuff Packs,4,1,0.25,3
38123,9860,Expansion Packs,12,0,0.0,12
38124,9860,Game Packs,5,0,0.0,5
38125,9860,Kits,3,1,0.3333333333333333,2
38126,9860,Stuff Packs,13,2,0.15384615384615385,11
38127,9861,Expansion Packs,16,0,0.0,16
38128,9861,Game Packs,12,0,0.0,12
38129,9861,Kits,22,0,0.0,22
38130,9861,Stuff Packs,20,0,0.0,20
38131,9862,Expansion Packs,16,1,0.0625,15
38132,9862,Game Packs,12,0,0.0,12
38133,9862,Kits,33,7,0.21212121212121213,26
38134,9862,Stuff Packs,20,2,0.1,18
38135,9863,Expansion Packs,16,0,0.0,16
38136,9863,Game Packs,8,0,0.0,8
38137,9863,Kits,20,0,0.0,20
38138,9863,Stuff Packs,14,2,0.14285714285714285,12
38139,9864,Expansion Packs,6,0,0.0,6
38140,9864,Game Packs,3,0,0.0,3
38141,9864,Kits,2,1,0.5,1
38142,9864,Stuff Packs,4,1,0.25,3
38143,9865,Expansion Packs,16,0,0.0,16
38144,9865,Game Packs,11,0,0.0,11
38145,9865,Kits,16,1,0.0625,15
38146,9865,Stuff Packs,19,0,0.0,19
38147,9866,Expansion Packs,16,0,0.0,16
38148,9866,Game Packs,11,1,0.09090909090909091,10
38149,9866,Kits,14,1,0.07142857142857142,13
38150,9866,Stuff Packs,16,3,0.1875,13
38151,9867,Expansion Packs,15,0,0.0,15
38152,9867,Game Packs,5,0,0.0,5
38153,9867,Kits,19,2,0.10526315789473684,17
38154,9867,Stuff Packs,16,0,0.0,16
38155,9868,Expansion Packs,12,0,0.0,12
38156,9868,Game Packs,6,0,0.0,6
38157,9868,Kits,13,0,0.0,13
38158,9868,Stuff Packs,9,2,0.2222222222222222,7
38159,9869,Expansion Packs,16,0,0.0,16
38160,9869,Game Packs,12,0,0.0,12
38161,9869,Kits,33,2,0.06060606060606061,31
38162,9869,Stuff Packs,20,3,0.15,17
38163,9870,Expansion Packs,16,0,0.0,16
38164,9870,Game Packs,7,0,0.0,7
38165,9870,Kits,3,0,0.0,3
38166,9870,Stuff Packs,8,1,0.125,7
38167,9871,Expansion Packs,15,0,0.0,15
38168,9871,Game Packs,11,0,0.0,11
38169,9871,Kits,9,1,0.1111111111111111,8
38170,9871,Stuff Packs,19,0,0.0,19
38171,9872,Expansion Packs,9,0,0.0,9
38172,9872,Game Packs,7,0,0.0,7
38173,9872,Kits,2,1,0.5,1
38174,9872,Stuff Packs,3,1,0.3333333333333333,2
38175,9873,Expansion Packs,16,0,0.0,16
38176,9873,Game Packs,12,0,0.0,12
38177,9873,Kits,33,1,0.030303030303030304,32
38178,9873,Stuff Packs,20,0,0.0,20
38179,9874,Expansion Packs,12,0,0.0,12
38180,9874,Game Packs,6,0,0.0,6
38181,9874,Kits,2,2,1.0,0
38182,9874,Stuff Packs,7,0,0.0,7
38183,9875,Expansion Packs,1,0,0.0,1
38184,9875,Game Packs,3,0,0.0,3
38185,9875,Stuff Packs,1,0,0.0,1
38186,9876,Expansion Packs,13,2,0.15384615384615385,11
38187,9876,Game Packs,7,3,0.42857142857142855,4
38188,9876,Kits,5,0,0.0,5
38189,9876,Stuff Packs,9,0,0.0,9
38190,9877,Expansion Packs,15,0,0.0,15
38191,9877,Game Packs,11,0,0.0,11
38192,9877,Kits,1,0,0.0,1
38193,9877,Stuff Packs,18,0,0.0,18
38194,9878,Expansion Packs,13,0,0.0,13
38195,9878,Game Packs,11,0,0.0,11
38196,9878,Kits,3,1,0.3333333333333333,2
38197,9878,Stuff Packs,19,0,0.0,19
38198,9879,Expansion Packs,14,1,0.07142857142857142,13
38199,9879,Game Packs,5,0,0.0,5
38200,9879,Kits,2,0,0.0,2
38201,9879,Stuff Packs,11,0,0.0,11
38202,9880,Expansion Packs,13,0,0.0,13
38203,9880,Game Packs,12,0,0.0,12
38204,9880,Stuff Packs,18,0,0.0,18
38205,9881,Expansion Packs,16,0,0.0,16
38206,9881,Game Packs,12,0,0.0,12
38207,9881,Kits,33,0,0.0,33
38208,9881,Stuff Packs,20,0,0.0,20
38209,9882,Expansion Packs,13,0,0.0,13
38210,9882,Game Packs,11,0,0.0,11
38211,9882,Kits,8,1,0.125,7
38212,9882,Stuff Packs,18,3,0.16666666666666666,15
38213,9883,Expansion Packs,1,0,0.0,1
38214,9883,Game Packs,1,0,0.0,1
38215,9883,Kits,1,1,1.0,0
38216,9883,Stuff Packs,4,3,0.75,1
38217,9884,Expansion Packs,8,0,0.0,8
38218,9884,Game Packs,5,1,0.2,4
38219,9884,Kits,7,2,0.2857142857142857,5
38220,9884,Stuff Packs,9,4,0.4444444444444444,5
38221,9885,Expansion Packs,14,0,0.0,14
38222,9885,Game Packs,7,0,0.0,7
38223,9885,Kits,18,0,0.0,18
38224,9885,Stuff Packs,15,2,0.13333333333333333,13
38225,9886,Expansion Packs,5,0,0.0,5
38226,9886,Game Packs,1,0,0.0,1
38227,9886,Kits,1,1,1.0,0
38228,9886,Stuff Packs,1,0,0.0,1
38229,9887,Expansion Packs,3,0,0.0,3
38230,9887,Game Packs,2,0,0.0,2
38231,9887,Kits,3,0,0.0,3
38232,9887,Stuff Packs,2,0,0.0,2
38233,9888,Expansion Packs,13,0,0.0,13
38234,9888,Game Packs,6,0,0.0,6
38235,9888,Kits,4,1,0.25,3
38236,9888,Stuff Packs,10,0,0.0,10
38237,9889,Expansion Packs,16,0,0.0,16
38238,9889,Game Packs,12,0,0.0,12
38239,9889,Kits,31,1,0.03225806451612903,30
38240,9889,Stuff Packs,20,0,0.0,20
38241,9890,Expansion Packs,13,0,0.0,13
38242,9890,Game Packs,10,0,0.0,10
38243,9890,Stuff Packs,19,0,0.0,19
38244,9891,Expansion Packs,3,2,0.6666666666666666,1
38245,9891,Game Packs,3,1,0.3333333333333333,2
38246,9891,Kits,6,1,0.16666666666666666,5
38247,9891,Stuff Packs,6,4,0.6666666666666666,2
38248,9892,Expansion Packs,16,0,0.0,16
38249,9892,Game Packs,12,0,0.0,12
38250,9892,Kits,29,1,0.034482758620689655,28
38251,9892,Stuff Packs,14,1,0.07142857142857142,13
38252,9893,Expansion Packs,15,0,0.0,15
38253,9893,Game Packs,11,0,0.0,11
38254,9893,Kits,2,0,0.0,2
38255,9893,Stuff Packs,19,0,0.0,19
38256,9894,Expansion Packs,13,0,0.0,13
38257,9894,Game Packs,6,0,0.0,6
38258,9894,Kits,2,1,0.5,1
38259,9894,Stuff Packs,5,2,0.4,3
38260,9895,Expansion Packs,5,0,0.0,5
38261,9895,Game Packs,3,0,0.0,3
38262,9895,Stuff Packs,5,0,0.0,5
38263,9896,Expansion Packs,2,0,0.0,2
38264,9896,Stuff Packs,2,0,0.0,2
38265,9897,Expansion Packs,9,0,0.0,9
38266,9897,Game Packs,2,0,0.0,2
38267,9897,Kits,2,2,1.0,0
38268,9897,Stuff Packs,5,3,0.6,2
38269,9898,Expansion Packs,15,0,0.0,15
38270,9898,Game Packs,8,1,0.125,7
38271,9898,Kits,12,2,0.16666666666666666,10
38272,9898,Stuff Packs,17,2,0.11764705882352941,15
38273,9899,Expansion Packs,16,0,0.0,16
38274,9899,Game Packs,6,0,0.0,6
38275,9899,Kits,25,1,0.04,24
38276,9899,Stuff Packs,14,2,0.14285714285714285,12
38277,9900,Expansion Packs,12,0,0.0,12
38278,9900,Game Packs,6,0,0.0,6
38279,9900,Kits,2,1,0.5,1
38280,9900,Stuff Packs,3,1,0.3333333333333333,2
38281,9901,Expansion Packs,3,0,0.0,3
38282,9901,Game Packs,1,1,1.0,0
38283,9901,Stuff Packs,3,3,1.0,0
38284,9902,Expansion Packs,16,0,0.0,16
38285,9902,Game Packs,12,0,0.0,12
38286,9902,Kits,33,1,0.030303030303030304,32
38287,9902,Stuff Packs,20,0,0.0,20
38288,9903,Expansion Packs,16,0,0.0,16
38289,9903,Game Packs,11,0,0.0,11
38290,9903,Kits,21,1,0.047619047619047616,20
38291,9903,Stuff Packs,20,0,0.0,20
38292,9904,Expansion Packs,12,0,0.0,12
38293,9904,Game Packs,5,0,0.0,5
38294,9904,Kits,2,2,1.0,0
38295,9904,Stuff Packs,6,2,0.3333333333333333,4
38296,9905,Expansion Packs,12,1,0.08333333333333333,11
38297,9905,Game Packs,4,0,0.0,4
38298,9905,Stuff Packs,1,0,0.0,1
38299,9906,Expansion Packs,11,0,0.0,11
38300,9906,Game Packs,7,1,0.14285714285714285,6
38301,9906,Kits,2,2,1.0,0
38302,9906,Stuff Packs,10,3,0.3,7
38303,9907,Expansion Packs,3,0,0.0,3
38304,9907,Game Packs,2,0,0.0,2
38305,9907,Kits,4,1,0.25,3
38306,9907,Stuff Packs,3,1,0.3333333333333333,2
38307,9908,Expansion Packs,16,0,0.0,16
38308,9908,Game Packs,12,0,0.0,12
38309,9908,Kits,33,0,0.0,33
38310,9908,Stuff Packs,20,0,0.0,20
38311,9909,Expansion Packs,12,0,0.0,12
38312,9909,Game Packs,8,0,0.0,8
38313,9909,Kits,1,1,1.0,0
38314,9909,Stuff Packs,6,0,0.0,6
38315,9910,Expansion Packs,16,0,0.0,16
38316,9910,Game Packs,12,0,0.0,12
38317,9910,Kits,33,0,0.0,33
38318,9910,Stuff Packs,20,0,0.0,20
38319,9911,Expansion Packs,16,0,0.0,16
38320,9911,Game Packs,12,0,0.0,12
38321,9911,Kits,20,1,0.05,19
38322,9911,Stuff Packs,20,0,0.0,20
38323,9912,Expansion Packs,9,0,0.0,9
38324,9912,Game Packs,9,1,0.1111111111111111,8
38325,9912,Kits,3,3,1.0,0
38326,9912,Stuff Packs,11,3,0.2727272727272727,8
38327,9913,Expansion Packs,16,0,0.0,16
38328,9913,Game Packs,12,0,0.0,12
38329,9913,Kits,16,1,0.0625,15
38330,9913,Stuff Packs,18,0,0.0,18
38331,9914,Expansion Packs,16,0,0.0,16
38332,9914,Game Packs,11,0,0.0,11
38333,9914,Kits,20,0,0.0,20
38334,9914,Stuff Packs,18,0,0.0,18
38335,9915,Expansion Packs,16,0,0.0,16
38336,9915,Game Packs,12,0,0.0,12
38337,9915,Kits,33,0,0.0,33
38338,9915,Stuff Packs,20,0,0.0,20
38339,9916,Expansion Packs,3,0,0.0,3
38340,9916,Game Packs,1,1,1.0,0
38341,9916,Kits,1,1,1.0,0
38342,9916,Stuff Packs,3,0,0.0,3
38343,9917,Expansion Packs,10,0,0.0,10
38344,9917,Game Packs,8,0,0.0,8
38345,9917,Kits,1,1,1.0,0
38346,9917,Stuff Packs,13,0,0.0,13
38347,9918,Expansion Packs,5,0,0.0,5
38348,9918,Game Packs,4,0,0.0,4
38349,9918,Kits,1,1,1.0,0
38350,9918,Stuff Packs,4,1,0.25,3
38351,9919,Expansion Packs,7,0,0.0,7
38352,9919,Game Packs,3,0,0.0,3
38353,9919,Stuff Packs,3,1,0.3333333333333333,2
38354,9920,Expansion Packs,16,0,0.0,16
38355,9920,Game Packs,12,0,0.0,12
38356,9920,Kits,6,1,0.16666666666666666,5
38357,9920,Stuff Packs,20,1,0.05,19
38358,9921,Expansion Packs,14,0,0.0,14
38359,9921,Game Packs,6,2,0.3333333333333333,4
38360,9921,Kits,4,1,0.25,3
38361,9921,Stuff Packs,16,3,0.1875,13
38362,9922,Expansion Packs,6,0,0.0,6
38363,9922,Game Packs,1,0,0.0,1
38364,9922,Kits,1,1,1.0,0
38365,9922,Stuff Packs,4,2,0.5,2
38366,9923,Expansion Packs,9,0,0.0,9
38367,9923,Game Packs,3,0,0.0,3
38368,9923,Stuff Packs,5,0,0.0,5
38369,9924,Expansion Packs,9,0,0.0,9
38370,9924,Game Packs,7,0,0.0,7
38371,9924,Stuff Packs,8,1,0.125,7
38372,9925,Expansion Packs,16,0,0.0,16
38373,9925,Game Packs,12,0,0.0,12
38374,9925,Kits,3,1,0.3333333333333333,2
38375,9926,Expansion Packs,14,0,0.0,14
38376,9926,Game Packs,10,0,0.0,10
38377,9926,Kits,2,0,0.0,2
38378,9926,Stuff Packs,5,0,0.0,5
38379,9927,Expansion Packs,16,0,0.0,16
38380,9927,Game Packs,11,0,0.0,11
38381,9927,Kits,13,2,0.15384615384615385,11
38382,9927,Stuff Packs,20,1,0.05,19
38383,9928,Expansion Packs,12,0,0.0,12
38384,9928,Game Packs,4,0,0.0,4
38385,9928,Kits,1,1,1.0,0
38386,9928,Stuff Packs,4,0,0.0,4
38387,9929,Expansion Packs,13,0,0.0,13
38388,9929,Game Packs,9,0,0.0,9
38389,9929,Kits,9,1,0.1111111111111111,8
38390,9929,Stuff Packs,10,2,0.2,8
38391,9930,Expansion Packs,16,0,0.0,16
38392,9930,Game Packs,12,0,0.0,12
38393,9930,Kits,15,1,0.06666666666666667,14
38394,9930,Stuff Packs,20,1,0.05,19
38395,9931,Expansion Packs,3,0,0.0,3
38396,9931,Game Packs,5,1,0.2,4
38397,9931,Kits,4,3,0.75,1
38398,9931,Stuff Packs,6,3,0.5,3
38399,9932,Expansion Packs,15,0,0.0,15
38400,9932,Game Packs,5,0,0.0,5
38401,9932,Kits,1,1,1.0,0
38402,9932,Stuff Packs,8,3,0.375,5
38403,9933,Expansion Packs,15,0,0.0,15
38404,9933,Game Packs,8,0,0.0,8
38405,9933,Kits,2,0,0.0,2
38406,9933,Stuff Packs,11,0,0.0,11
38407,9934,Expansion Packs,15,0,0.0,15
38408,9934,Game Packs,11,0,0.0,11
38409,9934,Kits,11,2,0.18181818181818182,9
38410,9934,Stuff Packs,20,0,0.0,20
38411,9935,Expansion Packs,16,0,0.0,16
38412,9935,Game Packs,12,0,0.0,12
38413,9935,Kits,33,0,0.0,33
38414,9935,Stuff Packs,20,0,0.0,20
38415,9936,Expansion Packs,5,0,0.0,5
38416,9936,Game Packs,1,0,0.0,1
38417,9936,Kits,7,0,0.0,7
38418,9936,Stuff Packs,6,1,0.16666666666666666,5
38419,9937,Expansion Packs,16,13,0.8125,3
38420,9937,Game Packs,11,8,0.7272727272727273,3
38421,9937,Kits,7,2,0.2857142857142857,5
38422,9937,Stuff Packs,13,6,0.46153846153846156,7
38423,9938,Expansion Packs,14,0,0.0,14
38424,9938,Game Packs,9,0,0.0,9
38425,9938,Kits,10,2,0.2,8
38426,9938,Stuff Packs,11,0,0.0,11
38427,9939,Expansion Packs,16,0,0.0,16
38428,9939,Game Packs,12,0,0.0,12
38429,9939,Kits,26,1,0.038461538461538464,25
38430,9939,Stuff Packs,20,0,0.0,20
38431,9940,Expansion Packs,5,0,0.0,5
38432,9940,Game Packs,3,0,0.0,3
38433,9940,Stuff Packs,5,3,0.6,2
38434,9941,Expansion Packs,16,0,0.0,16
38435,9941,Game Packs,11,0,0.0,11
38436,9941,Kits,33,1,0.030303030303030304,32
38437,9941,Stuff Packs,20,0,0.0,20
38438,9942,Expansion Packs,15,0,0.0,15
38439,9942,Game Packs,10,0,0.0,10
38440,9942,Kits,4,0,0.0,4
38441,9942,Stuff Packs,15,0,0.0,15
38442,9943,Expansion Packs,2,1,0.5,1
38443,9943,Stuff Packs,3,1,0.3333333333333333,2
38444,9944,Expansion Packs,16,0,0.0,16
38445,9944,Game Packs,11,0,0.0,11
38446,9944,Kits,12,0,0.0,12
38447,9944,Stuff Packs,20,0,0.0,20
38448,9945,Expansion Packs,15,0,0.0,15
38449,9945,Game Packs,10,0,0.0,10
38450,9945,Kits,22,6,0.2727272727272727,16
38451,9945,Stuff Packs,20,5,0.25,15
38452,9946,Expansion Packs,10,0,0.0,10
38453,9946,Game Packs,4,0,0.0,4
38454,9946,Kits,2,1,0.5,1
38455,9946,Stuff Packs,5,2,0.4,3
38456,9947,Expansion Packs,4,0,0.0,4
38457,9947,Game Packs,2,0,0.0,2
38458,9947,Stuff Packs,2,1,0.5,1
38459,9948,Expansion Packs,11,0,0.0,11
38460,9948,Game Packs,7,0,0.0,7
38461,9948,Kits,27,1,0.037037037037037035,26
38462,9948,Stuff Packs,14,0,0.0,14
38463,9949,Expansion Packs,16,0,0.0,16
38464,9949,Game Packs,12,0,0.0,12
38465,9949,Kits,33,1,0.030303030303030304,32
38466,9949,Stuff Packs,20,0,0.0,20
38467,9950,Expansion Packs,15,0,0.0,15
38468,9950,Game Packs,7,0,0.0,7
38469,9950,Kits,22,0,0.0,22
38470,9950,Stuff Packs,14,0,0.0,14
38471,9951,Expansion Packs,13,0,0.0,13
38472,9951,Game Packs,9,0,0.0,9
38473,9951,Kits,1,0,0.0,1
38474,9951,Stuff Packs,8,1,0.125,7
38475,9952,Expansion Packs,11,1,0.09090909090909091,10
38476,9952,Game Packs,2,0,0.0,2
38477,9952,Kits,2,2,1.0,0
38478,9952,Stuff Packs,6,0,0.0,6
38479,9953,Expansion Packs,13,0,0.0,13
38480,9953,Game Packs,8,0,0.0,8
38481,9953,Kits,6,2,0.3333333333333333,4
38482,9953,Stuff Packs,12,2,0.16666666666666666,10
38483,9954,Expansion Packs,15,0,0.0,15
38484,9954,Game Packs,10,1,0.1,9
38485,9954,Kits,11,1,0.09090909090909091,10
38486,9954,Stuff Packs,12,2,0.16666666666666666,10
38487,9955,Expansion Packs,12,0,0.0,12
38488,9955,Game Packs,10,0,0.0,10
38489,9955,Kits,3,2,0.6666666666666666,1
38490,9955,Stuff Packs,17,0,0.0,17
38491,9956,Expansion Packs,5,0,0.0,5
38492,9956,Game Packs,5,0,0.0,5
38493,9956,Stuff Packs,1,0,0.0,1
38494,9957,Kits,1,0,0.0,1
38495,9958,Expansion Packs,16,0,0.0,16
38496,9958,Game Packs,12,1,0.08333333333333333,11
38497,9958,Kits,33,7,0.21212121212121213,26
38498,9958,Stuff Packs,20,4,0.2,16
38499,9959,Expansion Packs,15,0,0.0,15
38500,9959,Game Packs,7,0,0.0,7
38501,9959,Kits,15,1,0.06666666666666667,14
38502,9959,Stuff Packs,12,1,0.08333333333333333,11
38503,9960,Expansion Packs,4,0,0.0,4
38504,9960,Game Packs,5,0,0.0,5
38505,9960,Kits,3,3,1.0,0
38506,9960,Stuff Packs,8,4,0.5,4
38507,9961,Expansion Packs,16,0,0.0,16
38508,9961,Game Packs,11,0,0.0,11
38509,9961,Kits,33,1,0.030303030303030304,32
38510,9961,Stuff Packs,20,0,0.0,20
38511,9962,Expansion Packs,7,0,0.0,7
38512,9962,Game Packs,5,1,0.2,4
38513,9962,Stuff Packs,6,2,0.3333333333333333,4
38514,9963,Expansion Packs,15,0,0.0,15
38515,9963,Game Packs,10,0,0.0,10
38516,9963,Kits,12,1,0.08333333333333333,11
38517,9963,Stuff Packs,10,2,0.2,8
38518,9964,Expansion Packs,8,0,0.0,8
38519,9964,Game Packs,3,1,0.3333333333333333,2
38520,9964,Kits,7,2,0.2857142857142857,5
38521,9964,Stuff Packs,8,4,0.5,4
38522,9965,Expansion Packs,16,0,0.0,16
38523,9965,Game Packs,12,0,0.0,12
38524,9965,Kits,33,0,0.0,33
38525,9965,Stuff Packs,20,0,0.0,20
38526,9966,Expansion Packs,16,0,0.0,16
38527,9966,Game Packs,12,0,0.0,12
38528,9966,Kits,33,1,0.030303030303030304,32
38529,9966,Stuff Packs,20,0,0.0,20
38530,9967,Expansion Packs,8,0,0.0,8
38531,9967,Game Packs,5,0,0.0,5
38532,9967,Kits,2,2,1.0,0
38533,9967,Stuff Packs,5,1,0.2,4
38534,9968,Expansion Packs,6,0,0.0,6
38535,9968,Game Packs,2,0,0.0,2
38536,9968,Kits,1,0,0.0,1
38537,9968,Stuff Packs,1,0,0.0,1
38538,9969,Expansion Packs,5,0,0.0,5
38539,9969,Game Packs,3,0,0.0,3
38540,9969,Stuff Packs,5,0,0.0,5
38541,9970,Expansion Packs,15,0,0.0,15
38542,9970,Game Packs,9,0,0.0,9
38543,9970,Kits,10,0,0.0,10
38544,9970,Stuff Packs,12,0,0.0,12
38545,9971,Expansion Packs,14,1,0.07142857142857142,13
38546,9971,Game Packs,10,0,0.0,10
38547,9971,Kits,2,0,0.0,2
38548,9971,Stuff Packs,7,1,0.14285714285714285,6
38549,9972,Expansion Packs,7,0,0.0,7
38550,9972,Game Packs,4,1,0.25,3
38551,9972,Kits,11,2,0.18181818181818182,9
38552,9972,Stuff Packs,7,2,0.2857142857142857,5
38553,9973,Expansion Packs,13,0,0.0,13
38554,9973,Game Packs,5,0,0.0,5
38555,9973,Kits,2,2,1.0,0
38556,9973,Stuff Packs,6,0,0.0,6
38557,9974,Expansion Packs,16,0,0.0,16
38558,9974,Game Packs,12,0,0.0,12
38559,9974,Kits,33,0,0.0,33
38560,9974,Stuff Packs,20,0,0.0,20
38561,9975,Expansion Packs,3,0,0.0,3
38562,9975,Game Packs,3,0,0.0,3
38563,9975,Stuff Packs,3,0,0.0,3
38564,9976,Expansion Packs,16,0,0.0,16
38565,9976,Game Packs,12,0,0.0,12
38566,9976,Kits,33,1,0.030303030303030304,32
38567,9976,Stuff Packs,20,1,0.05,19
38568,9977,Expansion Packs,15,0,0.0,15
38569,9977,Game Packs,12,0,0.0,12
38570,9977,Kits,15,0,0.0,15
38571,9977,Stuff Packs,20,0,0.0,20
38572,9978,Expansion Packs,14,0,0.0,14
38573,9978,Game Packs,7,0,0.0,7
38574,9978,Kits,1,1,1.0,0
38575,9978,Stuff Packs,7,0,0.0,7
38576,9979,Expansion Packs,13,0,0.0,13
38577,9979,Game Packs,6,0,0.0,6
38578,9979,Kits,3,2,0.6666666666666666,1
38579,9979,Stuff Packs,10,2,0.2,8
38580,9980,Expansion Packs,15,0,0.0,15
38581,9980,Game Packs,10,0,0.0,10
38582,9980,Kits,1,1,1.0,0
38583,9980,Stuff Packs,11,0,0.0,11
38584,9981,Expansion Packs,2,0,0.0,2
38585,9981,Game Packs,2,1,0.5,1
38586,9981,Kits,2,2,1.0,0
38587,9981,Stuff Packs,5,4,0.8,1
38588,9982,Expansion Packs,16,1,0.0625,15
38589,9982,Game Packs,10,0,0.0,10
38590,9982,Kits,5,0,0.0,5
38591,9982,Stuff Packs,16,0,0.0,16
38592,9983,Expansion Packs,16,0,0.0,16
38593,9983,Game Packs,12,0,0.0,12
38594,9983,Kits,33,1,0.030303030303030304,32
38595,9983,Stuff Packs,20,0,0.0,20
38596,9984,Expansion Packs,6,0,0.0,6
38597,9984,Game Packs,4,0,0.0,4
38598,9984,Kits,3,0,0.0,3
38599,9984,Stuff Packs,4,0,0.0,4
38600,9985,Expansion Packs,13,0,0.0,13
38601,9985,Game Packs,5,1,0.2,4
38602,9985,Kits,3,3,1.0,0
38603,9985,Stuff Packs,6,2,0.3333333333333333,4
38604,9986,Expansion Packs,13,0,0.0,13
38605,9986,Game Packs,5,1,0.2,4
38606,9986,Kits,4,1,0.25,3
38607,9986,Stuff Packs,14,3,0.21428571428571427,11
38608,9987,Expansion Packs,16,0,0.0,16
38609,9987,Game Packs,12,0,0.0,12
38610,9987,Kits,27,2,0.07407407407407407,25
38611,9987,Stuff Packs,20,0,0.0,20
38612,9988,Expansion Packs,3,0,0.0,3
38613,9988,Game Packs,2,1,0.5,1
38614,9988,Stuff Packs,4,3,0.75,1
38615,9989,Expansion Packs,15,0,0.0,15
38616,9989,Game Packs,9,0,0.0,9
38617,9989,Kits,7,1,0.14285714285714285,6
38618,9989,Stuff Packs,12,1,0.08333333333333333,11
38619,9990,Expansion Packs,16,0,0.0,16
38620,9990,Game Packs,11,0,0.0,11
38621,9990,Kits,19,1,0.05263157894736842,18
38622,9990,Stuff Packs,20,0,0.0,20
38623,9991,Expansion Packs,12,0,0.0,12
38624,9991,Game Packs,5,1,0.2,4
38625,9991,Kits,7,3,0.42857142857142855,4
38626,9991,Stuff Packs,7,4,0.5714285714285714,3
38627,9992,Expansion Packs,16,0,0.0,16
38628,9992,Game Packs,11,0,0.0,11
38629,9992,Kits,12,0,0.0,12
38630,9992,Stuff Packs,17,1,0.058823529411764705,16
38631,9993,Expansion Packs,16,0,0.0,16
38632,9993,Game Packs,12,0,0.0,12
38633,9993,Kits,27,3,0.1111111111111111,24
38634,9993,Stuff Packs,20,1,0.05,19
38635,9994,Expansion Packs,8,0,0.0,8
38636,9994,Game Packs,8,0,0.0,8
38637,9994,Kits,3,3,1.0,0
38638,9994,Stuff Packs,12,4,0.3333333333333333,8
38639,9995,Expansion Packs,14,0,0.0,14
38640,9995,Game Packs,5,1,0.2,4
38641,9995,Kits,4,0,0.0,4
38642,9995,Stuff Packs,13,1,0.07692307692307693,12
38643,9996,Expansion Packs,16,0,0.0,16
38644,9996,Game Packs,12,1,0.08333333333333333,11
38645,9996,Kits,18,1,0.05555555555555555,17
38646,9996,Stuff Packs,17,1,0.058823529411764705,16
38647,9997,Expansion Packs,16,0,0.0,16
38648,9997,Game Packs,12,0,0.0,12
38649,9997,Kits,33,0,0.0,33
38650,9997,Stuff Packs,20,0,0.0,20
38651,9998,Expansion Packs,10,0,0.0,10
38652,9998,Game Packs,5,0,0.0,5
38653,9998,Kits,1,1,1.0,0
38654,9998,Stuff Packs,7,3,0.42857142857142855,4
38655,9999,Expansion Packs,13,0,0.0,13
38656,9999,Game Packs,9,0,0.0,9
38657,9999,Kits,8,2,0.25,6
38658,9999,Stuff Packs,11,1,0.09090909090909091,10
38659,10000,Expansion Packs,12,0,0.0,12
38660,10000,Game Packs,4,0,0.0,4
38661,10000,Kits,1,1,1.0,0
38662,10000,Stuff Packs,7,3,0.42857142857142855,4
38663,10001,Expansion Packs,13,0,0.0,13
38664,10001,Game Packs,6,0,0.0,6
38665,10001,Kits,3,0,0.0,3
38666,10001,Stuff Packs,9,0,0.0,9
38667,10002,Expansion Packs,14,0,0.0,14
38668,10002,Game Packs,9,0,0.0,9
38669,10002,Kits,3,2,0.6666666666666666,1
38670,10002,Stuff Packs,14,1,0.07142857142857142,13
38671,10003,Expansion Packs,16,0,0.0,16
38672,10003,Game Packs,12,0,0.0,12
38673,10003,Kits,33,1,0.030303030303030304,32
38674,10003,Stuff Packs,20,0,0.0,20
38675,10004,Expansion Packs,15,0,0.0,15
38676,10004,Game Packs,10,0,0.0,10
38677,10004,Kits,12,2,0.16666666666666666,10
38678,10004,Stuff Packs,12,3,0.25,9
38679,10005,Expansion Packs,12,0,0.0,12
38680,10005,Game Packs,7,0,0.0,7
38681,10005,Kits,6,0,0.0,6
38682,10005,Stuff Packs,14,2,0.14285714285714285,12
38683,10006,Expansion Packs,4,0,0.0,4
38684,10006,Game Packs,3,0,0.0,3
38685,10006,Kits,3,0,0.0,3
38686,10006,Stuff Packs,3,0,0.0,3
38687,10007,Expansion Packs,3,0,0.0,3
38688,10007,Game Packs,1,0,0.0,1
38689,10007,Stuff Packs,1,0,0.0,1
38690,10008,Expansion Packs,15,0,0.0,15
38691,10008,Game Packs,12,0,0.0,12
38692,10008,Kits,12,0,0.0,12
38693,10008,Stuff Packs,20,0,0.0,20
38694,10009,Expansion Packs,5,0,0.0,5
38695,10009,Game Packs,3,1,0.3333333333333333,2
38696,10009,Kits,3,3,1.0,0
38697,10009,Stuff Packs,5,4,0.8,1
38698,10010,Expansion Packs,5,0,0.0,5
38699,10010,Game Packs,2,1,0.5,1
38700,10010,Kits,2,2,1.0,0
38701,10010,Stuff Packs,5,4,0.8,1
38702,10011,Expansion Packs,13,0,0.0,13
38703,10011,Game Packs,7,0,0.0,7
38704,10011,Stuff Packs,9,2,0.2222222222222222,7
38705,10012,Expansion Packs,15,0,0.0,15
38706,10012,Game Packs,10,1,0.1,9
38707,10012,Kits,14,4,0.2857142857142857,10
38708,10012,Stuff Packs,16,3,0.1875,13
38709,10013,Expansion Packs,15,0,0.0,15
38710,10013,Game Packs,11,0,0.0,11
38711,10013,Kits,19,0,0.0,19
38712,10013,Stuff Packs,20,0,0.0,20
38713,10014,Expansion Packs,16,0,0.0,16
38714,10014,Game Packs,12,0,0.0,12
38715,10014,Kits,32,2,0.0625,30
38716,10014,Stuff Packs,20,2,0.1,18
38717,10015,Expansion Packs,16,0,0.0,16
38718,10015,Game Packs,12,0,0.0,12
38719,10015,Kits,33,1,0.030303030303030304,32
38720,10015,Stuff Packs,20,0,0.0,20
38721,10016,Expansion Packs,8,0,0.0,8
38722,10016,Game Packs,3,0,0.0,3
38723,10016,Kits,4,0,0.0,4
38724,10016,Stuff Packs,4,0,0.0,4
38725,10017,Expansion Packs,16,0,0.0,16
38726,10017,Game Packs,12,0,0.0,12
38727,10017,Kits,21,0,0.0,21
38728,10017,Stuff Packs,20,0,0.0,20
38729,10018,Expansion Packs,16,0,0.0,16
38730,10018,Game Packs,12,0,0.0,12
38731,10018,Kits,17,1,0.058823529411764705,16
38732,10018,Stuff Packs,19,0,0.0,19
38733,10019,Expansion Packs,13,0,0.0,13
38734,10019,Game Packs,7,0,0.0,7
38735,10019,Kits,3,2,0.6666666666666666,1
38736,10019,Stuff Packs,9,4,0.4444444444444444,5
38737,10020,Expansion Packs,16,0,0.0,16
38738,10020,Game Packs,11,0,0.0,11
38739,10020,Kits,5,0,0.0,5
38740,10020,Stuff Packs,20,0,0.0,20
38741,10021,Expansion Packs,11,0,0.0,11
38742,10021,Game Packs,6,1,0.16666666666666666,5
38743,10021,Kits,2,2,1.0,0
38744,10021,Stuff Packs,11,2,0.18181818181818182,9
38745,10022,Expansion Packs,16,0,0.0,16
38746,10022,Game Packs,12,0,0.0,12
38747,10022,Stuff Packs,20,0,0.0,20
38748,10023,Expansion Packs,16,0,0.0,16
38749,10023,Game Packs,12,1,0.08333333333333333,11
38750,10023,Kits,33,1,0.030303030303030304,32
38751,10023,Stuff Packs,20,0,0.0,20
38752,10024,Expansion Packs,12,0,0.0,12
38753,10024,Game Packs,6,0,0.0,6
38754,10024,Kits,9,0,0.0,9
38755,10024,Stuff Packs,9,3,0.3333333333333333,6
38756,10025,Expansion Packs,16,0,0.0,16
38757,10025,Game Packs,12,0,0.0,12
38758,10025,Kits,33,1,0.030303030303030304,32
38759,10025,Stuff Packs,20,0,0.0,20
38760,10026,Expansion Packs,8,0,0.0,8
38761,10026,Game Packs,5,0,0.0,5
38762,10026,Kits,3,2,0.6666666666666666,1
38763,10026,Stuff Packs,9,2,0.2222222222222222,7
38764,10027,Expansion Packs,16,0,0.0,16
38765,10027,Game Packs,12,0,0.0,12
38766,10027,Kits,24,1,0.041666666666666664,23
38767,10027,Stuff Packs,20,0,0.0,20
38768,10028,Expansion Packs,10,0,0.0,10
38769,10028,Game Packs,5,2,0.4,3
38770,10028,Stuff Packs,7,4,0.5714285714285714,3
38771,10029,Expansion Packs,13,0,0.0,13
38772,10029,Game Packs,10,0,0.0,10
38773,10029,Kits,1,0,0.0,1
38774,10029,Stuff Packs,11,0,0.0,11
38775,10030,Expansion Packs,13,0,0.0,13
38776,10030,Game Packs,8,0,0.0,8
38777,10030,Kits,9,1,0.1111111111111111,8
38778,10030,Stuff Packs,11,1,0.09090909090909091,10
38779,10031,Expansion Packs,10,0,0.0,10
38780,10031,Game Packs,5,0,0.0,5
38781,10031,Kits,2,1,0.5,1
38782,10031,Stuff Packs,6,3,0.5,3
38783,10032,Expansion Packs,10,0,0.0,10
38784,10032,Game Packs,1,0,0.0,1
38785,10032,Kits,7,1,0.14285714285714285,6
38786,10032,Stuff Packs,7,3,0.42857142857142855,4
38787,10033,Expansion Packs,16,1,0.0625,15
38788,10033,Game Packs,12,0,0.0,12
38789,10033,Kits,33,0,0.0,33
38790,10033,Stuff Packs,20,0,0.0,20
38791,10034,Expansion Packs,15,0,0.0,15
38792,10034,Game Packs,11,0,0.0,11
38793,10034,Kits,17,0,0.0,17
38794,10034,Stuff Packs,20,0,0.0,20
38795,10035,Expansion Packs,13,1,0.07692307692307693,12
38796,10035,Game Packs,9,0,0.0,9
38797,10035,Kits,2,2,1.0,0
38798,10035,Stuff Packs,19,0,0.0,19
38799,10036,Expansion Packs,15,0,0.0,15
38800,10036,Game Packs,8,0,0.0,8
38801,10036,Kits,5,1,0.2,4
38802,10036,Stuff Packs,11,1,0.09090909090909091,10
38803,10037,Expansion Packs,16,0,0.0,16
38804,10037,Game Packs,12,0,0.0,12
38805,10037,Kits,33,0,0.0,33
38806,10037,Stuff Packs,20,0,0.0,20
38807,10038,Expansion Packs,5,1,0.2,4
38808,10038,Stuff Packs,1,1,1.0,0
38809,10039,Expansion Packs,16,1,0.0625,15
38810,10039,Game Packs,11,0,0.0,11
38811,10039,Kits,16,1,0.0625,15
38812,10039,Stuff Packs,19,0,0.0,19
38813,10040,Expansion Packs,7,0,0.0,7
38814,10040,Game Packs,4,0,0.0,4
38815,10040,Kits,7,2,0.2857142857142857,5
38816,10040,Stuff Packs,10,3,0.3,7
38817,10041,Expansion Packs,15,0,0.0,15
38818,10041,Game Packs,11,0,0.0,11
38819,10041,Kits,8,1,0.125,7
38820,10041,Stuff Packs,10,0,0.0,10
38821,10042,Expansion Packs,12,0,0.0,12
38822,10042,Game Packs,8,1,0.125,7
38823,10042,Kits,1,1,1.0,0
38824,10042,Stuff Packs,10,0,0.0,10
38825,10043,Expansion Packs,11,0,0.0,11
38826,10043,Game Packs,10,0,0.0,10
38827,10043,Kits,3,2,0.6666666666666666,1
38828,10043,Stuff Packs,17,3,0.17647058823529413,14
38829,10044,Expansion Packs,16,0,0.0,16
38830,10044,Game Packs,11,0,0.0,11
38831,10044,Kits,20,0,0.0,20
38832,10044,Stuff Packs,19,0,0.0,19
38833,10045,Expansion Packs,15,0,0.0,15
38834,10045,Game Packs,12,0,0.0,12
38835,10045,Kits,14,1,0.07142857142857142,13
38836,10045,Stuff Packs,20,0,0.0,20
38837,10046,Expansion Packs,16,0,0.0,16
38838,10046,Game Packs,12,0,0.0,12
38839,10046,Kits,33,0,0.0,33
38840,10046,Stuff Packs,20,0,0.0,20
38841,10047,Expansion Packs,6,0,0.0,6
38842,10047,Game Packs,2,0,0.0,2
38843,10047,Kits,2,2,1.0,0
38844,10047,Stuff Packs,6,3,0.5,3
38845,10048,Expansion Packs,15,0,0.0,15
38846,10048,Game Packs,10,3,0.3,7
38847,10048,Kits,3,1,0.3333333333333333,2
38848,10048,Stuff Packs,12,5,0.4166666666666667,7
38849,10049,Expansion Packs,16,0,0.0,16
38850,10049,Game Packs,12,0,0.0,12
38851,10049,Kits,33,0,0.0,33
38852,10049,Stuff Packs,20,0,0.0,20
38853,10050,Expansion Packs,5,0,0.0,5
38854,10050,Game Packs,5,0,0.0,5
38855,10050,Stuff Packs,7,6,0.8571428571428571,1
38856,10051,Expansion Packs,16,0,0.0,16
38857,10051,Game Packs,10,0,0.0,10
38858,10051,Kits,11,0,0.0,11
38859,10051,Stuff Packs,10,0,0.0,10
38860,10052,Expansion Packs,13,0,0.0,13
38861,10052,Game Packs,6,0,0.0,6
38862,10052,Kits,6,2,0.3333333333333333,4
38863,10052,Stuff Packs,7,2,0.2857142857142857,5
38864,10053,Expansion Packs,16,0,0.0,16
38865,10053,Game Packs,11,0,0.0,11
38866,10053,Kits,29,1,0.034482758620689655,28
38867,10053,Stuff Packs,20,1,0.05,19
38868,10054,Expansion Packs,14,7,0.5,7
38869,10054,Game Packs,7,3,0.42857142857142855,4
38870,10054,Stuff Packs,6,1,0.16666666666666666,5
38871,10055,Expansion Packs,15,0,0.0,15
38872,10055,Game Packs,9,0,0.0,9
38873,10055,Kits,21,1,0.047619047619047616,20
38874,10055,Stuff Packs,17,0,0.0,17
38875,10056,Expansion Packs,2,0,0.0,2
38876,10056,Game Packs,1,1,1.0,0
38877,10056,Kits,3,3,1.0,0
38878,10056,Stuff Packs,4,4,1.0,0
38879,10057,Expansion Packs,14,0,0.0,14
38880,10057,Game Packs,10,0,0.0,10
38881,10057,Kits,7,1,0.14285714285714285,6
38882,10057,Stuff Packs,16,1,0.0625,15
38883,10058,Expansion Packs,9,0,0.0,9
38884,10058,Game Packs,2,0,0.0,2
38885,10058,Kits,2,2,1.0,0
38886,10058,Stuff Packs,8,4,0.5,4
38887,10059,Expansion Packs,15,0,0.0,15
38888,10059,Game Packs,10,2,0.2,8
38889,10059,Kits,30,3,0.1,27
38890,10059,Stuff Packs,20,4,0.2,16
38891,10060,Expansion Packs,15,0,0.0,15
38892,10060,Game Packs,6,0,0.0,6
38893,10060,Kits,2,0,0.0,2
38894,10060,Stuff Packs,16,1,0.0625,15
38895,10061,Expansion Packs,16,0,0.0,16
38896,10061,Game Packs,11,0,0.0,11
38897,10061,Kits,15,0,0.0,15
38898,10061,Stuff Packs,16,1,0.0625,15
38899,10062,Expansion Packs,16,0,0.0,16
38900,10062,Game Packs,12,0,0.0,12
38901,10062,Kits,33,1,0.030303030303030304,32
38902,10062,Stuff Packs,20,0,0.0,20
38903,10063,Expansion Packs,16,0,0.0,16
38904,10063,Game Packs,12,0,0.0,12
38905,10063,Kits,31,0,0.0,31
38906,10063,Stuff Packs,20,1,0.05,19
38907,10064,Expansion Packs,13,1,0.07692307692307693,12
38908,10064,Game Packs,3,0,0.0,3
38909,10064,Kits,7,0,0.0,7
38910,10064,Stuff Packs,6,0,0.0,6
38911,10065,Expansion Packs,11,0,0.0,11
38912,10065,Game Packs,5,1,0.2,4
38913,10065,Kits,3,1,0.3333333333333333,2
38914,10065,Stuff Packs,7,1,0.14285714285714285,6
38915,10066,Expansion Packs,13,0,0.0,13
38916,10066,Game Packs,7,0,0.0,7
38917,10066,Kits,2,0,0.0,2
38918,10066,Stuff Packs,4,0,0.0,4
38919,10067,Expansion Packs,13,0,0.0,13
38920,10067,Game Packs,4,0,0.0,4
38921,10067,Kits,2,0,0.0,2
38922,10067,Stuff Packs,6,2,0.3333333333333333,4
38923,10068,Expansion Packs,16,0,0.0,16
38924,10068,Game Packs,11,0,0.0,11
38925,10068,Kits,25,0,0.0,25
38926,10068,Stuff Packs,19,0,0.0,19
38927,10069,Expansion Packs,16,4,0.25,12
38928,10069,Game Packs,12,1,0.08333333333333333,11
38929,10069,Kits,22,9,0.4090909090909091,13
38930,10069,Stuff Packs,17,1,0.058823529411764705,16
38931,10070,Expansion Packs,16,0,0.0,16
38932,10070,Game Packs,12,0,0.0,12
38933,10070,Kits,33,1,0.030303030303030304,32
38934,10070,Stuff Packs,20,2,0.1,18
38935,10071,Expansion Packs,13,0,0.0,13
38936,10071,Game Packs,9,0,0.0,9
38937,10071,Kits,6,0,0.0,6
38938,10071,Stuff Packs,12,0,0.0,12
38939,10072,Expansion Packs,16,0,0.0,16
38940,10072,Game Packs,12,0,0.0,12
38941,10072,Kits,22,1,0.045454545454545456,21
38942,10072,Stuff Packs,20,0,0.0,20
38943,10073,Expansion Packs,16,0,0.0,16
38944,10073,Game Packs,12,0,0.0,12
38945,10073,Kits,33,0,0.0,33
38946,10073,Stuff Packs,20,0,0.0,20
38947,10074,Expansion Packs,8,0,0.0,8
38948,10074,Game Packs,3,0,0.0,3
38949,10074,Kits,5,3,0.6,2
38950,10074,Stuff Packs,6,3,0.5,3
38951,10075,Expansion Packs,11,0,0.0,11
38952,10075,Game Packs,1,0,0.0,1
38953,10075,Kits,3,1,0.3333333333333333,2
38954,10075,Stuff Packs,2,1,0.5,1
38955,10076,Expansion Packs,10,0,0.0,10
38956,10076,Game Packs,4,0,0.0,4
38957,10076,Kits,14,1,0.07142857142857142,13
38958,10076,Stuff Packs,8,2,0.25,6
38959,10077,Expansion Packs,4,0,0.0,4
38960,10077,Game Packs,1,0,0.0,1
38961,10077,Kits,1,1,1.0,0
38962,10077,Stuff Packs,2,0,0.0,2
38963,10078,Expansion Packs,12,0,0.0,12
38964,10078,Game Packs,4,0,0.0,4
38965,10078,Kits,2,1,0.5,1
38966,10078,Stuff Packs,5,1,0.2,4
38967,10079,Expansion Packs,15,0,0.0,15
38968,10079,Game Packs,11,0,0.0,11
38969,10079,Kits,3,2,0.6666666666666666,1
38970,10079,Stuff Packs,14,1,0.07142857142857142,13
38971,10080,Expansion Packs,16,0,0.0,16
38972,10080,Game Packs,6,0,0.0,6
38973,10080,Stuff Packs,1,0,0.0,1
38974,10081,Expansion Packs,16,2,0.125,14
38975,10081,Game Packs,12,2,0.16666666666666666,10
38976,10081,Kits,33,3,0.09090909090909091,30
38977,10081,Stuff Packs,20,4,0.2,16
38978,10082,Expansion Packs,13,0,0.0,13
38979,10082,Game Packs,8,0,0.0,8
38980,10082,Stuff Packs,7,0,0.0,7
38981,10083,Expansion Packs,16,0,0.0,16
38982,10083,Game Packs,11,0,0.0,11
38983,10083,Kits,7,1,0.14285714285714285,6
38984,10083,Stuff Packs,12,0,0.0,12
38985,10084,Expansion Packs,15,3,0.2,12
38986,10084,Game Packs,11,2,0.18181818181818182,9
38987,10084,Kits,16,2,0.125,14
38988,10084,Stuff Packs,14,3,0.21428571428571427,11
38989,10085,Expansion Packs,16,0,0.0,16
38990,10085,Game Packs,8,0,0.0,8
38991,10085,Kits,14,0,0.0,14
38992,10085,Stuff Packs,9,2,0.2222222222222222,7
38993,10086,Expansion Packs,14,0,0.0,14
38994,10087,Expansion Packs,8,0,0.0,8
38995,10087,Game Packs,5,0,0.0,5
38996,10087,Stuff Packs,6,2,0.3333333333333333,4
38997,10088,Expansion Packs,12,0,0.0,12
38998,10088,Game Packs,6,0,0.0,6
38999,10088,Kits,4,0,0.0,4
39000,10088,Stuff Packs,10,0,0.0,10
39001,10089,Kits,1,1,1.0,0
39002,10089,Stuff Packs,3,3,1.0,0
39003,10090,Expansion Packs,7,0,0.0,7
39004,10090,Game Packs,1,0,0.0,1
39005,10090,Stuff Packs,7,2,0.2857142857142857,5
39006,10091,Expansion Packs,16,1,0.0625,15
39007,10091,Game Packs,9,0,0.0,9
39008,10091,Kits,2,2,1.0,0
39009,10091,Stuff Packs,6,2,0.3333333333333333,4
39010,10092,Expansion Packs,16,0,0.0,16
39011,10092,Game Packs,10,0,0.0,10
39012,10092,Kits,12,1,0.08333333333333333,11
39013,10092,Stuff Packs,13,0,0.0,13
39014,10093,Expansion Packs,4,0,0.0,4
39015,10093,Kits,1,1,1.0,0
39016,10093,Stuff Packs,4,3,0.75,1
39017,10094,Expansion Packs,16,0,0.0,16
39018,10094,Game Packs,12,0,0.0,12
39019,10094,Kits,32,1,0.03125,31
39020,10094,Stuff Packs,20,0,0.0,20
39021,10095,Expansion Packs,13,0,0.0,13
39022,10095,Game Packs,7,1,0.14285714285714285,6
39023,10095,Kits,6,1,0.16666666666666666,5
39024,10095,Stuff Packs,16,2,0.125,14
39025,10096,Expansion Packs,12,0,0.0,12
39026,10096,Game Packs,11,0,0.0,11
39027,10096,Kits,3,2,0.6666666666666666,1
39028,10096,Stuff Packs,18,0,0.0,18
39029,10097,Expansion Packs,16,0,0.0,16
39030,10097,Game Packs,11,0,0.0,11
39031,10097,Kits,33,0,0.0,33
39032,10097,Stuff Packs,20,0,0.0,20
39033,10098,Expansion Packs,7,0,0.0,7
39034,10098,Game Packs,3,0,0.0,3
39035,10098,Kits,4,1,0.25,3
39036,10098,Stuff Packs,2,1,0.5,1
39037,10099,Expansion Packs,6,0,0.0,6
39038,10099,Game Packs,2,0,0.0,2
39039,10099,Stuff Packs,3,1,0.3333333333333333,2
39040,10100,Expansion Packs,16,0,0.0,16
39041,10100,Game Packs,12,0,0.0,12
39042,10100,Kits,29,0,0.0,29
39043,10100,Stuff Packs,20,0,0.0,20
39044,10101,Expansion Packs,13,0,0.0,13
39045,10101,Game Packs,9,0,0.0,9
39046,10101,Kits,4,3,0.75,1
39047,10101,Stuff Packs,8,3,0.375,5
39048,10102,Expansion Packs,7,0,0.0,7
39049,10102,Game Packs,2,0,0.0,2
39050,10102,Kits,1,1,1.0,0
39051,10102,Stuff Packs,1,1,1.0,0
39052,10103,Expansion Packs,16,0,0.0,16
39053,10103,Game Packs,11,0,0.0,11
39054,10103,Kits,11,1,0.09090909090909091,10
39055,10103,Stuff Packs,15,3,0.2,12
39056,10104,Expansion Packs,11,0,0.0,11
39057,10104,Game Packs,3,0,0.0,3
39058,10104,Kits,1,1,1.0,0
39059,10104,Stuff Packs,8,3,0.375,5
39060,10105,Expansion Packs,12,0,0.0,12
39061,10105,Game Packs,6,1,0.16666666666666666,5
39062,10105,Kits,3,3,1.0,0
39063,10105,Stuff Packs,9,2,0.2222222222222222,7
39064,10106,Expansion Packs,10,0,0.0,10
39065,10106,Game Packs,5,0,0.0,5
39066,10106,Kits,3,3,1.0,0
39067,10106,Stuff Packs,8,4,0.5,4
39068,10107,Expansion Packs,16,0,0.0,16
39069,10107,Game Packs,12,0,0.0,12
39070,10107,Kits,18,1,0.05555555555555555,17
39071,10107,Stuff Packs,20,0,0.0,20
39072,10108,Expansion Packs,15,0,0.0,15
39073,10108,Game Packs,12,0,0.0,12
39074,10108,Kits,3,1,0.3333333333333333,2
39075,10108,Stuff Packs,19,0,0.0,19
39076,10109,Expansion Packs,16,0,0.0,16
39077,10109,Game Packs,11,0,0.0,11
39078,10109,Kits,7,2,0.2857142857142857,5
39079,10109,Stuff Packs,20,2,0.1,18
39080,10110,Expansion Packs,16,0,0.0,16
39081,10110,Game Packs,12,0,0.0,12
39082,10110,Kits,31,0,0.0,31
39083,10110,Stuff Packs,20,0,0.0,20
39084,10111,Expansion Packs,14,0,0.0,14
39085,10111,Game Packs,10,0,0.0,10
39086,10111,Kits,4,1,0.25,3
39087,10111,Stuff Packs,18,0,0.0,18
39088,10112,Expansion Packs,2,0,0.0,2
39089,10112,Game Packs,1,0,0.0,1
39090,10112,Kits,2,0,0.0,2
39091,10112,Stuff Packs,3,3,1.0,0
39092,10113,Expansion Packs,10,0,0.0,10
39093,10113,Game Packs,7,0,0.0,7
39094,10113,Kits,1,1,1.0,0
39095,10113,Stuff Packs,16,1,0.0625,15
39096,10114,Expansion Packs,16,0,0.0,16
39097,10114,Game Packs,12,0,0.0,12
39098,10114,Kits,33,0,0.0,33
39099,10114,Stuff Packs,20,0,0.0,20
39100,10115,Expansion Packs,15,0,0.0,15
39101,10115,Game Packs,11,0,0.0,11
39102,10115,Kits,18,0,0.0,18
39103,10115,Stuff Packs,19,0,0.0,19
39104,10116,Expansion Packs,16,0,0.0,16
39105,10116,Game Packs,11,0,0.0,11
39106,10116,Kits,5,1,0.2,4
39107,10116,Stuff Packs,14,1,0.07142857142857142,13
39108,10117,Expansion Packs,15,0,0.0,15
39109,10117,Game Packs,11,0,0.0,11
39110,10117,Kits,13,0,0.0,13
39111,10117,Stuff Packs,16,0,0.0,16
39112,10118,Expansion Packs,8,0,0.0,8
39113,10118,Game Packs,3,0,0.0,3
39114,10118,Kits,1,1,1.0,0
39115,10118,Stuff Packs,3,2,0.6666666666666666,1
39116,10119,Expansion Packs,14,0,0.0,14
39117,10119,Game Packs,7,1,0.14285714285714285,6
39118,10119,Kits,5,4,0.8,1
39119,10119,Stuff Packs,12,4,0.3333333333333333,8
39120,10120,Expansion Packs,15,0,0.0,15
39121,10120,Game Packs,9,0,0.0,9
39122,10120,Kits,3,1,0.3333333333333333,2
39123,10120,Stuff Packs,18,0,0.0,18
39124,10121,Expansion Packs,15,0,0.0,15
39125,10121,Game Packs,11,0,0.0,11
39126,10121,Kits,6,0,0.0,6
39127,10121,Stuff Packs,19,1,0.05263157894736842,18
39128,10122,Expansion Packs,16,0,0.0,16
39129,10122,Game Packs,12,1,0.08333333333333333,11
39130,10122,Kits,18,1,0.05555555555555555,17
39131,10122,Stuff Packs,20,0,0.0,20
39132,10123,Expansion Packs,13,0,0.0,13
39133,10123,Game Packs,8,0,0.0,8
39134,10123,Kits,7,1,0.14285714285714285,6
39135,10123,Stuff Packs,11,1,0.09090909090909091,10
39136,10124,Expansion Packs,16,0,0.0,16
39137,10124,Game Packs,12,0,0.0,12
39138,10124,Kits,23,0,0.0,23
39139,10124,Stuff Packs,20,0,0.0,20
39140,10125,Expansion Packs,10,0,0.0,10
39141,10125,Game Packs,5,0,0.0,5
39142,10125,Kits,4,1,0.25,3
39143,10125,Stuff Packs,10,2,0.2,8
39144,10126,Expansion Packs,15,0,0.0,15
39145,10126,Game Packs,11,0,0.0,11
39146,10126,Kits,18,1,0.05555555555555555,17
39147,10126,Stuff Packs,19,2,0.10526315789473684,17
39148,10127,Expansion Packs,16,0,0.0,16
39149,10127,Game Packs,8,0,0.0,8
39150,10127,Kits,10,0,0.0,10
39151,10127,Stuff Packs,10,0,0.0,10
39152,10128,Expansion Packs,12,4,0.3333333333333333,8
39153,10128,Game Packs,5,1,0.2,4
39154,10128,Kits,6,5,0.8333333333333334,1
39155,10128,Stuff Packs,2,0,0.0,2
39156,10129,Expansion Packs,16,0,0.0,16
39157,10129,Game Packs,9,0,0.0,9
39158,10129,Kits,13,2,0.15384615384615385,11
39159,10129,Stuff Packs,10,0,0.0,10
39160,10130,Expansion Packs,8,0,0.0,8
39161,10130,Game Packs,2,0,0.0,2
39162,10131,Expansion Packs,16,2,0.125,14
39163,10131,Game Packs,9,2,0.2222222222222222,7
39164,10131,Kits,12,0,0.0,12
39165,10131,Stuff Packs,15,2,0.13333333333333333,13
39166,10132,Expansion Packs,12,0,0.0,12
39167,10132,Game Packs,8,0,0.0,8
39168,10132,Kits,2,2,1.0,0
39169,10132,Stuff Packs,11,1,0.09090909090909091,10
39170,10133,Expansion Packs,8,0,0.0,8
39171,10133,Game Packs,7,1,0.14285714285714285,6
39172,10133,Kits,3,2,0.6666666666666666,1
39173,10133,Stuff Packs,8,4,0.5,4
39174,10134,Expansion Packs,15,0,0.0,15
39175,10134,Game Packs,8,0,0.0,8
39176,10134,Kits,7,2,0.2857142857142857,5
39177,10134,Stuff Packs,12,3,0.25,9
39178,10135,Expansion Packs,16,0,0.0,16
39179,10135,Game Packs,12,0,0.0,12
39180,10135,Kits,24,2,0.08333333333333333,22
39181,10135,Stuff Packs,20,0,0.0,20
39182,10136,Expansion Packs,5,0,0.0,5
39183,10136,Game Packs,2,0,0.0,2
39184,10136,Kits,1,1,1.0,0
39185,10136,Stuff Packs,2,1,0.5,1
39186,10137,Expansion Packs,11,0,0.0,11
39187,10137,Game Packs,9,0,0.0,9
39188,10137,Kits,2,0,0.0,2
39189,10137,Stuff Packs,18,0,0.0,18
39190,10138,Expansion Packs,14,0,0.0,14
39191,10138,Game Packs,9,0,0.0,9
39192,10138,Kits,12,1,0.08333333333333333,11
39193,10138,Stuff Packs,14,0,0.0,14
39194,10139,Expansion Packs,14,0,0.0,14
39195,10139,Game Packs,6,0,0.0,6
39196,10139,Kits,6,1,0.16666666666666666,5
39197,10139,Stuff Packs,6,1,0.16666666666666666,5
39198,10140,Expansion Packs,12,0,0.0,12
39199,10140,Game Packs,4,0,0.0,4
39200,10140,Kits,2,2,1.0,0
39201,10140,Stuff Packs,12,2,0.16666666666666666,10
39202,10141,Expansion Packs,16,0,0.0,16
39203,10141,Game Packs,11,0,0.0,11
39204,10141,Kits,23,0,0.0,23
39205,10141,Stuff Packs,19,0,0.0,19
39206,10142,Expansion Packs,9,0,0.0,9
39207,10142,Game Packs,6,0,0.0,6
39208,10142,Kits,3,0,0.0,3
39209,10142,Stuff Packs,5,0,0.0,5
39210,10143,Expansion Packs,16,0,0.0,16
39211,10143,Game Packs,6,0,0.0,6
39212,10143,Kits,2,0,0.0,2
39213,10143,Stuff Packs,7,0,0.0,7
39214,10144,Expansion Packs,15,0,0.0,15
39215,10144,Game Packs,6,0,0.0,6
39216,10144,Kits,2,1,0.5,1
39217,10144,Stuff Packs,10,2,0.2,8
39218,10145,Expansion Packs,14,0,0.0,14
39219,10145,Game Packs,9,0,0.0,9
39220,10145,Kits,5,2,0.4,3
39221,10145,Stuff Packs,18,0,0.0,18
39222,10146,Expansion Packs,16,0,0.0,16
39223,10146,Game Packs,10,0,0.0,10
39224,10146,Kits,16,0,0.0,16
39225,10146,Stuff Packs,20,0,0.0,20
39226,10147,Expansion Packs,15,0,0.0,15
39227,10147,Game Packs,11,0,0.0,11
39228,10147,Kits,13,1,0.07692307692307693,12
39229,10147,Stuff Packs,14,1,0.07142857142857142,13
39230,10148,Expansion Packs,3,0,0.0,3
39231,10148,Game Packs,2,0,0.0,2
39232,10148,Kits,5,0,0.0,5
39233,10148,Stuff Packs,6,1,0.16666666666666666,5
39234,10149,Expansion Packs,15,0,0.0,15
39235,10149,Game Packs,12,1,0.08333333333333333,11
39236,10149,Kits,7,0,0.0,7
39237,10149,Stuff Packs,19,0,0.0,19
39238,10150,Expansion Packs,16,0,0.0,16
39239,10150,Game Packs,12,0,0.0,12
39240,10150,Kits,33,1,0.030303030303030304,32
39241,10150,Stuff Packs,20,0,0.0,20
39242,10151,Expansion Packs,16,0,0.0,16
39243,10151,Game Packs,12,0,0.0,12
39244,10151,Kits,33,0,0.0,33
39245,10151,Stuff Packs,20,0,0.0,20
39246,10152,Expansion Packs,13,0,0.0,13
39247,10152,Game Packs,12,0,0.0,12
39248,10152,Stuff Packs,18,0,0.0,18
39249,10153,Expansion Packs,16,0,0.0,16
39250,10153,Game Packs,12,0,0.0,12
39251,10153,Kits,33,1,0.030303030303030304,32
39252,10153,Stuff Packs,20,0,0.0,20
39253,10154,Expansion Packs,12,0,0.0,12
39254,10154,Game Packs,7,1,0.14285714285714285,6
39255,10154,Kits,2,2,1.0,0
39256,10154,Stuff Packs,11,4,0.36363636363636365,7
39257,10155,Expansion Packs,14,0,0.0,14
39258,10155,Game Packs,9,0,0.0,9
39259,10155,Kits,2,2,1.0,0
39260,10155,Stuff Packs,18,2,0.1111111111111111,16
39261,10156,Expansion Packs,14,0,0.0,14
39262,10156,Game Packs,12,0,0.0,12
39263,10156,Kits,10,1,0.1,9
39264,10156,Stuff Packs,18,0,0.0,18
39265,10157,Expansion Packs,16,0,0.0,16
39266,10157,Game Packs,12,0,0.0,12
39267,10157,Kits,23,3,0.13043478260869565,20
39268,10157,Stuff Packs,14,0,0.0,14
39269,10158,Expansion Packs,16,0,0.0,16
39270,10158,Game Packs,12,0,0.0,12
39271,10158,Kits,33,0,0.0,33
39272,10158,Stuff Packs,20,0,0.0,20
39273,10159,Expansion Packs,6,2,0.3333333333333333,4
39274,10159,Game Packs,2,1,0.5,1
39275,10159,Kits,1,0,0.0,1
39276,10159,Stuff Packs,4,0,0.0,4
39277,10160,Expansion Packs,14,0,0.0,14
39278,10160,Game Packs,12,0,0.0,12
39279,10160,Kits,9,0,0.0,9
39280,10160,Stuff Packs,19,0,0.0,19
39281,10161,Expansion Packs,16,0,0.0,16
39282,10161,Game Packs,12,0,0.0,12
39283,10161,Kits,30,0,0.0,30
39284,10161,Stuff Packs,20,0,0.0,20
39285,10162,Expansion Packs,12,0,0.0,12
39286,10162,Game Packs,10,0,0.0,10
39287,10162,Kits,6,0,0.0,6
39288,10162,Stuff Packs,16,0,0.0,16
39289,10163,Expansion Packs,12,0,0.0,12
39290,10163,Game Packs,11,0,0.0,11
39291,10163,Kits,2,0,0.0,2
39292,10163,Stuff Packs,8,0,0.0,8
39293,10164,Expansion Packs,15,0,0.0,15
39294,10164,Game Packs,5,0,0.0,5
39295,10164,Kits,1,0,0.0,1
39296,10164,Stuff Packs,5,0,0.0,5
39297,10165,Expansion Packs,7,0,0.0,7
39298,10165,Game Packs,2,0,0.0,2
39299,10165,Stuff Packs,4,1,0.25,3
39300,10166,Expansion Packs,16,0,0.0,16
39301,10166,Game Packs,12,0,0.0,12
39302,10166,Kits,1,0,0.0,1
39303,10166,Stuff Packs,20,4,0.2,16
39304,10167,Expansion Packs,16,0,0.0,16
39305,10167,Game Packs,12,0,0.0,12
39306,10167,Kits,31,0,0.0,31
39307,10167,Stuff Packs,20,0,0.0,20
39308,10168,Expansion Packs,9,1,0.1111111111111111,8
39309,10168,Game Packs,5,2,0.4,3
39310,10168,Kits,1,1,1.0,0
39311,10168,Stuff Packs,7,1,0.14285714285714285,6
39312,10169,Expansion Packs,16,0,0.0,16
39313,10169,Game Packs,12,0,0.0,12
39314,10169,Kits,33,1,0.030303030303030304,32
39315,10169,Stuff Packs,20,0,0.0,20
39316,10170,Expansion Packs,15,1,0.06666666666666667,14
39317,10170,Game Packs,10,1,0.1,9
39318,10170,Kits,6,2,0.3333333333333333,4
39319,10170,Stuff Packs,11,0,0.0,11
39320,10171,Expansion Packs,10,0,0.0,10
39321,10171,Game Packs,5,0,0.0,5
39322,10171,Kits,1,0,0.0,1
39323,10171,Stuff Packs,5,2,0.4,3
39324,10172,Expansion Packs,8,0,0.0,8
39325,10172,Game Packs,6,1,0.16666666666666666,5
39326,10172,Kits,3,3,1.0,0
39327,10172,Stuff Packs,8,5,0.625,3
39328,10173,Expansion Packs,16,0,0.0,16
39329,10173,Game Packs,12,0,0.0,12
39330,10173,Kits,33,1,0.030303030303030304,32
39331,10173,Stuff Packs,20,0,0.0,20
39332,10174,Expansion Packs,3,0,0.0,3
39333,10174,Game Packs,1,0,0.0,1
39334,10174,Kits,2,0,0.0,2
39335,10174,Stuff Packs,2,0,0.0,2
39336,10175,Expansion Packs,15,0,0.0,15
39337,10175,Game Packs,12,0,0.0,12
39338,10175,Kits,14,1,0.07142857142857142,13
39339,10175,Stuff Packs,19,0,0.0,19
39340,10176,Expansion Packs,3,0,0.0,3
39341,10176,Stuff Packs,1,0,0.0,1
39342,10177,Expansion Packs,12,0,0.0,12
39343,10177,Game Packs,6,0,0.0,6
39344,10177,Kits,1,0,0.0,1
39345,10177,Stuff Packs,9,0,0.0,9
39346,10178,Expansion Packs,15,0,0.0,15
39347,10178,Game Packs,5,0,0.0,5
39348,10178,Kits,4,2,0.5,2
39349,10178,Stuff Packs,13,3,0.23076923076923078,10
39350,10179,Expansion Packs,8,0,0.0,8
39351,10179,Game Packs,4,0,0.0,4
39352,10179,Kits,1,1,1.0,0
39353,10179,Stuff Packs,6,1,0.16666666666666666,5
39354,10180,Expansion Packs,16,0,0.0,16
39355,10180,Game Packs,12,0,0.0,12
39356,10180,Kits,14,1,0.07142857142857142,13
39357,10180,Stuff Packs,20,0,0.0,20
39358,10181,Expansion Packs,7,0,0.0,7
39359,10181,Game Packs,4,0,0.0,4
39360,10181,Kits,3,2,0.6666666666666666,1
39361,10181,Stuff Packs,7,3,0.42857142857142855,4
39362,10182,Expansion Packs,14,0,0.0,14
39363,10182,Game Packs,11,0,0.0,11
39364,10182,Stuff Packs,18,0,0.0,18
39365,10183,Expansion Packs,14,0,0.0,14
39366,10183,Game Packs,6,0,0.0,6
39367,10183,Kits,1,1,1.0,0
39368,10183,Stuff Packs,11,2,0.18181818181818182,9
39369,10184,Expansion Packs,14,0,0.0,14
39370,10184,Game Packs,11,0,0.0,11
39371,10184,Kits,5,0,0.0,5
39372,10184,Stuff Packs,14,4,0.2857142857142857,10
39373,10185,Expansion Packs,12,0,0.0,12
39374,10185,Game Packs,5,0,0.0,5
39375,10185,Kits,2,0,0.0,2
39376,10185,Stuff Packs,6,0,0.0,6
39377,10186,Expansion Packs,12,0,0.0,12
39378,10186,Game Packs,4,1,0.25,3
39379,10186,Kits,7,3,0.42857142857142855,4
39380,10186,Stuff Packs,9,3,0.3333333333333333,6
39381,10187,Expansion Packs,7,0,0.0,7
39382,10187,Game Packs,8,0,0.0,8
39383,10187,Kits,2,1,0.5,1
39384,10187,Stuff Packs,7,0,0.0,7
39385,10188,Expansion Packs,11,0,0.0,11
39386,10188,Game Packs,8,0,0.0,8
39387,10188,Kits,2,1,0.5,1
39388,10188,Stuff Packs,17,3,0.17647058823529413,14
39389,10189,Expansion Packs,16,0,0.0,16
39390,10189,Game Packs,12,0,0.0,12
39391,10189,Kits,33,0,0.0,33
39392,10189,Stuff Packs,20,0,0.0,20
39393,10190,Expansion Packs,15,0,0.0,15
39394,10190,Game Packs,10,0,0.0,10
39395,10190,Kits,32,1,0.03125,31
39396,10190,Stuff Packs,20,0,0.0,20
39397,10191,Expansion Packs,4,0,0.0,4
39398,10191,Game Packs,1,0,0.0,1
39399,10191,Kits,1,1,1.0,0
39400,10191,Stuff Packs,2,0,0.0,2
39401,10192,Expansion Packs,16,0,0.0,16
39402,10192,Game Packs,8,0,0.0,8
39403,10192,Kits,26,1,0.038461538461538464,25
39404,10192,Stuff Packs,20,0,0.0,20
39405,10193,Expansion Packs,10,0,0.0,10
39406,10193,Game Packs,4,0,0.0,4
39407,10193,Kits,6,0,0.0,6
39408,10193,Stuff Packs,12,3,0.25,9
39409,10194,Expansion Packs,16,0,0.0,16
39410,10194,Game Packs,12,0,0.0,12
39411,10194,Kits,33,2,0.06060606060606061,31
39412,10194,Stuff Packs,20,0,0.0,20
39413,10195,Expansion Packs,14,0,0.0,14
39414,10195,Game Packs,10,0,0.0,10
39415,10195,Kits,7,1,0.14285714285714285,6
39416,10195,Stuff Packs,17,1,0.058823529411764705,16
39417,10196,Expansion Packs,15,0,0.0,15
39418,10196,Game Packs,5,0,0.0,5
39419,10196,Kits,19,2,0.10526315789473684,17
39420,10196,Stuff Packs,7,3,0.42857142857142855,4
39421,10197,Expansion Packs,6,0,0.0,6
39422,10198,Expansion Packs,10,0,0.0,10
39423,10198,Game Packs,3,2,0.6666666666666666,1
39424,10198,Stuff Packs,5,5,1.0,0
39425,10199,Expansion Packs,16,0,0.0,16
39426,10199,Game Packs,11,0,0.0,11
39427,10199,Kits,29,1,0.034482758620689655,28
39428,10199,Stuff Packs,20,0,0.0,20
39429,10200,Expansion Packs,14,0,0.0,14
39430,10200,Game Packs,5,0,0.0,5
39431,10200,Kits,10,0,0.0,10
39432,10200,Stuff Packs,13,3,0.23076923076923078,10
39433,10201,Expansion Packs,16,0,0.0,16
39434,10201,Game Packs,12,0,0.0,12
39435,10201,Kits,19,0,0.0,19
39436,10201,Stuff Packs,20,0,0.0,20
39437,10202,Expansion Packs,11,0,0.0,11
39438,10202,Game Packs,4,0,0.0,4
39439,10202,Kits,3,2,0.6666666666666666,1
39440,10202,Stuff Packs,5,3,0.6,2
39441,10203,Expansion Packs,16,0,0.0,16
39442,10203,Game Packs,12,0,0.0,12
39443,10203,Kits,33,1,0.030303030303030304,32
39444,10203,Stuff Packs,20,0,0.0,20
39445,10204,Expansion Packs,14,0,0.0,14
39446,10204,Game Packs,11,0,0.0,11
39447,10204,Kits,5,3,0.6,2
39448,10204,Stuff Packs,16,3,0.1875,13
39449,10205,Expansion Packs,16,0,0.0,16
39450,10205,Game Packs,12,0,0.0,12
39451,10205,Kits,30,0,0.0,30
39452,10205,Stuff Packs,20,0,0.0,20
39453,10206,Expansion Packs,10,0,0.0,10
39454,10206,Game Packs,9,0,0.0,9
39455,10206,Stuff Packs,6,3,0.5,3
39456,10207,Expansion Packs,14,0,0.0,14
39457,10207,Game Packs,10,0,0.0,10
39458,10207,Kits,3,3,1.0,0
39459,10207,Stuff Packs,17,1,0.058823529411764705,16
39460,10208,Expansion Packs,10,0,0.0,10
39461,10208,Game Packs,5,0,0.0,5
39462,10208,Kits,5,2,0.4,3
39463,10208,Stuff Packs,9,3,0.3333333333333333,6
39464,10209,Expansion Packs,10,0,0.0,10
39465,10209,Game Packs,6,0,0.0,6
39466,10209,Kits,3,0,0.0,3
39467,10209,Stuff Packs,10,0,0.0,10
39468,10210,Expansion Packs,16,0,0.0,16
39469,10210,Game Packs,6,0,0.0,6
39470,10210,Kits,29,1,0.034482758620689655,28
39471,10210,Stuff Packs,13,0,0.0,13
39472,10211,Expansion Packs,10,0,0.0,10
39473,10211,Game Packs,5,0,0.0,5
39474,10211,Kits,1,1,1.0,0
39475,10211,Stuff Packs,13,1,0.07692307692307693,12
39476,10212,Expansion Packs,16,0,0.0,16
39477,10212,Game Packs,12,0,0.0,12
39478,10212,Kits,33,0,0.0,33
39479,10212,Stuff Packs,20,0,0.0,20
39480,10213,Expansion Packs,4,1,0.25,3
39481,10213,Game Packs,2,1,0.5,1
39482,10213,Kits,2,1,0.5,1
39483,10213,Stuff Packs,4,2,0.5,2
39484,10214,Expansion Packs,16,0,0.0,16
39485,10214,Game Packs,12,0,0.0,12
39486,10214,Kits,33,0,0.0,33
39487,10214,Stuff Packs,20,0,0.0,20
39488,10215,Expansion Packs,10,0,0.0,10
39489,10215,Game Packs,1,1,1.0,0
39490,10215,Kits,2,2,1.0,0
39491,10215,Stuff Packs,4,2,0.5,2
39492,10216,Expansion Packs,15,0,0.0,15
39493,10216,Game Packs,12,0,0.0,12
39494,10216,Kits,10,1,0.1,9
39495,10216,Stuff Packs,20,0,0.0,20
39496,10217,Expansion Packs,7,0,0.0,7
39497,10217,Game Packs,6,0,0.0,6
39498,10217,Kits,3,2,0.6666666666666666,1
39499,10217,Stuff Packs,6,3,0.5,3
39500,10218,Expansion Packs,15,0,0.0,15
39501,10218,Game Packs,11,0,0.0,11
39502,10218,Kits,14,1,0.07142857142857142,13
39503,10218,Stuff Packs,17,0,0.0,17
39504,10219,Expansion Packs,2,0,0.0,2
39505,10219,Kits,1,1,1.0,0
39506,10220,Expansion Packs,16,0,0.0,16
39507,10220,Game Packs,11,1,0.09090909090909091,10
39508,10220,Kits,13,3,0.23076923076923078,10
39509,10220,Stuff Packs,15,4,0.26666666666666666,11
39510,10221,Expansion Packs,16,0,0.0,16
39511,10221,Game Packs,12,0,0.0,12
39512,10221,Kits,33,0,0.0,33
39513,10221,Stuff Packs,20,0,0.0,20
39514,10222,Expansion Packs,12,0,0.0,12
39515,10222,Game Packs,8,0,0.0,8
39516,10222,Stuff Packs,13,1,0.07692307692307693,12
39517,10223,Expansion Packs,11,0,0.0,11
39518,10223,Game Packs,5,0,0.0,5
39519,10223,Kits,1,1,1.0,0
39520,10223,Stuff Packs,4,1,0.25,3
39521,10224,Expansion Packs,6,0,0.0,6
39522,10224,Game Packs,1,0,0.0,1
39523,10224,Kits,1,1,1.0,0
39524,10224,Stuff Packs,6,1,0.16666666666666666,5
39525,10225,Expansion Packs,12,0,0.0,12
39526,10225,Game Packs,7,0,0.0,7
39527,10225,Kits,10,1,0.1,9
39528,10225,Stuff Packs,9,0,0.0,9
39529,10226,Expansion Packs,15,0,0.0,15
39530,10226,Game Packs,8,0,0.0,8
39531,10226,Kits,5,1,0.2,4
39532,10226,Stuff Packs,10,2,0.2,8
39533,10227,Expansion Packs,4,0,0.0,4
39534,10227,Game Packs,3,0,0.0,3
39535,10227,Stuff Packs,3,0,0.0,3
39536,10228,Expansion Packs,14,0,0.0,14
39537,10228,Game Packs,10,0,0.0,10
39538,10228,Kits,1,1,1.0,0
39539,10228,Stuff Packs,10,4,0.4,6
39540,10229,Expansion Packs,14,0,0.0,14
39541,10229,Game Packs,9,0,0.0,9
39542,10229,Kits,16,0,0.0,16
39543,10229,Stuff Packs,18,0,0.0,18
39544,10230,Expansion Packs,16,0,0.0,16
39545,10230,Game Packs,12,0,0.0,12
39546,10230,Kits,20,0,0.0,20
39547,10230,Stuff Packs,18,0,0.0,18
39548,10231,Expansion Packs,10,0,0.0,10
39549,10231,Game Packs,5,0,0.0,5
39550,10231,Stuff Packs,12,0,0.0,12
39551,10232,Expansion Packs,15,0,0.0,15
39552,10232,Game Packs,11,0,0.0,11
39553,10232,Kits,25,1,0.04,24
39554,10232,Stuff Packs,19,0,0.0,19
39555,10233,Expansion Packs,6,0,0.0,6
39556,10233,Game Packs,1,0,0.0,1
39557,10233,Kits,1,1,1.0,0
39558,10233,Stuff Packs,2,1,0.5,1
39559,10234,Expansion Packs,15,0,0.0,15
39560,10234,Game Packs,11,0,0.0,11
39561,10234,Kits,12,1,0.08333333333333333,11
39562,10234,Stuff Packs,20,0,0.0,20
39563,10235,Expansion Packs,15,0,0.0,15
39564,10235,Game Packs,11,0,0.0,11
39565,10235,Kits,3,0,0.0,3
39566,10235,Stuff Packs,17,0,0.0,17
39567,10236,Expansion Packs,12,0,0.0,12
39568,10236,Game Packs,8,0,0.0,8
39569,10236,Kits,5,3,0.6,2
39570,10236,Stuff Packs,13,2,0.15384615384615385,11
39571,10237,Expansion Packs,16,0,0.0,16
39572,10237,Game Packs,12,0,0.0,12
39573,10237,Kits,21,1,0.047619047619047616,20
39574,10237,Stuff Packs,20,0,0.0,20
39575,10238,Expansion Packs,14,0,0.0,14
39576,10238,Game Packs,9,0,0.0,9
39577,10238,Kits,5,0,0.0,5
39578,10238,Stuff Packs,8,0,0.0,8
39579,10239,Expansion Packs,5,0,0.0,5
39580,10239,Game Packs,2,0,0.0,2
39581,10239,Kits,4,2,0.5,2
39582,10239,Stuff Packs,4,1,0.25,3
39583,10240,Expansion Packs,10,0,0.0,10
39584,10240,Game Packs,2,0,0.0,2
39585,10240,Kits,1,1,1.0,0
39586,10241,Expansion Packs,7,0,0.0,7
39587,10241,Game Packs,4,0,0.0,4
39588,10241,Stuff Packs,5,0,0.0,5
39589,10242,Expansion Packs,13,0,0.0,13
39590,10242,Game Packs,7,0,0.0,7
39591,10242,Kits,2,0,0.0,2
39592,10242,Stuff Packs,7,0,0.0,7
39593,10243,Expansion Packs,15,0,0.0,15
39594,10243,Game Packs,9,0,0.0,9
39595,10243,Kits,6,0,0.0,6
39596,10243,Stuff Packs,18,2,0.1111111111111111,16
39597,10244,Expansion Packs,15,0,0.0,15
39598,10244,Game Packs,12,0,0.0,12
39599,10244,Kits,31,0,0.0,31
39600,10244,Stuff Packs,19,0,0.0,19
39601,10245,Expansion Packs,15,0,0.0,15
39602,10245,Game Packs,11,0,0.0,11
39603,10245,Kits,22,2,0.09090909090909091,20
39604,10245,Stuff Packs,19,0,0.0,19
39605,10246,Expansion Packs,7,0,0.0,7
39606,10246,Game Packs,8,0,0.0,8
39607,10246,Kits,6,3,0.5,3
39608,10246,Stuff Packs,12,3,0.25,9
39609,10247,Expansion Packs,16,0,0.0,16
39610,10247,Game Packs,12,0,0.0,12
39611,10247,Kits,33,0,0.0,33
39612,10247,Stuff Packs,20,0,0.0,20
39613,10248,Expansion Packs,16,0,0.0,16
39614,10248,Game Packs,7,0,0.0,7
39615,10248,Kits,1,1,1.0,0
39616,10248,Stuff Packs,6,3,0.5,3
39617,10249,Expansion Packs,14,0,0.0,14
39618,10249,Game Packs,11,0,0.0,11
39619,10249,Kits,11,1,0.09090909090909091,10
39620,10249,Stuff Packs,14,2,0.14285714285714285,12
39621,10250,Expansion Packs,16,0,0.0,16
39622,10250,Game Packs,12,0,0.0,12
39623,10250,Kits,33,0,0.0,33
39624,10250,Stuff Packs,20,0,0.0,20
39625,10251,Expansion Packs,8,0,0.0,8
39626,10251,Game Packs,4,1,0.25,3
39627,10251,Kits,1,1,1.0,0
39628,10251,Stuff Packs,6,3,0.5,3
39629,10252,Expansion Packs,7,0,0.0,7
39630,10252,Game Packs,3,0,0.0,3
39631,10252,Kits,14,0,0.0,14
39632,10252,Stuff Packs,12,1,0.08333333333333333,11
39633,10253,Expansion Packs,13,0,0.0,13
39634,10253,Game Packs,11,0,0.0,11
39635,10253,Kits,3,0,0.0,3
39636,10253,Stuff Packs,15,0,0.0,15
39637,10254,Expansion Packs,16,0,0.0,16
39638,10254,Game Packs,11,0,0.0,11
39639,10254,Kits,12,0,0.0,12
39640,10254,Stuff Packs,15,1,0.06666666666666667,14
39641,10255,Expansion Packs,15,0,0.0,15
39642,10255,Game Packs,11,0,0.0,11
39643,10255,Kits,7,1,0.14285714285714285,6
39644,10255,Stuff Packs,18,0,0.0,18
39645,10256,Expansion Packs,14,0,0.0,14
39646,10256,Game Packs,12,0,0.0,12
39647,10256,Kits,20,0,0.0,20
39648,10256,Stuff Packs,20,0,0.0,20
39649,10257,Expansion Packs,16,0,0.0,16
39650,10257,Game Packs,12,0,0.0,12
39651,10257,Stuff Packs,20,0,0.0,20
39652,10258,Expansion Packs,7,0,0.0,7
39653,10258,Game Packs,2,0,0.0,2
39654,10258,Kits,1,1,1.0,0
39655,10258,Stuff Packs,1,0,0.0,1
39656,10259,Expansion Packs,16,0,0.0,16
39657,10259,Game Packs,12,0,0.0,12
39658,10259,Kits,2,0,0.0,2
39659,10259,Stuff Packs,19,0,0.0,19
39660,10260,Expansion Packs,13,2,0.15384615384615385,11
39661,10260,Game Packs,6,0,0.0,6
39662,10260,Kits,2,0,0.0,2
39663,10260,Stuff Packs,13,2,0.15384615384615385,11
39664,10261,Expansion Packs,15,0,0.0,15
39665,10261,Game Packs,10,0,0.0,10
39666,10261,Kits,14,2,0.14285714285714285,12
39667,10261,Stuff Packs,17,0,0.0,17
39668,10262,Expansion Packs,9,0,0.0,9
39669,10262,Game Packs,3,0,0.0,3
39670,10262,Kits,2,1,0.5,1
39671,10262,Stuff Packs,8,1,0.125,7
39672,10263,Expansion Packs,16,0,0.0,16
39673,10263,Game Packs,12,0,0.0,12
39674,10263,Kits,33,0,0.0,33
39675,10263,Stuff Packs,20,0,0.0,20
39676,10264,Expansion Packs,16,0,0.0,16
39677,10264,Game Packs,10,0,0.0,10
39678,10264,Kits,4,2,0.5,2
39679,10264,Stuff Packs,14,2,0.14285714285714285,12
39680,10265,Expansion Packs,14,0,0.0,14
39681,10265,Game Packs,8,1,0.125,7
39682,10265,Kits,6,3,0.5,3
39683,10265,Stuff Packs,11,5,0.45454545454545453,6
39684,10266,Expansion Packs,16,0,0.0,16
39685,10266,Game Packs,12,0,0.0,12
39686,10266,Kits,27,1,0.037037037037037035,26
39687,10266,Stuff Packs,20,1,0.05,19
39688,10267,Expansion Packs,14,0,0.0,14
39689,10267,Game Packs,5,0,0.0,5
39690,10267,Kits,8,0,0.0,8
39691,10267,Stuff Packs,5,2,0.4,3
39692,10268,Expansion Packs,16,0,0.0,16
39693,10268,Game Packs,12,0,0.0,12
39694,10268,Kits,33,1,0.030303030303030304,32
39695,10268,Stuff Packs,20,0,0.0,20
39696,10269,Expansion Packs,10,0,0.0,10
39697,10269,Game Packs,3,0,0.0,3
39698,10269,Kits,2,1,0.5,1
39699,10269,Stuff Packs,6,2,0.3333333333333333,4
39700,10270,Expansion Packs,16,0,0.0,16
39701,10270,Game Packs,8,0,0.0,8
39702,10270,Kits,4,2,0.5,2
39703,10270,Stuff Packs,14,2,0.14285714285714285,12
39704,10271,Expansion Packs,9,0,0.0,9
39705,10271,Game Packs,3,0,0.0,3
39706,10271,Kits,5,0,0.0,5
39707,10271,Stuff Packs,5,0,0.0,5
39708,10272,Expansion Packs,16,0,0.0,16
39709,10272,Game Packs,12,0,0.0,12
39710,10272,Kits,10,0,0.0,10
39711,10272,Stuff Packs,18,0,0.0,18
39712,10273,Expansion Packs,16,0,0.0,16
39713,10273,Game Packs,12,0,0.0,12
39714,10273,Kits,33,2,0.06060606060606061,31
39715,10273,Stuff Packs,20,0,0.0,20
39716,10274,Expansion Packs,5,0,0.0,5
39717,10274,Game Packs,4,0,0.0,4
39718,10274,Kits,3,1,0.3333333333333333,2
39719,10274,Stuff Packs,5,1,0.2,4
39720,10275,Expansion Packs,16,0,0.0,16
39721,10275,Game Packs,12,0,0.0,12
39722,10275,Kits,33,0,0.0,33
39723,10275,Stuff Packs,20,0,0.0,20
39724,10276,Expansion Packs,16,1,0.0625,15
39725,10276,Game Packs,10,0,0.0,10
39726,10276,Kits,4,0,0.0,4
39727,10276,Stuff Packs,9,0,0.0,9
39728,10277,Expansion Packs,15,0,0.0,15
39729,10277,Game Packs,11,0,0.0,11
39730,10277,Kits,21,1,0.047619047619047616,20
39731,10277,Stuff Packs,20,1,0.05,19
39732,10278,Expansion Packs,3,0,0.0,3
39733,10278,Game Packs,1,0,0.0,1
39734,10278,Kits,2,2,1.0,0
39735,10278,Stuff Packs,2,0,0.0,2
39736,10279,Expansion Packs,3,0,0.0,3
39737,10279,Game Packs,2,1,0.5,1
39738,10279,Kits,2,2,1.0,0
39739,10279,Stuff Packs,6,0,0.0,6
39740,10280,Expansion Packs,15,0,0.0,15
39741,10280,Game Packs,11,0,0.0,11
39742,10280,Kits,21,1,0.047619047619047616,20
39743,10280,Stuff Packs,20,2,0.1,18
39744,10281,Expansion Packs,16,0,0.0,16
39745,10281,Game Packs,11,0,0.0,11
39746,10281,Kits,14,0,0.0,14
39747,10281,Stuff Packs,17,0,0.0,17
39748,10282,Expansion Packs,16,0,0.0,16
39749,10282,Game Packs,12,0,0.0,12
39750,10282,Kits,33,1,0.030303030303030304,32
39751,10282,Stuff Packs,20,1,0.05,19
39752,10283,Expansion Packs,10,0,0.0,10
39753,10283,Game Packs,5,2,0.4,3
39754,10283,Kits,2,2,1.0,0
39755,10283,Stuff Packs,5,3,0.6,2
39756,10284,Expansion Packs,2,0,0.0,2
39757,10284,Game Packs,4,1,0.25,3
39758,10284,Kits,7,1,0.14285714285714285,6
39759,10284,Stuff Packs,2,0,0.0,2
39760,10285,Expansion Packs,16,0,0.0,16
39761,10285,Game Packs,10,0,0.0,10
39762,10285,Kits,4,0,0.0,4
39763,10285,Stuff Packs,15,1,0.06666666666666667,14
39764,10286,Expansion Packs,12,0,0.0,12
39765,10286,Game Packs,8,0,0.0,8
39766,10286,Kits,3,2,0.6666666666666666,1
39767,10286,Stuff Packs,6,3,0.5,3
39768,10287,Expansion Packs,11,0,0.0,11
39769,10287,Game Packs,5,0,0.0,5
39770,10287,Stuff Packs,13,1,0.07692307692307693,12
39771,10288,Expansion Packs,13,0,0.0,13
39772,10288,Game Packs,4,0,0.0,4
39773,10288,Kits,4,0,0.0,4
39774,10288,Stuff Packs,8,0,0.0,8
39775,10289,Expansion Packs,6,0,0.0,6
39776,10289,Game Packs,1,0,0.0,1
39777,10289,Kits,2,1,0.5,1
39778,10289,Stuff Packs,1,0,0.0,1
39779,10290,Expansion Packs,9,1,0.1111111111111111,8
39780,10290,Game Packs,5,0,0.0,5
39781,10290,Kits,3,1,0.3333333333333333,2
39782,10290,Stuff Packs,5,2,0.4,3
39783,10291,Expansion Packs,16,0,0.0,16
39784,10291,Game Packs,12,0,0.0,12
39785,10291,Kits,33,2,0.06060606060606061,31
39786,10291,Stuff Packs,20,2,0.1,18
39787,10292,Expansion Packs,16,0,0.0,16
39788,10292,Game Packs,12,0,0.0,12
39789,10292,Kits,26,0,0.0,26
39790,10292,Stuff Packs,20,0,0.0,20
39791,10293,Expansion Packs,11,2,0.18181818181818182,9
39792,10293,Game Packs,7,1,0.14285714285714285,6
39793,10293,Kits,1,0,0.0,1
39794,10293,Stuff Packs,6,0,0.0,6
39795,10294,Expansion Packs,15,0,0.0,15
39796,10294,Game Packs,10,0,0.0,10
39797,10294,Kits,3,3,1.0,0
39798,10294,Stuff Packs,19,2,0.10526315789473684,17
39799,10295,Expansion Packs,16,0,0.0,16
39800,10295,Game Packs,12,0,0.0,12
39801,10295,Kits,5,0,0.0,5
39802,10295,Stuff Packs,13,0,0.0,13
39803,10296,Expansion Packs,16,0,0.0,16
39804,10296,Game Packs,12,0,0.0,12
39805,10296,Kits,33,1,0.030303030303030304,32
39806,10296,Stuff Packs,20,0,0.0,20
39807,10297,Expansion Packs,14,0,0.0,14
39808,10297,Game Packs,9,0,0.0,9
39809,10297,Kits,9,0,0.0,9
39810,10297,Stuff Packs,14,0,0.0,14
39811,10298,Expansion Packs,14,0,0.0,14
39812,10298,Game Packs,9,1,0.1111111111111111,8
39813,10298,Kits,2,2,1.0,0
39814,10298,Stuff Packs,14,2,0.14285714285714285,12
39815,10299,Expansion Packs,16,0,0.0,16
39816,10299,Game Packs,12,0,0.0,12
39817,10299,Kits,24,0,0.0,24
39818,10299,Stuff Packs,20,0,0.0,20
39819,10300,Expansion Packs,4,0,0.0,4
39820,10300,Game Packs,1,0,0.0,1
39821,10300,Stuff Packs,5,0,0.0,5
39822,10301,Expansion Packs,3,0,0.0,3
39823,10302,Expansion Packs,16,0,0.0,16
39824,10302,Game Packs,12,0,0.0,12
39825,10302,Kits,33,2,0.06060606060606061,31
39826,10302,Stuff Packs,20,1,0.05,19
39827,10303,Expansion Packs,6,0,0.0,6
39828,10303,Game Packs,3,1,0.3333333333333333,2
39829,10303,Stuff Packs,5,3,0.6,2
39830,10304,Expansion Packs,16,0,0.0,16
39831,10304,Game Packs,12,0,0.0,12
39832,10304,Kits,30,0,0.0,30
39833,10304,Stuff Packs,19,0,0.0,19
39834,10305,Expansion Packs,16,0,0.0,16
39835,10305,Game Packs,12,0,0.0,12
39836,10305,Kits,33,0,0.0,33
39837,10305,Stuff Packs,20,0,0.0,20
39838,10306,Expansion Packs,11,0,0.0,11
39839,10306,Game Packs,6,0,0.0,6
39840,10306,Kits,3,0,0.0,3
39841,10306,Stuff Packs,7,1,0.14285714285714285,6
39842,10307,Expansion Packs,10,0,0.0,10
39843,10307,Game Packs,3,0,0.0,3
39844,10307,Kits,2,2,1.0,0
39845,10307,Stuff Packs,8,2,0.25,6
39846,10308,Expansion Packs,16,0,0.0,16
39847,10308,Game Packs,10,0,0.0,10
39848,10308,Kits,11,3,0.2727272727272727,8
39849,10308,Stuff Packs,19,3,0.15789473684210525,16
39850,10309,Expansion Packs,12,0,0.0,12
39851,10309,Game Packs,9,0,0.0,9
39852,10309,Kits,2,1,0.5,1
39853,10309,Stuff Packs,11,1,0.09090909090909091,10
39854,10310,Expansion Packs,10,0,0.0,10
39855,10310,Game Packs,2,0,0.0,2
39856,10310,Stuff Packs,2,0,0.0,2
39857,10311,Expansion Packs,15,1,0.06666666666666667,14
39858,10311,Game Packs,9,0,0.0,9
39859,10311,Kits,9,2,0.2222222222222222,7
39860,10311,Stuff Packs,13,2,0.15384615384615385,11
39861,10312,Expansion Packs,16,0,0.0,16
39862,10312,Game Packs,12,0,0.0,12
39863,10312,Kits,10,1,0.1,9
39864,10312,Stuff Packs,20,0,0.0,20
39865,10313,Expansion Packs,15,0,0.0,15
39866,10313,Game Packs,11,0,0.0,11
39867,10313,Kits,7,0,0.0,7
39868,10313,Stuff Packs,19,0,0.0,19
39869,10314,Expansion Packs,5,0,0.0,5
39870,10315,Expansion Packs,10,0,0.0,10
39871,10315,Game Packs,2,1,0.5,1
39872,10315,Kits,3,1,0.3333333333333333,2
39873,10315,Stuff Packs,3,2,0.6666666666666666,1
39874,10316,Expansion Packs,16,0,0.0,16
39875,10316,Game Packs,12,0,0.0,12
39876,10316,Kits,31,0,0.0,31
39877,10316,Stuff Packs,20,0,0.0,20
39878,10317,Expansion Packs,13,0,0.0,13
39879,10317,Game Packs,11,0,0.0,11
39880,10317,Kits,14,0,0.0,14
39881,10317,Stuff Packs,18,0,0.0,18
39882,10318,Expansion Packs,14,0,0.0,14
39883,10318,Game Packs,11,0,0.0,11
39884,10318,Kits,1,1,1.0,0
39885,10318,Stuff Packs,18,0,0.0,18
39886,10319,Expansion Packs,12,0,0.0,12
39887,10319,Game Packs,6,0,0.0,6
39888,10319,Kits,4,1,0.25,3
39889,10319,Stuff Packs,12,0,0.0,12
39890,10320,Expansion Packs,3,0,0.0,3
39891,10320,Kits,2,2,1.0,0
39892,10320,Stuff Packs,1,1,1.0,0
39893,10321,Expansion Packs,16,0,0.0,16
39894,10321,Game Packs,10,0,0.0,10
39895,10321,Kits,14,1,0.07142857142857142,13
39896,10321,Stuff Packs,14,0,0.0,14
39897,10322,Expansion Packs,16,0,0.0,16
39898,10322,Game Packs,11,1,0.09090909090909091,10
39899,10322,Kits,5,2,0.4,3
39900,10322,Stuff Packs,17,3,0.17647058823529413,14
39901,10323,Expansion Packs,16,0,0.0,16
39902,10323,Game Packs,11,1,0.09090909090909091,10
39903,10323,Kits,2,2,1.0,0
39904,10323,Stuff Packs,17,3,0.17647058823529413,14
39905,10324,Expansion Packs,14,0,0.0,14
39906,10324,Game Packs,9,0,0.0,9
39907,10324,Kits,6,2,0.3333333333333333,4
39908,10324,Stuff Packs,16,2,0.125,14
39909,10325,Expansion Packs,16,0,0.0,16
39910,10325,Game Packs,12,0,0.0,12
39911,10325,Kits,33,0,0.0,33
39912,10325,Stuff Packs,20,0,0.0,20
39913,10326,Expansion Packs,15,0,0.0,15
39914,10326,Game Packs,7,0,0.0,7
39915,10326,Kits,1,1,1.0,0
39916,10326,Stuff Packs,13,2,0.15384615384615385,11
39917,10327,Expansion Packs,16,0,0.0,16
39918,10327,Game Packs,12,0,0.0,12
39919,10327,Kits,30,0,0.0,30
39920,10327,Stuff Packs,20,0,0.0,20
39921,10328,Expansion Packs,15,0,0.0,15
39922,10328,Game Packs,9,1,0.1111111111111111,8
39923,10328,Kits,13,4,0.3076923076923077,9
39924,10328,Stuff Packs,13,1,0.07692307692307693,12
39925,10329,Expansion Packs,16,0,0.0,16
39926,10329,Game Packs,12,0,0.0,12
39927,10329,Kits,33,0,0.0,33
39928,10329,Stuff Packs,20,0,0.0,20
39929,10330,Expansion Packs,5,0,0.0,5
39930,10330,Kits,1,0,0.0,1
39931,10330,Stuff Packs,6,0,0.0,6
39932,10331,Expansion Packs,13,0,0.0,13
39933,10331,Game Packs,9,0,0.0,9
39934,10331,Kits,2,2,1.0,0
39935,10331,Stuff Packs,1,0,0.0,1
39936,10332,Expansion Packs,16,0,0.0,16
39937,10332,Game Packs,12,0,0.0,12
39938,10332,Kits,30,1,0.03333333333333333,29
39939,10332,Stuff Packs,20,0,0.0,20
39940,10333,Expansion Packs,6,0,0.0,6
39941,10333,Game Packs,2,0,0.0,2
39942,10333,Kits,2,0,0.0,2
39943,10333,Stuff Packs,5,1,0.2,4
39944,10334,Expansion Packs,16,0,0.0,16
39945,10334,Game Packs,12,0,0.0,12
39946,10334,Kits,33,0,0.0,33
39947,10334,Stuff Packs,20,0,0.0,20
39948,10335,Expansion Packs,12,0,0.0,12
39949,10335,Game Packs,8,0,0.0,8
39950,10335,Kits,3,0,0.0,3
39951,10335,Stuff Packs,15,0,0.0,15
39952,10336,Expansion Packs,10,1,0.1,9
39953,10336,Game Packs,9,1,0.1111111111111111,8
39954,10336,Stuff Packs,16,0,0.0,16
39955,10337,Expansion Packs,15,0,0.0,15
39956,10337,Game Packs,12,0,0.0,12
39957,10337,Kits,8,1,0.125,7
39958,10337,Stuff Packs,20,0,0.0,20
39959,10338,Expansion Packs,13,0,0.0,13
39960,10338,Game Packs,5,0,0.0,5
39961,10338,Kits,8,1,0.125,7
39962,10338,Stuff Packs,15,2,0.13333333333333333,13
39963,10339,Expansion Packs,14,0,0.0,14
39964,10339,Game Packs,7,0,0.0,7
39965,10339,Kits,1,0,0.0,1
39966,10339,Stuff Packs,9,0,0.0,9
39967,10340,Expansion Packs,15,0,0.0,15
39968,10340,Game Packs,10,0,0.0,10
39969,10340,Kits,9,0,0.0,9
39970,10340,Stuff Packs,20,0,0.0,20
39971,10341,Expansion Packs,14,0,0.0,14
39972,10341,Game Packs,7,0,0.0,7
39973,10341,Kits,1,0,0.0,1
39974,10341,Stuff Packs,11,0,0.0,11
39975,10342,Expansion Packs,15,0,0.0,15
39976,10342,Game Packs,9,0,0.0,9
39977,10342,Kits,15,0,0.0,15
39978,10342,Stuff Packs,14,0,0.0,14
39979,10343,Expansion Packs,8,0,0.0,8
39980,10343,Game Packs,1,0,0.0,1
39981,10343,Kits,4,1,0.25,3
39982,10343,Stuff Packs,5,3,0.6,2
39983,10344,Expansion Packs,5,0,0.0,5
39984,10344,Game Packs,3,0,0.0,3
39985,10344,Stuff Packs,5,2,0.4,3
39986,10345,Expansion Packs,12,0,0.0,12
39987,10345,Game Packs,6,0,0.0,6
39988,10345,Kits,3,0,0.0,3
39989,10345,Stuff Packs,10,0,0.0,10
39990,10346,Expansion Packs,4,0,0.0,4
39991,10346,Game Packs,5,0,0.0,5
39992,10346,Kits,1,0,0.0,1
39993,10346,Stuff Packs,4,2,0.5,2
39994,10347,Expansion Packs,6,0,0.0,6
39995,10347,Game Packs,6,0,0.0,6
39996,10347,Kits,3,1,0.3333333333333333,2
39997,10347,Stuff Packs,12,3,0.25,9
39998,10348,Expansion Packs,14,0,0.0,14
39999,10348,Game Packs,5,1,0.2,4
40000,10348,Kits,3,1,0.3333333333333333,2
40001,10348,Stuff Packs,3,2,0.6666666666666666,1
40002,10349,Expansion Packs,16,0,0.0,16
40003,10349,Game Packs,12,1,0.08333333333333333,11
40004,10349,Kits,14,3,0.21428571428571427,11
40005,10349,Stuff Packs,18,0,0.0,18
40006,10350,Expansion Packs,8,0,0.0,8
40007,10350,Game Packs,4,0,0.0,4
40008,10350,Kits,3,1,0.3333333333333333,2
40009,10350,Stuff Packs,9,2,0.2222222222222222,7
40010,10351,Expansion Packs,16,0,0.0,16
40011,10351,Game Packs,10,0,0.0,10
40012,10351,Kits,3,2,0.6666666666666666,1
40013,10351,Stuff Packs,12,2,0.16666666666666666,10
40014,10352,Expansion Packs,16,0,0.0,16
40015,10352,Game Packs,11,0,0.0,11
40016,10352,Kits,26,1,0.038461538461538464,25
40017,10352,Stuff Packs,19,1,0.05263157894736842,18
40018,10353,Expansion Packs,15,0,0.0,15
40019,10353,Game Packs,10,0,0.0,10
40020,10353,Kits,5,0,0.0,5
40021,10353,Stuff Packs,10,1,0.1,9
40022,10354,Expansion Packs,16,0,0.0,16
40023,10354,Game Packs,12,0,0.0,12
40024,10354,Kits,33,0,0.0,33
40025,10354,Stuff Packs,20,0,0.0,20
40026,10355,Expansion Packs,16,0,0.0,16
40027,10355,Game Packs,12,0,0.0,12
40028,10355,Kits,7,0,0.0,7
40029,10355,Stuff Packs,20,0,0.0,20
40030,10356,Expansion Packs,16,0,0.0,16
40031,10356,Game Packs,12,0,0.0,12
40032,10356,Kits,33,0,0.0,33
40033,10356,Stuff Packs,20,0,0.0,20
40034,10357,Expansion Packs,10,0,0.0,10
40035,10357,Game Packs,2,0,0.0,2
40036,10357,Kits,2,0,0.0,2
40037,10357,Stuff Packs,11,0,0.0,11
40038,10358,Expansion Packs,16,0,0.0,16
40039,10358,Game Packs,12,0,0.0,12
40040,10358,Kits,5,0,0.0,5
40041,10358,Stuff Packs,11,0,0.0,11
40042,10359,Expansion Packs,10,0,0.0,10
40043,10359,Game Packs,4,0,0.0,4
40044,10359,Kits,2,2,1.0,0
40045,10359,Stuff Packs,10,2,0.2,8
40046,10360,Expansion Packs,16,0,0.0,16
40047,10360,Game Packs,12,0,0.0,12
40048,10360,Kits,5,0,0.0,5
40049,10360,Stuff Packs,10,2,0.2,8
40050,10361,Expansion Packs,1,0,0.0,1
40051,10361,Game Packs,1,0,0.0,1
40052,10361,Kits,1,0,0.0,1
40053,10361,Stuff Packs,1,1,1.0,0
40054,10362,Expansion Packs,14,0,0.0,14
40055,10362,Game Packs,7,0,0.0,7
40056,10362,Kits,8,1,0.125,7
40057,10362,Stuff Packs,16,0,0.0,16
40058,10363,Expansion Packs,16,0,0.0,16
40059,10363,Game Packs,12,0,0.0,12
40060,10363,Kits,20,0,0.0,20
40061,10363,Stuff Packs,20,0,0.0,20
40062,10364,Expansion Packs,12,0,0.0,12
40063,10364,Game Packs,11,0,0.0,11
40064,10364,Kits,1,0,0.0,1
40065,10364,Stuff Packs,18,0,0.0,18
40066,10365,Expansion Packs,14,0,0.0,14
40067,10365,Game Packs,6,0,0.0,6
40068,10365,Kits,7,2,0.2857142857142857,5
40069,10365,Stuff Packs,5,2,0.4,3
40070,10366,Expansion Packs,16,0,0.0,16
40071,10366,Game Packs,12,0,0.0,12
40072,10366,Kits,33,0,0.0,33
40073,10366,Stuff Packs,20,0,0.0,20
40074,10367,Expansion Packs,7,0,0.0,7
40075,10367,Game Packs,1,0,0.0,1
40076,10367,Kits,1,0,0.0,1
40077,10367,Stuff Packs,2,0,0.0,2
40078,10368,Expansion Packs,16,0,0.0,16
40079,10368,Game Packs,12,0,0.0,12
40080,10368,Kits,21,0,0.0,21
40081,10368,Stuff Packs,20,0,0.0,20
40082,10369,Expansion Packs,15,0,0.0,15
40083,10369,Game Packs,12,0,0.0,12
40084,10369,Kits,13,0,0.0,13
40085,10369,Stuff Packs,19,0,0.0,19
40086,10370,Expansion Packs,16,0,0.0,16
40087,10370,Game Packs,12,0,0.0,12
40088,10370,Kits,33,0,0.0,33
40089,10370,Stuff Packs,20,0,0.0,20
40090,10371,Expansion Packs,16,0,0.0,16
40091,10371,Game Packs,12,0,0.0,12
40092,10371,Kits,33,1,0.030303030303030304,32
40093,10371,Stuff Packs,20,2,0.1,18
40094,10372,Expansion Packs,2,0,0.0,2
40095,10372,Game Packs,1,1,1.0,0
40096,10372,Kits,2,2,1.0,0
40097,10372,Stuff Packs,1,1,1.0,0
40098,10373,Expansion Packs,6,0,0.0,6
40099,10373,Game Packs,4,0,0.0,4
40100,10373,Kits,1,1,1.0,0
40101,10373,Stuff Packs,4,1,0.25,3
40102,10374,Expansion Packs,11,0,0.0,11
40103,10374,Game Packs,4,1,0.25,3
40104,10374,Kits,4,1,0.25,3
40105,10374,Stuff Packs,5,2,0.4,3
40106,10375,Expansion Packs,13,0,0.0,13
40107,10375,Game Packs,12,0,0.0,12
40108,10375,Kits,19,0,0.0,19
40109,10375,Stuff Packs,18,0,0.0,18
40110,10376,Expansion Packs,14,0,0.0,14
40111,10376,Game Packs,9,0,0.0,9
40112,10376,Kits,2,2,1.0,0
40113,10376,Stuff Packs,11,2,0.18181818181818182,9
40114,10377,Expansion Packs,16,0,0.0,16
40115,10377,Game Packs,12,0,0.0,12
40116,10377,Kits,33,0,0.0,33
40117,10377,Stuff Packs,20,0,0.0,20
40118,10378,Expansion Packs,11,0,0.0,11
40119,10378,Game Packs,7,1,0.14285714285714285,6
40120,10378,Kits,8,3,0.375,5
40121,10378,Stuff Packs,7,3,0.42857142857142855,4
40122,10379,Expansion Packs,12,0,0.0,12
40123,10379,Game Packs,8,0,0.0,8
40124,10379,Kits,2,1,0.5,1
40125,10379,Stuff Packs,15,0,0.0,15
40126,10380,Expansion Packs,2,0,0.0,2
40127,10380,Stuff Packs,4,3,0.75,1
40128,10381,Expansion Packs,15,0,0.0,15
40129,10381,Game Packs,8,0,0.0,8
40130,10381,Kits,1,1,1.0,0
40131,10381,Stuff Packs,16,1,0.0625,15
40132,10382,Expansion Packs,4,0,0.0,4
40133,10382,Game Packs,3,0,0.0,3
40134,10382,Kits,5,1,0.2,4
40135,10382,Stuff Packs,6,1,0.16666666666666666,5
40136,10383,Expansion Packs,11,0,0.0,11
40137,10383,Game Packs,7,0,0.0,7
40138,10383,Kits,2,1,0.5,1
40139,10383,Stuff Packs,9,1,0.1111111111111111,8
40140,10384,Expansion Packs,16,0,0.0,16
40141,10384,Game Packs,10,0,0.0,10
40142,10384,Kits,15,1,0.06666666666666667,14
40143,10384,Stuff Packs,17,2,0.11764705882352941,15
40144,10385,Expansion Packs,16,0,0.0,16
40145,10385,Game Packs,12,0,0.0,12
40146,10385,Kits,30,0,0.0,30
40147,10385,Stuff Packs,20,0,0.0,20
40148,10386,Expansion Packs,16,0,0.0,16
40149,10386,Game Packs,11,0,0.0,11
40150,10386,Kits,6,0,0.0,6
40151,10386,Stuff Packs,13,0,0.0,13
40152,10387,Expansion Packs,16,0,0.0,16
40153,10387,Game Packs,12,0,0.0,12
40154,10387,Kits,33,1,0.030303030303030304,32
40155,10387,Stuff Packs,20,2,0.1,18
40156,10388,Expansion Packs,8,0,0.0,8
40157,10388,Game Packs,6,0,0.0,6
40158,10388,Stuff Packs,4,0,0.0,4
40159,10389,Expansion Packs,4,0,0.0,4
40160,10389,Game Packs,3,1,0.3333333333333333,2
40161,10389,Kits,3,2,0.6666666666666666,1
40162,10389,Stuff Packs,5,4,0.8,1
40163,10390,Expansion Packs,15,0,0.0,15
40164,10390,Game Packs,11,0,0.0,11
40165,10390,Kits,4,1,0.25,3
40166,10390,Stuff Packs,2,0,0.0,2
40167,10391,Expansion Packs,14,0,0.0,14
40168,10391,Game Packs,7,1,0.14285714285714285,6
40169,10391,Kits,12,3,0.25,9
40170,10391,Stuff Packs,12,4,0.3333333333333333,8
40171,10392,Expansion Packs,9,0,0.0,9
40172,10392,Game Packs,5,0,0.0,5
40173,10392,Kits,5,1,0.2,4
40174,10392,Stuff Packs,9,4,0.4444444444444444,5
40175,10393,Expansion Packs,9,0,0.0,9
40176,10393,Game Packs,6,0,0.0,6
40177,10393,Stuff Packs,10,0,0.0,10
40178,10394,Expansion Packs,14,0,0.0,14
40179,10394,Game Packs,12,1,0.08333333333333333,11
40180,10394,Kits,28,0,0.0,28
40181,10394,Stuff Packs,20,0,0.0,20
40182,10395,Expansion Packs,13,0,0.0,13
40183,10395,Game Packs,5,0,0.0,5
40184,10395,Kits,13,1,0.07692307692307693,12
40185,10395,Stuff Packs,12,0,0.0,12
40186,10396,Expansion Packs,16,0,0.0,16
40187,10396,Game Packs,11,0,0.0,11
40188,10396,Kits,16,1,0.0625,15
40189,10396,Stuff Packs,14,3,0.21428571428571427,11
40190,10397,Expansion Packs,16,0,0.0,16
40191,10397,Game Packs,12,0,0.0,12
40192,10397,Kits,3,0,0.0,3
40193,10397,Stuff Packs,20,0,0.0,20
40194,10398,Expansion Packs,1,0,0.0,1
40195,10398,Kits,2,2,1.0,0
40196,10398,Stuff Packs,4,4,1.0,0
40197,10399,Expansion Packs,4,0,0.0,4
40198,10399,Game Packs,2,0,0.0,2
40199,10399,Kits,1,1,1.0,0
40200,10399,Stuff Packs,4,2,0.5,2
40201,10400,Expansion Packs,10,0,0.0,10
40202,10400,Game Packs,2,0,0.0,2
40203,10400,Stuff Packs,5,2,0.4,3
40204,10401,Expansion Packs,1,0,0.0,1
40205,10401,Kits,1,1,1.0,0
40206,10401,Stuff Packs,3,3,1.0,0
40207,10402,Expansion Packs,9,0,0.0,9
40208,10402,Game Packs,5,0,0.0,5
40209,10402,Kits,23,1,0.043478260869565216,22
40210,10402,Stuff Packs,12,0,0.0,12
40211,10403,Expansion Packs,3,0,0.0,3
40212,10403,Game Packs,1,0,0.0,1
40213,10403,Kits,1,1,1.0,0
40214,10403,Stuff Packs,2,0,0.0,2
40215,10404,Expansion Packs,16,1,0.0625,15
40216,10404,Game Packs,12,2,0.16666666666666666,10
40217,10404,Kits,33,3,0.09090909090909091,30
40218,10404,Stuff Packs,20,0,0.0,20
40219,10405,Expansion Packs,7,0,0.0,7
40220,10405,Game Packs,7,0,0.0,7
40221,10405,Kits,2,2,1.0,0
40222,10405,Stuff Packs,9,2,0.2222222222222222,7
40223,10406,Expansion Packs,14,0,0.0,14
40224,10406,Game Packs,7,0,0.0,7
40225,10406,Kits,9,1,0.1111111111111111,8
40226,10406,Stuff Packs,8,1,0.125,7
40227,10407,Expansion Packs,12,0,0.0,12
40228,10407,Game Packs,8,0,0.0,8
40229,10407,Kits,9,0,0.0,9
40230,10407,Stuff Packs,17,0,0.0,17
40231,10408,Expansion Packs,16,0,0.0,16
40232,10408,Game Packs,11,0,0.0,11
40233,10408,Kits,33,0,0.0,33
40234,10408,Stuff Packs,20,0,0.0,20
40235,10409,Expansion Packs,16,0,0.0,16
40236,10409,Game Packs,11,0,0.0,11
40237,10409,Kits,15,2,0.13333333333333333,13
40238,10409,Stuff Packs,19,3,0.15789473684210525,16
40239,10410,Expansion Packs,10,0,0.0,10
40240,10410,Game Packs,6,0,0.0,6
40241,10410,Kits,4,3,0.75,1
40242,10410,Stuff Packs,7,3,0.42857142857142855,4
40243,10411,Expansion Packs,16,0,0.0,16
40244,10411,Game Packs,12,0,0.0,12
40245,10411,Kits,6,0,0.0,6
40246,10411,Stuff Packs,19,0,0.0,19
40247,10412,Expansion Packs,11,0,0.0,11
40248,10412,Game Packs,4,0,0.0,4
40249,10412,Kits,2,2,1.0,0
40250,10412,Stuff Packs,7,2,0.2857142857142857,5
40251,10413,Expansion Packs,9,0,0.0,9
40252,10413,Game Packs,4,0,0.0,4
40253,10413,Kits,10,2,0.2,8
40254,10413,Stuff Packs,5,3,0.6,2
40255,10414,Expansion Packs,9,0,0.0,9
40256,10414,Game Packs,4,1,0.25,3
40257,10414,Kits,1,1,1.0,0
40258,10414,Stuff Packs,3,0,0.0,3
40259,10415,Expansion Packs,8,0,0.0,8
40260,10415,Game Packs,1,0,0.0,1
40261,10415,Kits,1,0,0.0,1
40262,10415,Stuff Packs,5,2,0.4,3
40263,10416,Expansion Packs,14,0,0.0,14
40264,10416,Game Packs,9,0,0.0,9
40265,10416,Kits,12,2,0.16666666666666666,10
40266,10416,Stuff Packs,14,2,0.14285714285714285,12
40267,10417,Expansion Packs,10,0,0.0,10
40268,10417,Game Packs,5,0,0.0,5
40269,10417,Kits,3,1,0.3333333333333333,2
40270,10417,Stuff Packs,9,0,0.0,9
40271,10418,Expansion Packs,15,0,0.0,15
40272,10418,Game Packs,12,0,0.0,12
40273,10418,Kits,4,1,0.25,3
40274,10418,Stuff Packs,19,0,0.0,19
40275,10419,Expansion Packs,16,0,0.0,16
40276,10419,Game Packs,11,0,0.0,11
40277,10419,Kits,32,0,0.0,32
40278,10419,Stuff Packs,20,0,0.0,20
40279,10420,Expansion Packs,16,0,0.0,16
40280,10420,Game Packs,11,0,0.0,11
40281,10420,Kits,18,2,0.1111111111111111,16
40282,10420,Stuff Packs,20,0,0.0,20
40283,10421,Expansion Packs,16,0,0.0,16
40284,10421,Game Packs,12,0,0.0,12
40285,10421,Kits,33,2,0.06060606060606061,31
40286,10421,Stuff Packs,20,1,0.05,19
40287,10422,Expansion Packs,15,0,0.0,15
40288,10422,Game Packs,8,0,0.0,8
40289,10422,Kits,3,2,0.6666666666666666,1
40290,10422,Stuff Packs,16,2,0.125,14
40291,10423,Expansion Packs,16,0,0.0,16
40292,10423,Game Packs,8,0,0.0,8
40293,10423,Kits,15,0,0.0,15
40294,10423,Stuff Packs,13,0,0.0,13
40295,10424,Expansion Packs,10,0,0.0,10
40296,10424,Game Packs,6,0,0.0,6
40297,10424,Kits,9,2,0.2222222222222222,7
40298,10424,Stuff Packs,12,2,0.16666666666666666,10
40299,10425,Expansion Packs,16,0,0.0,16
40300,10425,Game Packs,11,0,0.0,11
40301,10425,Kits,21,0,0.0,21
40302,10425,Stuff Packs,20,0,0.0,20
40303,10426,Expansion Packs,11,0,0.0,11
40304,10426,Game Packs,8,0,0.0,8
40305,10426,Kits,2,0,0.0,2
40306,10426,Stuff Packs,13,0,0.0,13
40307,10427,Expansion Packs,16,0,0.0,16
40308,10427,Game Packs,11,0,0.0,11
40309,10427,Kits,11,1,0.09090909090909091,10
40310,10427,Stuff Packs,12,0,0.0,12
40311,10428,Expansion Packs,13,0,0.0,13
40312,10428,Game Packs,5,0,0.0,5
40313,10428,Kits,20,0,0.0,20
40314,10428,Stuff Packs,11,2,0.18181818181818182,9
40315,10429,Expansion Packs,9,0,0.0,9
40316,10429,Game Packs,1,0,0.0,1
40317,10429,Kits,8,0,0.0,8
40318,10429,Stuff Packs,4,0,0.0,4
40319,10430,Expansion Packs,16,0,0.0,16
40320,10430,Game Packs,10,0,0.0,10
40321,10430,Kits,24,2,0.08333333333333333,22
40322,10430,Stuff Packs,20,0,0.0,20
40323,10431,Expansion Packs,3,0,0.0,3
40324,10431,Game Packs,1,0,0.0,1
40325,10431,Stuff Packs,1,0,0.0,1
40326,10432,Expansion Packs,16,0,0.0,16
40327,10432,Game Packs,11,0,0.0,11
40328,10432,Kits,31,0,0.0,31
40329,10432,Stuff Packs,20,0,0.0,20
40330,10433,Expansion Packs,16,0,0.0,16
40331,10433,Game Packs,12,0,0.0,12
40332,10433,Kits,33,1,0.030303030303030304,32
40333,10433,Stuff Packs,20,0,0.0,20
40334,10434,Expansion Packs,16,0,0.0,16
40335,10434,Game Packs,11,0,0.0,11
40336,10434,Kits,7,0,0.0,7
40337,10434,Stuff Packs,13,1,0.07692307692307693,12
40338,10435,Expansion Packs,1,0,0.0,1
40339,10435,Game Packs,2,0,0.0,2
40340,10435,Kits,1,1,1.0,0
40341,10435,Stuff Packs,2,2,1.0,0
40342,10436,Expansion Packs,14,0,0.0,14
40343,10436,Game Packs,9,0,0.0,9
40344,10436,Kits,9,0,0.0,9
40345,10436,Stuff Packs,9,0,0.0,9
40346,10437,Expansion Packs,14,0,0.0,14
40347,10437,Game Packs,10,0,0.0,10
40348,10437,Kits,2,0,0.0,2
40349,10437,Stuff Packs,18,0,0.0,18
40350,10438,Expansion Packs,16,0,0.0,16
40351,10438,Game Packs,12,0,0.0,12
40352,10438,Kits,26,1,0.038461538461538464,25
40353,10438,Stuff Packs,19,0,0.0,19
40354,10439,Expansion Packs,6,0,0.0,6
40355,10439,Game Packs,2,0,0.0,2
40356,10439,Stuff Packs,5,3,0.6,2
40357,10440,Expansion Packs,16,0,0.0,16
40358,10440,Game Packs,10,0,0.0,10
40359,10440,Kits,1,1,1.0,0
40360,10440,Stuff Packs,16,1,0.0625,15
40361,10441,Expansion Packs,13,0,0.0,13
40362,10441,Game Packs,5,0,0.0,5
40363,10441,Kits,3,1,0.3333333333333333,2
40364,10441,Stuff Packs,8,3,0.375,5
40365,10442,Expansion Packs,15,0,0.0,15
40366,10442,Game Packs,11,0,0.0,11
40367,10442,Kits,1,0,0.0,1
40368,10442,Stuff Packs,11,1,0.09090909090909091,10
40369,10443,Expansion Packs,16,0,0.0,16
40370,10443,Game Packs,12,0,0.0,12
40371,10443,Kits,33,0,0.0,33
40372,10443,Stuff Packs,20,0,0.0,20
40373,10444,Expansion Packs,2,0,0.0,2
40374,10444,Game Packs,1,0,0.0,1
40375,10444,Kits,2,2,1.0,0
40376,10444,Stuff Packs,5,3,0.6,2
40377,10445,Expansion Packs,6,0,0.0,6
40378,10445,Stuff Packs,1,1,1.0,0
40379,10446,Expansion Packs,16,0,0.0,16
40380,10446,Game Packs,11,0,0.0,11
40381,10446,Kits,6,0,0.0,6
40382,10446,Stuff Packs,15,2,0.13333333333333333,13
40383,10447,Expansion Packs,12,0,0.0,12
40384,10447,Game Packs,4,0,0.0,4
40385,10447,Kits,1,1,1.0,0
40386,10447,Stuff Packs,5,0,0.0,5
40387,10448,Expansion Packs,13,0,0.0,13
40388,10448,Game Packs,7,0,0.0,7
40389,10448,Stuff Packs,7,0,0.0,7
40390,10449,Expansion Packs,16,0,0.0,16
40391,10449,Game Packs,12,0,0.0,12
40392,10449,Kits,33,1,0.030303030303030304,32
40393,10449,Stuff Packs,20,0,0.0,20
40394,10450,Expansion Packs,12,0,0.0,12
40395,10450,Game Packs,12,0,0.0,12
40396,10450,Kits,5,1,0.2,4
40397,10450,Stuff Packs,15,0,0.0,15
40398,10451,Expansion Packs,13,0,0.0,13
40399,10451,Game Packs,9,0,0.0,9
40400,10451,Kits,3,3,1.0,0
40401,10451,Stuff Packs,14,2,0.14285714285714285,12
40402,10452,Expansion Packs,11,0,0.0,11
40403,10452,Game Packs,7,0,0.0,7
40404,10452,Kits,8,1,0.125,7
40405,10452,Stuff Packs,12,3,0.25,9
40406,10453,Expansion Packs,11,0,0.0,11
40407,10453,Game Packs,9,0,0.0,9
40408,10453,Kits,5,1,0.2,4
40409,10453,Stuff Packs,4,1,0.25,3
40410,10454,Expansion Packs,11,0,0.0,11
40411,10454,Game Packs,5,1,0.2,4
40412,10454,Kits,6,0,0.0,6
40413,10454,Stuff Packs,5,2,0.4,3
40414,10455,Expansion Packs,10,0,0.0,10
40415,10455,Game Packs,7,0,0.0,7
40416,10455,Kits,3,1,0.3333333333333333,2
40417,10455,Stuff Packs,14,1,0.07142857142857142,13
40418,10456,Expansion Packs,4,0,0.0,4
40419,10456,Game Packs,3,0,0.0,3
40420,10456,Kits,1,1,1.0,0
40421,10456,Stuff Packs,5,2,0.4,3
40422,10457,Expansion Packs,12,0,0.0,12
40423,10457,Game Packs,9,0,0.0,9
40424,10457,Kits,1,1,1.0,0
40425,10457,Stuff Packs,10,0,0.0,10
40426,10458,Expansion Packs,16,0,0.0,16
40427,10458,Game Packs,11,0,0.0,11
40428,10458,Kits,19,3,0.15789473684210525,16
40429,10458,Stuff Packs,20,0,0.0,20
40430,10459,Expansion Packs,16,0,0.0,16
40431,10459,Game Packs,11,0,0.0,11
40432,10459,Kits,24,0,0.0,24
40433,10459,Stuff Packs,15,1,0.06666666666666667,14
40434,10460,Expansion Packs,13,0,0.0,13
40435,10460,Game Packs,5,0,0.0,5
40436,10460,Kits,1,1,1.0,0
40437,10460,Stuff Packs,10,0,0.0,10
40438,10461,Expansion Packs,4,0,0.0,4
40439,10461,Game Packs,1,0,0.0,1
40440,10461,Stuff Packs,1,0,0.0,1
40441,10462,Expansion Packs,16,0,0.0,16
40442,10462,Game Packs,12,0,0.0,12
40443,10462,Kits,24,2,0.08333333333333333,22
40444,10462,Stuff Packs,20,1,0.05,19
40445,10463,Expansion Packs,10,0,0.0,10
40446,10463,Game Packs,4,0,0.0,4
40447,10463,Kits,1,1,1.0,0
40448,10463,Stuff Packs,11,1,0.09090909090909091,10
40449,10464,Expansion Packs,16,0,0.0,16
40450,10464,Game Packs,12,0,0.0,12
40451,10464,Kits,21,0,0.0,21
40452,10464,Stuff Packs,16,0,0.0,16
40453,10465,Expansion Packs,16,0,0.0,16
40454,10465,Game Packs,12,0,0.0,12
40455,10465,Kits,29,1,0.034482758620689655,28
40456,10465,Stuff Packs,20,0,0.0,20
40457,10466,Expansion Packs,13,0,0.0,13
40458,10466,Game Packs,5,1,0.2,4
40459,10466,Kits,4,2,0.5,2
40460,10466,Stuff Packs,10,2,0.2,8
40461,10467,Expansion Packs,16,0,0.0,16
40462,10467,Game Packs,12,0,0.0,12
40463,10467,Kits,33,1,0.030303030303030304,32
40464,10467,Stuff Packs,20,2,0.1,18
40465,10468,Expansion Packs,16,0,0.0,16
40466,10468,Game Packs,11,0,0.0,11
40467,10468,Kits,28,0,0.0,28
40468,10468,Stuff Packs,19,0,0.0,19
40469,10469,Expansion Packs,16,0,0.0,16
40470,10469,Game Packs,11,0,0.0,11
40471,10469,Kits,18,1,0.05555555555555555,17
40472,10469,Stuff Packs,19,0,0.0,19
40473,10470,Expansion Packs,16,0,0.0,16
40474,10470,Game Packs,11,0,0.0,11
40475,10470,Kits,19,1,0.05263157894736842,18
40476,10470,Stuff Packs,20,0,0.0,20
40477,10471,Expansion Packs,14,0,0.0,14
40478,10471,Game Packs,11,0,0.0,11
40479,10471,Kits,3,2,0.6666666666666666,1
40480,10471,Stuff Packs,16,0,0.0,16
40481,10472,Expansion Packs,16,0,0.0,16
40482,10472,Game Packs,11,0,0.0,11
40483,10472,Kits,31,1,0.03225806451612903,30
40484,10472,Stuff Packs,20,0,0.0,20
40485,10473,Expansion Packs,12,0,0.0,12
40486,10473,Game Packs,11,0,0.0,11
40487,10473,Kits,11,1,0.09090909090909091,10
40488,10473,Stuff Packs,19,0,0.0,19
40489,10474,Expansion Packs,16,0,0.0,16
40490,10474,Game Packs,12,0,0.0,12
40491,10474,Kits,28,1,0.03571428571428571,27
40492,10474,Stuff Packs,20,1,0.05,19
40493,10475,Expansion Packs,16,0,0.0,16
40494,10475,Game Packs,11,0,0.0,11
40495,10475,Kits,19,1,0.05263157894736842,18
40496,10475,Stuff Packs,20,0,0.0,20
40497,10476,Game Packs,1,1,1.0,0
40498,10476,Kits,1,1,1.0,0
40499,10476,Stuff Packs,4,4,1.0,0
40500,10477,Expansion Packs,11,0,0.0,11
40501,10477,Game Packs,8,0,0.0,8
40502,10477,Kits,2,2,1.0,0
40503,10477,Stuff Packs,19,0,0.0,19
40504,10478,Expansion Packs,8,0,0.0,8
40505,10478,Game Packs,6,1,0.16666666666666666,5
40506,10478,Kits,3,3,1.0,0
40507,10478,Stuff Packs,10,4,0.4,6
40508,10479,Expansion Packs,14,0,0.0,14
40509,10479,Game Packs,10,0,0.0,10
40510,10479,Kits,2,0,0.0,2
40511,10479,Stuff Packs,15,0,0.0,15
40512,10480,Expansion Packs,15,0,0.0,15
40513,10480,Game Packs,12,0,0.0,12
40514,10480,Kits,3,2,0.6666666666666666,1
40515,10480,Stuff Packs,14,0,0.0,14
40516,10481,Expansion Packs,16,0,0.0,16
40517,10481,Game Packs,12,0,0.0,12
40518,10481,Kits,33,0,0.0,33
40519,10481,Stuff Packs,20,0,0.0,20
40520,10482,Expansion Packs,11,0,0.0,11
40521,10482,Game Packs,7,0,0.0,7
40522,10482,Kits,3,1,0.3333333333333333,2
40523,10482,Stuff Packs,11,2,0.18181818181818182,9
40524,10483,Expansion Packs,15,0,0.0,15
40525,10483,Game Packs,7,0,0.0,7
40526,10483,Kits,2,2,1.0,0
40527,10483,Stuff Packs,9,1,0.1111111111111111,8
40528,10484,Expansion Packs,13,0,0.0,13
40529,10484,Game Packs,10,0,0.0,10
40530,10484,Kits,2,2,1.0,0
40531,10484,Stuff Packs,10,0,0.0,10
40532,10485,Expansion Packs,16,0,0.0,16
40533,10485,Game Packs,12,0,0.0,12
40534,10485,Kits,12,1,0.08333333333333333,11
40535,10485,Stuff Packs,20,0,0.0,20
40536,10486,Expansion Packs,16,0,0.0,16
40537,10486,Game Packs,12,0,0.0,12
40538,10486,Kits,33,0,0.0,33
40539,10486,Stuff Packs,20,0,0.0,20
40540,10487,Expansion Packs,15,0,0.0,15
40541,10487,Game Packs,11,0,0.0,11
40542,10487,Kits,22,1,0.045454545454545456,21
40543,10487,Stuff Packs,19,0,0.0,19
40544,10488,Expansion Packs,7,0,0.0,7
40545,10488,Game Packs,4,1,0.25,3
40546,10488,Kits,7,2,0.2857142857142857,5
40547,10488,Stuff Packs,9,3,0.3333333333333333,6
40548,10489,Expansion Packs,16,0,0.0,16
40549,10489,Game Packs,12,1,0.08333333333333333,11
40550,10489,Kits,21,0,0.0,21
40551,10489,Stuff Packs,20,0,0.0,20
40552,10490,Expansion Packs,14,0,0.0,14
40553,10490,Game Packs,9,0,0.0,9
40554,10490,Kits,21,0,0.0,21
40555,10490,Stuff Packs,20,0,0.0,20
40556,10491,Expansion Packs,5,0,0.0,5
40557,10491,Game Packs,4,1,0.25,3
40558,10491,Kits,3,3,1.0,0
40559,10491,Stuff Packs,6,3,0.5,3
40560,10492,Expansion Packs,16,0,0.0,16
40561,10492,Game Packs,11,0,0.0,11
40562,10492,Kits,20,1,0.05,19
40563,10492,Stuff Packs,18,0,0.0,18
40564,10493,Expansion Packs,9,1,0.1111111111111111,8
40565,10493,Game Packs,1,0,0.0,1
40566,10493,Kits,1,1,1.0,0
40567,10493,Stuff Packs,3,2,0.6666666666666666,1
40568,10494,Expansion Packs,16,2,0.125,14
40569,10494,Game Packs,12,1,0.08333333333333333,11
40570,10494,Kits,33,0,0.0,33
40571,10494,Stuff Packs,20,0,0.0,20
40572,10495,Expansion Packs,16,0,0.0,16
40573,10495,Game Packs,11,0,0.0,11
40574,10495,Kits,20,1,0.05,19
40575,10495,Stuff Packs,20,1,0.05,19
40576,10496,Expansion Packs,2,0,0.0,2
40577,10496,Kits,1,1,1.0,0
40578,10497,Expansion Packs,11,0,0.0,11
40579,10497,Game Packs,9,0,0.0,9
40580,10497,Stuff Packs,17,0,0.0,17
40581,10498,Expansion Packs,3,0,0.0,3
40582,10498,Game Packs,1,0,0.0,1
40583,10498,Kits,1,1,1.0,0
40584,10498,Stuff Packs,3,2,0.6666666666666666,1
40585,10499,Expansion Packs,16,0,0.0,16
40586,10499,Game Packs,12,0,0.0,12
40587,10499,Kits,4,2,0.5,2
40588,10499,Stuff Packs,11,1,0.09090909090909091,10
40589,10500,Expansion Packs,11,0,0.0,11
40590,10500,Game Packs,7,0,0.0,7
40591,10500,Kits,14,0,0.0,14
40592,10500,Stuff Packs,6,0,0.0,6
40593,10501,Expansion Packs,16,0,0.0,16
40594,10501,Game Packs,11,0,0.0,11
40595,10501,Kits,27,0,0.0,27
40596,10501,Stuff Packs,17,0,0.0,17
40597,10502,Expansion Packs,7,0,0.0,7
40598,10502,Game Packs,3,0,0.0,3
40599,10502,Kits,3,0,0.0,3
40600,10502,Stuff Packs,7,0,0.0,7
40601,10503,Expansion Packs,14,0,0.0,14
40602,10503,Game Packs,11,0,0.0,11
40603,10503,Kits,6,1,0.16666666666666666,5
40604,10503,Stuff Packs,20,1,0.05,19
40605,10504,Expansion Packs,5,0,0.0,5
40606,10504,Game Packs,6,0,0.0,6
40607,10504,Kits,3,3,1.0,0
40608,10504,Stuff Packs,9,3,0.3333333333333333,6
40609,10505,Expansion Packs,15,0,0.0,15
40610,10505,Game Packs,11,0,0.0,11
40611,10505,Kits,3,2,0.6666666666666666,1
40612,10505,Stuff Packs,18,0,0.0,18
40613,10506,Expansion Packs,12,0,0.0,12
40614,10506,Game Packs,6,0,0.0,6
40615,10506,Stuff Packs,9,1,0.1111111111111111,8
40616,10507,Expansion Packs,16,0,0.0,16
40617,10507,Game Packs,12,0,0.0,12
40618,10507,Kits,33,0,0.0,33
40619,10507,Stuff Packs,20,0,0.0,20
40620,10508,Expansion Packs,16,0,0.0,16
40621,10508,Game Packs,12,0,0.0,12
40622,10508,Kits,33,0,0.0,33
40623,10508,Stuff Packs,20,0,0.0,20
40624,10509,Expansion Packs,13,0,0.0,13
40625,10509,Game Packs,11,0,0.0,11
40626,10509,Kits,4,2,0.5,2
40627,10509,Stuff Packs,17,1,0.058823529411764705,16
40628,10510,Expansion Packs,3,0,0.0,3
40629,10510,Game Packs,1,0,0.0,1
40630,10510,Kits,2,1,0.5,1
40631,10510,Stuff Packs,4,3,0.75,1
40632,10511,Expansion Packs,14,0,0.0,14
40633,10511,Game Packs,7,1,0.14285714285714285,6
40634,10511,Kits,5,1,0.2,4
40635,10511,Stuff Packs,10,1,0.1,9
40636,10512,Expansion Packs,15,0,0.0,15
40637,10512,Game Packs,9,1,0.1111111111111111,8
40638,10512,Kits,11,3,0.2727272727272727,8
40639,10512,Stuff Packs,12,4,0.3333333333333333,8
40640,10513,Expansion Packs,13,0,0.0,13
40641,10513,Game Packs,9,0,0.0,9
40642,10513,Kits,2,2,1.0,0
40643,10513,Stuff Packs,11,2,0.18181818181818182,9
40644,10514,Expansion Packs,15,0,0.0,15
40645,10514,Game Packs,12,0,0.0,12
40646,10514,Kits,8,2,0.25,6
40647,10514,Stuff Packs,18,2,0.1111111111111111,16
40648,10515,Expansion Packs,10,0,0.0,10
40649,10515,Game Packs,4,0,0.0,4
40650,10515,Kits,4,1,0.25,3
40651,10515,Stuff Packs,10,0,0.0,10
40652,10516,Expansion Packs,10,0,0.0,10
40653,10516,Game Packs,4,0,0.0,4
40654,10516,Kits,16,0,0.0,16
40655,10516,Stuff Packs,10,1,0.1,9
40656,10517,Expansion Packs,5,0,0.0,5
40657,10517,Game Packs,2,1,0.5,1
40658,10517,Kits,2,2,1.0,0
40659,10517,Stuff Packs,5,4,0.8,1
40660,10518,Expansion Packs,7,0,0.0,7
40661,10518,Game Packs,2,0,0.0,2
40662,10518,Kits,10,0,0.0,10
40663,10518,Stuff Packs,7,2,0.2857142857142857,5
40664,10519,Expansion Packs,11,0,0.0,11
40665,10519,Game Packs,4,0,0.0,4
40666,10519,Kits,3,2,0.6666666666666666,1
40667,10519,Stuff Packs,6,2,0.3333333333333333,4
40668,10520,Expansion Packs,16,0,0.0,16
40669,10520,Game Packs,11,1,0.09090909090909091,10
40670,10520,Kits,17,0,0.0,17
40671,10520,Stuff Packs,15,3,0.2,12
40672,10521,Expansion Packs,9,0,0.0,9
40673,10521,Game Packs,7,0,0.0,7
40674,10521,Kits,1,1,1.0,0
40675,10521,Stuff Packs,8,1,0.125,7
40676,10522,Expansion Packs,16,0,0.0,16
40677,10522,Game Packs,12,0,0.0,12
40678,10522,Kits,33,0,0.0,33
40679,10522,Stuff Packs,20,0,0.0,20
40680,10523,Expansion Packs,12,0,0.0,12
40681,10523,Game Packs,6,0,0.0,6
40682,10523,Kits,1,0,0.0,1
40683,10523,Stuff Packs,9,0,0.0,9
40684,10524,Expansion Packs,12,0,0.0,12
40685,10524,Game Packs,11,0,0.0,11
40686,10524,Kits,11,0,0.0,11
40687,10524,Stuff Packs,20,0,0.0,20
40688,10525,Expansion Packs,15,0,0.0,15
40689,10525,Game Packs,10,0,0.0,10
40690,10525,Kits,8,0,0.0,8
40691,10525,Stuff Packs,17,0,0.0,17
40692,10526,Expansion Packs,14,0,0.0,14
40693,10526,Game Packs,9,1,0.1111111111111111,8
40694,10526,Kits,5,3,0.6,2
40695,10526,Stuff Packs,11,3,0.2727272727272727,8
40696,10527,Expansion Packs,16,0,0.0,16
40697,10527,Game Packs,12,0,0.0,12
40698,10527,Kits,28,0,0.0,28
40699,10527,Stuff Packs,19,0,0.0,19
40700,10528,Expansion Packs,4,0,0.0,4
40701,10528,Game Packs,4,0,0.0,4
40702,10528,Kits,2,0,0.0,2
40703,10528,Stuff Packs,5,0,0.0,5
40704,10529,Expansion Packs,2,0,0.0,2
40705,10529,Game Packs,2,0,0.0,2
40706,10529,Kits,1,1,1.0,0
40707,10529,Stuff Packs,2,2,1.0,0
40708,10530,Expansion Packs,12,0,0.0,12
40709,10530,Game Packs,5,0,0.0,5
40710,10530,Stuff Packs,2,0,0.0,2
40711,10531,Expansion Packs,16,0,0.0,16
40712,10531,Game Packs,12,0,0.0,12
40713,10531,Kits,21,1,0.047619047619047616,20
40714,10531,Stuff Packs,19,0,0.0,19
40715,10532,Expansion Packs,11,0,0.0,11
40716,10532,Game Packs,5,1,0.2,4
40717,10532,Kits,18,1,0.05555555555555555,17
40718,10532,Stuff Packs,16,3,0.1875,13
40719,10533,Expansion Packs,16,0,0.0,16
40720,10533,Game Packs,11,0,0.0,11
40721,10533,Kits,21,2,0.09523809523809523,19
40722,10533,Stuff Packs,20,1,0.05,19
40723,10534,Expansion Packs,9,0,0.0,9
40724,10534,Game Packs,5,0,0.0,5
40725,10534,Kits,3,0,0.0,3
40726,10534,Stuff Packs,4,1,0.25,3
40727,10535,Expansion Packs,16,0,0.0,16
40728,10535,Game Packs,12,0,0.0,12
40729,10535,Kits,22,1,0.045454545454545456,21
40730,10535,Stuff Packs,20,0,0.0,20
40731,10536,Expansion Packs,12,0,0.0,12
40732,10536,Game Packs,5,0,0.0,5
40733,10536,Kits,7,0,0.0,7
40734,10536,Stuff Packs,11,1,0.09090909090909091,10
40735,10537,Expansion Packs,9,0,0.0,9
40736,10537,Game Packs,5,0,0.0,5
40737,10537,Stuff Packs,6,0,0.0,6
40738,10538,Expansion Packs,16,0,0.0,16
40739,10538,Game Packs,11,0,0.0,11
40740,10538,Kits,21,2,0.09523809523809523,19
40741,10538,Stuff Packs,20,0,0.0,20
40742,10539,Expansion Packs,12,0,0.0,12
40743,10539,Game Packs,4,1,0.25,3
40744,10539,Stuff Packs,5,1,0.2,4
40745,10540,Expansion Packs,11,0,0.0,11
40746,10540,Game Packs,3,1,0.3333333333333333,2
40747,10540,Kits,2,2,1.0,0
40748,10540,Stuff Packs,10,4,0.4,6
40749,10541,Expansion Packs,5,0,0.0,5
40750,10541,Game Packs,2,0,0.0,2
40751,10541,Kits,1,1,1.0,0
40752,10541,Stuff Packs,5,0,0.0,5
40753,10542,Expansion Packs,16,0,0.0,16
40754,10542,Game Packs,12,1,0.08333333333333333,11
40755,10542,Kits,21,2,0.09523809523809523,19
40756,10542,Stuff Packs,20,0,0.0,20
40757,10543,Expansion Packs,15,0,0.0,15
40758,10543,Game Packs,4,0,0.0,4
40759,10543,Kits,7,1,0.14285714285714285,6
40760,10543,Stuff Packs,5,2,0.4,3
40761,10544,Expansion Packs,16,0,0.0,16
40762,10544,Game Packs,12,0,0.0,12
40763,10544,Kits,14,0,0.0,14
40764,10544,Stuff Packs,17,2,0.11764705882352941,15
40765,10545,Expansion Packs,5,0,0.0,5
40766,10545,Game Packs,3,0,0.0,3
40767,10545,Kits,2,2,1.0,0
40768,10545,Stuff Packs,6,3,0.5,3
40769,10546,Expansion Packs,1,0,0.0,1
40770,10546,Kits,1,1,1.0,0
40771,10546,Stuff Packs,2,2,1.0,0
40772,10547,Expansion Packs,14,0,0.0,14
40773,10547,Game Packs,12,0,0.0,12
40774,10547,Kits,7,0,0.0,7
40775,10547,Stuff Packs,18,0,0.0,18
40776,10548,Expansion Packs,12,0,0.0,12
40777,10548,Game Packs,6,0,0.0,6
40778,10548,Stuff Packs,3,1,0.3333333333333333,2
40779,10549,Expansion Packs,5,0,0.0,5
40780,10549,Game Packs,4,0,0.0,4
40781,10549,Kits,2,2,1.0,0
40782,10549,Stuff Packs,6,3,0.5,3
40783,10550,Expansion Packs,13,0,0.0,13
40784,10550,Game Packs,5,0,0.0,5
40785,10550,Stuff Packs,8,5,0.625,3
40786,10551,Expansion Packs,16,0,0.0,16
40787,10551,Game Packs,10,0,0.0,10
40788,10551,Kits,20,0,0.0,20
40789,10551,Stuff Packs,16,0,0.0,16
40790,10552,Expansion Packs,7,0,0.0,7
40791,10552,Game Packs,2,0,0.0,2
40792,10552,Kits,2,2,1.0,0
40793,10553,Expansion Packs,16,0,0.0,16
40794,10553,Game Packs,12,0,0.0,12
40795,10553,Kits,33,0,0.0,33
40796,10553,Stuff Packs,20,0,0.0,20
40797,10554,Expansion Packs,12,0,0.0,12
40798,10554,Game Packs,4,0,0.0,4
40799,10554,Kits,9,0,0.0,9
40800,10554,Stuff Packs,7,3,0.42857142857142855,4
40801,10555,Expansion Packs,16,0,0.0,16
40802,10555,Game Packs,12,0,0.0,12
40803,10555,Kits,29,0,0.0,29
40804,10555,Stuff Packs,20,2,0.1,18
40805,10556,Expansion Packs,14,0,0.0,14
40806,10556,Game Packs,11,0,0.0,11
40807,10556,Kits,16,5,0.3125,11
40808,10556,Stuff Packs,17,1,0.058823529411764705,16
40809,10557,Expansion Packs,2,0,0.0,2
40810,10557,Game Packs,1,0,0.0,1
40811,10557,Kits,1,0,0.0,1
40812,10557,Stuff Packs,1,0,0.0,1
40813,10558,Expansion Packs,15,0,0.0,15
40814,10558,Game Packs,9,0,0.0,9
40815,10558,Kits,1,0,0.0,1
40816,10558,Stuff Packs,18,2,0.1111111111111111,16
40817,10559,Expansion Packs,15,0,0.0,15
40818,10559,Game Packs,8,0,0.0,8
40819,10559,Kits,4,1,0.25,3
40820,10559,Stuff Packs,15,2,0.13333333333333333,13
40821,10560,Expansion Packs,12,0,0.0,12
40822,10560,Game Packs,6,0,0.0,6
40823,10560,Kits,2,2,1.0,0
40824,10560,Stuff Packs,12,1,0.08333333333333333,11
40825,10561,Expansion Packs,15,0,0.0,15
40826,10561,Game Packs,12,0,0.0,12
40827,10561,Kits,4,1,0.25,3
40828,10561,Stuff Packs,19,0,0.0,19
40829,10562,Expansion Packs,15,0,0.0,15
40830,10562,Game Packs,11,0,0.0,11
40831,10562,Kits,20,1,0.05,19
40832,10562,Stuff Packs,13,0,0.0,13
40833,10563,Expansion Packs,16,0,0.0,16
40834,10563,Game Packs,12,0,0.0,12
40835,10563,Kits,33,1,0.030303030303030304,32
40836,10563,Stuff Packs,20,2,0.1,18
40837,10564,Expansion Packs,14,1,0.07142857142857142,13
40838,10564,Game Packs,8,0,0.0,8
40839,10564,Kits,3,1,0.3333333333333333,2
40840,10564,Stuff Packs,3,2,0.6666666666666666,1
40841,10565,Expansion Packs,16,0,0.0,16
40842,10565,Game Packs,12,0,0.0,12
40843,10565,Kits,33,1,0.030303030303030304,32
40844,10565,Stuff Packs,20,0,0.0,20
40845,10566,Expansion Packs,10,0,0.0,10
40846,10566,Game Packs,6,0,0.0,6
40847,10566,Kits,4,0,0.0,4
40848,10566,Stuff Packs,8,0,0.0,8
40849,10567,Expansion Packs,15,0,0.0,15
40850,10567,Game Packs,8,0,0.0,8
40851,10567,Kits,5,0,0.0,5
40852,10567,Stuff Packs,12,0,0.0,12
40853,10568,Expansion Packs,11,0,0.0,11
40854,10568,Game Packs,3,0,0.0,3
40855,10568,Kits,2,2,1.0,0
40856,10568,Stuff Packs,7,2,0.2857142857142857,5
40857,10569,Expansion Packs,11,0,0.0,11
40858,10569,Game Packs,5,0,0.0,5
40859,10569,Kits,1,1,1.0,0
40860,10569,Stuff Packs,6,1,0.16666666666666666,5
40861,10570,Expansion Packs,15,0,0.0,15
40862,10570,Game Packs,7,0,0.0,7
40863,10570,Kits,2,2,1.0,0
40864,10570,Stuff Packs,9,3,0.3333333333333333,6
40865,10571,Expansion Packs,4,0,0.0,4
40866,10571,Stuff Packs,3,0,0.0,3
40867,10572,Expansion Packs,7,0,0.0,7
40868,10572,Game Packs,4,0,0.0,4
40869,10572,Kits,9,0,0.0,9
40870,10572,Stuff Packs,8,1,0.125,7
40871,10573,Expansion Packs,4,0,0.0,4
40872,10573,Game Packs,3,0,0.0,3
40873,10573,Kits,1,1,1.0,0
40874,10573,Stuff Packs,4,2,0.5,2
40875,10574,Expansion Packs,16,0,0.0,16
40876,10574,Game Packs,11,0,0.0,11
40877,10574,Stuff Packs,13,2,0.15384615384615385,11
40878,10575,Expansion Packs,16,0,0.0,16
40879,10575,Game Packs,9,0,0.0,9
40880,10575,Kits,25,1,0.04,24
40881,10575,Stuff Packs,20,0,0.0,20
40882,10576,Expansion Packs,16,0,0.0,16
40883,10576,Game Packs,12,0,0.0,12
40884,10576,Kits,25,0,0.0,25
40885,10576,Stuff Packs,20,0,0.0,20
40886,10577,Expansion Packs,15,0,0.0,15
40887,10577,Game Packs,10,0,0.0,10
40888,10577,Kits,6,0,0.0,6
40889,10577,Stuff Packs,14,0,0.0,14
40890,10578,Expansion Packs,15,0,0.0,15
40891,10578,Game Packs,11,0,0.0,11
40892,10578,Kits,3,3,1.0,0
40893,10578,Stuff Packs,20,0,0.0,20
40894,10579,Expansion Packs,16,0,0.0,16
40895,10579,Game Packs,12,0,0.0,12
40896,10579,Kits,33,0,0.0,33
40897,10579,Stuff Packs,20,0,0.0,20
40898,10580,Expansion Packs,13,0,0.0,13
40899,10580,Game Packs,11,0,0.0,11
40900,10580,Kits,30,0,0.0,30
40901,10580,Stuff Packs,20,1,0.05,19
40902,10581,Expansion Packs,5,0,0.0,5
40903,10581,Game Packs,3,0,0.0,3
40904,10581,Kits,1,0,0.0,1
40905,10581,Stuff Packs,4,1,0.25,3
40906,10582,Expansion Packs,10,0,0.0,10
40907,10582,Game Packs,9,0,0.0,9
40908,10582,Kits,12,0,0.0,12
40909,10582,Stuff Packs,10,0,0.0,10
40910,10583,Expansion Packs,10,0,0.0,10
40911,10583,Kits,2,2,1.0,0
40912,10583,Stuff Packs,4,3,0.75,1
40913,10584,Expansion Packs,16,0,0.0,16
40914,10584,Game Packs,12,0,0.0,12
40915,10584,Kits,33,0,0.0,33
40916,10584,Stuff Packs,20,0,0.0,20
40917,10585,Expansion Packs,11,0,0.0,11
40918,10585,Game Packs,7,0,0.0,7
40919,10585,Kits,6,1,0.16666666666666666,5
40920,10585,Stuff Packs,9,1,0.1111111111111111,8
40921,10586,Expansion Packs,10,0,0.0,10
40922,10586,Game Packs,2,0,0.0,2
40923,10586,Kits,2,1,0.5,1
40924,10586,Stuff Packs,5,2,0.4,3
40925,10587,Expansion Packs,16,0,0.0,16
40926,10587,Game Packs,10,0,0.0,10
40927,10587,Kits,21,0,0.0,21
40928,10587,Stuff Packs,16,0,0.0,16
40929,10588,Expansion Packs,10,0,0.0,10
40930,10588,Game Packs,9,0,0.0,9
40931,10588,Kits,6,0,0.0,6
40932,10588,Stuff Packs,9,2,0.2222222222222222,7
40933,10589,Expansion Packs,8,0,0.0,8
40934,10589,Game Packs,7,0,0.0,7
40935,10589,Kits,8,3,0.375,5
40936,10589,Stuff Packs,14,2,0.14285714285714285,12
40937,10590,Expansion Packs,16,0,0.0,16
40938,10590,Game Packs,11,1,0.09090909090909091,10
40939,10590,Kits,30,0,0.0,30
40940,10590,Stuff Packs,17,0,0.0,17
40941,10591,Expansion Packs,10,1,0.1,9
40942,10591,Game Packs,8,0,0.0,8
40943,10591,Kits,12,2,0.16666666666666666,10
40944,10591,Stuff Packs,11,0,0.0,11
40945,10592,Expansion Packs,14,0,0.0,14
40946,10592,Game Packs,10,2,0.2,8
40947,10592,Kits,12,2,0.16666666666666666,10
40948,10592,Stuff Packs,15,4,0.26666666666666666,11
40949,10593,Expansion Packs,12,0,0.0,12
40950,10593,Game Packs,7,0,0.0,7
40951,10593,Kits,4,0,0.0,4
40952,10593,Stuff Packs,14,0,0.0,14
40953,10594,Expansion Packs,13,0,0.0,13
40954,10594,Game Packs,8,0,0.0,8
40955,10594,Kits,6,2,0.3333333333333333,4
40956,10594,Stuff Packs,14,3,0.21428571428571427,11
40957,10595,Expansion Packs,14,0,0.0,14
40958,10595,Game Packs,11,0,0.0,11
40959,10595,Stuff Packs,19,3,0.15789473684210525,16
40960,10596,Expansion Packs,16,0,0.0,16
40961,10596,Game Packs,12,0,0.0,12
40962,10596,Kits,33,0,0.0,33
40963,10596,Stuff Packs,20,0,0.0,20
40964,10597,Expansion Packs,16,0,0.0,16
40965,10597,Game Packs,12,0,0.0,12
40966,10597,Kits,33,1,0.030303030303030304,32
40967,10597,Stuff Packs,20,0,0.0,20
40968,10598,Expansion Packs,12,0,0.0,12
40969,10598,Game Packs,4,0,0.0,4
40970,10598,Stuff Packs,7,1,0.14285714285714285,6
40971,10599,Expansion Packs,3,0,0.0,3
40972,10600,Expansion Packs,16,0,0.0,16
40973,10600,Game Packs,12,0,0.0,12
40974,10600,Kits,32,0,0.0,32
40975,10600,Stuff Packs,20,0,0.0,20
40976,10601,Expansion Packs,12,0,0.0,12
40977,10601,Game Packs,7,1,0.14285714285714285,6
40978,10601,Kits,5,0,0.0,5
40979,10601,Stuff Packs,6,1,0.16666666666666666,5
40980,10602,Game Packs,1,0,0.0,1
40981,10602,Kits,1,1,1.0,0
40982,10602,Stuff Packs,3,3,1.0,0
40983,10603,Expansion Packs,15,0,0.0,15
40984,10603,Game Packs,5,0,0.0,5
40985,10603,Kits,5,1,0.2,4
40986,10603,Stuff Packs,6,2,0.3333333333333333,4
40987,10604,Expansion Packs,15,0,0.0,15
40988,10604,Game Packs,11,0,0.0,11
40989,10604,Kits,9,0,0.0,9
40990,10604,Stuff Packs,20,0,0.0,20
40991,10605,Expansion Packs,14,1,0.07142857142857142,13
40992,10605,Game Packs,8,0,0.0,8
40993,10605,Stuff Packs,13,3,0.23076923076923078,10
40994,10606,Expansion Packs,16,0,0.0,16
40995,10606,Game Packs,10,0,0.0,10
40996,10606,Kits,13,0,0.0,13
40997,10606,Stuff Packs,15,0,0.0,15
40998,10607,Expansion Packs,16,0,0.0,16
40999,10607,Game Packs,12,0,0.0,12
41000,10607,Kits,21,0,0.0,21
41001,10607,Stuff Packs,20,0,0.0,20
41002,10608,Expansion Packs,15,0,0.0,15
41003,10608,Game Packs,11,0,0.0,11
41004,10608,Kits,18,1,0.05555555555555555,17
41005,10608,Stuff Packs,20,1,0.05,19
41006,10609,Expansion Packs,7,0,0.0,7
41007,10609,Stuff Packs,2,0,0.0,2
41008,10610,Expansion Packs,15,0,0.0,15
41009,10610,Game Packs,12,0,0.0,12
41010,10610,Kits,4,4,1.0,0
41011,10610,Stuff Packs,19,0,0.0,19
41012,10611,Expansion Packs,12,1,0.08333333333333333,11
41013,10611,Game Packs,5,0,0.0,5
41014,10611,Kits,6,0,0.0,6
41015,10611,Stuff Packs,13,2,0.15384615384615385,11
41016,10612,Expansion Packs,10,0,0.0,10
41017,10612,Game Packs,3,0,0.0,3
41018,10612,Kits,3,0,0.0,3
41019,10612,Stuff Packs,5,1,0.2,4
41020,10613,Expansion Packs,12,0,0.0,12
41021,10613,Game Packs,2,0,0.0,2
41022,10613,Kits,5,1,0.2,4
41023,10613,Stuff Packs,12,2,0.16666666666666666,10
41024,10614,Expansion Packs,16,1,0.0625,15
41025,10614,Game Packs,12,0,0.0,12
41026,10614,Kits,33,0,0.0,33
41027,10614,Stuff Packs,20,0,0.0,20
41028,10615,Expansion Packs,12,0,0.0,12
41029,10615,Game Packs,9,0,0.0,9
41030,10615,Kits,16,2,0.125,14
41031,10615,Stuff Packs,16,1,0.0625,15
41032,10616,Expansion Packs,16,0,0.0,16
41033,10616,Game Packs,11,0,0.0,11
41034,10616,Kits,3,1,0.3333333333333333,2
41035,10616,Stuff Packs,11,0,0.0,11
41036,10617,Expansion Packs,13,0,0.0,13
41037,10617,Game Packs,9,0,0.0,9
41038,10617,Kits,9,1,0.1111111111111111,8
41039,10617,Stuff Packs,15,0,0.0,15
41040,10618,Expansion Packs,15,0,0.0,15
41041,10618,Game Packs,12,0,0.0,12
41042,10618,Kits,14,1,0.07142857142857142,13
41043,10618,Stuff Packs,19,1,0.05263157894736842,18
41044,10619,Expansion Packs,9,0,0.0,9
41045,10619,Game Packs,3,0,0.0,3
41046,10619,Stuff Packs,10,2,0.2,8
41047,10620,Expansion Packs,16,16,1.0,0
41048,10620,Game Packs,12,12,1.0,0
41049,10620,Kits,33,33,1.0,0
41050,10620,Stuff Packs,20,20,1.0,0
41051,10621,Expansion Packs,9,0,0.0,9
41052,10621,Game Packs,2,0,0.0,2
41053,10621,Kits,4,2,0.5,2
41054,10621,Stuff Packs,8,2,0.25,6
41055,10622,Expansion Packs,16,0,0.0,16
41056,10622,Game Packs,12,0,0.0,12
41057,10622,Kits,32,0,0.0,32
41058,10622,Stuff Packs,20,0,0.0,20
41059,10623,Expansion Packs,15,0,0.0,15
41060,10623,Game Packs,12,1,0.08333333333333333,11
41061,10623,Kits,5,1,0.2,4
41062,10623,Stuff Packs,18,1,0.05555555555555555,17
41063,10624,Expansion Packs,15,0,0.0,15
41064,10624,Game Packs,9,0,0.0,9
41065,10624,Kits,11,1,0.09090909090909091,10
41066,10624,Stuff Packs,19,0,0.0,19
41067,10625,Expansion Packs,16,0,0.0,16
41068,10625,Game Packs,11,0,0.0,11
41069,10625,Kits,19,0,0.0,19
41070,10625,Stuff Packs,20,0,0.0,20
41071,10626,Expansion Packs,16,0,0.0,16
41072,10626,Game Packs,10,0,0.0,10
41073,10626,Kits,12,2,0.16666666666666666,10
41074,10626,Stuff Packs,17,4,0.23529411764705882,13
41075,10627,Expansion Packs,10,0,0.0,10
41076,10627,Game Packs,7,0,0.0,7
41077,10627,Kits,7,0,0.0,7
41078,10627,Stuff Packs,9,0,0.0,9
41079,10628,Expansion Packs,16,0,0.0,16
41080,10628,Game Packs,12,0,0.0,12
41081,10628,Kits,33,1,0.030303030303030304,32
41082,10628,Stuff Packs,20,0,0.0,20
41083,10629,Expansion Packs,7,0,0.0,7
41084,10629,Game Packs,2,0,0.0,2
41085,10629,Kits,5,0,0.0,5
41086,10629,Stuff Packs,3,3,1.0,0
41087,10630,Expansion Packs,16,0,0.0,16
41088,10630,Game Packs,11,0,0.0,11
41089,10630,Kits,24,1,0.041666666666666664,23
41090,10630,Stuff Packs,20,0,0.0,20
41091,10631,Expansion Packs,16,0,0.0,16
41092,10631,Game Packs,11,0,0.0,11
41093,10631,Kits,9,1,0.1111111111111111,8
41094,10631,Stuff Packs,20,0,0.0,20
41095,10632,Expansion Packs,16,0,0.0,16
41096,10632,Game Packs,12,0,0.0,12
41097,10632,Kits,13,1,0.07692307692307693,12
41098,10632,Stuff Packs,20,0,0.0,20
41099,10633,Expansion Packs,4,0,0.0,4
41100,10633,Game Packs,2,1,0.5,1
41101,10633,Kits,1,0,0.0,1
41102,10633,Stuff Packs,3,1,0.3333333333333333,2
41103,10634,Expansion Packs,10,0,0.0,10
41104,10634,Game Packs,4,0,0.0,4
41105,10634,Stuff Packs,8,0,0.0,8
41106,10635,Expansion Packs,12,0,0.0,12
41107,10635,Game Packs,8,0,0.0,8
41108,10635,Kits,19,1,0.05263157894736842,18
41109,10635,Stuff Packs,11,2,0.18181818181818182,9
41110,10636,Expansion Packs,16,0,0.0,16
41111,10636,Game Packs,11,0,0.0,11
41112,10636,Kits,23,0,0.0,23
41113,10636,Stuff Packs,14,1,0.07142857142857142,13
41114,10637,Expansion Packs,3,0,0.0,3
41115,10637,Game Packs,1,0,0.0,1
41116,10638,Expansion Packs,12,0,0.0,12
41117,10638,Game Packs,4,0,0.0,4
41118,10638,Kits,10,0,0.0,10
41119,10638,Stuff Packs,8,0,0.0,8
41120,10639,Expansion Packs,6,0,0.0,6
41121,10639,Game Packs,4,0,0.0,4
41122,10639,Kits,1,1,1.0,0
41123,10639,Stuff Packs,6,0,0.0,6
41124,10640,Expansion Packs,8,0,0.0,8
41125,10640,Game Packs,2,0,0.0,2
41126,10640,Kits,16,0,0.0,16
41127,10640,Stuff Packs,11,0,0.0,11
41128,10641,Expansion Packs,16,0,0.0,16
41129,10641,Game Packs,12,0,0.0,12
41130,10641,Kits,20,0,0.0,20
41131,10641,Stuff Packs,20,3,0.15,17
41132,10642,Expansion Packs,16,0,0.0,16
41133,10642,Game Packs,12,0,0.0,12
41134,10642,Kits,21,1,0.047619047619047616,20
41135,10642,Stuff Packs,20,0,0.0,20
41136,10643,Expansion Packs,8,0,0.0,8
41137,10643,Game Packs,6,0,0.0,6
41138,10643,Kits,11,0,0.0,11
41139,10643,Stuff Packs,10,3,0.3,7
41140,10644,Expansion Packs,16,0,0.0,16
41141,10644,Game Packs,11,2,0.18181818181818182,9
41142,10644,Kits,25,0,0.0,25
41143,10644,Stuff Packs,20,0,0.0,20
41144,10645,Expansion Packs,7,0,0.0,7
41145,10645,Game Packs,2,0,0.0,2
41146,10645,Kits,6,1,0.16666666666666666,5
41147,10645,Stuff Packs,8,2,0.25,6
41148,10646,Expansion Packs,9,0,0.0,9
41149,10646,Game Packs,5,2,0.4,3
41150,10646,Kits,3,3,1.0,0
41151,10646,Stuff Packs,9,3,0.3333333333333333,6
41152,10647,Expansion Packs,15,0,0.0,15
41153,10647,Game Packs,12,0,0.0,12
41154,10647,Kits,19,1,0.05263157894736842,18
41155,10647,Stuff Packs,19,0,0.0,19
41156,10648,Expansion Packs,14,0,0.0,14
41157,10648,Game Packs,12,0,0.0,12
41158,10648,Kits,2,2,1.0,0
41159,10648,Stuff Packs,11,1,0.09090909090909091,10
41160,10649,Expansion Packs,11,0,0.0,11
41161,10649,Game Packs,4,0,0.0,4
41162,10649,Kits,1,1,1.0,0
41163,10649,Stuff Packs,4,0,0.0,4
41164,10650,Expansion Packs,16,0,0.0,16
41165,10650,Game Packs,12,0,0.0,12
41166,10650,Kits,33,0,0.0,33
41167,10650,Stuff Packs,20,0,0.0,20
41168,10651,Expansion Packs,16,0,0.0,16
41169,10651,Game Packs,12,0,0.0,12
41170,10651,Kits,23,0,0.0,23
41171,10651,Stuff Packs,20,0,0.0,20
41172,10652,Expansion Packs,8,0,0.0,8
41173,10652,Game Packs,2,0,0.0,2
41174,10652,Kits,5,0,0.0,5
41175,10652,Stuff Packs,5,2,0.4,3
41176,10653,Expansion Packs,14,0,0.0,14
41177,10653,Game Packs,3,0,0.0,3
41178,10653,Kits,6,0,0.0,6
41179,10653,Stuff Packs,7,1,0.14285714285714285,6
41180,10654,Expansion Packs,16,0,0.0,16
41181,10654,Game Packs,9,0,0.0,9
41182,10654,Kits,11,0,0.0,11
41183,10654,Stuff Packs,9,0,0.0,9
41184,10655,Expansion Packs,16,0,0.0,16
41185,10655,Game Packs,12,0,0.0,12
41186,10655,Kits,33,0,0.0,33
41187,10655,Stuff Packs,20,0,0.0,20
41188,10656,Expansion Packs,7,0,0.0,7
41189,10656,Game Packs,4,0,0.0,4
41190,10656,Kits,3,0,0.0,3
41191,10656,Stuff Packs,4,2,0.5,2
41192,10657,Expansion Packs,13,0,0.0,13
41193,10657,Game Packs,7,0,0.0,7
41194,10657,Kits,6,2,0.3333333333333333,4
41195,10657,Stuff Packs,10,2,0.2,8
41196,10658,Expansion Packs,15,0,0.0,15
41197,10658,Game Packs,11,0,0.0,11
41198,10658,Kits,3,0,0.0,3
41199,10658,Stuff Packs,7,1,0.14285714285714285,6
41200,10659,Expansion Packs,15,0,0.0,15
41201,10659,Game Packs,7,0,0.0,7
41202,10659,Kits,7,1,0.14285714285714285,6
41203,10659,Stuff Packs,12,0,0.0,12
41204,10660,Expansion Packs,3,0,0.0,3
41205,10660,Game Packs,2,2,1.0,0
41206,10660,Kits,2,1,0.5,1
41207,10660,Stuff Packs,6,4,0.6666666666666666,2
41208,10661,Expansion Packs,9,0,0.0,9
41209,10661,Game Packs,10,1,0.1,9
41210,10661,Kits,3,1,0.3333333333333333,2
41211,10661,Stuff Packs,11,1,0.09090909090909091,10
41212,10662,Expansion Packs,6,0,0.0,6
41213,10662,Game Packs,3,2,0.6666666666666666,1
41214,10662,Kits,1,1,1.0,0
41215,10662,Stuff Packs,7,0,0.0,7
41216,10663,Expansion Packs,10,0,0.0,10
41217,10663,Game Packs,7,1,0.14285714285714285,6
41218,10663,Kits,13,1,0.07692307692307693,12
41219,10663,Stuff Packs,14,4,0.2857142857142857,10
41220,10664,Expansion Packs,16,0,0.0,16
41221,10664,Game Packs,12,0,0.0,12
41222,10664,Kits,17,1,0.058823529411764705,16
41223,10664,Stuff Packs,17,1,0.058823529411764705,16
41224,10665,Expansion Packs,16,0,0.0,16
41225,10665,Game Packs,11,0,0.0,11
41226,10665,Kits,9,0,0.0,9
41227,10665,Stuff Packs,20,1,0.05,19
41228,10666,Expansion Packs,16,0,0.0,16
41229,10666,Game Packs,8,0,0.0,8
41230,10666,Kits,8,2,0.25,6
41231,10666,Stuff Packs,14,1,0.07142857142857142,13
41232,10667,Expansion Packs,2,0,0.0,2
41233,10667,Game Packs,1,0,0.0,1
41234,10667,Stuff Packs,1,0,0.0,1
41235,10668,Expansion Packs,16,0,0.0,16
41236,10668,Game Packs,11,0,0.0,11
41237,10668,Kits,30,1,0.03333333333333333,29
41238,10668,Stuff Packs,19,1,0.05263157894736842,18
41239,10669,Expansion Packs,4,0,0.0,4
41240,10669,Game Packs,3,0,0.0,3
41241,10669,Kits,9,1,0.1111111111111111,8
41242,10669,Stuff Packs,5,2,0.4,3
41243,10670,Expansion Packs,16,0,0.0,16
41244,10670,Game Packs,9,0,0.0,9
41245,10670,Kits,14,1,0.07142857142857142,13
41246,10670,Stuff Packs,15,2,0.13333333333333333,13
41247,10671,Expansion Packs,15,0,0.0,15
41248,10671,Game Packs,12,0,0.0,12
41249,10671,Kits,9,0,0.0,9
41250,10671,Stuff Packs,19,2,0.10526315789473684,17
41251,10672,Expansion Packs,16,0,0.0,16
41252,10672,Game Packs,12,0,0.0,12
41253,10672,Kits,33,0,0.0,33
41254,10672,Stuff Packs,20,0,0.0,20
41255,10673,Stuff Packs,1,0,0.0,1
41256,10674,Expansion Packs,16,0,0.0,16
41257,10674,Game Packs,9,0,0.0,9
41258,10674,Kits,26,0,0.0,26
41259,10674,Stuff Packs,18,0,0.0,18
41260,10675,Expansion Packs,13,0,0.0,13
41261,10675,Game Packs,10,0,0.0,10
41262,10675,Kits,2,1,0.5,1
41263,10675,Stuff Packs,13,2,0.15384615384615385,11
41264,10676,Expansion Packs,16,0,0.0,16
41265,10676,Game Packs,12,0,0.0,12
41266,10676,Kits,33,0,0.0,33
41267,10676,Stuff Packs,20,0,0.0,20
41268,10677,Expansion Packs,13,0,0.0,13
41269,10677,Game Packs,2,0,0.0,2
41270,10677,Kits,4,1,0.25,3
41271,10677,Stuff Packs,7,1,0.14285714285714285,6
41272,10678,Expansion Packs,16,0,0.0,16
41273,10678,Game Packs,12,0,0.0,12
41274,10678,Kits,23,1,0.043478260869565216,22
41275,10678,Stuff Packs,20,0,0.0,20
41276,10679,Expansion Packs,7,0,0.0,7
41277,10679,Game Packs,5,0,0.0,5
41278,10680,Expansion Packs,14,0,0.0,14
41279,10680,Game Packs,10,0,0.0,10
41280,10680,Kits,5,0,0.0,5
41281,10680,Stuff Packs,17,2,0.11764705882352941,15
41282,10681,Expansion Packs,16,0,0.0,16
41283,10681,Game Packs,12,0,0.0,12
41284,10681,Kits,12,0,0.0,12
41285,10681,Stuff Packs,17,0,0.0,17
41286,10682,Expansion Packs,2,0,0.0,2
41287,10682,Game Packs,3,0,0.0,3
41288,10682,Kits,3,1,0.3333333333333333,2
41289,10682,Stuff Packs,2,0,0.0,2
41290,10683,Expansion Packs,15,0,0.0,15
41291,10683,Game Packs,10,0,0.0,10
41292,10683,Kits,12,1,0.08333333333333333,11
41293,10683,Stuff Packs,17,0,0.0,17
41294,10684,Expansion Packs,16,0,0.0,16
41295,10684,Game Packs,11,0,0.0,11
41296,10684,Kits,10,1,0.1,9
41297,10684,Stuff Packs,15,2,0.13333333333333333,13
41298,10685,Expansion Packs,1,0,0.0,1
41299,10685,Game Packs,1,0,0.0,1
41300,10685,Kits,1,1,1.0,0
41301,10685,Stuff Packs,4,3,0.75,1
41302,10686,Expansion Packs,15,0,0.0,15
41303,10686,Game Packs,10,0,0.0,10
41304,10686,Kits,3,1,0.3333333333333333,2
41305,10686,Stuff Packs,18,0,0.0,18
41306,10687,Expansion Packs,14,0,0.0,14
41307,10687,Game Packs,12,0,0.0,12
41308,10687,Kits,21,0,0.0,21
41309,10687,Stuff Packs,18,0,0.0,18
41310,10688,Expansion Packs,16,0,0.0,16
41311,10688,Game Packs,12,0,0.0,12
41312,10688,Kits,21,4,0.19047619047619047,17
41313,10688,Stuff Packs,20,0,0.0,20
41314,10689,Expansion Packs,3,0,0.0,3
41315,10689,Game Packs,3,0,0.0,3
41316,10689,Kits,3,0,0.0,3
41317,10689,Stuff Packs,4,2,0.5,2
41318,10690,Expansion Packs,12,0,0.0,12
41319,10690,Game Packs,8,0,0.0,8
41320,10690,Kits,1,0,0.0,1
41321,10690,Stuff Packs,18,0,0.0,18
41322,10691,Expansion Packs,16,0,0.0,16
41323,10691,Game Packs,12,0,0.0,12
41324,10691,Kits,33,0,0.0,33
41325,10691,Stuff Packs,20,0,0.0,20
41326,10692,Expansion Packs,13,0,0.0,13
41327,10692,Game Packs,3,1,0.3333333333333333,2
41328,10692,Kits,4,1,0.25,3
41329,10692,Stuff Packs,8,3,0.375,5
41330,10693,Expansion Packs,16,0,0.0,16
41331,10693,Game Packs,12,0,0.0,12
41332,10693,Kits,9,1,0.1111111111111111,8
41333,10693,Stuff Packs,20,0,0.0,20
41334,10694,Expansion Packs,15,0,0.0,15
41335,10694,Game Packs,8,0,0.0,8
41336,10694,Kits,4,0,0.0,4
41337,10694,Stuff Packs,11,0,0.0,11
41338,10695,Expansion Packs,9,0,0.0,9
41339,10695,Game Packs,6,2,0.3333333333333333,4
41340,10695,Kits,1,1,1.0,0
41341,10695,Stuff Packs,4,1,0.25,3
41342,10696,Expansion Packs,9,0,0.0,9
41343,10696,Game Packs,3,1,0.3333333333333333,2
41344,10696,Kits,12,0,0.0,12
41345,10696,Stuff Packs,10,1,0.1,9
41346,10697,Kits,2,2,1.0,0
41347,10698,Expansion Packs,13,0,0.0,13
41348,10698,Game Packs,9,0,0.0,9
41349,10698,Kits,17,0,0.0,17
41350,10698,Stuff Packs,10,0,0.0,10
41351,10699,Expansion Packs,12,0,0.0,12
41352,10699,Game Packs,8,0,0.0,8
41353,10699,Kits,10,0,0.0,10
41354,10699,Stuff Packs,9,0,0.0,9
41355,10700,Expansion Packs,4,0,0.0,4
41356,10700,Game Packs,3,0,0.0,3
41357,10700,Kits,4,0,0.0,4
41358,10700,Stuff Packs,2,0,0.0,2
41359,10701,Expansion Packs,9,0,0.0,9
41360,10701,Game Packs,5,1,0.2,4
41361,10701,Kits,4,3,0.75,1
41362,10701,Stuff Packs,10,4,0.4,6
41363,10702,Expansion Packs,5,0,0.0,5
41364,10702,Game Packs,2,0,0.0,2
41365,10702,Kits,1,0,0.0,1
41366,10702,Stuff Packs,3,1,0.3333333333333333,2
41367,10703,Expansion Packs,4,0,0.0,4
41368,10704,Expansion Packs,11,0,0.0,11
41369,10704,Game Packs,3,0,0.0,3
41370,10704,Stuff Packs,5,2,0.4,3
41371,10705,Expansion Packs,7,0,0.0,7
41372,10705,Kits,2,2,1.0,0
41373,10705,Stuff Packs,4,2,0.5,2
41374,10706,Expansion Packs,2,0,0.0,2
41375,10706,Game Packs,3,0,0.0,3
41376,10706,Stuff Packs,2,0,0.0,2
41377,10707,Expansion Packs,8,0,0.0,8
41378,10707,Game Packs,2,0,0.0,2
41379,10707,Stuff Packs,4,1,0.25,3
41380,10708,Expansion Packs,16,0,0.0,16
41381,10708,Game Packs,10,0,0.0,10
41382,10708,Kits,1,1,1.0,0
41383,10708,Stuff Packs,18,2,0.1111111111111111,16
41384,10709,Expansion Packs,16,0,0.0,16
41385,10709,Game Packs,11,0,0.0,11
41386,10709,Kits,19,1,0.05263157894736842,18
41387,10709,Stuff Packs,15,0,0.0,15
41388,10710,Expansion Packs,12,0,0.0,12
41389,10710,Game Packs,8,0,0.0,8
41390,10710,Kits,5,1,0.2,4
41391,10710,Stuff Packs,6,1,0.16666666666666666,5
41392,10711,Game Packs,1,0,0.0,1
41393,10711,Kits,2,0,0.0,2
41394,10712,Expansion Packs,9,7,0.7777777777777778,2
41395,10712,Game Packs,5,2,0.4,3
41396,10712,Stuff Packs,10,0,0.0,10
41397,10713,Expansion Packs,16,1,0.0625,15
41398,10713,Game Packs,7,0,0.0,7
41399,10713,Kits,1,1,1.0,0
41400,10713,Stuff Packs,11,3,0.2727272727272727,8
41401,10714,Expansion Packs,10,0,0.0,10
41402,10714,Game Packs,6,0,0.0,6
41403,10714,Kits,7,0,0.0,7
41404,10714,Stuff Packs,9,1,0.1111111111111111,8
41405,10715,Expansion Packs,15,0,0.0,15
41406,10715,Game Packs,12,0,0.0,12
41407,10715,Kits,18,1,0.05555555555555555,17
41408,10715,Stuff Packs,20,1,0.05,19
41409,10716,Expansion Packs,16,0,0.0,16
41410,10716,Game Packs,12,0,0.0,12
41411,10716,Kits,3,1,0.3333333333333333,2
41412,10716,Stuff Packs,20,0,0.0,20
41413,10717,Expansion Packs,3,0,0.0,3
41414,10717,Game Packs,1,0,0.0,1
41415,10717,Stuff Packs,5,1,0.2,4
41416,10718,Expansion Packs,16,0,0.0,16
41417,10718,Game Packs,11,0,0.0,11
41418,10718,Kits,15,1,0.06666666666666667,14
41419,10718,Stuff Packs,20,0,0.0,20
41420,10719,Expansion Packs,16,0,0.0,16
41421,10719,Game Packs,8,0,0.0,8
41422,10719,Kits,5,0,0.0,5
41423,10719,Stuff Packs,7,1,0.14285714285714285,6
41424,10720,Expansion Packs,7,0,0.0,7
41425,10720,Game Packs,5,0,0.0,5
41426,10720,Kits,4,0,0.0,4
41427,10720,Stuff Packs,11,0,0.0,11
41428,10721,Expansion Packs,5,1,0.2,4
41429,10721,Game Packs,5,0,0.0,5
41430,10721,Kits,3,1,0.3333333333333333,2
41431,10721,Stuff Packs,7,3,0.42857142857142855,4
41432,10722,Expansion Packs,16,0,0.0,16
41433,10722,Game Packs,10,0,0.0,10
41434,10722,Kits,19,1,0.05263157894736842,18
41435,10722,Stuff Packs,15,1,0.06666666666666667,14
41436,10723,Expansion Packs,16,0,0.0,16
41437,10723,Game Packs,12,0,0.0,12
41438,10723,Kits,33,1,0.030303030303030304,32
41439,10723,Stuff Packs,20,0,0.0,20
41440,10724,Expansion Packs,16,0,0.0,16
41441,10724,Game Packs,12,0,0.0,12
41442,10724,Kits,18,0,0.0,18
41443,10724,Stuff Packs,18,0,0.0,18
41444,10725,Expansion Packs,16,0,0.0,16
41445,10725,Game Packs,12,0,0.0,12
41446,10725,Kits,33,0,0.0,33
41447,10725,Stuff Packs,20,0,0.0,20
41448,10726,Expansion Packs,15,0,0.0,15
41449,10726,Game Packs,12,0,0.0,12
41450,10726,Kits,6,1,0.16666666666666666,5
41451,10726,Stuff Packs,20,0,0.0,20
41452,10727,Expansion Packs,16,0,0.0,16
41453,10727,Game Packs,10,0,0.0,10
41454,10727,Kits,16,0,0.0,16
41455,10727,Stuff Packs,17,0,0.0,17
41456,10728,Expansion Packs,9,0,0.0,9
41457,10728,Game Packs,4,1,0.25,3
41458,10728,Kits,14,1,0.07142857142857142,13
41459,10728,Stuff Packs,4,0,0.0,4
41460,10729,Expansion Packs,14,0,0.0,14
41461,10729,Game Packs,10,0,0.0,10
41462,10729,Kits,2,2,1.0,0
41463,10729,Stuff Packs,18,0,0.0,18
41464,10730,Expansion Packs,8,0,0.0,8
41465,10730,Game Packs,3,0,0.0,3
41466,10730,Kits,2,0,0.0,2
41467,10730,Stuff Packs,4,0,0.0,4
41468,10731,Expansion Packs,14,0,0.0,14
41469,10731,Game Packs,6,0,0.0,6
41470,10731,Kits,2,2,1.0,0
41471,10731,Stuff Packs,9,4,0.4444444444444444,5
41472,10732,Expansion Packs,16,0,0.0,16
41473,10732,Game Packs,11,0,0.0,11
41474,10732,Kits,3,2,0.6666666666666666,1
41475,10732,Stuff Packs,9,2,0.2222222222222222,7
41476,10733,Expansion Packs,16,0,0.0,16
41477,10733,Game Packs,12,0,0.0,12
41478,10733,Kits,20,0,0.0,20
41479,10733,Stuff Packs,20,0,0.0,20
41480,10734,Expansion Packs,10,0,0.0,10
41481,10734,Game Packs,3,0,0.0,3
41482,10734,Kits,3,1,0.3333333333333333,2
41483,10734,Stuff Packs,5,0,0.0,5
41484,10735,Expansion Packs,16,0,0.0,16
41485,10735,Game Packs,12,0,0.0,12
41486,10735,Kits,32,0,0.0,32
41487,10735,Stuff Packs,20,0,0.0,20
41488,10736,Expansion Packs,16,0,0.0,16
41489,10736,Game Packs,10,0,0.0,10
41490,10736,Kits,30,1,0.03333333333333333,29
41491,10736,Stuff Packs,20,1,0.05,19
41492,10737,Expansion Packs,11,0,0.0,11
41493,10737,Game Packs,8,1,0.125,7
41494,10737,Kits,6,3,0.5,3
41495,10737,Stuff Packs,11,4,0.36363636363636365,7
41496,10738,Expansion Packs,14,0,0.0,14
41497,10738,Game Packs,11,0,0.0,11
41498,10738,Kits,19,2,0.10526315789473684,17
41499,10738,Stuff Packs,20,3,0.15,17
41500,10739,Expansion Packs,7,0,0.0,7
41501,10739,Game Packs,2,0,0.0,2
41502,10739,Stuff Packs,2,2,1.0,0
41503,10740,Expansion Packs,5,0,0.0,5
41504,10740,Game Packs,2,0,0.0,2
41505,10740,Kits,3,1,0.3333333333333333,2
41506,10740,Stuff Packs,4,2,0.5,2
41507,10741,Expansion Packs,8,0,0.0,8
41508,10741,Game Packs,2,0,0.0,2
41509,10741,Kits,1,0,0.0,1
41510,10741,Stuff Packs,5,2,0.4,3
41511,10742,Expansion Packs,3,0,0.0,3
41512,10743,Expansion Packs,11,0,0.0,11
41513,10743,Game Packs,7,0,0.0,7
41514,10743,Kits,2,2,1.0,0
41515,10743,Stuff Packs,15,0,0.0,15
41516,10744,Expansion Packs,15,0,0.0,15
41517,10744,Game Packs,10,0,0.0,10
41518,10744,Kits,13,1,0.07692307692307693,12
41519,10744,Stuff Packs,9,1,0.1111111111111111,8
41520,10745,Expansion Packs,4,0,0.0,4
41521,10745,Game Packs,3,0,0.0,3
41522,10745,Kits,1,0,0.0,1
41523,10745,Stuff Packs,5,0,0.0,5
41524,10746,Expansion Packs,13,0,0.0,13
41525,10746,Game Packs,9,0,0.0,9
41526,10746,Kits,2,0,0.0,2
41527,10746,Stuff Packs,12,0,0.0,12
41528,10747,Expansion Packs,16,0,0.0,16
41529,10747,Game Packs,12,0,0.0,12
41530,10747,Kits,8,1,0.125,7
41531,10747,Stuff Packs,16,0,0.0,16
41532,10748,Expansion Packs,14,0,0.0,14
41533,10748,Game Packs,2,0,0.0,2
41534,10748,Kits,2,1,0.5,1
41535,10748,Stuff Packs,6,1,0.16666666666666666,5
41536,10749,Expansion Packs,7,0,0.0,7
41537,10749,Game Packs,4,0,0.0,4
41538,10749,Kits,1,0,0.0,1
41539,10749,Stuff Packs,4,0,0.0,4
41540,10750,Expansion Packs,9,0,0.0,9
41541,10750,Game Packs,8,1,0.125,7
41542,10750,Kits,4,3,0.75,1
41543,10750,Stuff Packs,12,3,0.25,9
41544,10751,Expansion Packs,5,0,0.0,5
41545,10751,Game Packs,3,0,0.0,3
41546,10751,Kits,14,0,0.0,14
41547,10751,Stuff Packs,3,0,0.0,3
41548,10752,Expansion Packs,14,0,0.0,14
41549,10752,Game Packs,2,0,0.0,2
41550,10752,Stuff Packs,4,1,0.25,3
41551,10753,Expansion Packs,15,0,0.0,15
41552,10753,Game Packs,12,0,0.0,12
41553,10753,Kits,7,1,0.14285714285714285,6
41554,10753,Stuff Packs,20,0,0.0,20
41555,10754,Expansion Packs,15,0,0.0,15
41556,10754,Game Packs,11,1,0.09090909090909091,10
41557,10754,Kits,30,0,0.0,30
41558,10754,Stuff Packs,15,1,0.06666666666666667,14
41559,10755,Expansion Packs,16,0,0.0,16
41560,10755,Game Packs,11,0,0.0,11
41561,10755,Kits,8,1,0.125,7
41562,10755,Stuff Packs,18,1,0.05555555555555555,17
41563,10756,Expansion Packs,16,0,0.0,16
41564,10756,Game Packs,12,0,0.0,12
41565,10756,Kits,4,0,0.0,4
41566,10756,Stuff Packs,20,0,0.0,20
41567,10757,Expansion Packs,16,0,0.0,16
41568,10757,Game Packs,10,0,0.0,10
41569,10757,Kits,13,1,0.07692307692307693,12
41570,10757,Stuff Packs,14,0,0.0,14
41571,10758,Expansion Packs,16,0,0.0,16
41572,10758,Game Packs,12,0,0.0,12
41573,10758,Kits,33,1,0.030303030303030304,32
41574,10758,Stuff Packs,20,0,0.0,20
41575,10759,Expansion Packs,6,0,0.0,6
41576,10759,Game Packs,3,1,0.3333333333333333,2
41577,10759,Kits,1,1,1.0,0
41578,10759,Stuff Packs,5,4,0.8,1
41579,10760,Expansion Packs,13,1,0.07692307692307693,12
41580,10760,Game Packs,8,0,0.0,8
41581,10760,Kits,2,2,1.0,0
41582,10760,Stuff Packs,16,1,0.0625,15
41583,10761,Expansion Packs,16,0,0.0,16
41584,10761,Game Packs,12,0,0.0,12
41585,10761,Kits,33,0,0.0,33
41586,10761,Stuff Packs,20,0,0.0,20
41587,10762,Expansion Packs,12,0,0.0,12
41588,10762,Game Packs,4,0,0.0,4
41589,10762,Kits,1,1,1.0,0
41590,10762,Stuff Packs,4,2,0.5,2
41591,10763,Expansion Packs,16,0,0.0,16
41592,10763,Game Packs,12,0,0.0,12
41593,10763,Kits,33,2,0.06060606060606061,31
41594,10763,Stuff Packs,20,0,0.0,20
41595,10764,Expansion Packs,9,0,0.0,9
41596,10764,Game Packs,6,0,0.0,6
41597,10764,Kits,6,0,0.0,6
41598,10764,Stuff Packs,2,0,0.0,2
41599,10765,Expansion Packs,15,0,0.0,15
41600,10765,Game Packs,11,1,0.09090909090909091,10
41601,10765,Kits,29,0,0.0,29
41602,10765,Stuff Packs,15,1,0.06666666666666667,14
41603,10766,Expansion Packs,8,0,0.0,8
41604,10766,Game Packs,9,0,0.0,9
41605,10766,Kits,10,0,0.0,10
41606,10766,Stuff Packs,17,0,0.0,17
41607,10767,Expansion Packs,9,0,0.0,9
41608,10767,Game Packs,4,0,0.0,4
41609,10767,Kits,3,3,1.0,0
41610,10767,Stuff Packs,7,3,0.42857142857142855,4
41611,10768,Expansion Packs,16,0,0.0,16
41612,10768,Game Packs,11,0,0.0,11
41613,10768,Kits,12,1,0.08333333333333333,11
41614,10768,Stuff Packs,19,0,0.0,19
41615,10769,Expansion Packs,9,0,0.0,9
41616,10769,Game Packs,4,0,0.0,4
41617,10769,Kits,1,1,1.0,0
41618,10769,Stuff Packs,7,3,0.42857142857142855,4
41619,10770,Expansion Packs,16,0,0.0,16
41620,10770,Game Packs,11,0,0.0,11
41621,10770,Kits,25,0,0.0,25
41622,10770,Stuff Packs,18,1,0.05555555555555555,17
41623,10771,Expansion Packs,8,0,0.0,8
41624,10771,Game Packs,6,0,0.0,6
41625,10771,Stuff Packs,5,1,0.2,4
41626,10772,Expansion Packs,16,0,0.0,16
41627,10772,Game Packs,8,0,0.0,8
41628,10772,Kits,6,0,0.0,6
41629,10772,Stuff Packs,19,0,0.0,19
41630,10773,Expansion Packs,14,0,0.0,14
41631,10773,Game Packs,5,0,0.0,5
41632,10773,Kits,5,2,0.4,3
41633,10773,Stuff Packs,10,1,0.1,9
41634,10774,Expansion Packs,14,0,0.0,14
41635,10774,Game Packs,12,0,0.0,12
41636,10774,Kits,3,1,0.3333333333333333,2
41637,10774,Stuff Packs,17,1,0.058823529411764705,16
41638,10775,Expansion Packs,1,0,0.0,1
41639,10775,Kits,2,2,1.0,0
41640,10775,Stuff Packs,2,0,0.0,2
41641,10776,Expansion Packs,16,0,0.0,16
41642,10776,Game Packs,12,0,0.0,12
41643,10776,Kits,33,0,0.0,33
41644,10776,Stuff Packs,20,0,0.0,20
41645,10777,Expansion Packs,10,0,0.0,10
41646,10777,Game Packs,3,0,0.0,3
41647,10777,Kits,1,1,1.0,0
41648,10777,Stuff Packs,6,1,0.16666666666666666,5
41649,10778,Expansion Packs,10,0,0.0,10
41650,10778,Game Packs,3,0,0.0,3
41651,10778,Kits,3,1,0.3333333333333333,2
41652,10778,Stuff Packs,9,2,0.2222222222222222,7
41653,10779,Expansion Packs,16,0,0.0,16
41654,10779,Game Packs,11,0,0.0,11
41655,10779,Kits,11,0,0.0,11
41656,10779,Stuff Packs,18,0,0.0,18
41657,10780,Expansion Packs,16,0,0.0,16
41658,10780,Game Packs,12,0,0.0,12
41659,10780,Kits,11,0,0.0,11
41660,10780,Stuff Packs,19,0,0.0,19
41661,10781,Expansion Packs,13,0,0.0,13
41662,10781,Game Packs,2,1,0.5,1
41663,10781,Kits,3,3,1.0,0
41664,10781,Stuff Packs,6,4,0.6666666666666666,2
41665,10782,Expansion Packs,16,0,0.0,16
41666,10782,Game Packs,10,0,0.0,10
41667,10782,Kits,6,1,0.16666666666666666,5
41668,10782,Stuff Packs,18,1,0.05555555555555555,17
41669,10783,Expansion Packs,15,0,0.0,15
41670,10783,Game Packs,8,0,0.0,8
41671,10783,Kits,15,0,0.0,15
41672,10783,Stuff Packs,12,0,0.0,12
41673,10784,Expansion Packs,16,0,0.0,16
41674,10784,Game Packs,12,0,0.0,12
41675,10784,Kits,33,0,0.0,33
41676,10784,Stuff Packs,20,0,0.0,20
41677,10785,Expansion Packs,14,0,0.0,14
41678,10785,Game Packs,10,0,0.0,10
41679,10785,Stuff Packs,19,0,0.0,19
41680,10786,Expansion Packs,10,0,0.0,10
41681,10786,Game Packs,6,0,0.0,6
41682,10786,Kits,4,0,0.0,4
41683,10786,Stuff Packs,9,4,0.4444444444444444,5
41684,10787,Expansion Packs,15,0,0.0,15
41685,10787,Game Packs,9,0,0.0,9
41686,10787,Kits,11,1,0.09090909090909091,10
41687,10787,Stuff Packs,18,1,0.05555555555555555,17
41688,10788,Expansion Packs,13,0,0.0,13
41689,10788,Game Packs,7,2,0.2857142857142857,5
41690,10788,Kits,27,2,0.07407407407407407,25
41691,10788,Stuff Packs,13,3,0.23076923076923078,10
41692,10789,Expansion Packs,16,0,0.0,16
41693,10789,Game Packs,11,0,0.0,11
41694,10789,Kits,13,1,0.07692307692307693,12
41695,10789,Stuff Packs,12,0,0.0,12
41696,10790,Expansion Packs,12,0,0.0,12
41697,10790,Game Packs,6,0,0.0,6
41698,10790,Kits,9,1,0.1111111111111111,8
41699,10790,Stuff Packs,16,3,0.1875,13
41700,10791,Expansion Packs,15,0,0.0,15
41701,10791,Game Packs,9,0,0.0,9
41702,10791,Kits,3,1,0.3333333333333333,2
41703,10791,Stuff Packs,13,2,0.15384615384615385,11
41704,10792,Expansion Packs,16,0,0.0,16
41705,10792,Game Packs,10,0,0.0,10
41706,10792,Kits,1,0,0.0,1
41707,10792,Stuff Packs,9,0,0.0,9
41708,10793,Expansion Packs,5,0,0.0,5
41709,10793,Game Packs,2,0,0.0,2
41710,10793,Kits,2,2,1.0,0
41711,10793,Stuff Packs,5,3,0.6,2
41712,10794,Expansion Packs,11,0,0.0,11
41713,10794,Game Packs,7,0,0.0,7
41714,10794,Kits,9,0,0.0,9
41715,10794,Stuff Packs,15,2,0.13333333333333333,13
41716,10795,Expansion Packs,7,0,0.0,7
41717,10795,Kits,2,0,0.0,2
41718,10795,Stuff Packs,3,0,0.0,3
41719,10796,Expansion Packs,6,0,0.0,6
41720,10796,Game Packs,4,0,0.0,4
41721,10797,Expansion Packs,16,0,0.0,16
41722,10797,Game Packs,8,0,0.0,8
41723,10797,Kits,9,2,0.2222222222222222,7
41724,10797,Stuff Packs,9,3,0.3333333333333333,6
41725,10798,Expansion Packs,14,0,0.0,14
41726,10798,Game Packs,8,0,0.0,8
41727,10798,Kits,14,3,0.21428571428571427,11
41728,10798,Stuff Packs,13,3,0.23076923076923078,10
41729,10799,Expansion Packs,9,0,0.0,9
41730,10799,Game Packs,7,0,0.0,7
41731,10799,Kits,22,1,0.045454545454545456,21
41732,10799,Stuff Packs,15,1,0.06666666666666667,14
41733,10800,Expansion Packs,5,0,0.0,5
41734,10800,Game Packs,3,0,0.0,3
41735,10800,Stuff Packs,3,0,0.0,3
41736,10801,Expansion Packs,16,0,0.0,16
41737,10801,Game Packs,12,0,0.0,12
41738,10801,Kits,1,1,1.0,0
41739,10801,Stuff Packs,20,0,0.0,20
41740,10802,Expansion Packs,15,0,0.0,15
41741,10802,Game Packs,11,0,0.0,11
41742,10802,Kits,13,0,0.0,13
41743,10802,Stuff Packs,17,0,0.0,17
41744,10803,Expansion Packs,16,0,0.0,16
41745,10803,Game Packs,12,0,0.0,12
41746,10803,Kits,32,1,0.03125,31
41747,10803,Stuff Packs,20,0,0.0,20
41748,10804,Expansion Packs,16,0,0.0,16
41749,10804,Game Packs,12,1,0.08333333333333333,11
41750,10804,Kits,24,1,0.041666666666666664,23
41751,10804,Stuff Packs,20,1,0.05,19
41752,10805,Expansion Packs,15,0,0.0,15
41753,10805,Game Packs,8,0,0.0,8
41754,10805,Kits,3,0,0.0,3
41755,10805,Stuff Packs,6,0,0.0,6
41756,10806,Expansion Packs,15,0,0.0,15
41757,10806,Game Packs,7,0,0.0,7
41758,10806,Kits,2,2,1.0,0
41759,10806,Stuff Packs,2,2,1.0,0
41760,10807,Expansion Packs,16,0,0.0,16
41761,10807,Game Packs,12,0,0.0,12
41762,10807,Kits,23,3,0.13043478260869565,20
41763,10807,Stuff Packs,20,0,0.0,20
41764,10808,Expansion Packs,15,0,0.0,15
41765,10808,Game Packs,12,0,0.0,12
41766,10808,Kits,7,1,0.14285714285714285,6
41767,10808,Stuff Packs,16,0,0.0,16
41768,10809,Expansion Packs,16,0,0.0,16
41769,10809,Game Packs,11,0,0.0,11
41770,10809,Kits,27,0,0.0,27
41771,10809,Stuff Packs,20,0,0.0,20
41772,10810,Expansion Packs,16,0,0.0,16
41773,10810,Game Packs,12,0,0.0,12
41774,10810,Kits,28,0,0.0,28
41775,10810,Stuff Packs,20,0,0.0,20
41776,10811,Expansion Packs,4,0,0.0,4
41777,10811,Game Packs,1,0,0.0,1
41778,10811,Stuff Packs,2,0,0.0,2
41779,10812,Expansion Packs,10,1,0.1,9
41780,10812,Game Packs,6,0,0.0,6
41781,10812,Kits,3,0,0.0,3
41782,10812,Stuff Packs,6,2,0.3333333333333333,4
41783,10813,Expansion Packs,13,0,0.0,13
41784,10813,Game Packs,4,0,0.0,4
41785,10813,Kits,2,0,0.0,2
41786,10813,Stuff Packs,8,1,0.125,7
41787,10814,Expansion Packs,3,0,0.0,3
41788,10814,Game Packs,2,0,0.0,2
41789,10814,Stuff Packs,3,0,0.0,3
41790,10815,Expansion Packs,14,0,0.0,14
41791,10815,Game Packs,6,0,0.0,6
41792,10815,Kits,7,0,0.0,7
41793,10815,Stuff Packs,15,0,0.0,15
41794,10816,Expansion Packs,16,0,0.0,16
41795,10816,Game Packs,11,0,0.0,11
41796,10816,Kits,16,1,0.0625,15
41797,10816,Stuff Packs,19,1,0.05263157894736842,18
41798,10817,Expansion Packs,10,0,0.0,10
41799,10817,Game Packs,5,0,0.0,5
41800,10817,Kits,3,1,0.3333333333333333,2
41801,10817,Stuff Packs,7,0,0.0,7
41802,10818,Expansion Packs,12,0,0.0,12
41803,10818,Game Packs,9,0,0.0,9
41804,10818,Kits,5,1,0.2,4
41805,10818,Stuff Packs,14,0,0.0,14
41806,10819,Expansion Packs,7,0,0.0,7
41807,10819,Game Packs,4,0,0.0,4
41808,10819,Kits,1,0,0.0,1
41809,10819,Stuff Packs,5,2,0.4,3
41810,10820,Expansion Packs,12,0,0.0,12
41811,10820,Game Packs,3,1,0.3333333333333333,2
41812,10820,Kits,6,3,0.5,3
41813,10820,Stuff Packs,10,3,0.3,7
41814,10821,Expansion Packs,9,0,0.0,9
41815,10821,Game Packs,6,0,0.0,6
41816,10821,Kits,1,0,0.0,1
41817,10821,Stuff Packs,7,0,0.0,7
41818,10822,Expansion Packs,16,0,0.0,16
41819,10822,Game Packs,11,0,0.0,11
41820,10822,Kits,20,1,0.05,19
41821,10822,Stuff Packs,17,1,0.058823529411764705,16
41822,10823,Expansion Packs,16,0,0.0,16
41823,10823,Game Packs,12,0,0.0,12
41824,10823,Kits,7,1,0.14285714285714285,6
41825,10823,Stuff Packs,20,0,0.0,20
41826,10824,Expansion Packs,13,0,0.0,13
41827,10824,Game Packs,3,0,0.0,3
41828,10824,Kits,5,0,0.0,5
41829,10824,Stuff Packs,6,2,0.3333333333333333,4
41830,10825,Expansion Packs,15,0,0.0,15
41831,10825,Game Packs,5,0,0.0,5
41832,10825,Kits,6,5,0.8333333333333334,1
41833,10825,Stuff Packs,13,1,0.07692307692307693,12
41834,10826,Expansion Packs,16,0,0.0,16
41835,10826,Game Packs,7,0,0.0,7
41836,10826,Kits,10,2,0.2,8
41837,10826,Stuff Packs,11,2,0.18181818181818182,9
41838,10827,Expansion Packs,3,0,0.0,3
41839,10827,Game Packs,3,0,0.0,3
41840,10827,Kits,1,0,0.0,1
41841,10827,Stuff Packs,2,0,0.0,2
41842,10828,Expansion Packs,4,0,0.0,4
41843,10828,Game Packs,4,1,0.25,3
41844,10828,Kits,3,2,0.6666666666666666,1
41845,10828,Stuff Packs,5,3,0.6,2
41846,10829,Expansion Packs,1,1,1.0,0
41847,10829,Stuff Packs,1,1,1.0,0
41848,10830,Expansion Packs,16,0,0.0,16
41849,10830,Game Packs,12,0,0.0,12
41850,10830,Kits,15,0,0.0,15
41851,10830,Stuff Packs,20,0,0.0,20
41852,10831,Expansion Packs,16,0,0.0,16
41853,10831,Game Packs,12,0,0.0,12
41854,10831,Kits,33,0,0.0,33
41855,10831,Stuff Packs,20,0,0.0,20
41856,10832,Expansion Packs,9,0,0.0,9
41857,10832,Game Packs,1,0,0.0,1
41858,10832,Kits,2,0,0.0,2
41859,10832,Stuff Packs,3,0,0.0,3
41860,10833,Expansion Packs,3,1,0.3333333333333333,2
41861,10833,Game Packs,2,0,0.0,2
41862,10833,Kits,1,1,1.0,0
41863,10833,Stuff Packs,3,1,0.3333333333333333,2
41864,10834,Expansion Packs,14,0,0.0,14
41865,10834,Game Packs,5,0,0.0,5
41866,10834,Kits,1,1,1.0,0
41867,10834,Stuff Packs,8,3,0.375,5
41868,10835,Expansion Packs,6,0,0.0,6
41869,10835,Game Packs,1,0,0.0,1
41870,10835,Kits,4,0,0.0,4
41871,10835,Stuff Packs,3,0,0.0,3
41872,10836,Expansion Packs,16,0,0.0,16
41873,10836,Game Packs,11,0,0.0,11
41874,10836,Kits,14,1,0.07142857142857142,13
41875,10836,Stuff Packs,19,1,0.05263157894736842,18
41876,10837,Expansion Packs,16,0,0.0,16
41877,10837,Game Packs,12,0,0.0,12
41878,10837,Kits,33,2,0.06060606060606061,31
41879,10837,Stuff Packs,20,2,0.1,18
41880,10838,Expansion Packs,12,0,0.0,12
41881,10838,Game Packs,10,0,0.0,10
41882,10838,Kits,3,2,0.6666666666666666,1
41883,10838,Stuff Packs,14,1,0.07142857142857142,13
41884,10839,Expansion Packs,16,0,0.0,16
41885,10839,Game Packs,9,0,0.0,9
41886,10839,Kits,4,0,0.0,4
41887,10839,Stuff Packs,15,4,0.26666666666666666,11
41888,10840,Expansion Packs,11,0,0.0,11
41889,10840,Game Packs,7,1,0.14285714285714285,6
41890,10840,Kits,22,3,0.13636363636363635,19
41891,10840,Stuff Packs,14,4,0.2857142857142857,10
41892,10841,Expansion Packs,13,0,0.0,13
41893,10841,Game Packs,12,0,0.0,12
41894,10841,Kits,22,0,0.0,22
41895,10841,Stuff Packs,18,0,0.0,18
41896,10842,Expansion Packs,5,0,0.0,5
41897,10842,Game Packs,3,0,0.0,3
41898,10842,Kits,2,1,0.5,1
41899,10842,Stuff Packs,3,1,0.3333333333333333,2
41900,10843,Expansion Packs,16,0,0.0,16
41901,10843,Game Packs,12,0,0.0,12
41902,10843,Kits,33,0,0.0,33
41903,10843,Stuff Packs,20,1,0.05,19
41904,10844,Expansion Packs,16,0,0.0,16
41905,10844,Game Packs,12,0,0.0,12
41906,10844,Kits,33,1,0.030303030303030304,32
41907,10844,Stuff Packs,20,0,0.0,20
41908,10845,Expansion Packs,16,0,0.0,16
41909,10845,Game Packs,12,1,0.08333333333333333,11
41910,10845,Kits,33,3,0.09090909090909091,30
41911,10845,Stuff Packs,20,4,0.2,16
41912,10846,Expansion Packs,16,0,0.0,16
41913,10846,Game Packs,11,0,0.0,11
41914,10846,Kits,22,0,0.0,22
41915,10846,Stuff Packs,19,0,0.0,19
41916,10847,Expansion Packs,10,0,0.0,10
41917,10847,Game Packs,7,0,0.0,7
41918,10847,Kits,3,1,0.3333333333333333,2
41919,10847,Stuff Packs,9,2,0.2222222222222222,7
41920,10848,Expansion Packs,16,0,0.0,16
41921,10848,Game Packs,12,0,0.0,12
41922,10848,Kits,33,0,0.0,33
41923,10848,Stuff Packs,20,0,0.0,20
41924,10849,Expansion Packs,14,0,0.0,14
41925,10849,Game Packs,8,1,0.125,7
41926,10849,Kits,11,2,0.18181818181818182,9
41927,10849,Stuff Packs,11,3,0.2727272727272727,8
41928,10850,Expansion Packs,16,0,0.0,16
41929,10850,Game Packs,11,0,0.0,11
41930,10850,Kits,21,1,0.047619047619047616,20
41931,10850,Stuff Packs,20,0,0.0,20
41932,10851,Expansion Packs,11,1,0.09090909090909091,10
41933,10851,Game Packs,5,0,0.0,5
41934,10851,Kits,20,1,0.05,19
41935,10851,Stuff Packs,14,1,0.07142857142857142,13
41936,10852,Expansion Packs,16,0,0.0,16
41937,10852,Game Packs,12,0,0.0,12
41938,10852,Kits,33,0,0.0,33
41939,10852,Stuff Packs,20,0,0.0,20
41940,10853,Expansion Packs,2,0,0.0,2
41941,10853,Game Packs,3,1,0.3333333333333333,2
41942,10853,Kits,5,2,0.4,3
41943,10853,Stuff Packs,1,1,1.0,0
41944,10854,Expansion Packs,6,0,0.0,6
41945,10854,Game Packs,2,0,0.0,2
41946,10854,Kits,3,2,0.6666666666666666,1
41947,10854,Stuff Packs,6,3,0.5,3
41948,10855,Expansion Packs,16,0,0.0,16
41949,10855,Game Packs,12,0,0.0,12
41950,10855,Kits,16,0,0.0,16
41951,10855,Stuff Packs,19,0,0.0,19
41952,10856,Expansion Packs,16,0,0.0,16
41953,10856,Game Packs,12,0,0.0,12
41954,10856,Kits,12,0,0.0,12
41955,10856,Stuff Packs,20,0,0.0,20
41956,10857,Expansion Packs,2,0,0.0,2
41957,10857,Game Packs,1,0,0.0,1
41958,10857,Kits,2,1,0.5,1
41959,10857,Stuff Packs,4,2,0.5,2
41960,10858,Expansion Packs,16,0,0.0,16
41961,10858,Game Packs,12,0,0.0,12
41962,10858,Kits,33,1,0.030303030303030304,32
41963,10858,Stuff Packs,20,0,0.0,20
41964,10859,Expansion Packs,15,0,0.0,15
41965,10859,Game Packs,12,0,0.0,12
41966,10859,Kits,27,0,0.0,27
41967,10859,Stuff Packs,19,0,0.0,19
41968,10860,Expansion Packs,16,0,0.0,16
41969,10860,Game Packs,12,0,0.0,12
41970,10860,Kits,16,14,0.875,2
41971,10860,Stuff Packs,20,1,0.05,19
41972,10861,Expansion Packs,16,0,0.0,16
41973,10861,Game Packs,12,0,0.0,12
41974,10861,Kits,33,0,0.0,33
41975,10861,Stuff Packs,20,0,0.0,20
41976,10862,Expansion Packs,4,0,0.0,4
41977,10862,Game Packs,1,0,0.0,1
41978,10862,Kits,2,0,0.0,2
41979,10862,Stuff Packs,5,1,0.2,4
41980,10863,Expansion Packs,16,0,0.0,16
41981,10863,Game Packs,10,0,0.0,10
41982,10863,Kits,32,1,0.03125,31
41983,10863,Stuff Packs,19,0,0.0,19
41984,10864,Expansion Packs,16,0,0.0,16
41985,10864,Game Packs,12,0,0.0,12
41986,10864,Kits,17,1,0.058823529411764705,16
41987,10864,Stuff Packs,20,0,0.0,20
41988,10865,Expansion Packs,16,0,0.0,16
41989,10865,Game Packs,6,0,0.0,6
41990,10865,Kits,9,2,0.2222222222222222,7
41991,10865,Stuff Packs,9,0,0.0,9
41992,10866,Expansion Packs,16,0,0.0,16
41993,10866,Game Packs,9,0,0.0,9
41994,10866,Kits,7,0,0.0,7
41995,10866,Stuff Packs,14,1,0.07142857142857142,13
41996,10867,Expansion Packs,14,0,0.0,14
41997,10867,Game Packs,8,0,0.0,8
41998,10867,Kits,3,2,0.6666666666666666,1
41999,10867,Stuff Packs,13,2,0.15384615384615385,11
42000,10868,Expansion Packs,16,0,0.0,16
42001,10868,Game Packs,12,0,0.0,12
42002,10868,Kits,29,1,0.034482758620689655,28
42003,10868,Stuff Packs,20,0,0.0,20
42004,10869,Expansion Packs,12,0,0.0,12
42005,10869,Game Packs,4,1,0.25,3
42006,10869,Kits,3,1,0.3333333333333333,2
42007,10869,Stuff Packs,11,1,0.09090909090909091,10
42008,10870,Expansion Packs,15,0,0.0,15
42009,10870,Game Packs,10,0,0.0,10
42010,10870,Kits,4,0,0.0,4
42011,10870,Stuff Packs,18,1,0.05555555555555555,17
42012,10871,Expansion Packs,13,0,0.0,13
42013,10871,Game Packs,6,0,0.0,6
42014,10871,Kits,1,1,1.0,0
42015,10871,Stuff Packs,8,3,0.375,5
42016,10872,Expansion Packs,16,0,0.0,16
42017,10872,Game Packs,12,0,0.0,12
42018,10872,Kits,33,1,0.030303030303030304,32
42019,10872,Stuff Packs,20,0,0.0,20
42020,10873,Expansion Packs,13,0,0.0,13
42021,10873,Game Packs,8,2,0.25,6
42022,10873,Kits,6,1,0.16666666666666666,5
42023,10873,Stuff Packs,13,1,0.07692307692307693,12
42024,10874,Expansion Packs,15,0,0.0,15
42025,10874,Game Packs,5,0,0.0,5
42026,10874,Kits,2,2,1.0,0
42027,10874,Stuff Packs,10,2,0.2,8
42028,10875,Expansion Packs,7,0,0.0,7
42029,10875,Game Packs,3,0,0.0,3
42030,10875,Kits,2,0,0.0,2
42031,10875,Stuff Packs,3,2,0.6666666666666666,1
42032,10876,Expansion Packs,13,0,0.0,13
42033,10876,Game Packs,5,0,0.0,5
42034,10876,Kits,5,0,0.0,5
42035,10876,Stuff Packs,12,1,0.08333333333333333,11
42036,10877,Expansion Packs,5,0,0.0,5
42037,10877,Game Packs,1,0,0.0,1
42038,10878,Expansion Packs,4,0,0.0,4
42039,10878,Game Packs,3,0,0.0,3
42040,10878,Kits,1,0,0.0,1
42041,10878,Stuff Packs,4,3,0.75,1
42042,10879,Expansion Packs,16,0,0.0,16
42043,10879,Game Packs,12,0,0.0,12
42044,10879,Kits,18,0,0.0,18
42045,10879,Stuff Packs,20,0,0.0,20
42046,10880,Expansion Packs,12,1,0.08333333333333333,11
42047,10880,Game Packs,7,2,0.2857142857142857,5
42048,10880,Kits,10,3,0.3,7
42049,10880,Stuff Packs,19,1,0.05263157894736842,18
42050,10881,Expansion Packs,16,0,0.0,16
42051,10881,Game Packs,12,0,0.0,12
42052,10881,Kits,12,1,0.08333333333333333,11
42053,10881,Stuff Packs,20,0,0.0,20
42054,10882,Expansion Packs,6,0,0.0,6
42055,10882,Kits,1,1,1.0,0
42056,10882,Stuff Packs,4,2,0.5,2
42057,10883,Expansion Packs,16,0,0.0,16
42058,10883,Game Packs,12,0,0.0,12
42059,10883,Kits,33,2,0.06060606060606061,31
42060,10883,Stuff Packs,20,1,0.05,19
42061,10884,Expansion Packs,16,0,0.0,16
42062,10884,Game Packs,12,0,0.0,12
42063,10884,Kits,33,0,0.0,33
42064,10884,Stuff Packs,20,0,0.0,20
42065,10885,Expansion Packs,10,0,0.0,10
42066,10885,Game Packs,6,1,0.16666666666666666,5
42067,10885,Kits,2,2,1.0,0
42068,10885,Stuff Packs,10,2,0.2,8
42069,10886,Expansion Packs,16,0,0.0,16
42070,10886,Game Packs,12,0,0.0,12
42071,10886,Kits,33,0,0.0,33
42072,10886,Stuff Packs,20,0,0.0,20
42073,10887,Expansion Packs,16,0,0.0,16
42074,10887,Game Packs,12,0,0.0,12
42075,10887,Kits,33,0,0.0,33
42076,10887,Stuff Packs,20,0,0.0,20
42077,10888,Expansion Packs,6,0,0.0,6
42078,10888,Game Packs,5,0,0.0,5
42079,10888,Kits,1,1,1.0,0
42080,10888,Stuff Packs,6,1,0.16666666666666666,5
42081,10889,Expansion Packs,13,0,0.0,13
42082,10889,Game Packs,5,0,0.0,5
42083,10889,Kits,2,2,1.0,0
42084,10889,Stuff Packs,10,0,0.0,10
42085,10890,Expansion Packs,15,0,0.0,15
42086,10890,Game Packs,8,0,0.0,8
42087,10890,Kits,5,2,0.4,3
42088,10890,Stuff Packs,16,2,0.125,14
42089,10891,Expansion Packs,8,0,0.0,8
42090,10891,Game Packs,3,0,0.0,3
42091,10891,Kits,1,1,1.0,0
42092,10891,Stuff Packs,6,2,0.3333333333333333,4
42093,10892,Expansion Packs,16,0,0.0,16
42094,10892,Game Packs,10,0,0.0,10
42095,10892,Kits,4,2,0.5,2
42096,10892,Stuff Packs,14,1,0.07142857142857142,13
42097,10893,Expansion Packs,16,0,0.0,16
42098,10893,Game Packs,12,0,0.0,12
42099,10893,Kits,33,0,0.0,33
42100,10893,Stuff Packs,20,0,0.0,20
42101,10894,Expansion Packs,7,0,0.0,7
42102,10894,Game Packs,3,0,0.0,3
42103,10894,Stuff Packs,4,1,0.25,3
42104,10895,Expansion Packs,14,0,0.0,14
42105,10895,Game Packs,9,0,0.0,9
42106,10895,Kits,6,1,0.16666666666666666,5
42107,10895,Stuff Packs,17,1,0.058823529411764705,16
42108,10896,Expansion Packs,3,0,0.0,3
42109,10896,Game Packs,1,0,0.0,1
42110,10896,Kits,1,1,1.0,0
42111,10896,Stuff Packs,3,2,0.6666666666666666,1
42112,10897,Expansion Packs,2,0,0.0,2
42113,10897,Game Packs,1,0,0.0,1
42114,10897,Stuff Packs,1,0,0.0,1
42115,10898,Expansion Packs,11,0,0.0,11
42116,10898,Game Packs,10,0,0.0,10
42117,10898,Kits,4,0,0.0,4
42118,10898,Stuff Packs,16,1,0.0625,15
42119,10899,Expansion Packs,9,0,0.0,9
42120,10899,Game Packs,6,1,0.16666666666666666,5
42121,10899,Kits,10,2,0.2,8
42122,10899,Stuff Packs,9,4,0.4444444444444444,5
42123,10900,Expansion Packs,14,0,0.0,14
42124,10900,Game Packs,11,0,0.0,11
42125,10900,Kits,12,1,0.08333333333333333,11
42126,10900,Stuff Packs,15,1,0.06666666666666667,14
42127,10901,Expansion Packs,7,0,0.0,7
42128,10901,Game Packs,1,0,0.0,1
42129,10901,Kits,3,1,0.3333333333333333,2
42130,10901,Stuff Packs,4,1,0.25,3
42131,10902,Expansion Packs,12,0,0.0,12
42132,10902,Game Packs,9,0,0.0,9
42133,10902,Kits,1,0,0.0,1
42134,10902,Stuff Packs,15,0,0.0,15
42135,10903,Expansion Packs,14,0,0.0,14
42136,10903,Game Packs,9,0,0.0,9
42137,10903,Kits,8,1,0.125,7
42138,10903,Stuff Packs,15,4,0.26666666666666666,11
42139,10904,Expansion Packs,7,0,0.0,7
42140,10904,Game Packs,2,0,0.0,2
42141,10904,Kits,2,2,1.0,0
42142,10904,Stuff Packs,4,2,0.5,2
42143,10905,Expansion Packs,16,0,0.0,16
42144,10905,Game Packs,11,0,0.0,11
42145,10905,Kits,11,0,0.0,11
42146,10905,Stuff Packs,19,0,0.0,19
42147,10906,Expansion Packs,16,0,0.0,16
42148,10906,Game Packs,11,0,0.0,11
42149,10906,Kits,24,1,0.041666666666666664,23
42150,10906,Stuff Packs,18,0,0.0,18
42151,10907,Expansion Packs,14,0,0.0,14
42152,10907,Game Packs,7,0,0.0,7
42153,10907,Kits,6,1,0.16666666666666666,5
42154,10907,Stuff Packs,3,0,0.0,3
42155,10908,Expansion Packs,12,0,0.0,12
42156,10908,Game Packs,11,0,0.0,11
42157,10908,Kits,2,2,1.0,0
42158,10908,Stuff Packs,8,2,0.25,6
42159,10909,Expansion Packs,8,0,0.0,8
42160,10909,Game Packs,2,0,0.0,2
42161,10909,Kits,2,0,0.0,2
42162,10909,Stuff Packs,4,0,0.0,4
42163,10910,Expansion Packs,16,0,0.0,16
42164,10910,Game Packs,12,0,0.0,12
42165,10910,Kits,33,0,0.0,33
42166,10910,Stuff Packs,20,0,0.0,20
42167,10911,Expansion Packs,5,0,0.0,5
42168,10911,Game Packs,4,0,0.0,4
42169,10911,Stuff Packs,5,3,0.6,2
42170,10912,Expansion Packs,4,0,0.0,4
42171,10912,Game Packs,4,0,0.0,4
42172,10912,Kits,5,2,0.4,3
42173,10912,Stuff Packs,7,1,0.14285714285714285,6
42174,10913,Expansion Packs,8,0,0.0,8
42175,10913,Game Packs,4,1,0.25,3
42176,10913,Kits,3,3,1.0,0
42177,10913,Stuff Packs,9,4,0.4444444444444444,5
42178,10914,Expansion Packs,16,0,0.0,16
42179,10914,Game Packs,12,0,0.0,12
42180,10914,Kits,33,0,0.0,33
42181,10914,Stuff Packs,20,0,0.0,20
42182,10915,Expansion Packs,14,0,0.0,14
42183,10915,Game Packs,7,0,0.0,7
42184,10915,Kits,5,3,0.6,2
42185,10915,Stuff Packs,8,1,0.125,7
42186,10916,Expansion Packs,7,0,0.0,7
42187,10916,Game Packs,4,0,0.0,4
42188,10916,Kits,1,1,1.0,0
42189,10916,Stuff Packs,7,2,0.2857142857142857,5
42190,10917,Expansion Packs,15,0,0.0,15
42191,10917,Game Packs,12,0,0.0,12
42192,10917,Kits,19,1,0.05263157894736842,18
42193,10917,Stuff Packs,20,0,0.0,20
42194,10918,Expansion Packs,4,0,0.0,4
42195,10918,Game Packs,1,0,0.0,1
42196,10918,Kits,1,1,1.0,0
42197,10918,Stuff Packs,2,2,1.0,0
42198,10919,Expansion Packs,11,0,0.0,11
42199,10919,Game Packs,9,0,0.0,9
42200,10919,Kits,2,1,0.5,1
42201,10919,Stuff Packs,7,2,0.2857142857142857,5
42202,10920,Expansion Packs,16,0,0.0,16
42203,10920,Game Packs,12,0,0.0,12
42204,10920,Kits,18,0,0.0,18
42205,10920,Stuff Packs,18,2,0.1111111111111111,16
42206,10921,Expansion Packs,12,0,0.0,12
42207,10921,Game Packs,5,1,0.2,4
42208,10921,Stuff Packs,6,2,0.3333333333333333,4
42209,10922,Expansion Packs,16,0,0.0,16
42210,10922,Game Packs,11,0,0.0,11
42211,10922,Kits,16,1,0.0625,15
42212,10922,Stuff Packs,20,0,0.0,20
42213,10923,Expansion Packs,7,0,0.0,7
42214,10923,Game Packs,2,0,0.0,2
42215,10923,Kits,1,1,1.0,0
42216,10923,Stuff Packs,3,2,0.6666666666666666,1
42217,10924,Expansion Packs,9,6,0.6666666666666666,3
42218,10924,Game Packs,4,2,0.5,2
42219,10924,Kits,1,1,1.0,0
42220,10924,Stuff Packs,3,1,0.3333333333333333,2
42221,10925,Expansion Packs,16,0,0.0,16
42222,10925,Game Packs,12,0,0.0,12
42223,10925,Kits,32,1,0.03125,31
42224,10925,Stuff Packs,20,0,0.0,20
42225,10926,Expansion Packs,16,0,0.0,16
42226,10926,Game Packs,12,0,0.0,12
42227,10926,Kits,33,0,0.0,33
42228,10926,Stuff Packs,20,0,0.0,20
42229,10927,Expansion Packs,16,1,0.0625,15
42230,10927,Game Packs,12,0,0.0,12
42231,10927,Kits,5,0,0.0,5
42232,10927,Stuff Packs,19,0,0.0,19
42233,10928,Expansion Packs,16,0,0.0,16
42234,10928,Game Packs,12,1,0.08333333333333333,11
42235,10928,Kits,33,0,0.0,33
42236,10928,Stuff Packs,20,0,0.0,20
42237,10929,Expansion Packs,16,0,0.0,16
42238,10929,Game Packs,11,0,0.0,11
42239,10929,Kits,2,2,1.0,0
42240,10929,Stuff Packs,20,0,0.0,20
42241,10930,Expansion Packs,10,0,0.0,10
42242,10930,Game Packs,6,0,0.0,6
42243,10930,Kits,7,2,0.2857142857142857,5
42244,10930,Stuff Packs,9,4,0.4444444444444444,5
42245,10931,Expansion Packs,16,0,0.0,16
42246,10931,Game Packs,12,0,0.0,12
42247,10931,Kits,17,0,0.0,17
42248,10931,Stuff Packs,20,0,0.0,20
42249,10932,Expansion Packs,16,0,0.0,16
42250,10932,Game Packs,10,0,0.0,10
42251,10932,Kits,13,1,0.07692307692307693,12
42252,10932,Stuff Packs,13,0,0.0,13
42253,10933,Expansion Packs,11,0,0.0,11
42254,10933,Game Packs,5,0,0.0,5
42255,10933,Kits,1,0,0.0,1
42256,10933,Stuff Packs,6,1,0.16666666666666666,5
42257,10934,Expansion Packs,11,0,0.0,11
42258,10934,Game Packs,4,0,0.0,4
42259,10934,Kits,2,0,0.0,2
42260,10934,Stuff Packs,4,0,0.0,4
42261,10935,Expansion Packs,7,0,0.0,7
42262,10935,Game Packs,3,0,0.0,3
42263,10935,Kits,1,1,1.0,0
42264,10935,Stuff Packs,4,2,0.5,2
42265,10936,Expansion Packs,14,0,0.0,14
42266,10936,Game Packs,11,0,0.0,11
42267,10936,Kits,17,1,0.058823529411764705,16
42268,10936,Stuff Packs,20,0,0.0,20
42269,10937,Expansion Packs,13,0,0.0,13
42270,10937,Game Packs,5,0,0.0,5
42271,10937,Kits,3,2,0.6666666666666666,1
42272,10937,Stuff Packs,12,2,0.16666666666666666,10
42273,10938,Expansion Packs,10,0,0.0,10
42274,10938,Game Packs,5,0,0.0,5
42275,10938,Kits,4,1,0.25,3
42276,10938,Stuff Packs,7,3,0.42857142857142855,4
42277,10939,Expansion Packs,8,0,0.0,8
42278,10939,Game Packs,10,0,0.0,10
42279,10939,Kits,2,0,0.0,2
42280,10939,Stuff Packs,10,0,0.0,10
42281,10940,Expansion Packs,15,0,0.0,15
42282,10940,Game Packs,10,0,0.0,10
42283,10940,Kits,1,1,1.0,0
42284,10940,Stuff Packs,14,1,0.07142857142857142,13
42285,10941,Expansion Packs,16,0,0.0,16
42286,10941,Game Packs,11,1,0.09090909090909091,10
42287,10941,Kits,7,3,0.42857142857142855,4
42288,10941,Stuff Packs,17,4,0.23529411764705882,13
42289,10942,Expansion Packs,15,0,0.0,15
42290,10942,Game Packs,11,0,0.0,11
42291,10942,Kits,9,0,0.0,9
42292,10942,Stuff Packs,16,1,0.0625,15
42293,10943,Expansion Packs,16,0,0.0,16
42294,10943,Game Packs,12,0,0.0,12
42295,10943,Kits,33,0,0.0,33
42296,10943,Stuff Packs,20,0,0.0,20
42297,10944,Expansion Packs,15,0,0.0,15
42298,10944,Game Packs,7,0,0.0,7
42299,10944,Kits,5,0,0.0,5
42300,10944,Stuff Packs,7,0,0.0,7
42301,10945,Expansion Packs,16,0,0.0,16
42302,10945,Game Packs,9,0,0.0,9
42303,10945,Kits,11,1,0.09090909090909091,10
42304,10945,Stuff Packs,17,1,0.058823529411764705,16
42305,10946,Expansion Packs,13,0,0.0,13
42306,10946,Game Packs,8,0,0.0,8
42307,10946,Stuff Packs,5,0,0.0,5
42308,10947,Expansion Packs,14,0,0.0,14
42309,10947,Game Packs,9,0,0.0,9
42310,10947,Kits,6,2,0.3333333333333333,4
42311,10947,Stuff Packs,16,2,0.125,14
42312,10948,Expansion Packs,10,0,0.0,10
42313,10948,Game Packs,2,0,0.0,2
42314,10948,Kits,2,1,0.5,1
42315,10948,Stuff Packs,4,3,0.75,1
42316,10949,Game Packs,1,1,1.0,0
42317,10949,Kits,3,3,1.0,0
42318,10949,Stuff Packs,4,4,1.0,0
42319,10950,Expansion Packs,15,0,0.0,15
42320,10950,Game Packs,12,0,0.0,12
42321,10950,Kits,33,0,0.0,33
42322,10950,Stuff Packs,20,0,0.0,20
42323,10951,Expansion Packs,10,0,0.0,10
42324,10951,Game Packs,7,0,0.0,7
42325,10951,Kits,7,2,0.2857142857142857,5
42326,10951,Stuff Packs,16,4,0.25,12
42327,10952,Expansion Packs,14,0,0.0,14
42328,10952,Game Packs,7,0,0.0,7
42329,10952,Kits,9,1,0.1111111111111111,8
42330,10952,Stuff Packs,18,0,0.0,18
42331,10953,Expansion Packs,11,0,0.0,11
42332,10953,Game Packs,8,0,0.0,8
42333,10953,Kits,4,1,0.25,3
42334,10953,Stuff Packs,11,0,0.0,11
42335,10954,Expansion Packs,16,0,0.0,16
42336,10954,Game Packs,11,0,0.0,11
42337,10954,Kits,28,1,0.03571428571428571,27
42338,10954,Stuff Packs,19,1,0.05263157894736842,18
42339,10955,Expansion Packs,16,0,0.0,16
42340,10955,Game Packs,12,0,0.0,12
42341,10955,Kits,8,3,0.375,5
42342,10955,Stuff Packs,17,2,0.11764705882352941,15
42343,10956,Expansion Packs,12,0,0.0,12
42344,10956,Game Packs,9,0,0.0,9
42345,10956,Kits,3,0,0.0,3
42346,10956,Stuff Packs,9,0,0.0,9
42347,10957,Expansion Packs,16,0,0.0,16
42348,10957,Game Packs,12,0,0.0,12
42349,10957,Kits,5,0,0.0,5
42350,10957,Stuff Packs,11,1,0.09090909090909091,10
42351,10958,Expansion Packs,14,0,0.0,14
42352,10958,Game Packs,5,0,0.0,5
42353,10958,Kits,5,0,0.0,5
42354,10958,Stuff Packs,8,3,0.375,5
42355,10959,Expansion Packs,14,0,0.0,14
42356,10959,Game Packs,6,0,0.0,6
42357,10959,Kits,12,1,0.08333333333333333,11
42358,10959,Stuff Packs,9,0,0.0,9
42359,10960,Expansion Packs,5,0,0.0,5
42360,10960,Game Packs,2,0,0.0,2
42361,10960,Kits,3,0,0.0,3
42362,10960,Stuff Packs,3,1,0.3333333333333333,2
42363,10961,Expansion Packs,16,0,0.0,16
42364,10961,Game Packs,12,0,0.0,12
42365,10961,Kits,22,0,0.0,22
42366,10961,Stuff Packs,17,1,0.058823529411764705,16
42367,10962,Expansion Packs,6,0,0.0,6
42368,10962,Game Packs,2,0,0.0,2
42369,10962,Kits,15,0,0.0,15
42370,10962,Stuff Packs,6,1,0.16666666666666666,5
42371,10963,Stuff Packs,1,1,1.0,0
42372,10964,Expansion Packs,14,0,0.0,14
42373,10964,Game Packs,7,0,0.0,7
42374,10964,Kits,3,2,0.6666666666666666,1
42375,10964,Stuff Packs,13,1,0.07692307692307693,12
42376,10965,Expansion Packs,6,1,0.16666666666666666,5
42377,10965,Game Packs,3,0,0.0,3
42378,10965,Stuff Packs,3,2,0.6666666666666666,1
42379,10966,Expansion Packs,15,0,0.0,15
42380,10966,Game Packs,9,0,0.0,9
42381,10966,Kits,10,0,0.0,10
42382,10966,Stuff Packs,11,0,0.0,11
42383,10967,Expansion Packs,16,1,0.0625,15
42384,10967,Game Packs,12,0,0.0,12
42385,10967,Kits,33,1,0.030303030303030304,32
42386,10967,Stuff Packs,20,0,0.0,20
42387,10968,Expansion Packs,16,1,0.0625,15
42388,10968,Game Packs,12,0,0.0,12
42389,10968,Kits,33,3,0.09090909090909091,30
42390,10968,Stuff Packs,20,1,0.05,19
42391,10969,Expansion Packs,16,0,0.0,16
42392,10969,Game Packs,12,0,0.0,12
42393,10969,Kits,33,0,0.0,33
42394,10969,Stuff Packs,20,0,0.0,20
42395,10970,Expansion Packs,9,0,0.0,9
42396,10970,Game Packs,2,0,0.0,2
42397,10970,Kits,4,0,0.0,4
42398,10970,Stuff Packs,3,0,0.0,3
42399,10971,Expansion Packs,9,0,0.0,9
42400,10971,Game Packs,5,0,0.0,5
42401,10971,Stuff Packs,4,0,0.0,4
42402,10972,Expansion Packs,7,0,0.0,7
42403,10972,Game Packs,6,0,0.0,6
42404,10972,Kits,1,0,0.0,1
42405,10972,Stuff Packs,7,0,0.0,7
42406,10973,Expansion Packs,11,0,0.0,11
42407,10973,Game Packs,9,0,0.0,9
42408,10973,Kits,9,1,0.1111111111111111,8
42409,10973,Stuff Packs,12,2,0.16666666666666666,10
42410,10974,Expansion Packs,16,0,0.0,16
42411,10974,Game Packs,12,0,0.0,12
42412,10974,Kits,33,1,0.030303030303030304,32
42413,10974,Stuff Packs,20,0,0.0,20
42414,10975,Expansion Packs,16,0,0.0,16
42415,10975,Game Packs,12,0,0.0,12
42416,10975,Kits,32,0,0.0,32
42417,10975,Stuff Packs,20,0,0.0,20
42418,10976,Expansion Packs,15,0,0.0,15
42419,10976,Game Packs,11,0,0.0,11
42420,10976,Kits,11,0,0.0,11
42421,10976,Stuff Packs,19,0,0.0,19
42422,10977,Expansion Packs,16,0,0.0,16
42423,10977,Game Packs,12,0,0.0,12
42424,10977,Kits,33,0,0.0,33
42425,10977,Stuff Packs,20,0,0.0,20
42426,10978,Expansion Packs,16,0,0.0,16
42427,10978,Game Packs,12,0,0.0,12
42428,10978,Kits,16,2,0.125,14
42429,10978,Stuff Packs,20,1,0.05,19
42430,10979,Expansion Packs,16,0,0.0,16
42431,10979,Game Packs,12,0,0.0,12
42432,10979,Kits,33,0,0.0,33
42433,10979,Stuff Packs,20,0,0.0,20
42434,10980,Expansion Packs,5,0,0.0,5
42435,10980,Game Packs,3,0,0.0,3
42436,10980,Kits,3,0,0.0,3
42437,10980,Stuff Packs,5,2,0.4,3
42438,10981,Expansion Packs,1,0,0.0,1
42439,10981,Game Packs,2,1,0.5,1
42440,10981,Kits,2,2,1.0,0
42441,10981,Stuff Packs,3,2,0.6666666666666666,1
42442,10982,Expansion Packs,14,0,0.0,14
42443,10982,Game Packs,11,0,0.0,11
42444,10982,Kits,4,0,0.0,4
42445,10982,Stuff Packs,12,1,0.08333333333333333,11
42446,10983,Expansion Packs,16,0,0.0,16
42447,10983,Game Packs,11,0,0.0,11
42448,10983,Kits,27,1,0.037037037037037035,26
42449,10983,Stuff Packs,20,0,0.0,20
42450,10984,Expansion Packs,14,0,0.0,14
42451,10984,Game Packs,6,0,0.0,6
42452,10984,Kits,4,0,0.0,4
42453,10984,Stuff Packs,9,3,0.3333333333333333,6
42454,10985,Expansion Packs,14,0,0.0,14
42455,10985,Game Packs,8,1,0.125,7
42456,10985,Kits,7,1,0.14285714285714285,6
42457,10985,Stuff Packs,11,3,0.2727272727272727,8
42458,10986,Expansion Packs,16,0,0.0,16
42459,10986,Game Packs,12,1,0.08333333333333333,11
42460,10986,Kits,13,1,0.07692307692307693,12
42461,10986,Stuff Packs,15,2,0.13333333333333333,13
42462,10987,Expansion Packs,6,0,0.0,6
42463,10987,Game Packs,1,0,0.0,1
42464,10987,Stuff Packs,3,1,0.3333333333333333,2
42465,10988,Expansion Packs,8,0,0.0,8
42466,10988,Game Packs,9,0,0.0,9
42467,10988,Kits,18,0,0.0,18
42468,10988,Stuff Packs,19,0,0.0,19
42469,10989,Expansion Packs,11,0,0.0,11
42470,10989,Game Packs,5,0,0.0,5
42471,10989,Kits,5,1,0.2,4
42472,10989,Stuff Packs,4,1,0.25,3
42473,10990,Expansion Packs,12,0,0.0,12
42474,10990,Game Packs,6,0,0.0,6
42475,10990,Kits,8,1,0.125,7
42476,10990,Stuff Packs,8,3,0.375,5
42477,10991,Expansion Packs,6,0,0.0,6
42478,10991,Game Packs,6,0,0.0,6
42479,10991,Kits,12,0,0.0,12
42480,10991,Stuff Packs,5,1,0.2,4
42481,10992,Expansion Packs,16,0,0.0,16
42482,10992,Game Packs,12,0,0.0,12
42483,10992,Kits,33,0,0.0,33
42484,10992,Stuff Packs,20,0,0.0,20
42485,10993,Expansion Packs,10,0,0.0,10
42486,10993,Game Packs,5,0,0.0,5
42487,10993,Kits,3,2,0.6666666666666666,1
42488,10993,Stuff Packs,8,3,0.375,5
42489,10994,Expansion Packs,16,0,0.0,16
42490,10994,Game Packs,12,1,0.08333333333333333,11
42491,10994,Kits,33,1,0.030303030303030304,32
42492,10994,Stuff Packs,20,0,0.0,20
42493,10995,Expansion Packs,16,1,0.0625,15
42494,10995,Game Packs,12,8,0.6666666666666666,4
42495,10995,Kits,33,1,0.030303030303030304,32
42496,10995,Stuff Packs,20,11,0.55,9
42497,10996,Expansion Packs,16,0,0.0,16
42498,10996,Game Packs,12,0,0.0,12
42499,10996,Kits,23,0,0.0,23
42500,10996,Stuff Packs,20,0,0.0,20
42501,10997,Expansion Packs,16,0,0.0,16
42502,10997,Game Packs,12,0,0.0,12
42503,10997,Kits,26,0,0.0,26
42504,10997,Stuff Packs,20,0,0.0,20
42505,10998,Expansion Packs,16,0,0.0,16
42506,10998,Game Packs,10,0,0.0,10
42507,10998,Kits,2,1,0.5,1
42508,10998,Stuff Packs,16,3,0.1875,13
42509,10999,Expansion Packs,8,0,0.0,8
42510,10999,Game Packs,5,0,0.0,5
42511,10999,Kits,2,0,0.0,2
42512,10999,Stuff Packs,6,2,0.3333333333333333,4
42513,11000,Expansion Packs,16,0,0.0,16
42514,11000,Game Packs,12,0,0.0,12
42515,11000,Kits,33,1,0.030303030303030304,32
42516,11000,Stuff Packs,20,0,0.0,20
42517,11001,Expansion Packs,15,0,0.0,15
42518,11001,Game Packs,11,0,0.0,11
42519,11001,Kits,25,1,0.04,24
42520,11001,Stuff Packs,16,3,0.1875,13
42521,11002,Expansion Packs,5,0,0.0,5
42522,11002,Game Packs,2,0,0.0,2
42523,11002,Kits,1,1,1.0,0
42524,11002,Stuff Packs,1,1,1.0,0
42525,11003,Expansion Packs,16,0,0.0,16
42526,11003,Game Packs,12,1,0.08333333333333333,11
42527,11003,Kits,33,1,0.030303030303030304,32
42528,11003,Stuff Packs,20,3,0.15,17
42529,11004,Expansion Packs,14,0,0.0,14
42530,11004,Game Packs,6,0,0.0,6
42531,11004,Kits,2,0,0.0,2
42532,11004,Stuff Packs,9,0,0.0,9
42533,11005,Expansion Packs,12,0,0.0,12
42534,11005,Game Packs,6,0,0.0,6
42535,11005,Kits,16,0,0.0,16
42536,11005,Stuff Packs,7,0,0.0,7
42537,11006,Expansion Packs,8,0,0.0,8
42538,11006,Game Packs,3,0,0.0,3
42539,11006,Kits,1,1,1.0,0
42540,11006,Stuff Packs,2,0,0.0,2
42541,11007,Expansion Packs,15,0,0.0,15
42542,11007,Game Packs,11,0,0.0,11
42543,11007,Kits,21,1,0.047619047619047616,20
42544,11007,Stuff Packs,20,0,0.0,20
42545,11008,Expansion Packs,13,0,0.0,13
42546,11008,Game Packs,4,0,0.0,4
42547,11008,Kits,3,0,0.0,3
42548,11008,Stuff Packs,4,1,0.25,3
42549,11009,Expansion Packs,9,0,0.0,9
42550,11009,Game Packs,4,0,0.0,4
42551,11009,Kits,1,0,0.0,1
42552,11009,Stuff Packs,1,0,0.0,1
42553,11010,Expansion Packs,16,0,0.0,16
42554,11010,Game Packs,12,0,0.0,12
42555,11010,Kits,11,1,0.09090909090909091,10
42556,11010,Stuff Packs,20,0,0.0,20
42557,11011,Expansion Packs,11,0,0.0,11
42558,11011,Game Packs,6,0,0.0,6
42559,11011,Kits,3,0,0.0,3
42560,11011,Stuff Packs,10,0,0.0,10
42561,11012,Expansion Packs,16,0,0.0,16
42562,11012,Game Packs,12,0,0.0,12
42563,11012,Kits,32,1,0.03125,31
42564,11012,Stuff Packs,20,0,0.0,20
42565,11013,Expansion Packs,11,1,0.09090909090909091,10
42566,11013,Game Packs,4,2,0.5,2
42567,11013,Kits,1,0,0.0,1
42568,11013,Stuff Packs,6,3,0.5,3
42569,11014,Expansion Packs,15,0,0.0,15
42570,11014,Game Packs,11,0,0.0,11
42571,11014,Kits,11,1,0.09090909090909091,10
42572,11014,Stuff Packs,20,1,0.05,19
42573,11015,Expansion Packs,16,0,0.0,16
42574,11015,Game Packs,11,0,0.0,11
42575,11015,Kits,20,1,0.05,19
42576,11015,Stuff Packs,20,0,0.0,20
42577,11016,Expansion Packs,16,0,0.0,16
42578,11016,Game Packs,12,0,0.0,12
42579,11016,Kits,15,0,0.0,15
42580,11016,Stuff Packs,11,2,0.18181818181818182,9
42581,11017,Expansion Packs,7,0,0.0,7
42582,11017,Game Packs,3,1,0.3333333333333333,2
42583,11017,Kits,3,3,1.0,0
42584,11017,Stuff Packs,5,4,0.8,1
42585,11018,Expansion Packs,6,0,0.0,6
42586,11018,Game Packs,3,0,0.0,3
42587,11018,Kits,1,1,1.0,0
42588,11018,Stuff Packs,5,3,0.6,2
42589,11019,Expansion Packs,16,0,0.0,16
42590,11019,Game Packs,12,0,0.0,12
42591,11019,Kits,31,1,0.03225806451612903,30
42592,11019,Stuff Packs,20,0,0.0,20
42593,11020,Kits,2,2,1.0,0
42594,11020,Stuff Packs,3,3,1.0,0
42595,11021,Expansion Packs,11,0,0.0,11
42596,11021,Game Packs,5,0,0.0,5
42597,11021,Stuff Packs,8,0,0.0,8
42598,11022,Expansion Packs,15,0,0.0,15
42599,11022,Game Packs,6,0,0.0,6
42600,11022,Kits,2,2,1.0,0
42601,11022,Stuff Packs,8,2,0.25,6
42602,11023,Expansion Packs,16,0,0.0,16
42603,11023,Game Packs,11,0,0.0,11
42604,11023,Kits,16,2,0.125,14
42605,11023,Stuff Packs,20,0,0.0,20
42606,11024,Expansion Packs,16,0,0.0,16
42607,11024,Game Packs,11,2,0.18181818181818182,9
42608,11024,Kits,24,1,0.041666666666666664,23
42609,11024,Stuff Packs,20,4,0.2,16
42610,11025,Expansion Packs,16,0,0.0,16
42611,11025,Game Packs,12,0,0.0,12
42612,11025,Kits,33,0,0.0,33
42613,11025,Stuff Packs,20,0,0.0,20
42614,11026,Expansion Packs,10,0,0.0,10
42615,11026,Game Packs,4,0,0.0,4
42616,11026,Kits,9,1,0.1111111111111111,8
42617,11026,Stuff Packs,8,2,0.25,6
42618,11027,Expansion Packs,16,0,0.0,16
42619,11027,Game Packs,12,0,0.0,12
42620,11027,Kits,31,0,0.0,31
42621,11027,Stuff Packs,20,0,0.0,20
42622,11028,Expansion Packs,16,0,0.0,16
42623,11028,Game Packs,12,0,0.0,12
42624,11028,Kits,33,2,0.06060606060606061,31
42625,11028,Stuff Packs,20,1,0.05,19
42626,11029,Expansion Packs,16,0,0.0,16
42627,11029,Game Packs,10,0,0.0,10
42628,11029,Kits,10,1,0.1,9
42629,11029,Stuff Packs,19,0,0.0,19
42630,11030,Expansion Packs,14,0,0.0,14
42631,11030,Game Packs,9,0,0.0,9
42632,11030,Kits,1,0,0.0,1
42633,11030,Stuff Packs,17,0,0.0,17
42634,11031,Expansion Packs,16,0,0.0,16
42635,11031,Game Packs,10,0,0.0,10
42636,11031,Kits,6,0,0.0,6
42637,11031,Stuff Packs,15,0,0.0,15
42638,11032,Expansion Packs,10,0,0.0,10
42639,11032,Game Packs,4,0,0.0,4
42640,11032,Stuff Packs,9,1,0.1111111111111111,8
42641,11033,Expansion Packs,12,0,0.0,12
42642,11033,Game Packs,9,0,0.0,9
42643,11033,Kits,3,1,0.3333333333333333,2
42644,11033,Stuff Packs,9,2,0.2222222222222222,7
42645,11034,Expansion Packs,16,0,0.0,16
42646,11034,Game Packs,12,0,0.0,12
42647,11034,Kits,33,0,0.0,33
42648,11034,Stuff Packs,20,0,0.0,20
42649,11035,Expansion Packs,13,0,0.0,13
42650,11035,Game Packs,4,0,0.0,4
42651,11035,Kits,11,1,0.09090909090909091,10
42652,11035,Stuff Packs,15,3,0.2,12
42653,11036,Expansion Packs,11,0,0.0,11
42654,11036,Game Packs,5,0,0.0,5
42655,11036,Kits,5,1,0.2,4
42656,11036,Stuff Packs,9,0,0.0,9
42657,11037,Expansion Packs,9,0,0.0,9
42658,11037,Game Packs,4,0,0.0,4
42659,11037,Kits,2,2,1.0,0
42660,11037,Stuff Packs,8,2,0.25,6
42661,11038,Expansion Packs,15,1,0.06666666666666667,14
42662,11038,Game Packs,9,0,0.0,9
42663,11038,Kits,8,2,0.25,6
42664,11038,Stuff Packs,14,2,0.14285714285714285,12
42665,11039,Expansion Packs,16,0,0.0,16
42666,11039,Game Packs,12,0,0.0,12
42667,11039,Kits,33,2,0.06060606060606061,31
42668,11039,Stuff Packs,20,0,0.0,20
42669,11040,Expansion Packs,16,0,0.0,16
42670,11040,Game Packs,11,0,0.0,11
42671,11040,Kits,33,1,0.030303030303030304,32
42672,11040,Stuff Packs,20,0,0.0,20
42673,11041,Expansion Packs,16,0,0.0,16
42674,11041,Game Packs,12,0,0.0,12
42675,11041,Kits,13,0,0.0,13
42676,11041,Stuff Packs,20,0,0.0,20
42677,11042,Expansion Packs,13,0,0.0,13
42678,11042,Game Packs,6,0,0.0,6
42679,11042,Kits,3,1,0.3333333333333333,2
42680,11042,Stuff Packs,8,3,0.375,5
42681,11043,Expansion Packs,11,0,0.0,11
42682,11043,Game Packs,7,0,0.0,7
42683,11043,Kits,1,1,1.0,0
42684,11043,Stuff Packs,9,2,0.2222222222222222,7
42685,11044,Expansion Packs,15,0,0.0,15
42686,11044,Game Packs,11,0,0.0,11
42687,11044,Kits,15,1,0.06666666666666667,14
42688,11044,Stuff Packs,20,0,0.0,20
42689,11045,Expansion Packs,2,0,0.0,2
42690,11045,Game Packs,2,0,0.0,2
42691,11045,Kits,1,1,1.0,0
42692,11045,Stuff Packs,2,0,0.0,2
42693,11046,Expansion Packs,16,0,0.0,16
42694,11046,Game Packs,8,0,0.0,8
42695,11046,Kits,8,5,0.625,3
42696,11046,Stuff Packs,12,1,0.08333333333333333,11
42697,11047,Expansion Packs,10,0,0.0,10
42698,11047,Game Packs,6,0,0.0,6
42699,11047,Kits,1,0,0.0,1
42700,11047,Stuff Packs,10,0,0.0,10
42701,11048,Expansion Packs,14,0,0.0,14
42702,11048,Game Packs,7,0,0.0,7
42703,11048,Kits,10,1,0.1,9
42704,11048,Stuff Packs,17,0,0.0,17
42705,11049,Expansion Packs,12,0,0.0,12
42706,11049,Game Packs,5,0,0.0,5
42707,11049,Kits,4,0,0.0,4
42708,11049,Stuff Packs,6,0,0.0,6
42709,11050,Expansion Packs,16,0,0.0,16
42710,11050,Game Packs,12,0,0.0,12
42711,11050,Kits,17,1,0.058823529411764705,16
42712,11050,Stuff Packs,19,0,0.0,19
42713,11051,Expansion Packs,10,0,0.0,10
42714,11051,Game Packs,7,0,0.0,7
42715,11051,Kits,1,1,1.0,0
42716,11051,Stuff Packs,7,1,0.14285714285714285,6
42717,11052,Expansion Packs,16,0,0.0,16
42718,11052,Game Packs,11,0,0.0,11
42719,11052,Kits,33,0,0.0,33
42720,11052,Stuff Packs,20,0,0.0,20
42721,11053,Expansion Packs,6,0,0.0,6
42722,11053,Game Packs,5,0,0.0,5
42723,11053,Kits,1,1,1.0,0
42724,11053,Stuff Packs,8,3,0.375,5
42725,11054,Expansion Packs,7,0,0.0,7
42726,11054,Game Packs,2,0,0.0,2
42727,11054,Kits,2,0,0.0,2
42728,11054,Stuff Packs,7,2,0.2857142857142857,5
42729,11055,Expansion Packs,13,0,0.0,13
42730,11055,Game Packs,9,0,0.0,9
42731,11055,Kits,5,3,0.6,2
42732,11055,Stuff Packs,11,2,0.18181818181818182,9
42733,11056,Expansion Packs,1,1,1.0,0
42734,11056,Kits,1,1,1.0,0
42735,11056,Stuff Packs,3,3,1.0,0
42736,11057,Expansion Packs,16,0,0.0,16
42737,11057,Game Packs,11,0,0.0,11
42738,11057,Kits,19,2,0.10526315789473684,17
42739,11057,Stuff Packs,20,2,0.1,18
42740,11058,Expansion Packs,16,0,0.0,16
42741,11058,Game Packs,12,0,0.0,12
42742,11058,Kits,33,0,0.0,33
42743,11058,Stuff Packs,20,0,0.0,20
42744,11059,Expansion Packs,15,0,0.0,15
42745,11059,Game Packs,9,0,0.0,9
42746,11059,Kits,23,1,0.043478260869565216,22
42747,11059,Stuff Packs,19,0,0.0,19
42748,11060,Expansion Packs,12,0,0.0,12
42749,11060,Game Packs,8,0,0.0,8
42750,11060,Kits,3,1,0.3333333333333333,2
42751,11060,Stuff Packs,7,0,0.0,7
42752,11061,Expansion Packs,16,0,0.0,16
42753,11061,Game Packs,12,0,0.0,12
42754,11061,Kits,31,1,0.03225806451612903,30
42755,11061,Stuff Packs,20,0,0.0,20
42756,11062,Expansion Packs,4,0,0.0,4
42757,11062,Game Packs,3,0,0.0,3
42758,11062,Kits,3,0,0.0,3
42759,11062,Stuff Packs,7,0,0.0,7
42760,11063,Expansion Packs,9,0,0.0,9
42761,11063,Game Packs,5,1,0.2,4
42762,11063,Stuff Packs,5,3,0.6,2
42763,11064,Expansion Packs,16,0,0.0,16
42764,11064,Game Packs,12,0,0.0,12
42765,11064,Kits,33,0,0.0,33
42766,11064,Stuff Packs,20,0,0.0,20
42767,11065,Expansion Packs,7,0,0.0,7
42768,11065,Game Packs,5,0,0.0,5
42769,11065,Stuff Packs,4,0,0.0,4
42770,11066,Expansion Packs,4,0,0.0,4
42771,11066,Game Packs,2,0,0.0,2
42772,11066,Kits,2,2,1.0,0
42773,11066,Stuff Packs,3,1,0.3333333333333333,2
42774,11067,Expansion Packs,14,0,0.0,14
42775,11067,Game Packs,10,0,0.0,10
42776,11067,Kits,5,0,0.0,5
42777,11067,Stuff Packs,8,0,0.0,8
42778,11068,Expansion Packs,4,0,0.0,4
42779,11068,Game Packs,4,0,0.0,4
42780,11068,Kits,1,0,0.0,1
42781,11068,Stuff Packs,4,3,0.75,1
42782,11069,Expansion Packs,15,0,0.0,15
42783,11069,Game Packs,12,0,0.0,12
42784,11069,Kits,7,2,0.2857142857142857,5
42785,11069,Stuff Packs,20,0,0.0,20
42786,11070,Expansion Packs,12,0,0.0,12
42787,11070,Game Packs,12,0,0.0,12
42788,11070,Kits,8,0,0.0,8
42789,11070,Stuff Packs,18,0,0.0,18
42790,11071,Expansion Packs,14,0,0.0,14
42791,11071,Game Packs,9,1,0.1111111111111111,8
42792,11071,Kits,2,2,1.0,0
42793,11071,Stuff Packs,14,4,0.2857142857142857,10
42794,11072,Expansion Packs,15,2,0.13333333333333333,13
42795,11072,Game Packs,4,0,0.0,4
42796,11072,Kits,11,0,0.0,11
42797,11072,Stuff Packs,15,1,0.06666666666666667,14
42798,11073,Expansion Packs,16,0,0.0,16
42799,11073,Game Packs,12,0,0.0,12
42800,11073,Kits,26,0,0.0,26
42801,11073,Stuff Packs,20,0,0.0,20
42802,11074,Expansion Packs,10,0,0.0,10
42803,11074,Game Packs,6,0,0.0,6
42804,11074,Kits,2,2,1.0,0
42805,11074,Stuff Packs,3,2,0.6666666666666666,1
42806,11075,Expansion Packs,12,0,0.0,12
42807,11075,Game Packs,1,0,0.0,1
42808,11075,Kits,4,0,0.0,4
42809,11075,Stuff Packs,4,2,0.5,2
42810,11076,Expansion Packs,16,0,0.0,16
42811,11076,Game Packs,12,0,0.0,12
42812,11076,Kits,31,2,0.06451612903225806,29
42813,11076,Stuff Packs,20,1,0.05,19
42814,11077,Expansion Packs,16,0,0.0,16
42815,11077,Game Packs,9,1,0.1111111111111111,8
42816,11077,Kits,10,3,0.3,7
42817,11077,Stuff Packs,14,3,0.21428571428571427,11
42818,11078,Expansion Packs,16,0,0.0,16
42819,11078,Game Packs,11,0,0.0,11
42820,11078,Kits,14,0,0.0,14
42821,11078,Stuff Packs,20,0,0.0,20
42822,11079,Expansion Packs,15,0,0.0,15
42823,11079,Game Packs,11,0,0.0,11
42824,11079,Kits,2,2,1.0,0
42825,11079,Stuff Packs,12,2,0.16666666666666666,10
42826,11080,Expansion Packs,8,0,0.0,8
42827,11080,Game Packs,2,0,0.0,2
42828,11080,Kits,2,1,0.5,1
42829,11080,Stuff Packs,5,1,0.2,4
42830,11081,Expansion Packs,14,0,0.0,14
42831,11081,Game Packs,10,0,0.0,10
42832,11081,Kits,18,2,0.1111111111111111,16
42833,11081,Stuff Packs,19,0,0.0,19
42834,11082,Expansion Packs,15,0,0.0,15
42835,11082,Game Packs,12,0,0.0,12
42836,11082,Kits,11,2,0.18181818181818182,9
42837,11082,Stuff Packs,20,0,0.0,20
42838,11083,Expansion Packs,16,0,0.0,16
42839,11083,Game Packs,12,0,0.0,12
42840,11083,Kits,27,0,0.0,27
42841,11083,Stuff Packs,20,0,0.0,20
42842,11084,Expansion Packs,15,0,0.0,15
42843,11084,Game Packs,12,0,0.0,12
42844,11084,Kits,9,1,0.1111111111111111,8
42845,11084,Stuff Packs,17,1,0.058823529411764705,16
42846,11085,Expansion Packs,16,0,0.0,16
42847,11085,Game Packs,11,0,0.0,11
42848,11085,Kits,31,1,0.03225806451612903,30
42849,11085,Stuff Packs,20,0,0.0,20
42850,11086,Expansion Packs,16,0,0.0,16
42851,11086,Game Packs,12,0,0.0,12
42852,11086,Kits,33,2,0.06060606060606061,31
42853,11086,Stuff Packs,20,0,0.0,20
42854,11087,Expansion Packs,16,0,0.0,16
42855,11087,Game Packs,12,2,0.16666666666666666,10
42856,11087,Kits,28,9,0.32142857142857145,19
42857,11087,Stuff Packs,20,0,0.0,20
42858,11088,Expansion Packs,16,0,0.0,16
42859,11088,Game Packs,12,0,0.0,12
42860,11088,Kits,33,1,0.030303030303030304,32
42861,11088,Stuff Packs,20,0,0.0,20
42862,11089,Expansion Packs,16,0,0.0,16
42863,11089,Game Packs,12,0,0.0,12
42864,11089,Kits,16,0,0.0,16
42865,11089,Stuff Packs,19,0,0.0,19
42866,11090,Expansion Packs,16,0,0.0,16
42867,11090,Game Packs,11,0,0.0,11
42868,11090,Kits,32,1,0.03125,31
42869,11090,Stuff Packs,20,0,0.0,20
42870,11091,Expansion Packs,4,0,0.0,4
42871,11091,Game Packs,2,0,0.0,2
42872,11091,Kits,1,0,0.0,1
42873,11091,Stuff Packs,4,1,0.25,3
42874,11092,Expansion Packs,16,0,0.0,16
42875,11092,Game Packs,11,0,0.0,11
42876,11092,Kits,12,1,0.08333333333333333,11
42877,11092,Stuff Packs,17,0,0.0,17
42878,11093,Expansion Packs,14,0,0.0,14
42879,11093,Game Packs,9,0,0.0,9
42880,11093,Kits,14,0,0.0,14
42881,11093,Stuff Packs,20,0,0.0,20
42882,11094,Expansion Packs,14,0,0.0,14
42883,11094,Game Packs,10,0,0.0,10
42884,11094,Stuff Packs,20,0,0.0,20
42885,11095,Expansion Packs,16,0,0.0,16
42886,11095,Game Packs,8,0,0.0,8
42887,11095,Kits,5,0,0.0,5
42888,11095,Stuff Packs,19,0,0.0,19
42889,11096,Expansion Packs,8,0,0.0,8
42890,11096,Game Packs,6,0,0.0,6
42891,11096,Kits,1,0,0.0,1
42892,11096,Stuff Packs,10,0,0.0,10
42893,11097,Expansion Packs,16,0,0.0,16
42894,11097,Game Packs,11,0,0.0,11
42895,11097,Kits,2,2,1.0,0
42896,11097,Stuff Packs,19,0,0.0,19
42897,11098,Expansion Packs,13,0,0.0,13
42898,11098,Game Packs,8,0,0.0,8
42899,11098,Kits,4,0,0.0,4
42900,11098,Stuff Packs,13,0,0.0,13
42901,11099,Expansion Packs,8,0,0.0,8
42902,11099,Game Packs,2,0,0.0,2
42903,11099,Kits,2,0,0.0,2
42904,11099,Stuff Packs,1,0,0.0,1
42905,11100,Expansion Packs,6,0,0.0,6
42906,11100,Game Packs,6,0,0.0,6
42907,11100,Kits,2,1,0.5,1
42908,11100,Stuff Packs,5,3,0.6,2
42909,11101,Expansion Packs,10,0,0.0,10
42910,11101,Game Packs,8,0,0.0,8
42911,11101,Kits,1,1,1.0,0
42912,11101,Stuff Packs,8,2,0.25,6
42913,11102,Expansion Packs,16,0,0.0,16
42914,11102,Game Packs,11,0,0.0,11
42915,11102,Kits,16,1,0.0625,15
42916,11102,Stuff Packs,12,2,0.16666666666666666,10
42917,11103,Expansion Packs,16,0,0.0,16
42918,11103,Game Packs,12,0,0.0,12
42919,11103,Kits,33,0,0.0,33
42920,11103,Stuff Packs,20,0,0.0,20
42921,11104,Expansion Packs,10,0,0.0,10
42922,11104,Game Packs,5,0,0.0,5
42923,11104,Kits,2,2,1.0,0
42924,11104,Stuff Packs,8,3,0.375,5
42925,11105,Expansion Packs,4,0,0.0,4
42926,11105,Game Packs,2,0,0.0,2
42927,11105,Kits,2,0,0.0,2
42928,11105,Stuff Packs,2,0,0.0,2
42929,11106,Expansion Packs,3,0,0.0,3
42930,11106,Game Packs,2,1,0.5,1
42931,11106,Kits,3,3,1.0,0
42932,11106,Stuff Packs,6,4,0.6666666666666666,2
42933,11107,Expansion Packs,3,0,0.0,3
42934,11107,Game Packs,3,0,0.0,3
42935,11107,Kits,4,0,0.0,4
42936,11107,Stuff Packs,7,2,0.2857142857142857,5
42937,11108,Expansion Packs,16,0,0.0,16
42938,11108,Game Packs,12,0,0.0,12
42939,11108,Kits,33,0,0.0,33
42940,11108,Stuff Packs,20,0,0.0,20
42941,11109,Expansion Packs,10,0,0.0,10
42942,11109,Game Packs,7,0,0.0,7
42943,11109,Stuff Packs,2,0,0.0,2
42944,11110,Expansion Packs,13,0,0.0,13
42945,11110,Game Packs,10,0,0.0,10
42946,11110,Kits,2,2,1.0,0
42947,11110,Stuff Packs,9,2,0.2222222222222222,7
42948,11111,Expansion Packs,15,0,0.0,15
42949,11111,Game Packs,12,0,0.0,12
42950,11111,Kits,2,1,0.5,1
42951,11111,Stuff Packs,20,0,0.0,20
42952,11112,Expansion Packs,16,0,0.0,16
42953,11112,Game Packs,12,0,0.0,12
42954,11112,Kits,33,0,0.0,33
42955,11112,Stuff Packs,20,0,0.0,20
42956,11113,Expansion Packs,16,0,0.0,16
42957,11113,Game Packs,12,0,0.0,12
42958,11113,Kits,33,0,0.0,33
42959,11113,Stuff Packs,20,0,0.0,20
42960,11114,Expansion Packs,16,1,0.0625,15
42961,11114,Game Packs,12,0,0.0,12
42962,11114,Kits,25,1,0.04,24
42963,11114,Stuff Packs,20,0,0.0,20
42964,11115,Expansion Packs,10,0,0.0,10
42965,11115,Game Packs,8,0,0.0,8
42966,11115,Kits,6,1,0.16666666666666666,5
42967,11115,Stuff Packs,7,0,0.0,7
42968,11116,Expansion Packs,16,0,0.0,16
42969,11116,Game Packs,12,0,0.0,12
42970,11116,Kits,33,0,0.0,33
42971,11116,Stuff Packs,20,0,0.0,20
42972,11117,Expansion Packs,13,0,0.0,13
42973,11117,Game Packs,5,0,0.0,5
42974,11117,Kits,5,0,0.0,5
42975,11117,Stuff Packs,9,3,0.3333333333333333,6
42976,11118,Expansion Packs,12,0,0.0,12
42977,11118,Game Packs,2,0,0.0,2
42978,11118,Stuff Packs,2,0,0.0,2
42979,11119,Expansion Packs,16,0,0.0,16
42980,11119,Game Packs,12,0,0.0,12
42981,11119,Kits,11,0,0.0,11
42982,11119,Stuff Packs,20,0,0.0,20
42983,11120,Expansion Packs,13,0,0.0,13
42984,11120,Game Packs,11,0,0.0,11
42985,11120,Kits,3,1,0.3333333333333333,2
42986,11120,Stuff Packs,15,1,0.06666666666666667,14
42987,11121,Expansion Packs,16,0,0.0,16
42988,11121,Game Packs,10,0,0.0,10
42989,11121,Kits,15,1,0.06666666666666667,14
42990,11121,Stuff Packs,15,2,0.13333333333333333,13
42991,11122,Expansion Packs,15,0,0.0,15
42992,11122,Game Packs,10,0,0.0,10
42993,11122,Kits,7,1,0.14285714285714285,6
42994,11122,Stuff Packs,19,0,0.0,19
42995,11123,Expansion Packs,14,0,0.0,14
42996,11123,Game Packs,4,0,0.0,4
42997,11123,Kits,1,1,1.0,0
42998,11123,Stuff Packs,10,1,0.1,9
42999,11124,Game Packs,1,0,0.0,1
43000,11124,Kits,2,0,0.0,2
43001,11125,Expansion Packs,16,0,0.0,16
43002,11125,Game Packs,8,0,0.0,8
43003,11125,Kits,23,0,0.0,23
43004,11125,Stuff Packs,15,0,0.0,15
43005,11126,Expansion Packs,14,0,0.0,14
43006,11126,Game Packs,7,0,0.0,7
43007,11126,Kits,6,1,0.16666666666666666,5
43008,11126,Stuff Packs,8,0,0.0,8
43009,11127,Expansion Packs,16,0,0.0,16
43010,11127,Game Packs,12,0,0.0,12
43011,11127,Kits,9,0,0.0,9
43012,11127,Stuff Packs,20,0,0.0,20
43013,11128,Expansion Packs,15,0,0.0,15
43014,11128,Game Packs,8,0,0.0,8
43015,11128,Kits,14,0,0.0,14
43016,11128,Stuff Packs,19,0,0.0,19
43017,11129,Expansion Packs,16,0,0.0,16
43018,11129,Game Packs,12,2,0.16666666666666666,10
43019,11129,Kits,33,1,0.030303030303030304,32
43020,11129,Stuff Packs,20,2,0.1,18
43021,11130,Expansion Packs,14,0,0.0,14
43022,11130,Game Packs,10,0,0.0,10
43023,11130,Kits,3,1,0.3333333333333333,2
43024,11130,Stuff Packs,14,0,0.0,14
43025,11131,Expansion Packs,8,0,0.0,8
43026,11131,Game Packs,3,0,0.0,3
43027,11131,Kits,2,1,0.5,1
43028,11131,Stuff Packs,8,3,0.375,5
43029,11132,Expansion Packs,11,0,0.0,11
43030,11132,Game Packs,5,1,0.2,4
43031,11132,Kits,5,2,0.4,3
43032,11132,Stuff Packs,9,2,0.2222222222222222,7
43033,11133,Expansion Packs,12,0,0.0,12
43034,11133,Game Packs,10,0,0.0,10
43035,11133,Kits,6,0,0.0,6
43036,11133,Stuff Packs,18,0,0.0,18
43037,11134,Expansion Packs,16,0,0.0,16
43038,11134,Game Packs,12,0,0.0,12
43039,11134,Kits,33,1,0.030303030303030304,32
43040,11134,Stuff Packs,20,0,0.0,20
43041,11135,Expansion Packs,9,0,0.0,9
43042,11135,Game Packs,7,0,0.0,7
43043,11135,Kits,2,2,1.0,0
43044,11135,Stuff Packs,8,0,0.0,8
43045,11136,Expansion Packs,14,0,0.0,14
43046,11136,Game Packs,8,0,0.0,8
43047,11136,Kits,5,2,0.4,3
43048,11136,Stuff Packs,7,1,0.14285714285714285,6
43049,11137,Expansion Packs,11,0,0.0,11
43050,11137,Game Packs,6,0,0.0,6
43051,11137,Kits,1,1,1.0,0
43052,11137,Stuff Packs,5,1,0.2,4
43053,11138,Expansion Packs,10,0,0.0,10
43054,11138,Game Packs,7,0,0.0,7
43055,11138,Kits,2,0,0.0,2
43056,11138,Stuff Packs,13,1,0.07692307692307693,12
43057,11139,Expansion Packs,13,0,0.0,13
43058,11139,Game Packs,11,0,0.0,11
43059,11139,Kits,6,1,0.16666666666666666,5
43060,11139,Stuff Packs,16,0,0.0,16
43061,11140,Expansion Packs,16,0,0.0,16
43062,11140,Game Packs,12,0,0.0,12
43063,11140,Kits,33,0,0.0,33
43064,11140,Stuff Packs,20,0,0.0,20
43065,11141,Expansion Packs,6,0,0.0,6
43066,11141,Game Packs,2,0,0.0,2
43067,11141,Kits,3,0,0.0,3
43068,11141,Stuff Packs,4,0,0.0,4
43069,11142,Expansion Packs,7,0,0.0,7
43070,11142,Stuff Packs,2,1,0.5,1
43071,11143,Expansion Packs,12,0,0.0,12
43072,11143,Game Packs,4,0,0.0,4
43073,11143,Kits,4,1,0.25,3
43074,11143,Stuff Packs,2,0,0.0,2
43075,11144,Expansion Packs,7,0,0.0,7
43076,11144,Game Packs,4,0,0.0,4
43077,11144,Kits,2,2,1.0,0
43078,11144,Stuff Packs,11,2,0.18181818181818182,9
43079,11145,Expansion Packs,16,0,0.0,16
43080,11145,Game Packs,12,0,0.0,12
43081,11145,Kits,33,0,0.0,33
43082,11145,Stuff Packs,20,0,0.0,20
43083,11146,Kits,1,1,1.0,0
43084,11147,Expansion Packs,12,0,0.0,12
43085,11147,Game Packs,4,0,0.0,4
43086,11147,Kits,11,0,0.0,11
43087,11147,Stuff Packs,6,2,0.3333333333333333,4
43088,11148,Expansion Packs,16,0,0.0,16
43089,11148,Game Packs,12,0,0.0,12
43090,11148,Kits,33,1,0.030303030303030304,32
43091,11148,Stuff Packs,20,0,0.0,20
43092,11149,Expansion Packs,16,0,0.0,16
43093,11149,Game Packs,12,0,0.0,12
43094,11149,Kits,26,0,0.0,26
43095,11149,Stuff Packs,20,0,0.0,20
43096,11150,Expansion Packs,13,0,0.0,13
43097,11150,Game Packs,8,0,0.0,8
43098,11150,Kits,3,0,0.0,3
43099,11150,Stuff Packs,5,0,0.0,5
43100,11151,Expansion Packs,15,0,0.0,15
43101,11151,Game Packs,9,0,0.0,9
43102,11151,Stuff Packs,5,0,0.0,5
43103,11152,Expansion Packs,10,0,0.0,10
43104,11152,Game Packs,5,0,0.0,5
43105,11152,Kits,2,1,0.5,1
43106,11152,Stuff Packs,6,1,0.16666666666666666,5
43107,11153,Expansion Packs,16,0,0.0,16
43108,11153,Game Packs,12,0,0.0,12
43109,11153,Kits,16,1,0.0625,15
43110,11153,Stuff Packs,20,0,0.0,20
43111,11154,Expansion Packs,14,0,0.0,14
43112,11154,Game Packs,11,0,0.0,11
43113,11154,Kits,6,0,0.0,6
43114,11154,Stuff Packs,20,0,0.0,20
43115,11155,Expansion Packs,6,1,0.16666666666666666,5
43116,11155,Game Packs,2,0,0.0,2
43117,11155,Stuff Packs,1,1,1.0,0
43118,11156,Expansion Packs,11,0,0.0,11
43119,11156,Game Packs,7,0,0.0,7
43120,11156,Kits,9,1,0.1111111111111111,8
43121,11156,Stuff Packs,11,3,0.2727272727272727,8
43122,11157,Expansion Packs,10,0,0.0,10
43123,11157,Game Packs,5,0,0.0,5
43124,11157,Stuff Packs,5,0,0.0,5
43125,11158,Expansion Packs,16,0,0.0,16
43126,11158,Game Packs,9,0,0.0,9
43127,11158,Kits,9,1,0.1111111111111111,8
43128,11158,Stuff Packs,10,0,0.0,10
43129,11159,Expansion Packs,12,0,0.0,12
43130,11159,Game Packs,4,0,0.0,4
43131,11159,Kits,4,2,0.5,2
43132,11159,Stuff Packs,5,3,0.6,2
43133,11160,Expansion Packs,15,0,0.0,15
43134,11160,Game Packs,9,0,0.0,9
43135,11160,Kits,3,1,0.3333333333333333,2
43136,11160,Stuff Packs,11,1,0.09090909090909091,10
43137,11161,Expansion Packs,11,0,0.0,11
43138,11161,Game Packs,3,0,0.0,3
43139,11161,Kits,2,2,1.0,0
43140,11161,Stuff Packs,6,3,0.5,3
43141,11162,Expansion Packs,16,0,0.0,16
43142,11162,Game Packs,12,0,0.0,12
43143,11162,Kits,33,0,0.0,33
43144,11162,Stuff Packs,20,0,0.0,20
43145,11163,Expansion Packs,14,0,0.0,14
43146,11163,Game Packs,9,0,0.0,9
43147,11163,Stuff Packs,7,2,0.2857142857142857,5
43148,11164,Expansion Packs,16,0,0.0,16
43149,11164,Game Packs,11,0,0.0,11
43150,11164,Kits,14,2,0.14285714285714285,12
43151,11164,Stuff Packs,20,2,0.1,18
43152,11165,Expansion Packs,12,0,0.0,12
43153,11165,Game Packs,9,2,0.2222222222222222,7
43154,11165,Kits,4,3,0.75,1
43155,11165,Stuff Packs,13,2,0.15384615384615385,11
43156,11166,Expansion Packs,16,5,0.3125,11
43157,11166,Game Packs,12,7,0.5833333333333334,5
43158,11166,Kits,33,0,0.0,33
43159,11166,Stuff Packs,20,14,0.7,6
43160,11167,Expansion Packs,16,0,0.0,16
43161,11167,Game Packs,12,0,0.0,12
43162,11167,Kits,23,0,0.0,23
43163,11167,Stuff Packs,20,1,0.05,19
43164,11168,Expansion Packs,16,0,0.0,16
43165,11168,Game Packs,12,0,0.0,12
43166,11168,Kits,33,0,0.0,33
43167,11168,Stuff Packs,20,0,0.0,20
43168,11169,Expansion Packs,16,0,0.0,16
43169,11169,Game Packs,12,0,0.0,12
43170,11169,Kits,30,0,0.0,30
43171,11169,Stuff Packs,20,0,0.0,20
43172,11170,Expansion Packs,2,0,0.0,2
43173,11170,Game Packs,1,0,0.0,1
43174,11170,Kits,1,1,1.0,0
43175,11170,Stuff Packs,1,1,1.0,0
43176,11171,Expansion Packs,16,0,0.0,16
43177,11171,Game Packs,10,1,0.1,9
43178,11171,Kits,13,1,0.07692307692307693,12
43179,11171,Stuff Packs,16,2,0.125,14
43180,11172,Expansion Packs,10,0,0.0,10
43181,11172,Game Packs,3,0,0.0,3
43182,11172,Kits,1,1,1.0,0
43183,11172,Stuff Packs,6,4,0.6666666666666666,2
43184,11173,Expansion Packs,15,0,0.0,15
43185,11173,Game Packs,9,0,0.0,9
43186,11173,Kits,2,0,0.0,2
43187,11173,Stuff Packs,8,0,0.0,8
43188,11174,Expansion Packs,16,0,0.0,16
43189,11174,Game Packs,12,0,0.0,12
43190,11174,Kits,16,1,0.0625,15
43191,11174,Stuff Packs,20,0,0.0,20
43192,11175,Expansion Packs,15,0,0.0,15
43193,11175,Game Packs,12,0,0.0,12
43194,11175,Kits,10,2,0.2,8
43195,11175,Stuff Packs,17,0,0.0,17
43196,11176,Expansion Packs,9,0,0.0,9
43197,11176,Game Packs,6,0,0.0,6
43198,11176,Kits,1,1,1.0,0
43199,11176,Stuff Packs,8,1,0.125,7
43200,11177,Expansion Packs,16,0,0.0,16
43201,11177,Game Packs,12,0,0.0,12
43202,11177,Kits,33,0,0.0,33
43203,11177,Stuff Packs,20,0,0.0,20
43204,11178,Expansion Packs,16,0,0.0,16
43205,11178,Game Packs,10,0,0.0,10
43206,11178,Kits,27,0,0.0,27
43207,11178,Stuff Packs,20,0,0.0,20
43208,11179,Expansion Packs,2,0,0.0,2
43209,11179,Stuff Packs,1,0,0.0,1
43210,11180,Expansion Packs,16,0,0.0,16
43211,11180,Game Packs,12,0,0.0,12
43212,11180,Kits,31,0,0.0,31
43213,11180,Stuff Packs,20,0,0.0,20
43214,11181,Expansion Packs,4,0,0.0,4
43215,11181,Game Packs,2,0,0.0,2
43216,11181,Kits,1,0,0.0,1
43217,11181,Stuff Packs,1,0,0.0,1
43218,11182,Expansion Packs,15,0,0.0,15
43219,11182,Game Packs,11,0,0.0,11
43220,11182,Kits,12,1,0.08333333333333333,11
43221,11182,Stuff Packs,13,1,0.07692307692307693,12
43222,11183,Expansion Packs,16,0,0.0,16
43223,11183,Game Packs,12,0,0.0,12
43224,11183,Kits,32,1,0.03125,31
43225,11183,Stuff Packs,20,0,0.0,20
43226,11184,Game Packs,1,1,1.0,0
43227,11184,Kits,2,2,1.0,0
43228,11184,Stuff Packs,4,4,1.0,0
43229,11185,Expansion Packs,16,0,0.0,16
43230,11185,Game Packs,11,0,0.0,11
43231,11185,Kits,30,1,0.03333333333333333,29
43232,11185,Stuff Packs,20,0,0.0,20
43233,11186,Expansion Packs,16,0,0.0,16
43234,11186,Game Packs,7,0,0.0,7
43235,11186,Kits,12,2,0.16666666666666666,10
43236,11186,Stuff Packs,16,1,0.0625,15
43237,11187,Expansion Packs,16,0,0.0,16
43238,11187,Game Packs,10,0,0.0,10
43239,11187,Kits,33,1,0.030303030303030304,32
43240,11187,Stuff Packs,20,0,0.0,20
43241,11188,Expansion Packs,15,0,0.0,15
43242,11188,Game Packs,11,0,0.0,11
43243,11188,Kits,4,3,0.75,1
43244,11188,Stuff Packs,15,0,0.0,15
43245,11189,Expansion Packs,2,0,0.0,2
43246,11189,Game Packs,1,0,0.0,1
43247,11189,Kits,3,1,0.3333333333333333,2
43248,11189,Stuff Packs,2,0,0.0,2
43249,11190,Expansion Packs,12,0,0.0,12
43250,11190,Game Packs,10,0,0.0,10
43251,11190,Kits,2,2,1.0,0
43252,11190,Stuff Packs,10,2,0.2,8
43253,11191,Expansion Packs,14,0,0.0,14
43254,11191,Game Packs,6,0,0.0,6
43255,11191,Kits,12,1,0.08333333333333333,11
43256,11191,Stuff Packs,13,0,0.0,13
43257,11192,Expansion Packs,16,0,0.0,16
43258,11192,Game Packs,9,0,0.0,9
43259,11192,Kits,11,1,0.09090909090909091,10
43260,11192,Stuff Packs,17,1,0.058823529411764705,16
43261,11193,Expansion Packs,7,0,0.0,7
43262,11193,Game Packs,2,0,0.0,2
43263,11193,Kits,5,1,0.2,4
43264,11193,Stuff Packs,8,3,0.375,5
43265,11194,Expansion Packs,16,0,0.0,16
43266,11194,Game Packs,12,0,0.0,12
43267,11194,Kits,23,2,0.08695652173913043,21
43268,11194,Stuff Packs,20,0,0.0,20
43269,11195,Expansion Packs,16,0,0.0,16
43270,11195,Game Packs,11,0,0.0,11
43271,11195,Kits,9,0,0.0,9
43272,11195,Stuff Packs,19,0,0.0,19
43273,11196,Expansion Packs,6,0,0.0,6
43274,11196,Game Packs,2,0,0.0,2
43275,11196,Stuff Packs,5,1,0.2,4
43276,11197,Expansion Packs,16,0,0.0,16
43277,11197,Game Packs,12,0,0.0,12
43278,11197,Kits,12,2,0.16666666666666666,10
43279,11197,Stuff Packs,19,0,0.0,19
43280,11198,Expansion Packs,9,0,0.0,9
43281,11198,Game Packs,6,0,0.0,6
43282,11198,Kits,5,0,0.0,5
43283,11198,Stuff Packs,10,3,0.3,7
43284,11199,Expansion Packs,16,0,0.0,16
43285,11199,Game Packs,11,0,0.0,11
43286,11199,Kits,8,2,0.25,6
43287,11199,Stuff Packs,18,0,0.0,18
43288,11200,Expansion Packs,16,0,0.0,16
43289,11200,Game Packs,12,0,0.0,12
43290,11200,Kits,33,0,0.0,33
43291,11200,Stuff Packs,20,0,0.0,20
43292,11201,Expansion Packs,12,0,0.0,12
43293,11201,Game Packs,11,0,0.0,11
43294,11201,Kits,6,1,0.16666666666666666,5
43295,11201,Stuff Packs,20,0,0.0,20
43296,11202,Expansion Packs,12,0,0.0,12
43297,11202,Game Packs,9,0,0.0,9
43298,11202,Kits,2,1,0.5,1
43299,11202,Stuff Packs,16,2,0.125,14
43300,11203,Expansion Packs,16,0,0.0,16
43301,11203,Game Packs,10,0,0.0,10
43302,11203,Kits,6,1,0.16666666666666666,5
43303,11203,Stuff Packs,16,3,0.1875,13
43304,11204,Expansion Packs,16,0,0.0,16
43305,11204,Game Packs,11,0,0.0,11
43306,11204,Kits,33,0,0.0,33
43307,11204,Stuff Packs,20,0,0.0,20
43308,11205,Expansion Packs,5,0,0.0,5
43309,11205,Game Packs,2,0,0.0,2
43310,11205,Kits,1,1,1.0,0
43311,11205,Stuff Packs,6,2,0.3333333333333333,4
43312,11206,Expansion Packs,9,0,0.0,9
43313,11206,Game Packs,5,0,0.0,5
43314,11206,Kits,4,2,0.5,2
43315,11206,Stuff Packs,8,3,0.375,5
43316,11207,Expansion Packs,14,0,0.0,14
43317,11207,Game Packs,12,0,0.0,12
43318,11207,Kits,4,1,0.25,3
43319,11207,Stuff Packs,16,1,0.0625,15
43320,11208,Expansion Packs,16,0,0.0,16
43321,11208,Game Packs,12,0,0.0,12
43322,11208,Kits,33,1,0.030303030303030304,32
43323,11208,Stuff Packs,20,0,0.0,20
43324,11209,Expansion Packs,16,0,0.0,16
43325,11209,Game Packs,12,0,0.0,12
43326,11209,Kits,33,0,0.0,33
43327,11209,Stuff Packs,20,0,0.0,20
43328,11210,Expansion Packs,8,0,0.0,8
43329,11210,Game Packs,4,0,0.0,4
43330,11210,Stuff Packs,4,3,0.75,1
43331,11211,Expansion Packs,10,0,0.0,10
43332,11211,Game Packs,4,0,0.0,4
43333,11211,Kits,4,1,0.25,3
43334,11211,Stuff Packs,4,1,0.25,3
43335,11212,Expansion Packs,15,0,0.0,15
43336,11212,Game Packs,11,0,0.0,11
43337,11212,Kits,29,1,0.034482758620689655,28
43338,11212,Stuff Packs,20,1,0.05,19
43339,11213,Expansion Packs,16,0,0.0,16
43340,11213,Game Packs,9,0,0.0,9
43341,11213,Kits,7,0,0.0,7
43342,11213,Stuff Packs,9,0,0.0,9
43343,11214,Expansion Packs,16,0,0.0,16
43344,11214,Game Packs,11,0,0.0,11
43345,11214,Kits,16,0,0.0,16
43346,11214,Stuff Packs,15,3,0.2,12
43347,11215,Expansion Packs,13,0,0.0,13
43348,11215,Game Packs,6,0,0.0,6
43349,11215,Kits,2,2,1.0,0
43350,11215,Stuff Packs,9,5,0.5555555555555556,4
43351,11216,Expansion Packs,15,0,0.0,15
43352,11216,Game Packs,11,0,0.0,11
43353,11216,Kits,12,1,0.08333333333333333,11
43354,11216,Stuff Packs,16,0,0.0,16
43355,11217,Expansion Packs,15,0,0.0,15
43356,11217,Game Packs,10,0,0.0,10
43357,11217,Kits,13,1,0.07692307692307693,12
43358,11217,Stuff Packs,19,0,0.0,19
43359,11218,Expansion Packs,15,0,0.0,15
43360,11218,Game Packs,10,0,0.0,10
43361,11218,Kits,4,2,0.5,2
43362,11218,Stuff Packs,12,0,0.0,12
43363,11219,Expansion Packs,12,0,0.0,12
43364,11219,Game Packs,4,0,0.0,4
43365,11219,Kits,3,0,0.0,3
43366,11219,Stuff Packs,13,0,0.0,13
43367,11220,Expansion Packs,16,0,0.0,16
43368,11220,Game Packs,12,0,0.0,12
43369,11220,Kits,33,1,0.030303030303030304,32
43370,11220,Stuff Packs,20,0,0.0,20
43371,11221,Expansion Packs,9,0,0.0,9
43372,11221,Game Packs,3,0,0.0,3
43373,11221,Kits,8,0,0.0,8
43374,11221,Stuff Packs,7,0,0.0,7
43375,11222,Expansion Packs,16,0,0.0,16
43376,11222,Game Packs,12,0,0.0,12
43377,11222,Kits,25,1,0.04,24
43378,11222,Stuff Packs,20,0,0.0,20
43379,11223,Expansion Packs,16,0,0.0,16
43380,11223,Game Packs,11,0,0.0,11
43381,11223,Kits,32,0,0.0,32
43382,11223,Stuff Packs,20,0,0.0,20
43383,11224,Expansion Packs,16,0,0.0,16
43384,11224,Game Packs,11,1,0.09090909090909091,10
43385,11224,Kits,29,3,0.10344827586206896,26
43386,11224,Stuff Packs,20,3,0.15,17
43387,11225,Expansion Packs,16,1,0.0625,15
43388,11225,Game Packs,12,0,0.0,12
43389,11225,Kits,33,1,0.030303030303030304,32
43390,11225,Stuff Packs,20,2,0.1,18
43391,11226,Expansion Packs,8,0,0.0,8
43392,11226,Game Packs,6,1,0.16666666666666666,5
43393,11226,Kits,3,2,0.6666666666666666,1
43394,11226,Stuff Packs,15,2,0.13333333333333333,13
43395,11227,Expansion Packs,8,0,0.0,8
43396,11227,Game Packs,3,0,0.0,3
43397,11227,Kits,4,1,0.25,3
43398,11227,Stuff Packs,5,2,0.4,3
43399,11228,Expansion Packs,5,0,0.0,5
43400,11228,Game Packs,2,0,0.0,2
43401,11228,Kits,2,2,1.0,0
43402,11228,Stuff Packs,8,4,0.5,4
43403,11229,Expansion Packs,16,0,0.0,16
43404,11229,Game Packs,12,0,0.0,12
43405,11229,Kits,33,0,0.0,33
43406,11229,Stuff Packs,20,0,0.0,20
43407,11230,Expansion Packs,15,0,0.0,15
43408,11230,Game Packs,10,0,0.0,10
43409,11230,Kits,1,1,1.0,0
43410,11230,Stuff Packs,18,0,0.0,18
43411,11231,Expansion Packs,11,0,0.0,11
43412,11231,Game Packs,8,0,0.0,8
43413,11231,Kits,1,1,1.0,0
43414,11231,Stuff Packs,18,0,0.0,18
43415,11232,Expansion Packs,12,0,0.0,12
43416,11232,Game Packs,6,1,0.16666666666666666,5
43417,11232,Kits,11,0,0.0,11
43418,11232,Stuff Packs,15,0,0.0,15
43419,11233,Expansion Packs,7,0,0.0,7
43420,11233,Game Packs,5,0,0.0,5
43421,11233,Kits,2,2,1.0,0
43422,11233,Stuff Packs,9,2,0.2222222222222222,7
43423,11234,Expansion Packs,16,0,0.0,16
43424,11234,Game Packs,11,0,0.0,11
43425,11234,Kits,4,1,0.25,3
43426,11234,Stuff Packs,20,0,0.0,20
43427,11235,Expansion Packs,1,0,0.0,1
43428,11235,Game Packs,1,1,1.0,0
43429,11235,Kits,3,0,0.0,3
43430,11235,Stuff Packs,1,1,1.0,0
43431,11236,Expansion Packs,8,0,0.0,8
43432,11236,Game Packs,6,0,0.0,6
43433,11236,Kits,2,1,0.5,1
43434,11236,Stuff Packs,5,0,0.0,5
43435,11237,Expansion Packs,15,0,0.0,15
43436,11237,Game Packs,12,0,0.0,12
43437,11237,Kits,26,1,0.038461538461538464,25
43438,11237,Stuff Packs,19,0,0.0,19
43439,11238,Expansion Packs,16,0,0.0,16
43440,11238,Game Packs,12,0,0.0,12
43441,11238,Kits,3,0,0.0,3
43442,11238,Stuff Packs,20,1,0.05,19
43443,11239,Expansion Packs,15,0,0.0,15
43444,11239,Game Packs,9,0,0.0,9
43445,11239,Kits,9,2,0.2222222222222222,7
43446,11239,Stuff Packs,17,3,0.17647058823529413,14
43447,11240,Expansion Packs,5,0,0.0,5
43448,11240,Game Packs,5,0,0.0,5
43449,11240,Kits,1,1,1.0,0
43450,11240,Stuff Packs,5,0,0.0,5
43451,11241,Expansion Packs,11,0,0.0,11
43452,11241,Game Packs,6,0,0.0,6
43453,11241,Kits,6,2,0.3333333333333333,4
43454,11241,Stuff Packs,17,3,0.17647058823529413,14
43455,11242,Expansion Packs,16,0,0.0,16
43456,11242,Game Packs,12,0,0.0,12
43457,11242,Kits,19,1,0.05263157894736842,18
43458,11242,Stuff Packs,20,0,0.0,20
43459,11243,Expansion Packs,14,0,0.0,14
43460,11243,Game Packs,12,0,0.0,12
43461,11243,Kits,25,0,0.0,25
43462,11243,Stuff Packs,19,0,0.0,19
43463,11244,Expansion Packs,15,1,0.06666666666666667,14
43464,11244,Game Packs,11,0,0.0,11
43465,11244,Kits,5,0,0.0,5
43466,11244,Stuff Packs,18,0,0.0,18
43467,11245,Expansion Packs,9,0,0.0,9
43468,11245,Game Packs,5,0,0.0,5
43469,11245,Kits,10,0,0.0,10
43470,11245,Stuff Packs,6,2,0.3333333333333333,4
43471,11246,Expansion Packs,16,0,0.0,16
43472,11246,Game Packs,12,0,0.0,12
43473,11246,Kits,12,0,0.0,12
43474,11246,Stuff Packs,20,0,0.0,20
43475,11247,Expansion Packs,16,0,0.0,16
43476,11247,Game Packs,12,0,0.0,12
43477,11247,Kits,21,1,0.047619047619047616,20
43478,11247,Stuff Packs,20,0,0.0,20
43479,11248,Expansion Packs,9,0,0.0,9
43480,11248,Game Packs,3,0,0.0,3
43481,11248,Kits,4,1,0.25,3
43482,11248,Stuff Packs,3,2,0.6666666666666666,1
43483,11249,Expansion Packs,15,0,0.0,15
43484,11249,Game Packs,9,0,0.0,9
43485,11249,Kits,1,1,1.0,0
43486,11249,Stuff Packs,13,0,0.0,13
43487,11250,Expansion Packs,10,0,0.0,10
43488,11250,Game Packs,3,0,0.0,3
43489,11250,Stuff Packs,7,2,0.2857142857142857,5
43490,11251,Expansion Packs,16,0,0.0,16
43491,11251,Game Packs,9,0,0.0,9
43492,11251,Kits,10,0,0.0,10
43493,11251,Stuff Packs,16,3,0.1875,13
43494,11252,Expansion Packs,14,0,0.0,14
43495,11252,Game Packs,9,0,0.0,9
43496,11252,Kits,12,2,0.16666666666666666,10
43497,11252,Stuff Packs,14,3,0.21428571428571427,11
43498,11253,Expansion Packs,16,0,0.0,16
43499,11253,Game Packs,9,0,0.0,9
43500,11253,Kits,14,1,0.07142857142857142,13
43501,11253,Stuff Packs,20,1,0.05,19
43502,11254,Expansion Packs,15,0,0.0,15
43503,11254,Game Packs,12,0,0.0,12
43504,11254,Kits,9,0,0.0,9
43505,11254,Stuff Packs,17,0,0.0,17
43506,11255,Expansion Packs,11,0,0.0,11
43507,11255,Game Packs,9,0,0.0,9
43508,11255,Kits,3,2,0.6666666666666666,1
43509,11255,Stuff Packs,8,4,0.5,4
43510,11256,Expansion Packs,10,0,0.0,10
43511,11256,Game Packs,3,1,0.3333333333333333,2
43512,11256,Kits,2,2,1.0,0
43513,11256,Stuff Packs,5,4,0.8,1
43514,11257,Expansion Packs,16,0,0.0,16
43515,11257,Game Packs,10,0,0.0,10
43516,11257,Kits,7,2,0.2857142857142857,5
43517,11257,Stuff Packs,20,0,0.0,20
43518,11258,Expansion Packs,7,0,0.0,7
43519,11258,Kits,3,0,0.0,3
43520,11258,Stuff Packs,4,3,0.75,1
43521,11259,Expansion Packs,16,0,0.0,16
43522,11259,Game Packs,8,0,0.0,8
43523,11259,Kits,4,1,0.25,3
43524,11259,Stuff Packs,19,1,0.05263157894736842,18
43525,11260,Expansion Packs,16,0,0.0,16
43526,11260,Game Packs,11,0,0.0,11
43527,11260,Kits,23,1,0.043478260869565216,22
43528,11260,Stuff Packs,19,0,0.0,19
43529,11261,Expansion Packs,16,0,0.0,16
43530,11261,Game Packs,9,0,0.0,9
43531,11261,Kits,2,0,0.0,2
43532,11261,Stuff Packs,8,0,0.0,8
43533,11262,Expansion Packs,16,0,0.0,16
43534,11262,Game Packs,12,0,0.0,12
43535,11262,Kits,14,3,0.21428571428571427,11
43536,11262,Stuff Packs,20,0,0.0,20
43537,11263,Expansion Packs,4,0,0.0,4
43538,11263,Game Packs,5,0,0.0,5
43539,11263,Kits,1,0,0.0,1
43540,11263,Stuff Packs,6,0,0.0,6
43541,11264,Expansion Packs,13,0,0.0,13
43542,11264,Game Packs,12,1,0.08333333333333333,11
43543,11264,Kits,14,1,0.07142857142857142,13
43544,11264,Stuff Packs,17,1,0.058823529411764705,16
43545,11265,Expansion Packs,14,0,0.0,14
43546,11265,Game Packs,12,0,0.0,12
43547,11265,Kits,3,1,0.3333333333333333,2
43548,11265,Stuff Packs,14,0,0.0,14
43549,11266,Expansion Packs,16,0,0.0,16
43550,11266,Game Packs,12,0,0.0,12
43551,11266,Kits,22,2,0.09090909090909091,20
43552,11266,Stuff Packs,20,0,0.0,20
43553,11267,Expansion Packs,16,0,0.0,16
43554,11267,Game Packs,11,0,0.0,11
43555,11267,Kits,27,0,0.0,27
43556,11267,Stuff Packs,16,0,0.0,16
43557,11268,Expansion Packs,12,0,0.0,12
43558,11268,Game Packs,5,0,0.0,5
43559,11268,Kits,2,2,1.0,0
43560,11268,Stuff Packs,9,2,0.2222222222222222,7
43561,11269,Expansion Packs,16,0,0.0,16
43562,11269,Game Packs,9,0,0.0,9
43563,11269,Kits,15,0,0.0,15
43564,11269,Stuff Packs,18,2,0.1111111111111111,16
43565,11270,Expansion Packs,16,0,0.0,16
43566,11270,Game Packs,12,0,0.0,12
43567,11270,Kits,21,0,0.0,21
43568,11270,Stuff Packs,16,0,0.0,16
43569,11271,Expansion Packs,16,0,0.0,16
43570,11271,Game Packs,12,0,0.0,12
43571,11271,Kits,33,0,0.0,33
43572,11271,Stuff Packs,20,0,0.0,20
43573,11272,Expansion Packs,14,0,0.0,14
43574,11272,Game Packs,6,0,0.0,6
43575,11272,Kits,4,1,0.25,3
43576,11272,Stuff Packs,11,1,0.09090909090909091,10
43577,11273,Expansion Packs,3,0,0.0,3
43578,11273,Stuff Packs,2,2,1.0,0
43579,11274,Expansion Packs,14,2,0.14285714285714285,12
43580,11274,Game Packs,8,0,0.0,8
43581,11274,Kits,1,1,1.0,0
43582,11274,Stuff Packs,6,1,0.16666666666666666,5
43583,11275,Expansion Packs,8,0,0.0,8
43584,11275,Game Packs,5,0,0.0,5
43585,11275,Kits,4,1,0.25,3
43586,11275,Stuff Packs,9,2,0.2222222222222222,7
43587,11276,Expansion Packs,10,0,0.0,10
43588,11276,Game Packs,1,0,0.0,1
43589,11276,Kits,3,0,0.0,3
43590,11276,Stuff Packs,5,3,0.6,2
43591,11277,Expansion Packs,14,0,0.0,14
43592,11277,Game Packs,11,0,0.0,11
43593,11277,Kits,3,2,0.6666666666666666,1
43594,11277,Stuff Packs,18,0,0.0,18
43595,11278,Expansion Packs,11,0,0.0,11
43596,11278,Game Packs,1,0,0.0,1
43597,11278,Kits,4,1,0.25,3
43598,11278,Stuff Packs,4,0,0.0,4
43599,11279,Expansion Packs,15,0,0.0,15
43600,11279,Game Packs,7,0,0.0,7
43601,11279,Kits,3,1,0.3333333333333333,2
43602,11279,Stuff Packs,11,3,0.2727272727272727,8
43603,11280,Expansion Packs,13,0,0.0,13
43604,11280,Game Packs,3,0,0.0,3
43605,11280,Kits,7,2,0.2857142857142857,5
43606,11280,Stuff Packs,5,3,0.6,2
43607,11281,Expansion Packs,16,0,0.0,16
43608,11281,Game Packs,12,0,0.0,12
43609,11281,Kits,31,1,0.03225806451612903,30
43610,11281,Stuff Packs,20,0,0.0,20
43611,11282,Expansion Packs,11,0,0.0,11
43612,11282,Game Packs,7,0,0.0,7
43613,11282,Kits,4,1,0.25,3
43614,11282,Stuff Packs,9,1,0.1111111111111111,8
43615,11283,Expansion Packs,14,0,0.0,14
43616,11283,Game Packs,8,0,0.0,8
43617,11283,Kits,10,0,0.0,10
43618,11283,Stuff Packs,16,0,0.0,16
43619,11284,Expansion Packs,9,0,0.0,9
43620,11284,Game Packs,5,0,0.0,5
43621,11284,Kits,13,2,0.15384615384615385,11
43622,11284,Stuff Packs,10,3,0.3,7
43623,11285,Expansion Packs,16,0,0.0,16
43624,11285,Game Packs,11,0,0.0,11
43625,11285,Kits,17,1,0.058823529411764705,16
43626,11285,Stuff Packs,15,0,0.0,15
43627,11286,Expansion Packs,15,0,0.0,15
43628,11286,Game Packs,10,0,0.0,10
43629,11286,Kits,17,0,0.0,17
43630,11286,Stuff Packs,20,0,0.0,20
43631,11287,Expansion Packs,4,0,0.0,4
43632,11287,Game Packs,2,0,0.0,2
43633,11287,Kits,2,0,0.0,2
43634,11287,Stuff Packs,1,0,0.0,1
43635,11288,Expansion Packs,7,0,0.0,7
43636,11288,Game Packs,7,0,0.0,7
43637,11288,Kits,4,2,0.5,2
43638,11288,Stuff Packs,5,0,0.0,5
43639,11289,Expansion Packs,15,0,0.0,15
43640,11289,Game Packs,8,0,0.0,8
43641,11289,Kits,8,1,0.125,7
43642,11289,Stuff Packs,10,3,0.3,7
43643,11290,Expansion Packs,16,0,0.0,16
43644,11290,Game Packs,11,0,0.0,11
43645,11290,Kits,9,2,0.2222222222222222,7
43646,11290,Stuff Packs,19,0,0.0,19
43647,11291,Expansion Packs,14,0,0.0,14
43648,11291,Game Packs,7,0,0.0,7
43649,11291,Kits,9,2,0.2222222222222222,7
43650,11291,Stuff Packs,11,3,0.2727272727272727,8
43651,11292,Kits,1,1,1.0,0
43652,11292,Stuff Packs,3,3,1.0,0
43653,11293,Expansion Packs,16,0,0.0,16
43654,11293,Game Packs,12,0,0.0,12
43655,11293,Kits,8,2,0.25,6
43656,11293,Stuff Packs,17,1,0.058823529411764705,16
43657,11294,Expansion Packs,16,0,0.0,16
43658,11294,Game Packs,12,0,0.0,12
43659,11294,Kits,33,0,0.0,33
43660,11294,Stuff Packs,20,0,0.0,20
43661,11295,Expansion Packs,12,0,0.0,12
43662,11295,Game Packs,6,0,0.0,6
43663,11295,Kits,5,1,0.2,4
43664,11295,Stuff Packs,5,2,0.4,3
43665,11296,Expansion Packs,16,0,0.0,16
43666,11296,Game Packs,11,0,0.0,11
43667,11296,Kits,33,1,0.030303030303030304,32
43668,11296,Stuff Packs,20,0,0.0,20
43669,11297,Expansion Packs,16,0,0.0,16
43670,11297,Game Packs,11,0,0.0,11
43671,11297,Kits,8,2,0.25,6
43672,11297,Stuff Packs,13,1,0.07692307692307693,12
43673,11298,Expansion Packs,12,0,0.0,12
43674,11298,Game Packs,9,0,0.0,9
43675,11298,Kits,4,1,0.25,3
43676,11298,Stuff Packs,10,1,0.1,9
43677,11299,Expansion Packs,14,0,0.0,14
43678,11299,Game Packs,3,0,0.0,3
43679,11299,Kits,3,0,0.0,3
43680,11299,Stuff Packs,10,3,0.3,7
43681,11300,Expansion Packs,12,0,0.0,12
43682,11300,Game Packs,6,0,0.0,6
43683,11300,Stuff Packs,4,0,0.0,4
43684,11301,Expansion Packs,15,0,0.0,15
43685,11301,Game Packs,12,0,0.0,12
43686,11301,Kits,8,1,0.125,7
43687,11301,Stuff Packs,18,0,0.0,18
43688,11302,Expansion Packs,16,0,0.0,16
43689,11302,Game Packs,11,0,0.0,11
43690,11302,Kits,23,1,0.043478260869565216,22
43691,11302,Stuff Packs,20,0,0.0,20
43692,11303,Expansion Packs,4,0,0.0,4
43693,11303,Game Packs,1,0,0.0,1
43694,11303,Stuff Packs,2,1,0.5,1
43695,11304,Expansion Packs,16,0,0.0,16
43696,11304,Game Packs,11,0,0.0,11
43697,11304,Kits,18,0,0.0,18
43698,11304,Stuff Packs,18,0,0.0,18
43699,11305,Expansion Packs,13,0,0.0,13
43700,11305,Game Packs,10,0,0.0,10
43701,11305,Kits,4,1,0.25,3
43702,11305,Stuff Packs,13,0,0.0,13
43703,11306,Expansion Packs,3,0,0.0,3
43704,11306,Game Packs,2,0,0.0,2
43705,11306,Kits,7,0,0.0,7
43706,11306,Stuff Packs,6,3,0.5,3
43707,11307,Expansion Packs,8,0,0.0,8
43708,11307,Game Packs,8,0,0.0,8
43709,11307,Kits,2,2,1.0,0
43710,11307,Stuff Packs,12,0,0.0,12
43711,11308,Expansion Packs,12,0,0.0,12
43712,11308,Game Packs,6,0,0.0,6
43713,11308,Kits,15,0,0.0,15
43714,11308,Stuff Packs,12,0,0.0,12
43715,11309,Expansion Packs,16,0,0.0,16
43716,11309,Game Packs,12,0,0.0,12
43717,11309,Kits,17,1,0.058823529411764705,16
43718,11309,Stuff Packs,19,0,0.0,19
43719,11310,Expansion Packs,15,0,0.0,15
43720,11310,Game Packs,8,1,0.125,7
43721,11310,Kits,3,2,0.6666666666666666,1
43722,11310,Stuff Packs,12,2,0.16666666666666666,10
43723,11311,Expansion Packs,5,0,0.0,5
43724,11311,Game Packs,2,1,0.5,1
43725,11311,Kits,4,3,0.75,1
43726,11311,Stuff Packs,7,4,0.5714285714285714,3
43727,11312,Expansion Packs,14,0,0.0,14
43728,11312,Game Packs,9,1,0.1111111111111111,8
43729,11312,Kits,32,1,0.03125,31
43730,11312,Stuff Packs,20,0,0.0,20
43731,11313,Expansion Packs,7,0,0.0,7
43732,11313,Game Packs,3,0,0.0,3
43733,11313,Kits,1,1,1.0,0
43734,11313,Stuff Packs,6,0,0.0,6
43735,11314,Expansion Packs,5,0,0.0,5
43736,11314,Game Packs,2,0,0.0,2
43737,11314,Kits,2,1,0.5,1
43738,11314,Stuff Packs,3,1,0.3333333333333333,2
43739,11315,Expansion Packs,14,0,0.0,14
43740,11315,Game Packs,5,0,0.0,5
43741,11315,Kits,1,1,1.0,0
43742,11315,Stuff Packs,9,2,0.2222222222222222,7
43743,11316,Expansion Packs,14,0,0.0,14
43744,11316,Game Packs,9,0,0.0,9
43745,11316,Kits,1,0,0.0,1
43746,11316,Stuff Packs,9,1,0.1111111111111111,8
43747,11317,Expansion Packs,11,1,0.09090909090909091,10
43748,11317,Game Packs,9,0,0.0,9
43749,11317,Kits,12,3,0.25,9
43750,11317,Stuff Packs,12,2,0.16666666666666666,10
43751,11318,Expansion Packs,15,0,0.0,15
43752,11318,Game Packs,11,0,0.0,11
43753,11318,Kits,16,2,0.125,14
43754,11318,Stuff Packs,17,1,0.058823529411764705,16
43755,11319,Expansion Packs,14,0,0.0,14
43756,11319,Game Packs,12,0,0.0,12
43757,11319,Kits,27,1,0.037037037037037035,26
43758,11319,Stuff Packs,20,0,0.0,20
43759,11320,Expansion Packs,8,0,0.0,8
43760,11320,Game Packs,4,0,0.0,4
43761,11320,Kits,3,0,0.0,3
43762,11320,Stuff Packs,6,0,0.0,6
43763,11321,Expansion Packs,11,0,0.0,11
43764,11321,Game Packs,2,1,0.5,1
43765,11321,Kits,6,1,0.16666666666666666,5
43766,11321,Stuff Packs,6,3,0.5,3
43767,11322,Expansion Packs,16,0,0.0,16
43768,11322,Game Packs,12,0,0.0,12
43769,11322,Kits,31,0,0.0,31
43770,11322,Stuff Packs,20,0,0.0,20
43771,11323,Expansion Packs,16,0,0.0,16
43772,11323,Game Packs,7,0,0.0,7
43773,11323,Kits,12,1,0.08333333333333333,11
43774,11323,Stuff Packs,11,2,0.18181818181818182,9
43775,11324,Expansion Packs,12,0,0.0,12
43776,11324,Game Packs,4,0,0.0,4
43777,11324,Kits,3,2,0.6666666666666666,1
43778,11324,Stuff Packs,13,2,0.15384615384615385,11
43779,11325,Expansion Packs,14,0,0.0,14
43780,11325,Game Packs,10,0,0.0,10
43781,11325,Kits,7,3,0.42857142857142855,4
43782,11325,Stuff Packs,18,0,0.0,18
43783,11326,Expansion Packs,14,0,0.0,14
43784,11326,Game Packs,7,0,0.0,7
43785,11326,Stuff Packs,7,0,0.0,7
43786,11327,Expansion Packs,16,0,0.0,16
43787,11327,Game Packs,12,0,0.0,12
43788,11327,Kits,33,0,0.0,33
43789,11327,Stuff Packs,20,0,0.0,20
43790,11328,Expansion Packs,16,0,0.0,16
43791,11328,Game Packs,12,0,0.0,12
43792,11328,Kits,31,0,0.0,31
43793,11328,Stuff Packs,20,0,0.0,20
43794,11329,Expansion Packs,13,0,0.0,13
43795,11329,Game Packs,8,0,0.0,8
43796,11329,Stuff Packs,7,0,0.0,7
43797,11330,Expansion Packs,12,0,0.0,12
43798,11330,Kits,1,1,1.0,0
43799,11330,Stuff Packs,2,2,1.0,0
43800,11331,Expansion Packs,16,0,0.0,16
43801,11331,Game Packs,11,0,0.0,11
43802,11331,Kits,33,0,0.0,33
43803,11331,Stuff Packs,20,0,0.0,20
43804,11332,Expansion Packs,16,0,0.0,16
43805,11332,Game Packs,12,0,0.0,12
43806,11332,Kits,33,0,0.0,33
43807,11332,Stuff Packs,20,0,0.0,20
43808,11333,Expansion Packs,13,0,0.0,13
43809,11333,Game Packs,4,0,0.0,4
43810,11333,Kits,3,3,1.0,0
43811,11333,Stuff Packs,5,2,0.4,3
43812,11334,Expansion Packs,3,0,0.0,3
43813,11334,Game Packs,1,0,0.0,1
43814,11334,Kits,1,1,1.0,0
43815,11334,Stuff Packs,4,2,0.5,2
43816,11335,Expansion Packs,16,0,0.0,16
43817,11335,Game Packs,12,0,0.0,12
43818,11335,Kits,33,0,0.0,33
43819,11335,Stuff Packs,20,0,0.0,20
43820,11336,Expansion Packs,9,0,0.0,9
43821,11336,Game Packs,4,0,0.0,4
43822,11336,Kits,1,1,1.0,0
43823,11336,Stuff Packs,3,0,0.0,3
43824,11337,Expansion Packs,16,0,0.0,16
43825,11337,Game Packs,12,0,0.0,12
43826,11337,Kits,33,1,0.030303030303030304,32
43827,11337,Stuff Packs,20,0,0.0,20
43828,11338,Expansion Packs,14,0,0.0,14
43829,11338,Game Packs,10,0,0.0,10
43830,11338,Kits,2,2,1.0,0
43831,11338,Stuff Packs,12,3,0.25,9
43832,11339,Expansion Packs,11,0,0.0,11
43833,11339,Game Packs,9,0,0.0,9
43834,11339,Kits,1,1,1.0,0
43835,11339,Stuff Packs,11,0,0.0,11
43836,11340,Expansion Packs,8,0,0.0,8
43837,11340,Game Packs,3,1,0.3333333333333333,2
43838,11340,Kits,2,2,1.0,0
43839,11340,Stuff Packs,3,3,1.0,0
43840,11341,Expansion Packs,16,0,0.0,16
43841,11341,Game Packs,12,0,0.0,12
43842,11341,Kits,33,0,0.0,33
43843,11341,Stuff Packs,20,0,0.0,20
43844,11342,Expansion Packs,16,0,0.0,16
43845,11342,Game Packs,11,0,0.0,11
43846,11342,Kits,6,1,0.16666666666666666,5
43847,11342,Stuff Packs,15,1,0.06666666666666667,14
43848,11343,Expansion Packs,13,0,0.0,13
43849,11343,Game Packs,9,0,0.0,9
43850,11343,Stuff Packs,10,0,0.0,10
43851,11344,Expansion Packs,16,0,0.0,16
43852,11344,Game Packs,12,0,0.0,12
43853,11344,Kits,33,0,0.0,33
43854,11344,Stuff Packs,20,0,0.0,20
43855,11345,Expansion Packs,16,0,0.0,16
43856,11345,Game Packs,8,0,0.0,8
43857,11345,Kits,15,0,0.0,15
43858,11345,Stuff Packs,12,2,0.16666666666666666,10
43859,11346,Expansion Packs,7,6,0.8571428571428571,1
43860,11346,Game Packs,7,7,1.0,0
43861,11346,Kits,4,1,0.25,3
43862,11346,Stuff Packs,8,8,1.0,0
43863,11347,Expansion Packs,6,0,0.0,6
43864,11347,Game Packs,2,0,0.0,2
43865,11347,Kits,2,0,0.0,2
43866,11347,Stuff Packs,5,2,0.4,3
43867,11348,Expansion Packs,10,0,0.0,10
43868,11348,Game Packs,4,0,0.0,4
43869,11348,Kits,1,1,1.0,0
43870,11348,Stuff Packs,5,2,0.4,3
43871,11349,Expansion Packs,14,0,0.0,14
43872,11349,Game Packs,11,0,0.0,11
43873,11349,Kits,4,2,0.5,2
43874,11349,Stuff Packs,10,3,0.3,7
43875,11350,Expansion Packs,16,16,1.0,0
43876,11350,Game Packs,12,12,1.0,0
43877,11350,Kits,33,33,1.0,0
43878,11350,Stuff Packs,20,19,0.95,1
43879,11351,Expansion Packs,7,0,0.0,7
43880,11351,Game Packs,6,1,0.16666666666666666,5
43881,11351,Kits,3,3,1.0,0
43882,11351,Stuff Packs,9,2,0.2222222222222222,7
43883,11352,Expansion Packs,10,1,0.1,9
43884,11352,Game Packs,5,0,0.0,5
43885,11352,Kits,3,1,0.3333333333333333,2
43886,11352,Stuff Packs,12,2,0.16666666666666666,10
43887,11353,Expansion Packs,9,0,0.0,9
43888,11353,Game Packs,9,0,0.0,9
43889,11353,Kits,1,1,1.0,0
43890,11353,Stuff Packs,8,0,0.0,8
43891,11354,Expansion Packs,14,0,0.0,14
43892,11354,Game Packs,12,0,0.0,12
43893,11354,Kits,3,1,0.3333333333333333,2
43894,11354,Stuff Packs,17,0,0.0,17
43895,11355,Expansion Packs,6,0,0.0,6
43896,11355,Game Packs,5,0,0.0,5
43897,11355,Stuff Packs,4,0,0.0,4
43898,11356,Expansion Packs,3,1,0.3333333333333333,2
43899,11356,Kits,2,1,0.5,1
43900,11356,Stuff Packs,6,3,0.5,3
43901,11357,Expansion Packs,12,0,0.0,12
43902,11357,Game Packs,11,0,0.0,11
43903,11357,Kits,2,1,0.5,1
43904,11357,Stuff Packs,9,2,0.2222222222222222,7
43905,11358,Expansion Packs,7,0,0.0,7
43906,11358,Game Packs,4,0,0.0,4
43907,11358,Stuff Packs,4,0,0.0,4
43908,11359,Game Packs,2,0,0.0,2
43909,11359,Kits,1,1,1.0,0
43910,11359,Stuff Packs,4,2,0.5,2
43911,11360,Expansion Packs,14,0,0.0,14
43912,11360,Game Packs,8,1,0.125,7
43913,11360,Kits,3,2,0.6666666666666666,1
43914,11360,Stuff Packs,9,4,0.4444444444444444,5
43915,11361,Expansion Packs,16,0,0.0,16
43916,11361,Game Packs,12,0,0.0,12
43917,11361,Kits,33,1,0.030303030303030304,32
43918,11361,Stuff Packs,20,0,0.0,20
43919,11362,Expansion Packs,16,3,0.1875,13
43920,11362,Game Packs,12,5,0.4166666666666667,7
43921,11362,Kits,33,16,0.48484848484848486,17
43922,11362,Stuff Packs,20,3,0.15,17
43923,11363,Expansion Packs,2,0,0.0,2
43924,11364,Expansion Packs,16,0,0.0,16
43925,11364,Game Packs,12,0,0.0,12
43926,11364,Kits,33,0,0.0,33
43927,11364,Stuff Packs,20,0,0.0,20
43928,11365,Expansion Packs,5,0,0.0,5
43929,11365,Game Packs,4,0,0.0,4
43930,11365,Stuff Packs,1,0,0.0,1
43931,11366,Expansion Packs,13,0,0.0,13
43932,11366,Game Packs,2,1,0.5,1
43933,11366,Kits,1,1,1.0,0
43934,11366,Stuff Packs,4,0,0.0,4
43935,11367,Expansion Packs,8,0,0.0,8
43936,11367,Game Packs,10,0,0.0,10
43937,11367,Kits,23,1,0.043478260869565216,22
43938,11367,Stuff Packs,14,0,0.0,14
43939,11368,Expansion Packs,9,1,0.1111111111111111,8
43940,11368,Game Packs,6,0,0.0,6
43941,11368,Stuff Packs,10,0,0.0,10
43942,11369,Expansion Packs,15,0,0.0,15
43943,11369,Game Packs,11,0,0.0,11
43944,11369,Kits,8,1,0.125,7
43945,11369,Stuff Packs,20,2,0.1,18
43946,11370,Game Packs,1,1,1.0,0
43947,11370,Kits,1,1,1.0,0
43948,11370,Stuff Packs,3,3,1.0,0
43949,11371,Expansion Packs,3,0,0.0,3
43950,11371,Game Packs,5,0,0.0,5
43951,11371,Stuff Packs,11,0,0.0,11
43952,11372,Expansion Packs,15,0,0.0,15
43953,11372,Game Packs,12,0,0.0,12
43954,11372,Kits,31,0,0.0,31
43955,11372,Stuff Packs,20,0,0.0,20
43956,11373,Expansion Packs,13,0,0.0,13
43957,11373,Game Packs,6,0,0.0,6
43958,11373,Kits,14,0,0.0,14
43959,11373,Stuff Packs,11,0,0.0,11
43960,11374,Expansion Packs,9,0,0.0,9
43961,11374,Game Packs,4,0,0.0,4
43962,11374,Kits,4,1,0.25,3
43963,11374,Stuff Packs,3,0,0.0,3
43964,11375,Expansion Packs,4,0,0.0,4
43965,11375,Game Packs,2,1,0.5,1
43966,11375,Kits,3,3,1.0,0
43967,11375,Stuff Packs,7,4,0.5714285714285714,3
43968,11376,Expansion Packs,16,0,0.0,16
43969,11376,Game Packs,11,0,0.0,11
43970,11376,Kits,8,1,0.125,7
43971,11376,Stuff Packs,16,0,0.0,16
43972,11377,Expansion Packs,4,0,0.0,4
43973,11377,Game Packs,3,0,0.0,3
43974,11377,Stuff Packs,4,0,0.0,4
43975,11378,Expansion Packs,11,0,0.0,11
43976,11378,Game Packs,6,0,0.0,6
43977,11378,Kits,4,0,0.0,4
43978,11378,Stuff Packs,14,0,0.0,14
43979,11379,Expansion Packs,5,0,0.0,5
43980,11379,Game Packs,4,0,0.0,4
43981,11379,Kits,14,2,0.14285714285714285,12
43982,11379,Stuff Packs,9,2,0.2222222222222222,7
43983,11380,Expansion Packs,11,0,0.0,11
43984,11380,Game Packs,10,0,0.0,10
43985,11380,Kits,1,1,1.0,0
43986,11380,Stuff Packs,6,0,0.0,6
43987,11381,Expansion Packs,11,0,0.0,11
43988,11381,Game Packs,3,0,0.0,3
43989,11381,Kits,12,0,0.0,12
43990,11381,Stuff Packs,8,0,0.0,8
43991,11382,Expansion Packs,16,0,0.0,16
43992,11382,Game Packs,12,0,0.0,12
43993,11382,Kits,33,0,0.0,33
43994,11382,Stuff Packs,20,0,0.0,20
43995,11383,Expansion Packs,15,0,0.0,15
43996,11383,Game Packs,10,0,0.0,10
43997,11383,Kits,5,2,0.4,3
43998,11383,Stuff Packs,18,0,0.0,18
43999,11384,Expansion Packs,5,0,0.0,5
44000,11384,Game Packs,2,0,0.0,2
44001,11384,Kits,1,1,1.0,0
44002,11384,Stuff Packs,3,0,0.0,3
44003,11385,Expansion Packs,16,0,0.0,16
44004,11385,Game Packs,12,0,0.0,12
44005,11385,Kits,32,1,0.03125,31
44006,11385,Stuff Packs,20,1,0.05,19
44007,11386,Expansion Packs,2,0,0.0,2
44008,11386,Game Packs,2,0,0.0,2
44009,11386,Stuff Packs,2,0,0.0,2
44010,11387,Expansion Packs,16,0,0.0,16
44011,11387,Game Packs,11,0,0.0,11
44012,11387,Kits,15,1,0.06666666666666667,14
44013,11387,Stuff Packs,16,1,0.0625,15
44014,11388,Expansion Packs,16,0,0.0,16
44015,11388,Game Packs,11,0,0.0,11
44016,11388,Kits,28,0,0.0,28
44017,11388,Stuff Packs,20,0,0.0,20
44018,11389,Expansion Packs,4,1,0.25,3
44019,11389,Game Packs,4,1,0.25,3
44020,11389,Kits,2,0,0.0,2
44021,11389,Stuff Packs,4,2,0.5,2
44022,11390,Expansion Packs,16,0,0.0,16
44023,11390,Game Packs,12,0,0.0,12
44024,11390,Kits,33,0,0.0,33
44025,11390,Stuff Packs,20,0,0.0,20
44026,11391,Expansion Packs,15,13,0.8666666666666667,2
44027,11391,Game Packs,9,9,1.0,0
44028,11391,Kits,10,10,1.0,0
44029,11391,Stuff Packs,18,18,1.0,0
44030,11392,Expansion Packs,7,0,0.0,7
44031,11392,Game Packs,7,0,0.0,7
44032,11392,Stuff Packs,9,0,0.0,9
44033,11393,Expansion Packs,16,0,0.0,16
44034,11393,Game Packs,12,0,0.0,12
44035,11393,Kits,33,0,0.0,33
44036,11393,Stuff Packs,20,0,0.0,20
44037,11394,Expansion Packs,16,0,0.0,16
44038,11394,Game Packs,9,0,0.0,9
44039,11394,Kits,12,0,0.0,12
44040,11394,Stuff Packs,13,0,0.0,13
44041,11395,Expansion Packs,4,0,0.0,4
44042,11395,Game Packs,3,0,0.0,3
44043,11395,Kits,1,1,1.0,0
44044,11395,Stuff Packs,5,3,0.6,2
44045,11396,Expansion Packs,11,0,0.0,11
44046,11396,Game Packs,8,0,0.0,8
44047,11396,Stuff Packs,6,1,0.16666666666666666,5
44048,11397,Expansion Packs,16,0,0.0,16
44049,11397,Game Packs,12,0,0.0,12
44050,11397,Kits,20,1,0.05,19
44051,11397,Stuff Packs,20,0,0.0,20
44052,11398,Expansion Packs,16,0,0.0,16
44053,11398,Game Packs,12,0,0.0,12
44054,11398,Kits,23,0,0.0,23
44055,11398,Stuff Packs,20,0,0.0,20
44056,11399,Expansion Packs,16,0,0.0,16
44057,11399,Game Packs,9,0,0.0,9
44058,11399,Kits,16,0,0.0,16
44059,11399,Stuff Packs,11,0,0.0,11
44060,11400,Expansion Packs,16,0,0.0,16
44061,11400,Game Packs,11,0,0.0,11
44062,11400,Kits,9,2,0.2222222222222222,7
44063,11400,Stuff Packs,18,1,0.05555555555555555,17
44064,11401,Expansion Packs,12,0,0.0,12
44065,11401,Game Packs,6,0,0.0,6
44066,11401,Kits,6,0,0.0,6
44067,11401,Stuff Packs,12,1,0.08333333333333333,11
44068,11402,Expansion Packs,14,0,0.0,14
44069,11402,Game Packs,5,0,0.0,5
44070,11402,Kits,2,0,0.0,2
44071,11402,Stuff Packs,4,0,0.0,4
44072,11403,Expansion Packs,16,0,0.0,16
44073,11403,Game Packs,12,0,0.0,12
44074,11403,Kits,33,1,0.030303030303030304,32
44075,11403,Stuff Packs,20,0,0.0,20
44076,11404,Kits,2,1,0.5,1
44077,11405,Expansion Packs,15,0,0.0,15
44078,11405,Game Packs,11,0,0.0,11
44079,11405,Kits,15,0,0.0,15
44080,11405,Stuff Packs,19,0,0.0,19
44081,11406,Expansion Packs,16,0,0.0,16
44082,11406,Game Packs,12,0,0.0,12
44083,11406,Kits,33,0,0.0,33
44084,11406,Stuff Packs,20,0,0.0,20
44085,11407,Expansion Packs,16,0,0.0,16
44086,11407,Game Packs,12,0,0.0,12
44087,11407,Kits,22,0,0.0,22
44088,11407,Stuff Packs,20,0,0.0,20
44089,11408,Expansion Packs,15,0,0.0,15
44090,11408,Game Packs,10,0,0.0,10
44091,11408,Kits,3,2,0.6666666666666666,1
44092,11408,Stuff Packs,17,1,0.058823529411764705,16
44093,11409,Expansion Packs,16,0,0.0,16
44094,11409,Game Packs,12,0,0.0,12
44095,11409,Kits,17,0,0.0,17
44096,11409,Stuff Packs,20,0,0.0,20
44097,11410,Expansion Packs,3,0,0.0,3
44098,11410,Kits,2,1,0.5,1
44099,11410,Stuff Packs,3,2,0.6666666666666666,1
44100,11411,Expansion Packs,6,0,0.0,6
44101,11411,Game Packs,3,0,0.0,3
44102,11411,Kits,1,1,1.0,0
44103,11411,Stuff Packs,6,4,0.6666666666666666,2
44104,11412,Expansion Packs,16,0,0.0,16
44105,11412,Game Packs,12,0,0.0,12
44106,11412,Kits,21,1,0.047619047619047616,20
44107,11412,Stuff Packs,20,0,0.0,20
44108,11413,Expansion Packs,14,0,0.0,14
44109,11413,Game Packs,8,0,0.0,8
44110,11413,Kits,2,2,1.0,0
44111,11413,Stuff Packs,13,1,0.07692307692307693,12
44112,11414,Expansion Packs,16,0,0.0,16
44113,11414,Game Packs,12,0,0.0,12
44114,11414,Kits,33,0,0.0,33
44115,11414,Stuff Packs,20,0,0.0,20
44116,11415,Expansion Packs,7,0,0.0,7
44117,11415,Game Packs,3,1,0.3333333333333333,2
44118,11415,Kits,7,1,0.14285714285714285,6
44119,11415,Stuff Packs,9,4,0.4444444444444444,5
44120,11416,Expansion Packs,12,0,0.0,12
44121,11416,Game Packs,3,1,0.3333333333333333,2
44122,11416,Kits,1,1,1.0,0
44123,11416,Stuff Packs,7,2,0.2857142857142857,5
44124,11417,Expansion Packs,16,0,0.0,16
44125,11417,Game Packs,11,0,0.0,11
44126,11417,Kits,17,1,0.058823529411764705,16
44127,11417,Stuff Packs,15,3,0.2,12
44128,11418,Expansion Packs,16,0,0.0,16
44129,11418,Game Packs,12,0,0.0,12
44130,11418,Kits,30,0,0.0,30
44131,11418,Stuff Packs,20,0,0.0,20
44132,11419,Expansion Packs,12,0,0.0,12
44133,11419,Game Packs,7,0,0.0,7
44134,11419,Kits,9,1,0.1111111111111111,8
44135,11419,Stuff Packs,9,0,0.0,9
44136,11420,Expansion Packs,13,0,0.0,13
44137,11420,Game Packs,2,0,0.0,2
44138,11420,Kits,6,1,0.16666666666666666,5
44139,11420,Stuff Packs,6,3,0.5,3
44140,11421,Expansion Packs,15,0,0.0,15
44141,11421,Game Packs,10,0,0.0,10
44142,11421,Kits,6,1,0.16666666666666666,5
44143,11421,Stuff Packs,15,1,0.06666666666666667,14
44144,11422,Expansion Packs,12,0,0.0,12
44145,11422,Game Packs,8,0,0.0,8
44146,11422,Kits,4,0,0.0,4
44147,11422,Stuff Packs,8,1,0.125,7
44148,11423,Expansion Packs,16,0,0.0,16
44149,11423,Game Packs,12,0,0.0,12
44150,11423,Kits,33,1,0.030303030303030304,32
44151,11423,Stuff Packs,20,0,0.0,20
44152,11424,Expansion Packs,16,0,0.0,16
44153,11424,Game Packs,12,0,0.0,12
44154,11424,Kits,33,0,0.0,33
44155,11424,Stuff Packs,20,0,0.0,20
44156,11425,Expansion Packs,16,0,0.0,16
44157,11425,Game Packs,12,0,0.0,12
44158,11425,Kits,33,0,0.0,33
44159,11425,Stuff Packs,20,0,0.0,20
44160,11426,Expansion Packs,8,0,0.0,8
44161,11426,Game Packs,5,0,0.0,5
44162,11426,Kits,6,1,0.16666666666666666,5
44163,11426,Stuff Packs,9,2,0.2222222222222222,7
44164,11427,Expansion Packs,16,0,0.0,16
44165,11427,Game Packs,12,0,0.0,12
44166,11427,Kits,33,0,0.0,33
44167,11427,Stuff Packs,20,0,0.0,20
44168,11428,Expansion Packs,11,1,0.09090909090909091,10
44169,11428,Game Packs,4,0,0.0,4
44170,11428,Kits,6,1,0.16666666666666666,5
44171,11428,Stuff Packs,10,0,0.0,10
44172,11429,Expansion Packs,16,0,0.0,16
44173,11429,Game Packs,12,0,0.0,12
44174,11429,Kits,33,0,0.0,33
44175,11429,Stuff Packs,20,0,0.0,20
44176,11430,Expansion Packs,9,0,0.0,9
44177,11430,Game Packs,2,0,0.0,2
44178,11430,Kits,3,0,0.0,3
44179,11430,Stuff Packs,2,0,0.0,2
44180,11431,Expansion Packs,16,0,0.0,16
44181,11431,Game Packs,9,0,0.0,9
44182,11431,Stuff Packs,4,0,0.0,4
44183,11432,Expansion Packs,7,0,0.0,7
44184,11432,Game Packs,4,0,0.0,4
44185,11432,Kits,2,2,1.0,0
44186,11432,Stuff Packs,5,3,0.6,2
44187,11433,Expansion Packs,16,0,0.0,16
44188,11433,Game Packs,12,0,0.0,12
44189,11433,Kits,33,1,0.030303030303030304,32
44190,11433,Stuff Packs,20,0,0.0,20
44191,11434,Expansion Packs,14,0,0.0,14
44192,11434,Game Packs,9,0,0.0,9
44193,11434,Kits,1,0,0.0,1
44194,11434,Stuff Packs,12,3,0.25,9
44195,11435,Expansion Packs,5,5,1.0,0
44196,11435,Kits,2,2,1.0,0
44197,11435,Stuff Packs,3,2,0.6666666666666666,1
44198,11436,Expansion Packs,11,0,0.0,11
44199,11436,Game Packs,8,0,0.0,8
44200,11436,Kits,1,1,1.0,0
44201,11436,Stuff Packs,7,1,0.14285714285714285,6
44202,11437,Expansion Packs,9,0,0.0,9
44203,11437,Game Packs,5,0,0.0,5
44204,11437,Stuff Packs,4,0,0.0,4
44205,11438,Expansion Packs,9,0,0.0,9
44206,11438,Game Packs,3,0,0.0,3
44207,11438,Kits,15,1,0.06666666666666667,14
44208,11438,Stuff Packs,9,3,0.3333333333333333,6
44209,11439,Expansion Packs,12,0,0.0,12
44210,11439,Game Packs,8,0,0.0,8
44211,11439,Stuff Packs,10,0,0.0,10
44212,11440,Expansion Packs,16,0,0.0,16
44213,11440,Game Packs,12,0,0.0,12
44214,11440,Kits,33,0,0.0,33
44215,11440,Stuff Packs,20,0,0.0,20
44216,11441,Expansion Packs,15,0,0.0,15
44217,11441,Game Packs,6,0,0.0,6
44218,11441,Kits,1,1,1.0,0
44219,11441,Stuff Packs,8,3,0.375,5
44220,11442,Expansion Packs,8,0,0.0,8
44221,11442,Game Packs,2,0,0.0,2
44222,11442,Kits,3,2,0.6666666666666666,1
44223,11442,Stuff Packs,4,0,0.0,4
44224,11443,Expansion Packs,16,0,0.0,16
44225,11443,Game Packs,12,0,0.0,12
44226,11443,Kits,14,0,0.0,14
44227,11443,Stuff Packs,20,0,0.0,20
44228,11444,Expansion Packs,10,0,0.0,10
44229,11444,Game Packs,6,0,0.0,6
44230,11444,Kits,6,0,0.0,6
44231,11444,Stuff Packs,8,2,0.25,6
44232,11445,Expansion Packs,16,0,0.0,16
44233,11445,Game Packs,12,0,0.0,12
44234,11445,Kits,31,0,0.0,31
44235,11445,Stuff Packs,20,0,0.0,20
44236,11446,Expansion Packs,8,0,0.0,8
44237,11446,Game Packs,2,0,0.0,2
44238,11446,Kits,9,1,0.1111111111111111,8
44239,11446,Stuff Packs,4,1,0.25,3
44240,11447,Expansion Packs,16,0,0.0,16
44241,11447,Game Packs,12,0,0.0,12
44242,11447,Kits,33,0,0.0,33
44243,11447,Stuff Packs,20,0,0.0,20
44244,11448,Expansion Packs,8,0,0.0,8
44245,11448,Game Packs,3,0,0.0,3
44246,11448,Kits,4,1,0.25,3
44247,11448,Stuff Packs,5,3,0.6,2
44248,11449,Expansion Packs,13,0,0.0,13
44249,11449,Game Packs,8,0,0.0,8
44250,11449,Kits,6,0,0.0,6
44251,11449,Stuff Packs,16,3,0.1875,13
44252,11450,Expansion Packs,3,0,0.0,3
44253,11450,Game Packs,4,0,0.0,4
44254,11450,Stuff Packs,6,2,0.3333333333333333,4
44255,11451,Expansion Packs,16,0,0.0,16
44256,11451,Game Packs,12,0,0.0,12
44257,11451,Kits,10,0,0.0,10
44258,11451,Stuff Packs,11,0,0.0,11
44259,11452,Expansion Packs,13,0,0.0,13
44260,11452,Game Packs,6,0,0.0,6
44261,11452,Kits,9,0,0.0,9
44262,11452,Stuff Packs,13,0,0.0,13
44263,11453,Expansion Packs,16,0,0.0,16
44264,11453,Game Packs,12,0,0.0,12
44265,11453,Kits,33,1,0.030303030303030304,32
44266,11453,Stuff Packs,20,0,0.0,20
44267,11454,Expansion Packs,15,0,0.0,15
44268,11454,Game Packs,12,0,0.0,12
44269,11454,Kits,33,0,0.0,33
44270,11454,Stuff Packs,20,0,0.0,20
44271,11455,Expansion Packs,2,0,0.0,2
44272,11455,Game Packs,1,0,0.0,1
44273,11455,Kits,1,1,1.0,0
44274,11455,Stuff Packs,2,2,1.0,0
44275,11456,Expansion Packs,14,0,0.0,14
44276,11456,Game Packs,10,0,0.0,10
44277,11456,Kits,1,0,0.0,1
44278,11456,Stuff Packs,11,0,0.0,11
44279,11457,Expansion Packs,10,0,0.0,10
44280,11457,Game Packs,9,0,0.0,9
44281,11457,Kits,1,1,1.0,0
44282,11457,Stuff Packs,13,1,0.07692307692307693,12
44283,11458,Expansion Packs,7,0,0.0,7
44284,11458,Game Packs,3,0,0.0,3
44285,11458,Kits,3,1,0.3333333333333333,2
44286,11458,Stuff Packs,2,0,0.0,2
44287,11459,Expansion Packs,16,0,0.0,16
44288,11459,Game Packs,12,0,0.0,12
44289,11459,Kits,33,0,0.0,33
44290,11459,Stuff Packs,20,0,0.0,20
44291,11460,Expansion Packs,12,0,0.0,12
44292,11460,Game Packs,4,0,0.0,4
44293,11460,Kits,12,1,0.08333333333333333,11
44294,11460,Stuff Packs,12,2,0.16666666666666666,10
44295,11461,Expansion Packs,8,0,0.0,8
44296,11461,Game Packs,4,0,0.0,4
44297,11461,Kits,5,2,0.4,3
44298,11461,Stuff Packs,10,2,0.2,8
44299,11462,Expansion Packs,5,0,0.0,5
44300,11462,Game Packs,4,0,0.0,4
44301,11462,Kits,3,2,0.6666666666666666,1
44302,11462,Stuff Packs,5,0,0.0,5
44303,11463,Expansion Packs,16,0,0.0,16
44304,11463,Game Packs,9,0,0.0,9
44305,11463,Kits,22,0,0.0,22
44306,11463,Stuff Packs,18,0,0.0,18
44307,11464,Expansion Packs,14,0,0.0,14
44308,11464,Game Packs,11,0,0.0,11
44309,11464,Kits,8,0,0.0,8
44310,11464,Stuff Packs,18,0,0.0,18
44311,11465,Expansion Packs,16,0,0.0,16
44312,11465,Game Packs,12,0,0.0,12
44313,11465,Kits,33,0,0.0,33
44314,11465,Stuff Packs,20,0,0.0,20
44315,11466,Expansion Packs,10,0,0.0,10
44316,11466,Game Packs,7,1,0.14285714285714285,6
44317,11466,Kits,2,2,1.0,0
44318,11466,Stuff Packs,13,4,0.3076923076923077,9
44319,11467,Expansion Packs,7,1,0.14285714285714285,6
44320,11467,Game Packs,1,0,0.0,1
44321,11467,Kits,2,2,1.0,0
44322,11467,Stuff Packs,3,2,0.6666666666666666,1
44323,11468,Expansion Packs,5,0,0.0,5
44324,11468,Game Packs,3,0,0.0,3
44325,11468,Kits,1,1,1.0,0
44326,11468,Stuff Packs,9,2,0.2222222222222222,7
44327,11469,Kits,3,3,1.0,0
44328,11469,Stuff Packs,2,2,1.0,0
44329,11470,Expansion Packs,15,0,0.0,15
44330,11470,Game Packs,6,0,0.0,6
44331,11470,Kits,3,0,0.0,3
44332,11470,Stuff Packs,9,3,0.3333333333333333,6
44333,11471,Expansion Packs,15,0,0.0,15
44334,11471,Game Packs,12,0,0.0,12
44335,11471,Kits,25,0,0.0,25
44336,11471,Stuff Packs,16,0,0.0,16
44337,11472,Expansion Packs,7,0,0.0,7
44338,11472,Game Packs,4,0,0.0,4
44339,11472,Stuff Packs,3,0,0.0,3
44340,11473,Expansion Packs,11,0,0.0,11
44341,11473,Game Packs,8,1,0.125,7
44342,11473,Kits,2,1,0.5,1
44343,11473,Stuff Packs,13,2,0.15384615384615385,11
44344,11474,Expansion Packs,1,0,0.0,1
44345,11474,Game Packs,3,1,0.3333333333333333,2
44346,11474,Kits,8,0,0.0,8
44347,11474,Stuff Packs,7,4,0.5714285714285714,3
44348,11475,Expansion Packs,8,0,0.0,8
44349,11475,Game Packs,1,0,0.0,1
44350,11475,Kits,1,0,0.0,1
44351,11476,Expansion Packs,14,0,0.0,14
44352,11476,Game Packs,11,0,0.0,11
44353,11476,Kits,8,0,0.0,8
44354,11476,Stuff Packs,10,0,0.0,10
44355,11477,Expansion Packs,12,0,0.0,12
44356,11477,Game Packs,9,0,0.0,9
44357,11477,Kits,4,1,0.25,3
44358,11477,Stuff Packs,9,1,0.1111111111111111,8
44359,11478,Expansion Packs,11,0,0.0,11
44360,11478,Game Packs,5,0,0.0,5
44361,11478,Stuff Packs,5,0,0.0,5
44362,11479,Expansion Packs,14,0,0.0,14
44363,11479,Game Packs,11,0,0.0,11
44364,11479,Kits,3,0,0.0,3
44365,11479,Stuff Packs,12,0,0.0,12
44366,11480,Expansion Packs,16,0,0.0,16
44367,11480,Game Packs,10,0,0.0,10
44368,11480,Kits,9,2,0.2222222222222222,7
44369,11480,Stuff Packs,10,2,0.2,8
44370,11481,Expansion Packs,16,0,0.0,16
44371,11481,Game Packs,12,0,0.0,12
44372,11481,Kits,33,1,0.030303030303030304,32
44373,11481,Stuff Packs,20,0,0.0,20
44374,11482,Expansion Packs,6,0,0.0,6
44375,11482,Game Packs,2,0,0.0,2
44376,11482,Kits,1,1,1.0,0
44377,11482,Stuff Packs,5,3,0.6,2
44378,11483,Expansion Packs,16,0,0.0,16
44379,11483,Game Packs,12,0,0.0,12
44380,11483,Kits,33,0,0.0,33
44381,11483,Stuff Packs,20,0,0.0,20
44382,11484,Expansion Packs,14,0,0.0,14
44383,11484,Game Packs,11,0,0.0,11
44384,11484,Kits,24,0,0.0,24
44385,11484,Stuff Packs,20,0,0.0,20
44386,11485,Expansion Packs,16,0,0.0,16
44387,11485,Game Packs,12,0,0.0,12
44388,11485,Kits,28,0,0.0,28
44389,11485,Stuff Packs,20,0,0.0,20
44390,11486,Expansion Packs,15,0,0.0,15
44391,11486,Game Packs,12,0,0.0,12
44392,11486,Kits,9,0,0.0,9
44393,11486,Stuff Packs,20,0,0.0,20
44394,11487,Expansion Packs,12,0,0.0,12
44395,11487,Game Packs,2,0,0.0,2
44396,11487,Kits,1,0,0.0,1
44397,11487,Stuff Packs,4,2,0.5,2
44398,11488,Expansion Packs,14,0,0.0,14
44399,11488,Game Packs,12,0,0.0,12
44400,11488,Stuff Packs,19,0,0.0,19
44401,11489,Expansion Packs,9,0,0.0,9
44402,11489,Game Packs,3,0,0.0,3
44403,11489,Kits,1,1,1.0,0
44404,11489,Stuff Packs,3,3,1.0,0
44405,11490,Expansion Packs,12,0,0.0,12
44406,11490,Game Packs,10,0,0.0,10
44407,11490,Kits,6,0,0.0,6
44408,11490,Stuff Packs,18,0,0.0,18
44409,11491,Expansion Packs,14,0,0.0,14
44410,11491,Game Packs,10,0,0.0,10
44411,11491,Kits,10,1,0.1,9
44412,11491,Stuff Packs,20,1,0.05,19
44413,11492,Expansion Packs,14,0,0.0,14
44414,11492,Game Packs,4,0,0.0,4
44415,11492,Kits,5,0,0.0,5
44416,11492,Stuff Packs,12,0,0.0,12
44417,11493,Expansion Packs,13,0,0.0,13
44418,11493,Game Packs,4,0,0.0,4
44419,11493,Kits,9,0,0.0,9
44420,11493,Stuff Packs,9,3,0.3333333333333333,6
44421,11494,Expansion Packs,14,0,0.0,14
44422,11494,Game Packs,11,0,0.0,11
44423,11494,Kits,15,1,0.06666666666666667,14
44424,11494,Stuff Packs,14,1,0.07142857142857142,13
44425,11495,Expansion Packs,16,0,0.0,16
44426,11495,Game Packs,12,0,0.0,12
44427,11495,Kits,27,0,0.0,27
44428,11495,Stuff Packs,18,0,0.0,18
44429,11496,Expansion Packs,16,0,0.0,16
44430,11496,Game Packs,12,0,0.0,12
44431,11496,Kits,33,0,0.0,33
44432,11496,Stuff Packs,20,0,0.0,20
44433,11497,Expansion Packs,11,0,0.0,11
44434,11497,Game Packs,9,0,0.0,9
44435,11497,Kits,3,0,0.0,3
44436,11497,Stuff Packs,10,2,0.2,8
44437,11498,Expansion Packs,16,0,0.0,16
44438,11498,Game Packs,12,0,0.0,12
44439,11498,Kits,33,0,0.0,33
44440,11498,Stuff Packs,20,0,0.0,20
44441,11499,Expansion Packs,15,0,0.0,15
44442,11499,Game Packs,5,0,0.0,5
44443,11499,Kits,4,2,0.5,2
44444,11499,Stuff Packs,12,3,0.25,9
44445,11500,Expansion Packs,11,0,0.0,11
44446,11500,Game Packs,11,1,0.09090909090909091,10
44447,11500,Kits,9,2,0.2222222222222222,7
44448,11500,Stuff Packs,12,4,0.3333333333333333,8
44449,11501,Expansion Packs,11,2,0.18181818181818182,9
44450,11501,Game Packs,6,1,0.16666666666666666,5
44451,11501,Kits,7,0,0.0,7
44452,11501,Stuff Packs,9,2,0.2222222222222222,7
44453,11502,Expansion Packs,16,0,0.0,16
44454,11502,Game Packs,12,0,0.0,12
44455,11502,Kits,33,0,0.0,33
44456,11502,Stuff Packs,20,0,0.0,20
44457,11503,Expansion Packs,13,0,0.0,13
44458,11503,Game Packs,11,0,0.0,11
44459,11503,Kits,9,1,0.1111111111111111,8
44460,11503,Stuff Packs,20,0,0.0,20
44461,11504,Expansion Packs,14,0,0.0,14
44462,11504,Game Packs,6,0,0.0,6
44463,11504,Kits,7,0,0.0,7
44464,11504,Stuff Packs,6,0,0.0,6
44465,11505,Expansion Packs,15,0,0.0,15
44466,11505,Game Packs,12,0,0.0,12
44467,11505,Kits,9,0,0.0,9
44468,11505,Stuff Packs,18,0,0.0,18
44469,11506,Expansion Packs,16,0,0.0,16
44470,11506,Game Packs,11,0,0.0,11
44471,11506,Kits,16,0,0.0,16
44472,11506,Stuff Packs,16,0,0.0,16
44473,11507,Expansion Packs,13,0,0.0,13
44474,11507,Game Packs,12,0,0.0,12
44475,11507,Kits,1,1,1.0,0
44476,11507,Stuff Packs,18,0,0.0,18
44477,11508,Expansion Packs,16,0,0.0,16
44478,11508,Game Packs,12,0,0.0,12
44479,11508,Kits,29,1,0.034482758620689655,28
44480,11508,Stuff Packs,20,0,0.0,20
44481,11509,Expansion Packs,9,0,0.0,9
44482,11509,Game Packs,5,0,0.0,5
44483,11509,Stuff Packs,5,0,0.0,5
44484,11510,Expansion Packs,16,0,0.0,16
44485,11510,Game Packs,10,1,0.1,9
44486,11510,Kits,18,4,0.2222222222222222,14
44487,11510,Stuff Packs,15,3,0.2,12
44488,11511,Expansion Packs,8,0,0.0,8
44489,11511,Game Packs,5,0,0.0,5
44490,11511,Stuff Packs,4,2,0.5,2
44491,11512,Expansion Packs,16,0,0.0,16
44492,11512,Game Packs,11,0,0.0,11
44493,11512,Kits,19,0,0.0,19
44494,11512,Stuff Packs,17,0,0.0,17
44495,11513,Expansion Packs,16,0,0.0,16
44496,11513,Game Packs,12,0,0.0,12
44497,11513,Kits,15,0,0.0,15
44498,11513,Stuff Packs,20,0,0.0,20
44499,11514,Expansion Packs,13,0,0.0,13
44500,11514,Game Packs,12,0,0.0,12
44501,11514,Kits,17,1,0.058823529411764705,16
44502,11514,Stuff Packs,20,0,0.0,20
44503,11515,Expansion Packs,13,0,0.0,13
44504,11515,Game Packs,10,0,0.0,10
44505,11515,Kits,5,0,0.0,5
44506,11515,Stuff Packs,14,2,0.14285714285714285,12
44507,11516,Expansion Packs,16,0,0.0,16
44508,11516,Game Packs,12,0,0.0,12
44509,11516,Kits,18,0,0.0,18
44510,11516,Stuff Packs,17,0,0.0,17
44511,11517,Expansion Packs,10,1,0.1,9
44512,11517,Game Packs,4,1,0.25,3
44513,11517,Kits,14,1,0.07142857142857142,13
44514,11517,Stuff Packs,13,0,0.0,13
44515,11518,Expansion Packs,14,0,0.0,14
44516,11518,Game Packs,9,0,0.0,9
44517,11518,Kits,2,0,0.0,2
44518,11518,Stuff Packs,6,1,0.16666666666666666,5
44519,11519,Expansion Packs,16,0,0.0,16
44520,11519,Game Packs,12,0,0.0,12
44521,11519,Kits,33,1,0.030303030303030304,32
44522,11519,Stuff Packs,20,0,0.0,20
44523,11520,Expansion Packs,9,0,0.0,9
44524,11520,Game Packs,5,0,0.0,5
44525,11520,Kits,3,1,0.3333333333333333,2
44526,11520,Stuff Packs,4,0,0.0,4
44527,11521,Expansion Packs,15,0,0.0,15
44528,11521,Game Packs,11,0,0.0,11
44529,11521,Kits,11,1,0.09090909090909091,10
44530,11521,Stuff Packs,13,1,0.07692307692307693,12
44531,11522,Expansion Packs,15,0,0.0,15
44532,11522,Game Packs,6,0,0.0,6
44533,11522,Kits,5,1,0.2,4
44534,11522,Stuff Packs,17,1,0.058823529411764705,16
44535,11523,Expansion Packs,14,0,0.0,14
44536,11523,Game Packs,11,0,0.0,11
44537,11523,Kits,4,1,0.25,3
44538,11523,Stuff Packs,14,2,0.14285714285714285,12
44539,11524,Expansion Packs,16,0,0.0,16
44540,11524,Game Packs,12,0,0.0,12
44541,11524,Kits,33,0,0.0,33
44542,11524,Stuff Packs,20,0,0.0,20
44543,11525,Expansion Packs,16,0,0.0,16
44544,11525,Game Packs,12,0,0.0,12
44545,11525,Kits,31,1,0.03225806451612903,30
44546,11525,Stuff Packs,20,0,0.0,20
44547,11526,Expansion Packs,3,0,0.0,3
44548,11526,Game Packs,2,0,0.0,2
44549,11526,Stuff Packs,3,2,0.6666666666666666,1
44550,11527,Expansion Packs,14,0,0.0,14
44551,11527,Game Packs,12,0,0.0,12
44552,11527,Kits,10,0,0.0,10
44553,11527,Stuff Packs,20,0,0.0,20
44554,11528,Expansion Packs,7,0,0.0,7
44555,11528,Game Packs,1,0,0.0,1
44556,11528,Kits,1,1,1.0,0
44557,11528,Stuff Packs,2,0,0.0,2
44558,11529,Expansion Packs,6,0,0.0,6
44559,11529,Game Packs,2,0,0.0,2
44560,11529,Kits,3,2,0.6666666666666666,1
44561,11529,Stuff Packs,5,2,0.4,3
44562,11530,Expansion Packs,14,0,0.0,14
44563,11530,Game Packs,10,0,0.0,10
44564,11530,Kits,7,1,0.14285714285714285,6
44565,11530,Stuff Packs,13,1,0.07692307692307693,12
44566,11531,Expansion Packs,7,0,0.0,7
44567,11531,Game Packs,4,0,0.0,4
44568,11531,Kits,2,1,0.5,1
44569,11531,Stuff Packs,5,0,0.0,5
44570,11532,Expansion Packs,16,0,0.0,16
44571,11532,Game Packs,11,0,0.0,11
44572,11532,Kits,11,2,0.18181818181818182,9
44573,11532,Stuff Packs,20,0,0.0,20
44574,11533,Expansion Packs,14,0,0.0,14
44575,11533,Game Packs,11,0,0.0,11
44576,11533,Kits,6,2,0.3333333333333333,4
44577,11533,Stuff Packs,18,1,0.05555555555555555,17
44578,11534,Expansion Packs,16,0,0.0,16
44579,11534,Game Packs,12,0,0.0,12
44580,11534,Kits,33,1,0.030303030303030304,32
44581,11534,Stuff Packs,20,1,0.05,19
44582,11535,Expansion Packs,15,0,0.0,15
44583,11535,Game Packs,11,0,0.0,11
44584,11535,Kits,17,1,0.058823529411764705,16
44585,11535,Stuff Packs,20,0,0.0,20
44586,11536,Expansion Packs,16,0,0.0,16
44587,11536,Game Packs,12,0,0.0,12
44588,11536,Kits,20,0,0.0,20
44589,11536,Stuff Packs,20,0,0.0,20
44590,11537,Expansion Packs,16,0,0.0,16
44591,11537,Game Packs,12,1,0.08333333333333333,11
44592,11537,Kits,23,1,0.043478260869565216,22
44593,11537,Stuff Packs,17,2,0.11764705882352941,15
44594,11538,Expansion Packs,16,0,0.0,16
44595,11538,Game Packs,12,0,0.0,12
44596,11538,Kits,14,1,0.07142857142857142,13
44597,11538,Stuff Packs,20,0,0.0,20
44598,11539,Expansion Packs,14,0,0.0,14
44599,11539,Game Packs,7,0,0.0,7
44600,11539,Kits,10,2,0.2,8
44601,11539,Stuff Packs,10,4,0.4,6
44602,11540,Expansion Packs,9,0,0.0,9
44603,11540,Game Packs,6,0,0.0,6
44604,11540,Kits,8,2,0.25,6
44605,11540,Stuff Packs,12,3,0.25,9
44606,11541,Expansion Packs,16,0,0.0,16
44607,11541,Game Packs,11,0,0.0,11
44608,11541,Kits,23,0,0.0,23
44609,11541,Stuff Packs,20,0,0.0,20
44610,11542,Expansion Packs,3,0,0.0,3
44611,11542,Game Packs,1,0,0.0,1
44612,11542,Stuff Packs,1,0,0.0,1
44613,11543,Expansion Packs,9,0,0.0,9
44614,11543,Game Packs,7,0,0.0,7
44615,11543,Stuff Packs,15,0,0.0,15
44616,11544,Expansion Packs,16,0,0.0,16
44617,11544,Game Packs,12,0,0.0,12
44618,11544,Kits,29,3,0.10344827586206896,26
44619,11544,Stuff Packs,20,1,0.05,19
44620,11545,Expansion Packs,15,0,0.0,15
44621,11545,Game Packs,7,0,0.0,7
44622,11545,Kits,19,0,0.0,19
44623,11545,Stuff Packs,17,0,0.0,17
44624,11546,Expansion Packs,16,0,0.0,16
44625,11546,Game Packs,5,0,0.0,5
44626,11546,Kits,11,0,0.0,11
44627,11546,Stuff Packs,9,0,0.0,9
44628,11547,Expansion Packs,7,0,0.0,7
44629,11547,Game Packs,2,0,0.0,2
44630,11547,Kits,2,2,1.0,0
44631,11547,Stuff Packs,8,5,0.625,3
44632,11548,Expansion Packs,12,0,0.0,12
44633,11548,Game Packs,3,0,0.0,3
44634,11548,Stuff Packs,1,0,0.0,1
44635,11549,Expansion Packs,16,0,0.0,16
44636,11549,Game Packs,12,0,0.0,12
44637,11549,Kits,33,0,0.0,33
44638,11549,Stuff Packs,20,0,0.0,20
44639,11550,Expansion Packs,10,0,0.0,10
44640,11550,Game Packs,8,0,0.0,8
44641,11550,Kits,5,2,0.4,3
44642,11550,Stuff Packs,9,3,0.3333333333333333,6
44643,11551,Expansion Packs,12,0,0.0,12
44644,11551,Game Packs,6,0,0.0,6
44645,11551,Kits,7,0,0.0,7
44646,11551,Stuff Packs,12,0,0.0,12
44647,11552,Expansion Packs,2,0,0.0,2
44648,11552,Kits,3,0,0.0,3
44649,11552,Stuff Packs,5,2,0.4,3
44650,11553,Expansion Packs,15,0,0.0,15
44651,11553,Game Packs,9,0,0.0,9
44652,11553,Kits,4,2,0.5,2
44653,11553,Stuff Packs,5,2,0.4,3
44654,11554,Expansion Packs,5,0,0.0,5
44655,11554,Game Packs,4,0,0.0,4
44656,11554,Kits,4,2,0.5,2
44657,11554,Stuff Packs,5,2,0.4,3
44658,11555,Expansion Packs,3,0,0.0,3
44659,11555,Game Packs,1,1,1.0,0
44660,11555,Kits,2,2,1.0,0
44661,11555,Stuff Packs,4,3,0.75,1
44662,11556,Expansion Packs,16,0,0.0,16
44663,11556,Game Packs,10,0,0.0,10
44664,11556,Kits,14,0,0.0,14
44665,11556,Stuff Packs,14,0,0.0,14
44666,11557,Expansion Packs,4,0,0.0,4
44667,11557,Game Packs,1,0,0.0,1
44668,11557,Stuff Packs,2,0,0.0,2
44669,11558,Expansion Packs,7,0,0.0,7
44670,11558,Game Packs,4,0,0.0,4
44671,11558,Kits,1,1,1.0,0
44672,11558,Stuff Packs,4,2,0.5,2
44673,11559,Expansion Packs,6,0,0.0,6
44674,11559,Game Packs,3,1,0.3333333333333333,2
44675,11559,Kits,1,0,0.0,1
44676,11559,Stuff Packs,6,2,0.3333333333333333,4
44677,11560,Expansion Packs,16,0,0.0,16
44678,11560,Game Packs,11,0,0.0,11
44679,11560,Kits,16,2,0.125,14
44680,11560,Stuff Packs,17,1,0.058823529411764705,16
44681,11561,Expansion Packs,14,0,0.0,14
44682,11561,Game Packs,11,0,0.0,11
44683,11561,Kits,6,2,0.3333333333333333,4
44684,11561,Stuff Packs,16,2,0.125,14
44685,11562,Expansion Packs,4,0,0.0,4
44686,11562,Game Packs,3,0,0.0,3
44687,11562,Kits,1,1,1.0,0
44688,11562,Stuff Packs,6,3,0.5,3
44689,11563,Expansion Packs,15,0,0.0,15
44690,11563,Game Packs,11,0,0.0,11
44691,11563,Kits,1,0,0.0,1
44692,11563,Stuff Packs,10,0,0.0,10
44693,11564,Expansion Packs,15,0,0.0,15
44694,11564,Game Packs,9,0,0.0,9
44695,11564,Kits,7,0,0.0,7
44696,11564,Stuff Packs,17,3,0.17647058823529413,14
44697,11565,Expansion Packs,16,0,0.0,16
44698,11565,Game Packs,12,0,0.0,12
44699,11565,Kits,13,0,0.0,13
44700,11565,Stuff Packs,20,0,0.0,20
44701,11566,Expansion Packs,15,0,0.0,15
44702,11566,Game Packs,12,0,0.0,12
44703,11566,Kits,13,2,0.15384615384615385,11
44704,11566,Stuff Packs,19,3,0.15789473684210525,16
44705,11567,Expansion Packs,14,0,0.0,14
44706,11567,Game Packs,10,0,0.0,10
44707,11567,Kits,6,0,0.0,6
44708,11567,Stuff Packs,15,0,0.0,15
44709,11568,Expansion Packs,16,0,0.0,16
44710,11568,Game Packs,6,0,0.0,6
44711,11568,Kits,17,0,0.0,17
44712,11568,Stuff Packs,14,2,0.14285714285714285,12
44713,11569,Expansion Packs,15,0,0.0,15
44714,11569,Game Packs,7,0,0.0,7
44715,11569,Kits,2,1,0.5,1
44716,11569,Stuff Packs,12,1,0.08333333333333333,11
44717,11570,Expansion Packs,16,0,0.0,16
44718,11570,Game Packs,12,0,0.0,12
44719,11570,Kits,20,0,0.0,20
44720,11570,Stuff Packs,20,0,0.0,20
44721,11571,Expansion Packs,16,0,0.0,16
44722,11571,Game Packs,12,0,0.0,12
44723,11571,Kits,26,1,0.038461538461538464,25
44724,11571,Stuff Packs,20,0,0.0,20
44725,11572,Expansion Packs,3,0,0.0,3
44726,11572,Kits,1,1,1.0,0
44727,11572,Stuff Packs,2,2,1.0,0
44728,11573,Expansion Packs,5,0,0.0,5
44729,11573,Kits,2,2,1.0,0
44730,11573,Stuff Packs,2,2,1.0,0
44731,11574,Expansion Packs,15,0,0.0,15
44732,11574,Game Packs,11,0,0.0,11
44733,11574,Kits,8,1,0.125,7
44734,11574,Stuff Packs,20,0,0.0,20
44735,11575,Expansion Packs,16,0,0.0,16
44736,11575,Game Packs,11,0,0.0,11
44737,11575,Kits,18,0,0.0,18
44738,11575,Stuff Packs,16,1,0.0625,15
44739,11576,Expansion Packs,14,0,0.0,14
44740,11576,Game Packs,7,0,0.0,7
44741,11576,Kits,3,2,0.6666666666666666,1
44742,11576,Stuff Packs,4,0,0.0,4
44743,11577,Expansion Packs,14,0,0.0,14
44744,11577,Game Packs,8,0,0.0,8
44745,11577,Kits,4,3,0.75,1
44746,11577,Stuff Packs,12,4,0.3333333333333333,8
44747,11578,Expansion Packs,8,1,0.125,7
44748,11578,Game Packs,6,3,0.5,3
44749,11578,Kits,6,4,0.6666666666666666,2
44750,11578,Stuff Packs,9,7,0.7777777777777778,2
44751,11579,Expansion Packs,6,0,0.0,6
44752,11579,Game Packs,3,0,0.0,3
44753,11579,Kits,2,2,1.0,0
44754,11579,Stuff Packs,3,1,0.3333333333333333,2
44755,11580,Expansion Packs,16,0,0.0,16
44756,11580,Game Packs,12,0,0.0,12
44757,11580,Kits,19,0,0.0,19
44758,11580,Stuff Packs,20,0,0.0,20
44759,11581,Expansion Packs,4,0,0.0,4
44760,11581,Stuff Packs,2,0,0.0,2
44761,11582,Expansion Packs,15,0,0.0,15
44762,11582,Game Packs,11,0,0.0,11
44763,11582,Kits,1,0,0.0,1
44764,11582,Stuff Packs,14,0,0.0,14
44765,11583,Expansion Packs,10,0,0.0,10
44766,11583,Game Packs,3,1,0.3333333333333333,2
44767,11583,Kits,2,2,1.0,0
44768,11583,Stuff Packs,8,4,0.5,4
44769,11584,Expansion Packs,13,0,0.0,13
44770,11584,Game Packs,8,0,0.0,8
44771,11584,Kits,9,0,0.0,9
44772,11584,Stuff Packs,10,0,0.0,10
44773,11585,Expansion Packs,5,0,0.0,5
44774,11586,Expansion Packs,16,0,0.0,16
44775,11586,Game Packs,12,0,0.0,12
44776,11586,Kits,33,0,0.0,33
44777,11586,Stuff Packs,20,0,0.0,20
44778,11587,Expansion Packs,16,0,0.0,16
44779,11587,Game Packs,12,0,0.0,12
44780,11587,Kits,33,0,0.0,33
44781,11587,Stuff Packs,20,0,0.0,20
44782,11588,Expansion Packs,15,0,0.0,15
44783,11588,Game Packs,9,0,0.0,9
44784,11588,Kits,5,0,0.0,5
44785,11588,Stuff Packs,12,0,0.0,12
44786,11589,Expansion Packs,10,0,0.0,10
44787,11589,Game Packs,4,0,0.0,4
44788,11589,Kits,8,0,0.0,8
44789,11589,Stuff Packs,7,0,0.0,7
44790,11590,Expansion Packs,14,0,0.0,14
44791,11590,Game Packs,10,0,0.0,10
44792,11590,Stuff Packs,19,0,0.0,19
44793,11591,Expansion Packs,12,0,0.0,12
44794,11591,Game Packs,10,0,0.0,10
44795,11591,Kits,4,2,0.5,2
44796,11591,Stuff Packs,13,1,0.07692307692307693,12
44797,11592,Expansion Packs,13,0,0.0,13
44798,11592,Game Packs,4,0,0.0,4
44799,11592,Stuff Packs,5,1,0.2,4
44800,11593,Expansion Packs,13,0,0.0,13
44801,11593,Game Packs,6,1,0.16666666666666666,5
44802,11593,Kits,4,4,1.0,0
44803,11593,Stuff Packs,5,4,0.8,1
44804,11594,Expansion Packs,11,0,0.0,11
44805,11594,Game Packs,7,0,0.0,7
44806,11594,Kits,4,2,0.5,2
44807,11594,Stuff Packs,10,3,0.3,7
44808,11595,Expansion Packs,13,0,0.0,13
44809,11595,Game Packs,8,0,0.0,8
44810,11595,Kits,12,1,0.08333333333333333,11
44811,11595,Stuff Packs,8,2,0.25,6
44812,11596,Expansion Packs,12,0,0.0,12
44813,11596,Game Packs,6,0,0.0,6
44814,11596,Kits,2,0,0.0,2
44815,11596,Stuff Packs,9,1,0.1111111111111111,8
44816,11597,Expansion Packs,16,0,0.0,16
44817,11597,Game Packs,12,0,0.0,12
44818,11597,Kits,33,0,0.0,33
44819,11597,Stuff Packs,20,1,0.05,19
44820,11598,Expansion Packs,16,0,0.0,16
44821,11598,Game Packs,12,0,0.0,12
44822,11598,Kits,22,3,0.13636363636363635,19
44823,11598,Stuff Packs,20,0,0.0,20
44824,11599,Expansion Packs,16,0,0.0,16
44825,11599,Game Packs,12,0,0.0,12
44826,11599,Kits,33,0,0.0,33
44827,11599,Stuff Packs,20,0,0.0,20
44828,11600,Expansion Packs,16,0,0.0,16
44829,11600,Game Packs,10,0,0.0,10
44830,11600,Kits,6,1,0.16666666666666666,5
44831,11600,Stuff Packs,4,1,0.25,3
44832,11601,Expansion Packs,14,0,0.0,14
44833,11601,Game Packs,10,0,0.0,10
44834,11601,Kits,12,1,0.08333333333333333,11
44835,11601,Stuff Packs,20,0,0.0,20
44836,11602,Expansion Packs,16,0,0.0,16
44837,11602,Game Packs,12,0,0.0,12
44838,11602,Kits,33,0,0.0,33
44839,11602,Stuff Packs,20,0,0.0,20
44840,11603,Expansion Packs,15,0,0.0,15
44841,11603,Game Packs,10,0,0.0,10
44842,11603,Kits,9,0,0.0,9
44843,11603,Stuff Packs,12,0,0.0,12
44844,11604,Expansion Packs,16,0,0.0,16
44845,11604,Game Packs,12,0,0.0,12
44846,11604,Kits,33,0,0.0,33
44847,11604,Stuff Packs,20,0,0.0,20
44848,11605,Expansion Packs,5,0,0.0,5
44849,11605,Game Packs,1,0,0.0,1
44850,11605,Kits,4,2,0.5,2
44851,11605,Stuff Packs,5,2,0.4,3
44852,11606,Expansion Packs,16,3,0.1875,13
44853,11606,Game Packs,11,1,0.09090909090909091,10
44854,11606,Kits,21,1,0.047619047619047616,20
44855,11606,Stuff Packs,16,0,0.0,16
44856,11607,Expansion Packs,10,0,0.0,10
44857,11607,Game Packs,2,0,0.0,2
44858,11607,Kits,4,2,0.5,2
44859,11607,Stuff Packs,7,3,0.42857142857142855,4
44860,11608,Kits,1,1,1.0,0
44861,11608,Stuff Packs,3,2,0.6666666666666666,1
44862,11609,Expansion Packs,11,0,0.0,11
44863,11609,Game Packs,5,0,0.0,5
44864,11609,Kits,13,1,0.07692307692307693,12
44865,11609,Stuff Packs,9,2,0.2222222222222222,7
44866,11610,Expansion Packs,10,0,0.0,10
44867,11610,Game Packs,6,0,0.0,6
44868,11610,Kits,1,0,0.0,1
44869,11610,Stuff Packs,4,0,0.0,4
44870,11611,Expansion Packs,15,0,0.0,15
44871,11611,Game Packs,12,0,0.0,12
44872,11611,Kits,7,0,0.0,7
44873,11611,Stuff Packs,20,0,0.0,20
44874,11612,Expansion Packs,12,0,0.0,12
44875,11612,Game Packs,8,0,0.0,8
44876,11612,Stuff Packs,4,0,0.0,4
44877,11613,Expansion Packs,3,0,0.0,3
44878,11613,Stuff Packs,1,0,0.0,1
44879,11614,Expansion Packs,10,0,0.0,10
44880,11614,Game Packs,3,0,0.0,3
44881,11614,Kits,1,1,1.0,0
44882,11614,Stuff Packs,3,1,0.3333333333333333,2
44883,11615,Expansion Packs,12,0,0.0,12
44884,11615,Game Packs,9,0,0.0,9
44885,11615,Kits,3,0,0.0,3
44886,11615,Stuff Packs,16,1,0.0625,15
44887,11616,Expansion Packs,3,0,0.0,3
44888,11616,Stuff Packs,2,0,0.0,2
44889,11617,Expansion Packs,14,0,0.0,14
44890,11617,Game Packs,10,0,0.0,10
44891,11617,Kits,1,1,1.0,0
44892,11617,Stuff Packs,8,2,0.25,6
44893,11618,Expansion Packs,16,0,0.0,16
44894,11618,Game Packs,12,0,0.0,12
44895,11618,Kits,33,0,0.0,33
44896,11618,Stuff Packs,20,0,0.0,20
44897,11619,Expansion Packs,16,1,0.0625,15
44898,11619,Game Packs,11,0,0.0,11
44899,11619,Kits,18,0,0.0,18
44900,11619,Stuff Packs,20,0,0.0,20
44901,11620,Expansion Packs,6,0,0.0,6
44902,11620,Game Packs,3,0,0.0,3
44903,11620,Kits,1,1,1.0,0
44904,11620,Stuff Packs,5,0,0.0,5
44905,11621,Expansion Packs,16,16,1.0,0
44906,11621,Game Packs,12,12,1.0,0
44907,11621,Kits,33,33,1.0,0
44908,11621,Stuff Packs,20,20,1.0,0
44909,11622,Expansion Packs,16,0,0.0,16
44910,11622,Game Packs,11,0,0.0,11
44911,11622,Kits,31,0,0.0,31
44912,11622,Stuff Packs,20,0,0.0,20
44913,11623,Expansion Packs,7,0,0.0,7
44914,11623,Game Packs,4,0,0.0,4
44915,11623,Kits,5,0,0.0,5
44916,11623,Stuff Packs,4,0,0.0,4
44917,11624,Expansion Packs,16,0,0.0,16
44918,11624,Game Packs,12,0,0.0,12
44919,11624,Kits,12,0,0.0,12
44920,11624,Stuff Packs,16,2,0.125,14
44921,11625,Expansion Packs,15,0,0.0,15
44922,11625,Game Packs,10,0,0.0,10
44923,11625,Kits,3,3,1.0,0
44924,11625,Stuff Packs,20,1,0.05,19
44925,11626,Expansion Packs,14,0,0.0,14
44926,11626,Game Packs,9,0,0.0,9
44927,11626,Kits,3,1,0.3333333333333333,2
44928,11626,Stuff Packs,18,0,0.0,18
44929,11627,Expansion Packs,11,0,0.0,11
44930,11627,Game Packs,9,0,0.0,9
44931,11627,Kits,1,1,1.0,0
44932,11627,Stuff Packs,17,1,0.058823529411764705,16
44933,11628,Expansion Packs,16,0,0.0,16
44934,11628,Game Packs,11,0,0.0,11
44935,11628,Kits,9,2,0.2222222222222222,7
44936,11628,Stuff Packs,19,1,0.05263157894736842,18
44937,11629,Expansion Packs,16,0,0.0,16
44938,11629,Game Packs,11,0,0.0,11
44939,11629,Kits,25,0,0.0,25
44940,11629,Stuff Packs,19,0,0.0,19
44941,11630,Expansion Packs,14,0,0.0,14
44942,11630,Game Packs,5,0,0.0,5
44943,11630,Kits,1,0,0.0,1
44944,11630,Stuff Packs,7,0,0.0,7
44945,11631,Expansion Packs,12,0,0.0,12
44946,11631,Game Packs,8,0,0.0,8
44947,11631,Kits,2,0,0.0,2
44948,11631,Stuff Packs,9,1,0.1111111111111111,8
44949,11632,Expansion Packs,10,0,0.0,10
44950,11632,Game Packs,7,1,0.14285714285714285,6
44951,11632,Kits,7,2,0.2857142857142857,5
44952,11632,Stuff Packs,9,4,0.4444444444444444,5
44953,11633,Expansion Packs,16,0,0.0,16
44954,11633,Game Packs,12,0,0.0,12
44955,11633,Kits,33,0,0.0,33
44956,11633,Stuff Packs,20,0,0.0,20
44957,11634,Expansion Packs,16,0,0.0,16
44958,11634,Game Packs,12,0,0.0,12
44959,11634,Kits,7,0,0.0,7
44960,11634,Stuff Packs,20,0,0.0,20
44961,11635,Expansion Packs,10,0,0.0,10
44962,11635,Game Packs,6,0,0.0,6
44963,11635,Kits,2,0,0.0,2
44964,11635,Stuff Packs,4,0,0.0,4
44965,11636,Expansion Packs,15,0,0.0,15
44966,11636,Game Packs,8,0,0.0,8
44967,11636,Kits,15,2,0.13333333333333333,13
44968,11636,Stuff Packs,14,3,0.21428571428571427,11
44969,11637,Expansion Packs,3,0,0.0,3
44970,11637,Stuff Packs,2,2,1.0,0
44971,11638,Expansion Packs,4,0,0.0,4
44972,11638,Game Packs,3,0,0.0,3
44973,11638,Stuff Packs,5,1,0.2,4
44974,11639,Expansion Packs,9,0,0.0,9
44975,11639,Game Packs,3,0,0.0,3
44976,11639,Kits,5,3,0.6,2
44977,11639,Stuff Packs,3,2,0.6666666666666666,1
44978,11640,Expansion Packs,16,0,0.0,16
44979,11640,Game Packs,12,0,0.0,12
44980,11640,Kits,30,0,0.0,30
44981,11640,Stuff Packs,20,0,0.0,20
44982,11641,Expansion Packs,16,0,0.0,16
44983,11641,Game Packs,12,0,0.0,12
44984,11641,Kits,32,0,0.0,32
44985,11641,Stuff Packs,20,0,0.0,20
44986,11642,Expansion Packs,15,0,0.0,15
44987,11642,Game Packs,8,0,0.0,8
44988,11642,Kits,9,0,0.0,9
44989,11642,Stuff Packs,6,0,0.0,6
44990,11643,Expansion Packs,13,0,0.0,13
44991,11643,Game Packs,10,0,0.0,10
44992,11643,Kits,13,0,0.0,13
44993,11643,Stuff Packs,13,0,0.0,13
44994,11644,Expansion Packs,16,0,0.0,16
44995,11644,Game Packs,11,0,0.0,11
44996,11644,Kits,16,1,0.0625,15
44997,11644,Stuff Packs,20,0,0.0,20
44998,11645,Expansion Packs,16,0,0.0,16
44999,11645,Game Packs,12,0,0.0,12
45000,11645,Kits,33,1,0.030303030303030304,32
45001,11645,Stuff Packs,20,0,0.0,20
45002,11646,Expansion Packs,15,0,0.0,15
45003,11646,Game Packs,11,0,0.0,11
45004,11646,Kits,11,0,0.0,11
45005,11646,Stuff Packs,20,0,0.0,20
45006,11647,Expansion Packs,13,0,0.0,13
45007,11647,Game Packs,11,0,0.0,11
45008,11647,Kits,10,1,0.1,9
45009,11647,Stuff Packs,19,0,0.0,19
45010,11648,Expansion Packs,15,0,0.0,15
45011,11648,Game Packs,9,0,0.0,9
45012,11648,Kits,2,2,1.0,0
45013,11648,Stuff Packs,6,1,0.16666666666666666,5
45014,11649,Expansion Packs,16,0,0.0,16
45015,11649,Game Packs,11,0,0.0,11
45016,11649,Kits,11,1,0.09090909090909091,10
45017,11649,Stuff Packs,20,0,0.0,20
45018,11650,Expansion Packs,13,0,0.0,13
45019,11650,Game Packs,10,0,0.0,10
45020,11650,Kits,7,1,0.14285714285714285,6
45021,11650,Stuff Packs,14,0,0.0,14
45022,11651,Expansion Packs,15,0,0.0,15
45023,11651,Game Packs,8,0,0.0,8
45024,11651,Kits,16,1,0.0625,15
45025,11651,Stuff Packs,16,0,0.0,16
45026,11652,Expansion Packs,4,0,0.0,4
45027,11652,Game Packs,4,0,0.0,4
45028,11652,Kits,8,1,0.125,7
45029,11652,Stuff Packs,7,0,0.0,7
45030,11653,Expansion Packs,9,0,0.0,9
45031,11653,Game Packs,5,1,0.2,4
45032,11653,Kits,4,2,0.5,2
45033,11653,Stuff Packs,10,7,0.7,3
45034,11654,Expansion Packs,16,0,0.0,16
45035,11654,Game Packs,12,0,0.0,12
45036,11654,Kits,6,0,0.0,6
45037,11654,Stuff Packs,15,0,0.0,15
45038,11655,Expansion Packs,1,0,0.0,1
45039,11655,Stuff Packs,2,2,1.0,0
45040,11656,Expansion Packs,16,0,0.0,16
45041,11656,Game Packs,12,0,0.0,12
45042,11656,Kits,33,0,0.0,33
45043,11656,Stuff Packs,20,0,0.0,20
45044,11657,Expansion Packs,5,0,0.0,5
45045,11657,Game Packs,2,0,0.0,2
45046,11657,Kits,4,1,0.25,3
45047,11657,Stuff Packs,5,1,0.2,4
45048,11658,Expansion Packs,15,0,0.0,15
45049,11658,Game Packs,10,0,0.0,10
45050,11658,Kits,2,1,0.5,1
45051,11658,Stuff Packs,11,0,0.0,11
45052,11659,Expansion Packs,11,0,0.0,11
45053,11659,Game Packs,5,0,0.0,5
45054,11659,Kits,9,2,0.2222222222222222,7
45055,11659,Stuff Packs,5,0,0.0,5
45056,11660,Expansion Packs,13,0,0.0,13
45057,11660,Game Packs,7,0,0.0,7
45058,11660,Kits,2,0,0.0,2
45059,11660,Stuff Packs,6,0,0.0,6
45060,11661,Expansion Packs,16,16,1.0,0
45061,11661,Game Packs,12,12,1.0,0
45062,11661,Kits,33,33,1.0,0
45063,11661,Stuff Packs,20,20,1.0,0
45064,11662,Expansion Packs,13,0,0.0,13
45065,11662,Game Packs,9,0,0.0,9
45066,11662,Kits,3,0,0.0,3
45067,11662,Stuff Packs,10,0,0.0,10
45068,11663,Expansion Packs,16,0,0.0,16
45069,11663,Game Packs,12,0,0.0,12
45070,11663,Kits,7,1,0.14285714285714285,6
45071,11663,Stuff Packs,15,0,0.0,15
45072,11664,Expansion Packs,16,0,0.0,16
45073,11664,Game Packs,12,0,0.0,12
45074,11664,Kits,33,0,0.0,33
45075,11664,Stuff Packs,20,0,0.0,20
45076,11665,Expansion Packs,16,0,0.0,16
45077,11665,Game Packs,12,0,0.0,12
45078,11665,Kits,16,4,0.25,12
45079,11665,Stuff Packs,18,0,0.0,18
45080,11666,Expansion Packs,5,0,0.0,5
45081,11666,Game Packs,1,0,0.0,1
45082,11666,Kits,1,1,1.0,0
45083,11666,Stuff Packs,5,1,0.2,4
45084,11667,Expansion Packs,16,0,0.0,16
45085,11667,Game Packs,12,0,0.0,12
45086,11667,Kits,15,0,0.0,15
45087,11667,Stuff Packs,12,0,0.0,12
45088,11668,Expansion Packs,12,0,0.0,12
45089,11668,Game Packs,2,0,0.0,2
45090,11668,Kits,1,0,0.0,1
45091,11668,Stuff Packs,3,0,0.0,3
45092,11669,Expansion Packs,5,0,0.0,5
45093,11669,Game Packs,1,0,0.0,1
45094,11669,Kits,3,0,0.0,3
45095,11669,Stuff Packs,2,0,0.0,2
45096,11670,Expansion Packs,16,0,0.0,16
45097,11670,Game Packs,12,0,0.0,12
45098,11670,Kits,33,0,0.0,33
45099,11670,Stuff Packs,20,0,0.0,20
45100,11671,Expansion Packs,15,0,0.0,15
45101,11671,Game Packs,7,1,0.14285714285714285,6
45102,11671,Kits,1,1,1.0,0
45103,11671,Stuff Packs,10,3,0.3,7
45104,11672,Expansion Packs,16,0,0.0,16
45105,11672,Game Packs,12,0,0.0,12
45106,11672,Kits,31,0,0.0,31
45107,11672,Stuff Packs,20,0,0.0,20
45108,11673,Expansion Packs,16,0,0.0,16
45109,11673,Game Packs,12,0,0.0,12
45110,11673,Kits,33,1,0.030303030303030304,32
45111,11673,Stuff Packs,20,0,0.0,20
45112,11674,Expansion Packs,4,0,0.0,4
45113,11674,Game Packs,1,0,0.0,1
45114,11674,Kits,4,1,0.25,3
45115,11674,Stuff Packs,7,1,0.14285714285714285,6
45116,11675,Expansion Packs,16,0,0.0,16
45117,11675,Game Packs,11,0,0.0,11
45118,11675,Kits,19,0,0.0,19
45119,11675,Stuff Packs,20,0,0.0,20
45120,11676,Expansion Packs,16,0,0.0,16
45121,11676,Game Packs,12,0,0.0,12
45122,11676,Kits,16,0,0.0,16
45123,11676,Stuff Packs,20,0,0.0,20
45124,11677,Expansion Packs,16,0,0.0,16
45125,11677,Game Packs,7,0,0.0,7
45126,11677,Kits,20,1,0.05,19
45127,11677,Stuff Packs,12,1,0.08333333333333333,11
45128,11678,Expansion Packs,7,0,0.0,7
45129,11678,Game Packs,5,0,0.0,5
45130,11678,Stuff Packs,5,0,0.0,5
45131,11679,Expansion Packs,16,0,0.0,16
45132,11679,Game Packs,9,0,0.0,9
45133,11679,Kits,21,0,0.0,21
45134,11679,Stuff Packs,19,0,0.0,19
45135,11680,Expansion Packs,16,0,0.0,16
45136,11680,Game Packs,12,0,0.0,12
45137,11680,Kits,16,0,0.0,16
45138,11680,Stuff Packs,20,0,0.0,20
45139,11681,Expansion Packs,16,0,0.0,16
45140,11681,Game Packs,12,0,0.0,12
45141,11681,Kits,23,1,0.043478260869565216,22
45142,11681,Stuff Packs,20,0,0.0,20
45143,11682,Expansion Packs,13,0,0.0,13
45144,11682,Game Packs,9,0,0.0,9
45145,11682,Kits,24,0,0.0,24
45146,11682,Stuff Packs,18,0,0.0,18
45147,11683,Expansion Packs,11,0,0.0,11
45148,11683,Game Packs,6,0,0.0,6
45149,11683,Kits,2,0,0.0,2
45150,11683,Stuff Packs,5,0,0.0,5
45151,11684,Expansion Packs,13,1,0.07692307692307693,12
45152,11684,Game Packs,11,0,0.0,11
45153,11684,Stuff Packs,6,0,0.0,6
45154,11685,Expansion Packs,15,0,0.0,15
45155,11685,Game Packs,11,0,0.0,11
45156,11685,Kits,8,0,0.0,8
45157,11685,Stuff Packs,14,0,0.0,14
45158,11686,Expansion Packs,10,0,0.0,10
45159,11686,Game Packs,5,0,0.0,5
45160,11686,Kits,1,1,1.0,0
45161,11686,Stuff Packs,9,3,0.3333333333333333,6
45162,11687,Expansion Packs,16,0,0.0,16
45163,11687,Game Packs,12,0,0.0,12
45164,11687,Kits,10,1,0.1,9
45165,11687,Stuff Packs,14,0,0.0,14
45166,11688,Expansion Packs,3,0,0.0,3
45167,11688,Game Packs,2,0,0.0,2
45168,11688,Stuff Packs,1,0,0.0,1
45169,11689,Expansion Packs,15,0,0.0,15
45170,11689,Game Packs,9,0,0.0,9
45171,11689,Kits,4,1,0.25,3
45172,11689,Stuff Packs,10,0,0.0,10
45173,11690,Expansion Packs,16,0,0.0,16
45174,11690,Game Packs,11,0,0.0,11
45175,11690,Kits,33,0,0.0,33
45176,11690,Stuff Packs,20,0,0.0,20
45177,11691,Expansion Packs,16,0,0.0,16
45178,11691,Game Packs,12,0,0.0,12
45179,11691,Kits,18,1,0.05555555555555555,17
45180,11691,Stuff Packs,20,0,0.0,20
45181,11692,Expansion Packs,15,0,0.0,15
45182,11692,Game Packs,11,0,0.0,11
45183,11692,Kits,18,0,0.0,18
45184,11692,Stuff Packs,19,1,0.05263157894736842,18
45185,11693,Expansion Packs,16,0,0.0,16
45186,11693,Game Packs,12,0,0.0,12
45187,11693,Kits,33,0,0.0,33
45188,11693,Stuff Packs,20,0,0.0,20
45189,11694,Expansion Packs,5,0,0.0,5
45190,11694,Game Packs,1,0,0.0,1
45191,11694,Stuff Packs,3,1,0.3333333333333333,2
45192,11695,Expansion Packs,8,0,0.0,8
45193,11695,Game Packs,4,1,0.25,3
45194,11695,Kits,4,1,0.25,3
45195,11695,Stuff Packs,6,4,0.6666666666666666,2
45196,11696,Expansion Packs,9,0,0.0,9
45197,11696,Game Packs,3,0,0.0,3
45198,11696,Kits,6,1,0.16666666666666666,5
45199,11696,Stuff Packs,9,3,0.3333333333333333,6
45200,11697,Expansion Packs,16,0,0.0,16
45201,11697,Game Packs,6,0,0.0,6
45202,11697,Kits,16,0,0.0,16
45203,11697,Stuff Packs,12,1,0.08333333333333333,11
45204,11698,Expansion Packs,16,0,0.0,16
45205,11698,Game Packs,11,0,0.0,11
45206,11698,Kits,5,2,0.4,3
45207,11698,Stuff Packs,18,3,0.16666666666666666,15
45208,11699,Expansion Packs,13,0,0.0,13
45209,11699,Game Packs,6,0,0.0,6
45210,11699,Kits,11,2,0.18181818181818182,9
45211,11699,Stuff Packs,14,2,0.14285714285714285,12
45212,11700,Expansion Packs,10,0,0.0,10
45213,11700,Game Packs,5,1,0.2,4
45214,11700,Kits,3,3,1.0,0
45215,11700,Stuff Packs,8,4,0.5,4
45216,11701,Game Packs,1,0,0.0,1
45217,11701,Kits,2,1,0.5,1
45218,11701,Stuff Packs,1,1,1.0,0
45219,11702,Expansion Packs,5,0,0.0,5
45220,11702,Game Packs,5,0,0.0,5
45221,11702,Kits,1,0,0.0,1
45222,11702,Stuff Packs,5,0,0.0,5
45223,11703,Expansion Packs,3,0,0.0,3
45224,11703,Kits,2,2,1.0,0
45225,11703,Stuff Packs,3,3,1.0,0
45226,11704,Expansion Packs,8,0,0.0,8
45227,11704,Game Packs,3,1,0.3333333333333333,2
45228,11704,Kits,3,3,1.0,0
45229,11704,Stuff Packs,6,4,0.6666666666666666,2
45230,11705,Expansion Packs,16,0,0.0,16
45231,11705,Game Packs,12,0,0.0,12
45232,11705,Kits,31,0,0.0,31
45233,11705,Stuff Packs,20,0,0.0,20
45234,11706,Expansion Packs,16,0,0.0,16
45235,11706,Game Packs,12,0,0.0,12
45236,11706,Kits,33,0,0.0,33
45237,11706,Stuff Packs,20,0,0.0,20
45238,11707,Expansion Packs,16,0,0.0,16
45239,11707,Game Packs,12,0,0.0,12
45240,11707,Stuff Packs,20,0,0.0,20
45241,11708,Expansion Packs,5,0,0.0,5
45242,11708,Game Packs,4,0,0.0,4
45243,11708,Kits,5,1,0.2,4
45244,11708,Stuff Packs,7,2,0.2857142857142857,5
45245,11709,Expansion Packs,16,0,0.0,16
45246,11709,Game Packs,12,0,0.0,12
45247,11709,Kits,33,0,0.0,33
45248,11709,Stuff Packs,20,0,0.0,20
45249,11710,Expansion Packs,5,0,0.0,5
45250,11710,Game Packs,1,0,0.0,1
45251,11710,Kits,1,1,1.0,0
45252,11710,Stuff Packs,3,3,1.0,0
45253,11711,Expansion Packs,16,0,0.0,16
45254,11711,Game Packs,11,0,0.0,11
45255,11711,Kits,33,0,0.0,33
45256,11711,Stuff Packs,20,0,0.0,20
45257,11712,Expansion Packs,8,0,0.0,8
45258,11712,Game Packs,6,0,0.0,6
45259,11712,Kits,1,0,0.0,1
45260,11712,Stuff Packs,3,0,0.0,3
45261,11713,Expansion Packs,10,0,0.0,10
45262,11713,Game Packs,1,0,0.0,1
45263,11713,Kits,3,1,0.3333333333333333,2
45264,11713,Stuff Packs,2,1,0.5,1
45265,11714,Expansion Packs,16,1,0.0625,15
45266,11714,Game Packs,12,0,0.0,12
45267,11714,Kits,2,0,0.0,2
45268,11714,Stuff Packs,11,0,0.0,11
45269,11715,Expansion Packs,16,0,0.0,16
45270,11715,Game Packs,12,0,0.0,12
45271,11715,Kits,33,1,0.030303030303030304,32
45272,11715,Stuff Packs,20,1,0.05,19
45273,11716,Expansion Packs,14,0,0.0,14
45274,11716,Game Packs,10,0,0.0,10
45275,11716,Kits,7,1,0.14285714285714285,6
45276,11716,Stuff Packs,13,3,0.23076923076923078,10
45277,11717,Expansion Packs,15,0,0.0,15
45278,11717,Game Packs,8,0,0.0,8
45279,11717,Kits,2,1,0.5,1
45280,11717,Stuff Packs,8,2,0.25,6
45281,11718,Expansion Packs,12,0,0.0,12
45282,11718,Game Packs,8,0,0.0,8
45283,11718,Kits,2,2,1.0,0
45284,11718,Stuff Packs,11,1,0.09090909090909091,10
45285,11719,Expansion Packs,16,0,0.0,16
45286,11719,Game Packs,12,0,0.0,12
45287,11719,Kits,33,0,0.0,33
45288,11719,Stuff Packs,20,0,0.0,20
45289,11720,Expansion Packs,12,0,0.0,12
45290,11720,Game Packs,9,1,0.1111111111111111,8
45291,11720,Kits,10,1,0.1,9
45292,11720,Stuff Packs,14,3,0.21428571428571427,11
45293,11721,Expansion Packs,3,0,0.0,3
45294,11721,Game Packs,1,1,1.0,0
45295,11721,Kits,3,3,1.0,0
45296,11721,Stuff Packs,4,3,0.75,1
45297,11722,Expansion Packs,12,0,0.0,12
45298,11722,Game Packs,10,0,0.0,10
45299,11722,Kits,3,2,0.6666666666666666,1
45300,11722,Stuff Packs,17,0,0.0,17
45301,11723,Expansion Packs,12,0,0.0,12
45302,11723,Game Packs,10,0,0.0,10
45303,11723,Kits,4,1,0.25,3
45304,11723,Stuff Packs,6,1,0.16666666666666666,5
45305,11724,Expansion Packs,15,0,0.0,15
45306,11724,Game Packs,12,1,0.08333333333333333,11
45307,11724,Kits,22,0,0.0,22
45308,11724,Stuff Packs,20,0,0.0,20
45309,11725,Expansion Packs,16,0,0.0,16
45310,11725,Game Packs,11,0,0.0,11
45311,11725,Kits,26,0,0.0,26
45312,11725,Stuff Packs,20,0,0.0,20
45313,11726,Expansion Packs,8,0,0.0,8
45314,11726,Game Packs,8,1,0.125,7
45315,11726,Kits,2,2,1.0,0
45316,11726,Stuff Packs,16,3,0.1875,13
45317,11727,Expansion Packs,15,0,0.0,15
45318,11727,Game Packs,12,0,0.0,12
45319,11727,Kits,16,1,0.0625,15
45320,11727,Stuff Packs,17,0,0.0,17
45321,11728,Expansion Packs,15,0,0.0,15
45322,11728,Game Packs,12,0,0.0,12
45323,11728,Kits,28,0,0.0,28
45324,11728,Stuff Packs,20,0,0.0,20
45325,11729,Expansion Packs,15,0,0.0,15
45326,11729,Game Packs,8,0,0.0,8
45327,11729,Kits,4,1,0.25,3
45328,11729,Stuff Packs,15,2,0.13333333333333333,13
45329,11730,Expansion Packs,10,0,0.0,10
45330,11730,Game Packs,4,0,0.0,4
45331,11730,Kits,6,0,0.0,6
45332,11730,Stuff Packs,7,1,0.14285714285714285,6
45333,11731,Expansion Packs,15,0,0.0,15
45334,11731,Game Packs,5,0,0.0,5
45335,11731,Kits,2,2,1.0,0
45336,11731,Stuff Packs,7,3,0.42857142857142855,4
45337,11732,Expansion Packs,15,0,0.0,15
45338,11732,Game Packs,12,0,0.0,12
45339,11732,Kits,16,0,0.0,16
45340,11732,Stuff Packs,14,0,0.0,14
45341,11733,Expansion Packs,11,0,0.0,11
45342,11733,Game Packs,9,0,0.0,9
45343,11733,Stuff Packs,11,0,0.0,11
45344,11734,Expansion Packs,16,0,0.0,16
45345,11734,Game Packs,11,0,0.0,11
45346,11734,Kits,33,2,0.06060606060606061,31
45347,11734,Stuff Packs,20,0,0.0,20
45348,11735,Expansion Packs,16,0,0.0,16
45349,11735,Game Packs,12,0,0.0,12
45350,11735,Kits,33,2,0.06060606060606061,31
45351,11735,Stuff Packs,20,1,0.05,19
45352,11736,Expansion Packs,6,0,0.0,6
45353,11736,Game Packs,5,0,0.0,5
45354,11736,Kits,2,2,1.0,0
45355,11736,Stuff Packs,5,1,0.2,4
45356,11737,Expansion Packs,10,0,0.0,10
45357,11737,Game Packs,7,0,0.0,7
45358,11737,Kits,5,0,0.0,5
45359,11737,Stuff Packs,13,0,0.0,13
45360,11738,Expansion Packs,10,0,0.0,10
45361,11738,Game Packs,1,0,0.0,1
45362,11738,Kits,2,1,0.5,1
45363,11738,Stuff Packs,3,0,0.0,3
45364,11739,Expansion Packs,12,0,0.0,12
45365,11739,Game Packs,5,0,0.0,5
45366,11739,Kits,4,2,0.5,2
45367,11739,Stuff Packs,10,3,0.3,7
45368,11740,Expansion Packs,16,0,0.0,16
45369,11740,Game Packs,12,0,0.0,12
45370,11740,Kits,33,0,0.0,33
45371,11740,Stuff Packs,20,0,0.0,20
45372,11741,Expansion Packs,16,0,0.0,16
45373,11741,Game Packs,8,0,0.0,8
45374,11741,Kits,12,0,0.0,12
45375,11741,Stuff Packs,15,0,0.0,15
45376,11742,Expansion Packs,14,0,0.0,14
45377,11742,Game Packs,6,0,0.0,6
45378,11742,Kits,2,2,1.0,0
45379,11742,Stuff Packs,18,1,0.05555555555555555,17
45380,11743,Expansion Packs,12,0,0.0,12
45381,11743,Game Packs,5,0,0.0,5
45382,11743,Kits,6,0,0.0,6
45383,11743,Stuff Packs,8,1,0.125,7
45384,11744,Expansion Packs,9,0,0.0,9
45385,11744,Game Packs,4,0,0.0,4
45386,11745,Expansion Packs,3,0,0.0,3
45387,11745,Game Packs,3,1,0.3333333333333333,2
45388,11745,Kits,2,0,0.0,2
45389,11745,Stuff Packs,3,3,1.0,0
45390,11746,Expansion Packs,6,0,0.0,6
45391,11746,Game Packs,4,0,0.0,4
45392,11746,Stuff Packs,2,0,0.0,2
45393,11747,Expansion Packs,16,0,0.0,16
45394,11747,Game Packs,12,0,0.0,12
45395,11747,Kits,28,0,0.0,28
45396,11747,Stuff Packs,18,0,0.0,18
45397,11748,Expansion Packs,12,0,0.0,12
45398,11748,Game Packs,5,0,0.0,5
45399,11748,Kits,2,1,0.5,1
45400,11748,Stuff Packs,8,0,0.0,8
45401,11749,Expansion Packs,16,0,0.0,16
45402,11749,Game Packs,12,0,0.0,12
45403,11749,Kits,33,0,0.0,33
45404,11749,Stuff Packs,20,0,0.0,20
45405,11750,Expansion Packs,16,0,0.0,16
45406,11750,Game Packs,12,0,0.0,12
45407,11750,Kits,20,0,0.0,20
45408,11750,Stuff Packs,20,0,0.0,20
45409,11751,Expansion Packs,7,0,0.0,7
45410,11751,Game Packs,7,0,0.0,7
45411,11751,Kits,1,1,1.0,0
45412,11751,Stuff Packs,5,0,0.0,5
45413,11752,Expansion Packs,16,0,0.0,16
45414,11752,Game Packs,11,0,0.0,11
45415,11752,Kits,19,4,0.21052631578947367,15
45416,11752,Stuff Packs,16,2,0.125,14
45417,11753,Expansion Packs,11,0,0.0,11
45418,11753,Game Packs,2,0,0.0,2
45419,11753,Kits,1,1,1.0,0
45420,11753,Stuff Packs,7,3,0.42857142857142855,4
45421,11754,Expansion Packs,16,0,0.0,16
45422,11754,Game Packs,10,0,0.0,10
45423,11754,Kits,12,1,0.08333333333333333,11
45424,11754,Stuff Packs,18,0,0.0,18
45425,11755,Expansion Packs,11,0,0.0,11
45426,11755,Game Packs,6,0,0.0,6
45427,11755,Kits,2,1,0.5,1
45428,11755,Stuff Packs,10,0,0.0,10
45429,11756,Expansion Packs,16,0,0.0,16
45430,11756,Game Packs,12,0,0.0,12
45431,11756,Kits,33,0,0.0,33
45432,11756,Stuff Packs,20,0,0.0,20
45433,11757,Expansion Packs,11,0,0.0,11
45434,11757,Game Packs,11,0,0.0,11
45435,11757,Kits,8,2,0.25,6
45436,11757,Stuff Packs,20,1,0.05,19
45437,11758,Expansion Packs,14,0,0.0,14
45438,11758,Game Packs,10,0,0.0,10
45439,11758,Kits,4,0,0.0,4
45440,11758,Stuff Packs,8,0,0.0,8
45441,11759,Expansion Packs,15,0,0.0,15
45442,11759,Game Packs,8,0,0.0,8
45443,11759,Kits,6,1,0.16666666666666666,5
45444,11759,Stuff Packs,18,0,0.0,18
45445,11760,Expansion Packs,16,0,0.0,16
45446,11760,Game Packs,12,0,0.0,12
45447,11760,Kits,33,1,0.030303030303030304,32
45448,11760,Stuff Packs,20,0,0.0,20
45449,11761,Expansion Packs,16,0,0.0,16
45450,11761,Game Packs,12,0,0.0,12
45451,11761,Kits,9,4,0.4444444444444444,5
45452,11761,Stuff Packs,7,3,0.42857142857142855,4
45453,11762,Expansion Packs,15,0,0.0,15
45454,11762,Game Packs,11,0,0.0,11
45455,11762,Kits,31,0,0.0,31
45456,11762,Stuff Packs,20,0,0.0,20
45457,11763,Expansion Packs,8,0,0.0,8
45458,11763,Game Packs,4,0,0.0,4
45459,11763,Kits,18,1,0.05555555555555555,17
45460,11763,Stuff Packs,9,2,0.2222222222222222,7
45461,11764,Expansion Packs,3,0,0.0,3
45462,11764,Game Packs,4,1,0.25,3
45463,11764,Kits,3,3,1.0,0
45464,11764,Stuff Packs,5,4,0.8,1
45465,11765,Expansion Packs,6,0,0.0,6
45466,11765,Stuff Packs,4,2,0.5,2
45467,11766,Expansion Packs,16,0,0.0,16
45468,11766,Game Packs,11,0,0.0,11
45469,11766,Kits,21,0,0.0,21
45470,11766,Stuff Packs,18,0,0.0,18
45471,11767,Expansion Packs,8,0,0.0,8
45472,11767,Game Packs,3,0,0.0,3
45473,11767,Kits,2,2,1.0,0
45474,11767,Stuff Packs,7,0,0.0,7
45475,11768,Expansion Packs,16,0,0.0,16
45476,11768,Game Packs,12,0,0.0,12
45477,11768,Kits,31,0,0.0,31
45478,11768,Stuff Packs,20,0,0.0,20
45479,11769,Expansion Packs,12,0,0.0,12
45480,11769,Game Packs,8,0,0.0,8
45481,11769,Kits,11,0,0.0,11
45482,11769,Stuff Packs,13,1,0.07692307692307693,12
45483,11770,Expansion Packs,15,0,0.0,15
45484,11770,Game Packs,8,0,0.0,8
45485,11770,Kits,5,1,0.2,4
45486,11770,Stuff Packs,15,1,0.06666666666666667,14
45487,11771,Expansion Packs,14,0,0.0,14
45488,11771,Game Packs,3,0,0.0,3
45489,11771,Kits,11,0,0.0,11
45490,11771,Stuff Packs,5,0,0.0,5
45491,11772,Expansion Packs,16,0,0.0,16
45492,11772,Game Packs,12,0,0.0,12
45493,11772,Kits,33,0,0.0,33
45494,11772,Stuff Packs,20,0,0.0,20
45495,11773,Expansion Packs,16,0,0.0,16
45496,11773,Game Packs,6,0,0.0,6
45497,11773,Kits,7,1,0.14285714285714285,6
45498,11773,Stuff Packs,10,2,0.2,8
45499,11774,Expansion Packs,12,0,0.0,12
45500,11774,Game Packs,7,0,0.0,7
45501,11774,Kits,5,1,0.2,4
45502,11774,Stuff Packs,12,1,0.08333333333333333,11
45503,11775,Expansion Packs,3,0,0.0,3
45504,11775,Game Packs,4,0,0.0,4
45505,11775,Stuff Packs,1,0,0.0,1
45506,11776,Expansion Packs,7,0,0.0,7
45507,11776,Game Packs,3,0,0.0,3
45508,11776,Kits,7,1,0.14285714285714285,6
45509,11776,Stuff Packs,7,0,0.0,7
45510,11777,Expansion Packs,15,0,0.0,15
45511,11777,Game Packs,12,0,0.0,12
45512,11777,Kits,26,1,0.038461538461538464,25
45513,11777,Stuff Packs,20,0,0.0,20
45514,11778,Expansion Packs,12,0,0.0,12
45515,11778,Game Packs,3,0,0.0,3
45516,11778,Stuff Packs,3,0,0.0,3
45517,11779,Expansion Packs,14,0,0.0,14
45518,11779,Game Packs,12,0,0.0,12
45519,11779,Kits,5,2,0.4,3
45520,11779,Stuff Packs,20,2,0.1,18
45521,11780,Expansion Packs,8,0,0.0,8
45522,11780,Game Packs,5,0,0.0,5
45523,11780,Stuff Packs,4,0,0.0,4
45524,11781,Expansion Packs,6,0,0.0,6
45525,11781,Stuff Packs,2,2,1.0,0
45526,11782,Expansion Packs,7,0,0.0,7
45527,11782,Game Packs,2,0,0.0,2
45528,11782,Kits,2,2,1.0,0
45529,11782,Stuff Packs,5,2,0.4,3
45530,11783,Expansion Packs,8,0,0.0,8
45531,11783,Game Packs,3,1,0.3333333333333333,2
45532,11783,Kits,2,2,1.0,0
45533,11783,Stuff Packs,4,4,1.0,0
45534,11784,Expansion Packs,16,0,0.0,16
45535,11784,Game Packs,10,0,0.0,10
45536,11784,Kits,7,0,0.0,7
45537,11784,Stuff Packs,16,0,0.0,16
45538,11785,Expansion Packs,13,0,0.0,13
45539,11785,Game Packs,8,0,0.0,8
45540,11785,Kits,2,2,1.0,0
45541,11785,Stuff Packs,7,2,0.2857142857142857,5
45542,11786,Expansion Packs,15,0,0.0,15
45543,11786,Game Packs,5,0,0.0,5
45544,11786,Kits,1,1,1.0,0
45545,11786,Stuff Packs,11,5,0.45454545454545453,6
45546,11787,Expansion Packs,13,0,0.0,13
45547,11787,Game Packs,5,0,0.0,5
45548,11787,Stuff Packs,12,3,0.25,9
45549,11788,Expansion Packs,13,0,0.0,13
45550,11788,Game Packs,7,1,0.14285714285714285,6
45551,11788,Kits,4,3,0.75,1
45552,11788,Stuff Packs,13,7,0.5384615384615384,6
45553,11789,Expansion Packs,13,0,0.0,13
45554,11789,Game Packs,7,0,0.0,7
45555,11789,Kits,2,2,1.0,0
45556,11789,Stuff Packs,11,1,0.09090909090909091,10
45557,11790,Expansion Packs,16,0,0.0,16
45558,11790,Game Packs,10,0,0.0,10
45559,11790,Kits,26,1,0.038461538461538464,25
45560,11790,Stuff Packs,16,1,0.0625,15
45561,11791,Expansion Packs,16,0,0.0,16
45562,11791,Game Packs,11,0,0.0,11
45563,11791,Kits,13,1,0.07692307692307693,12
45564,11791,Stuff Packs,20,0,0.0,20
45565,11792,Expansion Packs,3,0,0.0,3
45566,11792,Game Packs,3,0,0.0,3
45567,11792,Kits,2,0,0.0,2
45568,11792,Stuff Packs,7,2,0.2857142857142857,5
45569,11793,Expansion Packs,6,0,0.0,6
45570,11793,Game Packs,3,0,0.0,3
45571,11793,Stuff Packs,2,1,0.5,1
45572,11794,Expansion Packs,16,0,0.0,16
45573,11794,Game Packs,10,0,0.0,10
45574,11794,Kits,6,1,0.16666666666666666,5
45575,11794,Stuff Packs,7,1,0.14285714285714285,6
45576,11795,Expansion Packs,12,0,0.0,12
45577,11795,Game Packs,9,0,0.0,9
45578,11795,Kits,8,0,0.0,8
45579,11795,Stuff Packs,11,0,0.0,11
45580,11796,Expansion Packs,7,0,0.0,7
45581,11796,Game Packs,3,0,0.0,3
45582,11797,Expansion Packs,7,0,0.0,7
45583,11797,Game Packs,4,0,0.0,4
45584,11797,Kits,3,0,0.0,3
45585,11797,Stuff Packs,6,2,0.3333333333333333,4
45586,11798,Expansion Packs,10,0,0.0,10
45587,11798,Game Packs,4,0,0.0,4
45588,11798,Kits,1,1,1.0,0
45589,11798,Stuff Packs,2,0,0.0,2
45590,11799,Expansion Packs,15,0,0.0,15
45591,11799,Game Packs,6,0,0.0,6
45592,11799,Kits,16,0,0.0,16
45593,11799,Stuff Packs,17,2,0.11764705882352941,15
45594,11800,Expansion Packs,11,0,0.0,11
45595,11800,Game Packs,9,1,0.1111111111111111,8
45596,11800,Kits,4,1,0.25,3
45597,11800,Stuff Packs,7,3,0.42857142857142855,4
45598,11801,Expansion Packs,11,0,0.0,11
45599,11801,Game Packs,6,0,0.0,6
45600,11801,Kits,7,0,0.0,7
45601,11801,Stuff Packs,7,1,0.14285714285714285,6
45602,11802,Expansion Packs,16,1,0.0625,15
45603,11802,Game Packs,9,0,0.0,9
45604,11802,Kits,18,1,0.05555555555555555,17
45605,11802,Stuff Packs,8,0,0.0,8
45606,11803,Expansion Packs,16,0,0.0,16
45607,11803,Game Packs,12,1,0.08333333333333333,11
45608,11803,Kits,33,1,0.030303030303030304,32
45609,11803,Stuff Packs,20,1,0.05,19
45610,11804,Expansion Packs,14,0,0.0,14
45611,11804,Game Packs,10,0,0.0,10
45612,11804,Kits,5,3,0.6,2
45613,11804,Stuff Packs,18,1,0.05555555555555555,17
45614,11805,Expansion Packs,16,0,0.0,16
45615,11805,Game Packs,12,0,0.0,12
45616,11805,Kits,33,2,0.06060606060606061,31
45617,11805,Stuff Packs,20,2,0.1,18
45618,11806,Expansion Packs,14,0,0.0,14
45619,11806,Game Packs,11,0,0.0,11
45620,11806,Kits,3,0,0.0,3
45621,11806,Stuff Packs,13,1,0.07692307692307693,12
45622,11807,Expansion Packs,16,0,0.0,16
45623,11807,Game Packs,12,0,0.0,12
45624,11807,Kits,33,0,0.0,33
45625,11807,Stuff Packs,20,0,0.0,20
45626,11808,Expansion Packs,12,0,0.0,12
45627,11808,Game Packs,8,0,0.0,8
45628,11808,Stuff Packs,11,0,0.0,11
45629,11809,Expansion Packs,16,0,0.0,16
45630,11809,Game Packs,8,0,0.0,8
45631,11809,Kits,2,0,0.0,2
45632,11809,Stuff Packs,11,0,0.0,11
45633,11810,Expansion Packs,16,0,0.0,16
45634,11810,Game Packs,12,0,0.0,12
45635,11810,Kits,6,1,0.16666666666666666,5
45636,11810,Stuff Packs,18,0,0.0,18
45637,11811,Expansion Packs,12,0,0.0,12
45638,11811,Game Packs,11,0,0.0,11
45639,11811,Kits,5,1,0.2,4
45640,11811,Stuff Packs,18,0,0.0,18
45641,11812,Expansion Packs,16,0,0.0,16
45642,11812,Game Packs,12,0,0.0,12
45643,11812,Kits,33,0,0.0,33
45644,11812,Stuff Packs,20,0,0.0,20
45645,11813,Expansion Packs,2,0,0.0,2
45646,11813,Game Packs,1,0,0.0,1
45647,11814,Expansion Packs,3,0,0.0,3
45648,11814,Game Packs,3,1,0.3333333333333333,2
45649,11814,Kits,1,1,1.0,0
45650,11814,Stuff Packs,6,4,0.6666666666666666,2
45651,11815,Expansion Packs,8,0,0.0,8
45652,11815,Game Packs,2,0,0.0,2
45653,11815,Kits,5,2,0.4,3
45654,11815,Stuff Packs,5,1,0.2,4
45655,11816,Expansion Packs,8,1,0.125,7
45656,11816,Game Packs,3,0,0.0,3
45657,11816,Kits,12,0,0.0,12
45658,11816,Stuff Packs,7,1,0.14285714285714285,6
45659,11817,Expansion Packs,16,0,0.0,16
45660,11817,Game Packs,11,0,0.0,11
45661,11817,Kits,25,0,0.0,25
45662,11817,Stuff Packs,20,0,0.0,20
45663,11818,Expansion Packs,11,0,0.0,11
45664,11818,Game Packs,4,1,0.25,3
45665,11818,Kits,7,3,0.42857142857142855,4
45666,11818,Stuff Packs,9,2,0.2222222222222222,7
45667,11819,Expansion Packs,6,0,0.0,6
45668,11819,Game Packs,6,0,0.0,6
45669,11819,Stuff Packs,4,0,0.0,4
45670,11820,Expansion Packs,1,0,0.0,1
45671,11820,Game Packs,1,1,1.0,0
45672,11820,Kits,3,3,1.0,0
45673,11820,Stuff Packs,4,4,1.0,0
45674,11821,Expansion Packs,16,0,0.0,16
45675,11821,Game Packs,11,0,0.0,11
45676,11821,Kits,6,2,0.3333333333333333,4
45677,11821,Stuff Packs,16,3,0.1875,13
45678,11822,Expansion Packs,12,0,0.0,12
45679,11822,Game Packs,4,0,0.0,4
45680,11822,Kits,2,2,1.0,0
45681,11822,Stuff Packs,7,2,0.2857142857142857,5
45682,11823,Game Packs,1,1,1.0,0
45683,11823,Kits,1,1,1.0,0
45684,11823,Stuff Packs,4,4,1.0,0
45685,11824,Expansion Packs,16,0,0.0,16
45686,11824,Game Packs,12,0,0.0,12
45687,11824,Kits,33,1,0.030303030303030304,32
45688,11824,Stuff Packs,20,0,0.0,20
45689,11825,Expansion Packs,15,0,0.0,15
45690,11825,Game Packs,10,0,0.0,10
45691,11825,Kits,2,2,1.0,0
45692,11825,Stuff Packs,11,1,0.09090909090909091,10
45693,11826,Expansion Packs,14,0,0.0,14
45694,11826,Game Packs,9,0,0.0,9
45695,11826,Kits,5,2,0.4,3
45696,11826,Stuff Packs,19,1,0.05263157894736842,18
45697,11827,Expansion Packs,7,0,0.0,7
45698,11827,Game Packs,3,0,0.0,3
45699,11827,Kits,6,0,0.0,6
45700,11827,Stuff Packs,4,0,0.0,4
45701,11828,Expansion Packs,15,0,0.0,15
45702,11828,Game Packs,11,0,0.0,11
45703,11828,Kits,28,1,0.03571428571428571,27
45704,11828,Stuff Packs,20,1,0.05,19
45705,11829,Expansion Packs,8,0,0.0,8
45706,11829,Game Packs,8,0,0.0,8
45707,11829,Stuff Packs,6,0,0.0,6
45708,11830,Expansion Packs,14,0,0.0,14
45709,11830,Game Packs,11,0,0.0,11
45710,11830,Kits,9,1,0.1111111111111111,8
45711,11830,Stuff Packs,13,0,0.0,13
45712,11831,Expansion Packs,16,0,0.0,16
45713,11831,Game Packs,12,0,0.0,12
45714,11831,Kits,33,1,0.030303030303030304,32
45715,11831,Stuff Packs,20,0,0.0,20
45716,11832,Expansion Packs,16,0,0.0,16
45717,11832,Game Packs,12,0,0.0,12
45718,11832,Kits,12,0,0.0,12
45719,11832,Stuff Packs,20,0,0.0,20
45720,11833,Expansion Packs,12,0,0.0,12
45721,11833,Game Packs,11,0,0.0,11
45722,11833,Kits,8,0,0.0,8
45723,11833,Stuff Packs,17,0,0.0,17
45724,11834,Expansion Packs,11,0,0.0,11
45725,11834,Game Packs,5,0,0.0,5
45726,11834,Kits,1,0,0.0,1
45727,11834,Stuff Packs,11,0,0.0,11
45728,11835,Expansion Packs,12,0,0.0,12
45729,11835,Game Packs,10,0,0.0,10
45730,11835,Kits,14,1,0.07142857142857142,13
45731,11835,Stuff Packs,18,0,0.0,18
45732,11836,Expansion Packs,13,0,0.0,13
45733,11836,Game Packs,7,0,0.0,7
45734,11836,Kits,17,2,0.11764705882352941,15
45735,11836,Stuff Packs,11,0,0.0,11
45736,11837,Expansion Packs,6,0,0.0,6
45737,11837,Stuff Packs,4,2,0.5,2
45738,11838,Expansion Packs,14,0,0.0,14
45739,11838,Game Packs,5,0,0.0,5
45740,11838,Kits,2,0,0.0,2
45741,11838,Stuff Packs,8,0,0.0,8
45742,11839,Expansion Packs,15,0,0.0,15
45743,11839,Game Packs,10,0,0.0,10
45744,11839,Kits,2,1,0.5,1
45745,11839,Stuff Packs,16,0,0.0,16
45746,11840,Expansion Packs,14,0,0.0,14
45747,11840,Game Packs,12,0,0.0,12
45748,11840,Kits,14,1,0.07142857142857142,13
45749,11840,Stuff Packs,20,1,0.05,19
45750,11841,Expansion Packs,7,0,0.0,7
45751,11841,Game Packs,1,0,0.0,1
45752,11841,Stuff Packs,1,0,0.0,1
45753,11842,Expansion Packs,16,0,0.0,16
45754,11842,Game Packs,11,1,0.09090909090909091,10
45755,11842,Kits,22,2,0.09090909090909091,20
45756,11842,Stuff Packs,20,2,0.1,18
45757,11843,Expansion Packs,16,0,0.0,16
45758,11843,Game Packs,12,0,0.0,12
45759,11843,Kits,32,2,0.0625,30
45760,11843,Stuff Packs,17,1,0.058823529411764705,16
45761,11844,Expansion Packs,14,0,0.0,14
45762,11844,Game Packs,10,0,0.0,10
45763,11844,Kits,3,2,0.6666666666666666,1
45764,11844,Stuff Packs,8,0,0.0,8
45765,11845,Expansion Packs,15,2,0.13333333333333333,13
45766,11845,Game Packs,12,0,0.0,12
45767,11845,Kits,15,0,0.0,15
45768,11845,Stuff Packs,16,0,0.0,16
45769,11846,Expansion Packs,13,0,0.0,13
45770,11846,Game Packs,5,2,0.4,3
45771,11846,Kits,9,3,0.3333333333333333,6
45772,11846,Stuff Packs,14,4,0.2857142857142857,10
45773,11847,Expansion Packs,13,0,0.0,13
45774,11847,Game Packs,11,0,0.0,11
45775,11847,Kits,6,0,0.0,6
45776,11847,Stuff Packs,14,0,0.0,14
45777,11848,Expansion Packs,11,0,0.0,11
45778,11848,Game Packs,8,0,0.0,8
45779,11848,Kits,2,0,0.0,2
45780,11848,Stuff Packs,9,3,0.3333333333333333,6
45781,11849,Expansion Packs,12,0,0.0,12
45782,11849,Game Packs,10,0,0.0,10
45783,11849,Kits,2,1,0.5,1
45784,11849,Stuff Packs,13,4,0.3076923076923077,9
45785,11850,Expansion Packs,8,0,0.0,8
45786,11850,Game Packs,4,0,0.0,4
45787,11850,Kits,2,0,0.0,2
45788,11850,Stuff Packs,4,0,0.0,4
45789,11851,Expansion Packs,16,0,0.0,16
45790,11851,Game Packs,12,0,0.0,12
45791,11851,Kits,24,0,0.0,24
45792,11851,Stuff Packs,19,0,0.0,19
45793,11852,Expansion Packs,12,0,0.0,12
45794,11852,Game Packs,6,0,0.0,6
45795,11852,Kits,2,2,1.0,0
45796,11852,Stuff Packs,9,3,0.3333333333333333,6
45797,11853,Expansion Packs,14,0,0.0,14
45798,11853,Game Packs,9,0,0.0,9
45799,11853,Kits,9,2,0.2222222222222222,7
45800,11853,Stuff Packs,11,4,0.36363636363636365,7
45801,11854,Expansion Packs,5,0,0.0,5
45802,11854,Game Packs,3,0,0.0,3
45803,11854,Kits,2,2,1.0,0
45804,11854,Stuff Packs,6,3,0.5,3
45805,11855,Expansion Packs,13,0,0.0,13
45806,11855,Game Packs,7,0,0.0,7
45807,11855,Kits,11,1,0.09090909090909091,10
45808,11855,Stuff Packs,9,3,0.3333333333333333,6
45809,11856,Expansion Packs,16,0,0.0,16
45810,11856,Game Packs,12,0,0.0,12
45811,11856,Kits,33,0,0.0,33
45812,11856,Stuff Packs,20,0,0.0,20
45813,11857,Expansion Packs,16,0,0.0,16
45814,11857,Game Packs,12,0,0.0,12
45815,11857,Kits,33,0,0.0,33
45816,11857,Stuff Packs,20,0,0.0,20
45817,11858,Expansion Packs,7,0,0.0,7
45818,11858,Game Packs,3,0,0.0,3
45819,11858,Kits,1,0,0.0,1
45820,11858,Stuff Packs,5,0,0.0,5
45821,11859,Expansion Packs,16,0,0.0,16
45822,11859,Game Packs,12,0,0.0,12
45823,11859,Kits,33,0,0.0,33
45824,11859,Stuff Packs,20,0,0.0,20
45825,11860,Expansion Packs,16,0,0.0,16
45826,11860,Game Packs,12,0,0.0,12
45827,11860,Kits,28,1,0.03571428571428571,27
45828,11860,Stuff Packs,20,0,0.0,20
45829,11861,Expansion Packs,13,0,0.0,13
45830,11861,Game Packs,4,0,0.0,4
45831,11861,Kits,5,1,0.2,4
45832,11861,Stuff Packs,5,2,0.4,3
45833,11862,Expansion Packs,15,0,0.0,15
45834,11862,Game Packs,12,0,0.0,12
45835,11862,Kits,7,1,0.14285714285714285,6
45836,11862,Stuff Packs,19,2,0.10526315789473684,17
45837,11863,Expansion Packs,7,0,0.0,7
45838,11863,Game Packs,3,0,0.0,3
45839,11863,Kits,9,2,0.2222222222222222,7
45840,11863,Stuff Packs,5,1,0.2,4
45841,11864,Expansion Packs,16,0,0.0,16
45842,11864,Game Packs,12,0,0.0,12
45843,11864,Kits,32,0,0.0,32
45844,11864,Stuff Packs,20,0,0.0,20
45845,11865,Expansion Packs,16,0,0.0,16
45846,11865,Game Packs,12,0,0.0,12
45847,11865,Kits,31,1,0.03225806451612903,30
45848,11865,Stuff Packs,20,0,0.0,20
45849,11866,Expansion Packs,16,0,0.0,16
45850,11866,Game Packs,12,0,0.0,12
45851,11866,Kits,9,0,0.0,9
45852,11866,Stuff Packs,20,0,0.0,20
45853,11867,Expansion Packs,13,0,0.0,13
45854,11867,Game Packs,4,0,0.0,4
45855,11867,Kits,1,0,0.0,1
45856,11867,Stuff Packs,13,2,0.15384615384615385,11
45857,11868,Expansion Packs,15,0,0.0,15
45858,11868,Game Packs,12,0,0.0,12
45859,11868,Kits,31,1,0.03225806451612903,30
45860,11868,Stuff Packs,20,0,0.0,20
45861,11869,Expansion Packs,13,0,0.0,13
45862,11869,Game Packs,10,0,0.0,10
45863,11869,Kits,9,2,0.2222222222222222,7
45864,11869,Stuff Packs,14,1,0.07142857142857142,13
45865,11870,Expansion Packs,16,0,0.0,16
45866,11870,Game Packs,12,0,0.0,12
45867,11870,Kits,19,0,0.0,19
45868,11870,Stuff Packs,16,0,0.0,16
45869,11871,Expansion Packs,16,0,0.0,16
45870,11871,Game Packs,12,0,0.0,12
45871,11871,Kits,33,0,0.0,33
45872,11871,Stuff Packs,20,0,0.0,20
45873,11872,Expansion Packs,16,0,0.0,16
45874,11872,Game Packs,12,0,0.0,12
45875,11872,Kits,33,1,0.030303030303030304,32
45876,11872,Stuff Packs,20,0,0.0,20
45877,11873,Expansion Packs,13,0,0.0,13
45878,11873,Game Packs,8,0,0.0,8
45879,11873,Stuff Packs,14,0,0.0,14
45880,11874,Expansion Packs,7,0,0.0,7
45881,11874,Game Packs,7,0,0.0,7
45882,11874,Kits,3,3,1.0,0
45883,11874,Stuff Packs,7,2,0.2857142857142857,5
45884,11875,Expansion Packs,15,0,0.0,15
45885,11875,Game Packs,6,0,0.0,6
45886,11875,Kits,10,1,0.1,9
45887,11875,Stuff Packs,13,1,0.07692307692307693,12
45888,11876,Expansion Packs,16,0,0.0,16
45889,11876,Game Packs,12,0,0.0,12
45890,11876,Kits,33,0,0.0,33
45891,11876,Stuff Packs,20,0,0.0,20
45892,11877,Expansion Packs,16,0,0.0,16
45893,11877,Game Packs,12,0,0.0,12
45894,11877,Kits,33,0,0.0,33
45895,11877,Stuff Packs,20,0,0.0,20
45896,11878,Expansion Packs,10,4,0.4,6
45897,11878,Game Packs,5,2,0.4,3
45898,11878,Stuff Packs,4,3,0.75,1
45899,11879,Expansion Packs,6,0,0.0,6
45900,11879,Game Packs,4,0,0.0,4
45901,11879,Kits,22,1,0.045454545454545456,21
45902,11879,Stuff Packs,6,0,0.0,6
45903,11880,Expansion Packs,16,0,0.0,16
45904,11880,Game Packs,12,0,0.0,12
45905,11880,Kits,33,0,0.0,33
45906,11880,Stuff Packs,20,0,0.0,20
45907,11881,Game Packs,2,1,0.5,1
45908,11881,Kits,2,0,0.0,2
45909,11881,Stuff Packs,3,2,0.6666666666666666,1
45910,11882,Expansion Packs,15,0,0.0,15
45911,11882,Game Packs,11,0,0.0,11
45912,11882,Kits,14,0,0.0,14
45913,11882,Stuff Packs,18,0,0.0,18
45914,11883,Expansion Packs,10,0,0.0,10
45915,11883,Game Packs,5,1,0.2,4
45916,11883,Kits,2,2,1.0,0
45917,11883,Stuff Packs,7,1,0.14285714285714285,6
45918,11884,Expansion Packs,15,0,0.0,15
45919,11884,Game Packs,8,0,0.0,8
45920,11884,Kits,7,1,0.14285714285714285,6
45921,11884,Stuff Packs,13,3,0.23076923076923078,10
45922,11885,Expansion Packs,16,0,0.0,16
45923,11885,Game Packs,11,0,0.0,11
45924,11885,Kits,26,0,0.0,26
45925,11885,Stuff Packs,20,0,0.0,20
45926,11886,Expansion Packs,11,0,0.0,11
45927,11886,Game Packs,4,1,0.25,3
45928,11886,Kits,2,2,1.0,0
45929,11886,Stuff Packs,6,2,0.3333333333333333,4
45930,11887,Expansion Packs,7,0,0.0,7
45931,11887,Game Packs,1,0,0.0,1
45932,11887,Stuff Packs,2,2,1.0,0
45933,11888,Expansion Packs,14,0,0.0,14
45934,11888,Game Packs,10,0,0.0,10
45935,11888,Kits,10,1,0.1,9
45936,11888,Stuff Packs,10,1,0.1,9
45937,11889,Expansion Packs,5,0,0.0,5
45938,11889,Game Packs,3,0,0.0,3
45939,11889,Kits,2,1,0.5,1
45940,11889,Stuff Packs,3,0,0.0,3
45941,11890,Expansion Packs,8,0,0.0,8
45942,11890,Game Packs,5,0,0.0,5
45943,11890,Kits,3,3,1.0,0
45944,11890,Stuff Packs,8,0,0.0,8
45945,11891,Expansion Packs,6,0,0.0,6
45946,11891,Game Packs,2,1,0.5,1
45947,11891,Kits,3,2,0.6666666666666666,1
45948,11891,Stuff Packs,5,4,0.8,1
45949,11892,Expansion Packs,16,0,0.0,16
45950,11892,Game Packs,6,0,0.0,6
45951,11892,Kits,5,0,0.0,5
45952,11892,Stuff Packs,7,0,0.0,7
45953,11893,Expansion Packs,16,0,0.0,16
45954,11893,Game Packs,12,0,0.0,12
45955,11893,Kits,20,0,0.0,20
45956,11893,Stuff Packs,17,0,0.0,17
45957,11894,Expansion Packs,14,0,0.0,14
45958,11894,Game Packs,8,1,0.125,7
45959,11894,Kits,1,1,1.0,0
45960,11894,Stuff Packs,5,3,0.6,2
45961,11895,Expansion Packs,16,0,0.0,16
45962,11895,Game Packs,12,0,0.0,12
45963,11895,Kits,14,0,0.0,14
45964,11895,Stuff Packs,19,0,0.0,19
45965,11896,Expansion Packs,16,0,0.0,16
45966,11896,Game Packs,12,0,0.0,12
45967,11896,Kits,33,0,0.0,33
45968,11896,Stuff Packs,20,0,0.0,20
45969,11897,Expansion Packs,16,0,0.0,16
45970,11897,Game Packs,11,0,0.0,11
45971,11897,Kits,13,1,0.07692307692307693,12
45972,11897,Stuff Packs,18,0,0.0,18
45973,11898,Expansion Packs,8,0,0.0,8
45974,11898,Game Packs,2,0,0.0,2
45975,11898,Kits,8,0,0.0,8
45976,11898,Stuff Packs,8,3,0.375,5
45977,11899,Expansion Packs,12,0,0.0,12
45978,11899,Game Packs,9,0,0.0,9
45979,11899,Kits,2,2,1.0,0
45980,11899,Stuff Packs,17,1,0.058823529411764705,16
45981,11900,Expansion Packs,16,0,0.0,16
45982,11900,Game Packs,12,0,0.0,12
45983,11900,Kits,10,1,0.1,9
45984,11900,Stuff Packs,20,0,0.0,20
45985,11901,Expansion Packs,15,0,0.0,15
45986,11901,Game Packs,10,0,0.0,10
45987,11901,Kits,13,1,0.07692307692307693,12
45988,11901,Stuff Packs,12,1,0.08333333333333333,11
45989,11902,Expansion Packs,12,0,0.0,12
45990,11902,Game Packs,7,0,0.0,7
45991,11902,Kits,8,0,0.0,8
45992,11902,Stuff Packs,15,0,0.0,15
45993,11903,Expansion Packs,16,0,0.0,16
45994,11903,Game Packs,8,0,0.0,8
45995,11903,Stuff Packs,2,0,0.0,2
45996,11904,Expansion Packs,6,0,0.0,6
45997,11904,Game Packs,4,0,0.0,4
45998,11904,Kits,8,2,0.25,6
45999,11904,Stuff Packs,7,2,0.2857142857142857,5
46000,11905,Expansion Packs,10,0,0.0,10
46001,11905,Game Packs,5,0,0.0,5
46002,11905,Kits,1,1,1.0,0
46003,11905,Stuff Packs,9,2,0.2222222222222222,7
46004,11906,Expansion Packs,16,0,0.0,16
46005,11906,Game Packs,12,0,0.0,12
46006,11906,Kits,33,1,0.030303030303030304,32
46007,11906,Stuff Packs,20,0,0.0,20
46008,11907,Expansion Packs,16,0,0.0,16
46009,11907,Game Packs,10,0,0.0,10
46010,11907,Kits,33,2,0.06060606060606061,31
46011,11907,Stuff Packs,18,3,0.16666666666666666,15
46012,11908,Expansion Packs,14,0,0.0,14
46013,11908,Game Packs,8,0,0.0,8
46014,11908,Kits,9,0,0.0,9
46015,11908,Stuff Packs,14,0,0.0,14
46016,11909,Expansion Packs,15,0,0.0,15
46017,11909,Game Packs,11,0,0.0,11
46018,11909,Kits,14,2,0.14285714285714285,12
46019,11909,Stuff Packs,17,0,0.0,17
46020,11910,Expansion Packs,15,0,0.0,15
46021,11910,Game Packs,9,0,0.0,9
46022,11910,Kits,3,3,1.0,0
46023,11910,Stuff Packs,16,0,0.0,16
46024,11911,Expansion Packs,8,0,0.0,8
46025,11911,Game Packs,5,0,0.0,5
46026,11911,Kits,1,1,1.0,0
46027,11911,Stuff Packs,5,1,0.2,4
46028,11912,Expansion Packs,13,0,0.0,13
46029,11912,Game Packs,9,0,0.0,9
46030,11912,Kits,1,0,0.0,1
46031,11912,Stuff Packs,12,0,0.0,12
46032,11913,Expansion Packs,16,0,0.0,16
46033,11913,Game Packs,12,0,0.0,12
46034,11913,Kits,32,1,0.03125,31
46035,11913,Stuff Packs,20,0,0.0,20
46036,11914,Expansion Packs,16,0,0.0,16
46037,11914,Game Packs,12,0,0.0,12
46038,11914,Kits,31,0,0.0,31
46039,11914,Stuff Packs,20,0,0.0,20
46040,11915,Expansion Packs,10,0,0.0,10
46041,11915,Game Packs,6,1,0.16666666666666666,5
46042,11915,Kits,2,1,0.5,1
46043,11915,Stuff Packs,8,4,0.5,4
46044,11916,Expansion Packs,7,0,0.0,7
46045,11916,Game Packs,7,0,0.0,7
46046,11916,Kits,3,2,0.6666666666666666,1
46047,11916,Stuff Packs,12,1,0.08333333333333333,11
46048,11917,Expansion Packs,15,0,0.0,15
46049,11917,Game Packs,12,0,0.0,12
46050,11917,Kits,12,0,0.0,12
46051,11917,Stuff Packs,13,2,0.15384615384615385,11
46052,11918,Expansion Packs,8,0,0.0,8
46053,11918,Game Packs,4,0,0.0,4
46054,11918,Kits,2,1,0.5,1
46055,11918,Stuff Packs,8,3,0.375,5
46056,11919,Expansion Packs,10,0,0.0,10
46057,11919,Game Packs,5,0,0.0,5
46058,11919,Kits,3,1,0.3333333333333333,2
46059,11919,Stuff Packs,12,3,0.25,9
46060,11920,Expansion Packs,14,0,0.0,14
46061,11920,Game Packs,8,1,0.125,7
46062,11920,Kits,8,2,0.25,6
46063,11920,Stuff Packs,11,3,0.2727272727272727,8
46064,11921,Expansion Packs,16,0,0.0,16
46065,11921,Game Packs,12,0,0.0,12
46066,11921,Kits,18,1,0.05555555555555555,17
46067,11921,Stuff Packs,20,0,0.0,20
46068,11922,Expansion Packs,10,0,0.0,10
46069,11922,Game Packs,4,0,0.0,4
46070,11922,Stuff Packs,5,2,0.4,3
46071,11923,Expansion Packs,16,0,0.0,16
46072,11923,Game Packs,12,0,0.0,12
46073,11923,Kits,33,1,0.030303030303030304,32
46074,11923,Stuff Packs,20,0,0.0,20
46075,11924,Expansion Packs,11,0,0.0,11
46076,11924,Game Packs,4,0,0.0,4
46077,11924,Kits,3,1,0.3333333333333333,2
46078,11924,Stuff Packs,9,1,0.1111111111111111,8
46079,11925,Expansion Packs,2,0,0.0,2
46080,11925,Game Packs,1,0,0.0,1
46081,11925,Kits,1,1,1.0,0
46082,11925,Stuff Packs,5,2,0.4,3
46083,11926,Expansion Packs,7,0,0.0,7
46084,11926,Game Packs,7,0,0.0,7
46085,11926,Kits,1,1,1.0,0
46086,11926,Stuff Packs,9,0,0.0,9
46087,11927,Expansion Packs,14,1,0.07142857142857142,13
46088,11927,Game Packs,9,0,0.0,9
46089,11927,Kits,2,0,0.0,2
46090,11927,Stuff Packs,17,0,0.0,17
46091,11928,Expansion Packs,16,0,0.0,16
46092,11928,Game Packs,12,0,0.0,12
46093,11928,Kits,33,1,0.030303030303030304,32
46094,11928,Stuff Packs,20,0,0.0,20
46095,11929,Expansion Packs,3,0,0.0,3
46096,11930,Expansion Packs,12,0,0.0,12
46097,11930,Game Packs,8,0,0.0,8
46098,11930,Kits,4,3,0.75,1
46099,11930,Stuff Packs,7,1,0.14285714285714285,6
46100,11931,Expansion Packs,12,0,0.0,12
46101,11931,Game Packs,8,0,0.0,8
46102,11931,Kits,2,2,1.0,0
46103,11931,Stuff Packs,11,2,0.18181818181818182,9
46104,11932,Expansion Packs,15,0,0.0,15
46105,11932,Game Packs,11,0,0.0,11
46106,11932,Kits,13,0,0.0,13
46107,11932,Stuff Packs,12,1,0.08333333333333333,11
46108,11933,Expansion Packs,1,0,0.0,1
46109,11933,Kits,2,1,0.5,1
46110,11933,Stuff Packs,2,1,0.5,1
46111,11934,Expansion Packs,16,0,0.0,16
46112,11934,Game Packs,12,0,0.0,12
46113,11934,Kits,9,0,0.0,9
46114,11934,Stuff Packs,20,0,0.0,20
46115,11935,Expansion Packs,16,0,0.0,16
46116,11935,Game Packs,11,0,0.0,11
46117,11935,Kits,16,0,0.0,16
46118,11935,Stuff Packs,20,0,0.0,20
46119,11936,Expansion Packs,14,0,0.0,14
46120,11936,Game Packs,7,0,0.0,7
46121,11936,Kits,3,1,0.3333333333333333,2
46122,11936,Stuff Packs,14,1,0.07142857142857142,13
46123,11937,Expansion Packs,1,0,0.0,1
46124,11937,Kits,1,0,0.0,1
46125,11938,Expansion Packs,16,0,0.0,16
46126,11938,Game Packs,11,0,0.0,11
46127,11938,Kits,3,0,0.0,3
46128,11938,Stuff Packs,14,0,0.0,14
46129,11939,Expansion Packs,9,0,0.0,9
46130,11939,Game Packs,5,1,0.2,4
46131,11939,Kits,6,2,0.3333333333333333,4
46132,11939,Stuff Packs,9,4,0.4444444444444444,5
46133,11940,Expansion Packs,13,0,0.0,13
46134,11940,Game Packs,10,0,0.0,10
46135,11940,Kits,33,2,0.06060606060606061,31
46136,11940,Stuff Packs,20,0,0.0,20
46137,11941,Expansion Packs,8,0,0.0,8
46138,11941,Game Packs,2,0,0.0,2
46139,11941,Kits,4,1,0.25,3
46140,11941,Stuff Packs,6,3,0.5,3
46141,11942,Expansion Packs,5,0,0.0,5
46142,11942,Game Packs,3,0,0.0,3
46143,11942,Kits,2,0,0.0,2
46144,11942,Stuff Packs,6,0,0.0,6
46145,11943,Expansion Packs,16,0,0.0,16
46146,11943,Game Packs,8,0,0.0,8
46147,11943,Kits,3,1,0.3333333333333333,2
46148,11943,Stuff Packs,17,0,0.0,17
46149,11944,Expansion Packs,3,0,0.0,3
46150,11944,Game Packs,3,0,0.0,3
46151,11944,Kits,1,1,1.0,0
46152,11944,Stuff Packs,4,0,0.0,4
46153,11945,Expansion Packs,16,0,0.0,16
46154,11945,Game Packs,12,0,0.0,12
46155,11945,Kits,33,1,0.030303030303030304,32
46156,11945,Stuff Packs,20,1,0.05,19
46157,11946,Expansion Packs,14,0,0.0,14
46158,11946,Game Packs,7,0,0.0,7
46159,11946,Kits,3,2,0.6666666666666666,1
46160,11946,Stuff Packs,13,1,0.07692307692307693,12
46161,11947,Expansion Packs,16,0,0.0,16
46162,11947,Game Packs,11,0,0.0,11
46163,11947,Kits,28,1,0.03571428571428571,27
46164,11947,Stuff Packs,20,0,0.0,20
46165,11948,Expansion Packs,11,0,0.0,11
46166,11948,Game Packs,10,0,0.0,10
46167,11948,Kits,2,2,1.0,0
46168,11948,Stuff Packs,18,0,0.0,18
46169,11949,Expansion Packs,6,0,0.0,6
46170,11949,Game Packs,1,0,0.0,1
46171,11949,Stuff Packs,7,2,0.2857142857142857,5
46172,11950,Expansion Packs,14,0,0.0,14
46173,11950,Game Packs,11,0,0.0,11
46174,11950,Kits,9,0,0.0,9
46175,11950,Stuff Packs,16,0,0.0,16
46176,11951,Expansion Packs,3,0,0.0,3
46177,11951,Game Packs,1,0,0.0,1
46178,11951,Kits,1,1,1.0,0
46179,11951,Stuff Packs,5,3,0.6,2
46180,11952,Expansion Packs,7,0,0.0,7
46181,11952,Game Packs,1,0,0.0,1
46182,11952,Kits,3,1,0.3333333333333333,2
46183,11952,Stuff Packs,4,3,0.75,1
46184,11953,Expansion Packs,4,0,0.0,4
46185,11953,Game Packs,2,0,0.0,2
46186,11953,Kits,2,2,1.0,0
46187,11953,Stuff Packs,5,3,0.6,2
46188,11954,Expansion Packs,14,0,0.0,14
46189,11954,Game Packs,6,1,0.16666666666666666,5
46190,11954,Kits,2,0,0.0,2
46191,11954,Stuff Packs,7,1,0.14285714285714285,6
46192,11955,Expansion Packs,16,0,0.0,16
46193,11955,Game Packs,7,0,0.0,7
46194,11955,Kits,22,0,0.0,22
46195,11955,Stuff Packs,10,2,0.2,8
46196,11956,Expansion Packs,13,0,0.0,13
46197,11956,Game Packs,5,0,0.0,5
46198,11956,Stuff Packs,6,0,0.0,6
46199,11957,Expansion Packs,7,0,0.0,7
46200,11957,Game Packs,5,0,0.0,5
46201,11957,Kits,6,2,0.3333333333333333,4
46202,11957,Stuff Packs,9,3,0.3333333333333333,6
46203,11958,Expansion Packs,11,0,0.0,11
46204,11958,Game Packs,7,0,0.0,7
46205,11958,Kits,2,1,0.5,1
46206,11958,Stuff Packs,6,1,0.16666666666666666,5
46207,11959,Expansion Packs,16,0,0.0,16
46208,11959,Game Packs,12,0,0.0,12
46209,11959,Kits,31,1,0.03225806451612903,30
46210,11959,Stuff Packs,18,0,0.0,18
46211,11960,Expansion Packs,16,0,0.0,16
46212,11960,Game Packs,8,0,0.0,8
46213,11960,Kits,22,1,0.045454545454545456,21
46214,11960,Stuff Packs,18,0,0.0,18
46215,11961,Expansion Packs,15,0,0.0,15
46216,11961,Game Packs,10,1,0.1,9
46217,11961,Kits,2,2,1.0,0
46218,11961,Stuff Packs,12,4,0.3333333333333333,8
46219,11962,Expansion Packs,16,0,0.0,16
46220,11962,Game Packs,8,0,0.0,8
46221,11962,Kits,7,1,0.14285714285714285,6
46222,11962,Stuff Packs,15,0,0.0,15
46223,11963,Expansion Packs,14,0,0.0,14
46224,11963,Game Packs,11,0,0.0,11
46225,11963,Kits,14,0,0.0,14
46226,11963,Stuff Packs,18,0,0.0,18
46227,11964,Expansion Packs,15,0,0.0,15
46228,11964,Game Packs,11,0,0.0,11
46229,11964,Kits,30,1,0.03333333333333333,29
46230,11964,Stuff Packs,20,0,0.0,20
46231,11965,Expansion Packs,16,0,0.0,16
46232,11965,Game Packs,12,0,0.0,12
46233,11965,Kits,33,2,0.06060606060606061,31
46234,11965,Stuff Packs,20,0,0.0,20
46235,11966,Expansion Packs,16,0,0.0,16
46236,11966,Game Packs,12,0,0.0,12
46237,11966,Kits,33,23,0.696969696969697,10
46238,11966,Stuff Packs,20,4,0.2,16
46239,11967,Expansion Packs,16,0,0.0,16
46240,11967,Game Packs,11,0,0.0,11
46241,11967,Kits,11,2,0.18181818181818182,9
46242,11967,Stuff Packs,20,0,0.0,20
46243,11968,Expansion Packs,4,0,0.0,4
46244,11968,Game Packs,3,0,0.0,3
46245,11968,Kits,1,0,0.0,1
46246,11968,Stuff Packs,5,0,0.0,5
46247,11969,Expansion Packs,6,0,0.0,6
46248,11969,Game Packs,2,0,0.0,2
46249,11969,Kits,3,2,0.6666666666666666,1
46250,11969,Stuff Packs,5,3,0.6,2
46251,11970,Expansion Packs,14,0,0.0,14
46252,11970,Game Packs,9,0,0.0,9
46253,11970,Kits,3,1,0.3333333333333333,2
46254,11970,Stuff Packs,16,2,0.125,14
46255,11971,Expansion Packs,16,0,0.0,16
46256,11971,Game Packs,11,3,0.2727272727272727,8
46257,11971,Kits,20,2,0.1,18
46258,11971,Stuff Packs,20,1,0.05,19
46259,11972,Expansion Packs,10,0,0.0,10
46260,11972,Game Packs,1,0,0.0,1
46261,11972,Kits,3,2,0.6666666666666666,1
46262,11972,Stuff Packs,5,0,0.0,5
46263,11973,Expansion Packs,16,0,0.0,16
46264,11973,Game Packs,6,0,0.0,6
46265,11973,Kits,15,2,0.13333333333333333,13
46266,11973,Stuff Packs,12,1,0.08333333333333333,11
46267,11974,Expansion Packs,7,0,0.0,7
46268,11974,Game Packs,5,1,0.2,4
46269,11974,Stuff Packs,3,2,0.6666666666666666,1
46270,11975,Expansion Packs,16,0,0.0,16
46271,11975,Game Packs,12,0,0.0,12
46272,11975,Kits,12,2,0.16666666666666666,10
46273,11975,Stuff Packs,17,0,0.0,17
46274,11976,Expansion Packs,3,0,0.0,3
46275,11976,Stuff Packs,1,0,0.0,1
46276,11977,Expansion Packs,16,0,0.0,16
46277,11977,Game Packs,8,0,0.0,8
46278,11977,Kits,5,1,0.2,4
46279,11977,Stuff Packs,8,0,0.0,8
46280,11978,Expansion Packs,6,0,0.0,6
46281,11978,Game Packs,1,0,0.0,1
46282,11978,Kits,1,1,1.0,0
46283,11978,Stuff Packs,5,2,0.4,3
46284,11979,Expansion Packs,11,0,0.0,11
46285,11979,Game Packs,7,0,0.0,7
46286,11979,Kits,3,1,0.3333333333333333,2
46287,11979,Stuff Packs,5,1,0.2,4
46288,11980,Expansion Packs,6,0,0.0,6
46289,11980,Game Packs,3,0,0.0,3
46290,11980,Stuff Packs,5,3,0.6,2
46291,11981,Expansion Packs,16,0,0.0,16
46292,11981,Game Packs,12,0,0.0,12
46293,11981,Kits,33,1,0.030303030303030304,32
46294,11981,Stuff Packs,20,0,0.0,20
46295,11982,Expansion Packs,10,0,0.0,10
46296,11982,Game Packs,3,0,0.0,3
46297,11982,Kits,5,2,0.4,3
46298,11982,Stuff Packs,5,2,0.4,3
46299,11983,Expansion Packs,8,0,0.0,8
46300,11983,Game Packs,3,0,0.0,3
46301,11983,Kits,5,1,0.2,4
46302,11983,Stuff Packs,5,3,0.6,2
46303,11984,Expansion Packs,7,0,0.0,7
46304,11984,Game Packs,6,0,0.0,6
46305,11984,Kits,14,0,0.0,14
46306,11984,Stuff Packs,8,0,0.0,8
46307,11985,Expansion Packs,7,0,0.0,7
46308,11985,Game Packs,3,0,0.0,3
46309,11985,Kits,8,4,0.5,4
46310,11985,Stuff Packs,17,2,0.11764705882352941,15
46311,11986,Expansion Packs,3,0,0.0,3
46312,11986,Game Packs,2,1,0.5,1
46313,11986,Kits,2,1,0.5,1
46314,11986,Stuff Packs,5,4,0.8,1
46315,11987,Expansion Packs,4,0,0.0,4
46316,11987,Game Packs,2,1,0.5,1
46317,11987,Kits,3,2,0.6666666666666666,1
46318,11987,Stuff Packs,7,5,0.7142857142857143,2
46319,11988,Expansion Packs,14,0,0.0,14
46320,11988,Game Packs,11,0,0.0,11
46321,11988,Kits,15,0,0.0,15
46322,11988,Stuff Packs,18,0,0.0,18
46323,11989,Expansion Packs,16,0,0.0,16
46324,11989,Game Packs,12,0,0.0,12
46325,11989,Kits,8,2,0.25,6
46326,11989,Stuff Packs,20,0,0.0,20
46327,11990,Expansion Packs,16,0,0.0,16
46328,11990,Game Packs,11,0,0.0,11
46329,11990,Kits,16,0,0.0,16
46330,11990,Stuff Packs,17,1,0.058823529411764705,16
46331,11991,Expansion Packs,8,1,0.125,7
46332,11991,Game Packs,3,0,0.0,3
46333,11991,Kits,8,0,0.0,8
46334,11991,Stuff Packs,7,2,0.2857142857142857,5
46335,11992,Expansion Packs,10,0,0.0,10
46336,11992,Game Packs,6,1,0.16666666666666666,5
46337,11992,Kits,5,3,0.6,2
46338,11992,Stuff Packs,10,4,0.4,6
46339,11993,Expansion Packs,14,0,0.0,14
46340,11993,Game Packs,9,0,0.0,9
46341,11993,Kits,2,2,1.0,0
46342,11993,Stuff Packs,15,3,0.2,12
46343,11994,Expansion Packs,16,0,0.0,16
46344,11994,Game Packs,12,0,0.0,12
46345,11994,Kits,33,0,0.0,33
46346,11994,Stuff Packs,20,0,0.0,20
46347,11995,Expansion Packs,15,0,0.0,15
46348,11995,Game Packs,11,0,0.0,11
46349,11995,Kits,3,1,0.3333333333333333,2
46350,11995,Stuff Packs,13,0,0.0,13
46351,11996,Expansion Packs,16,0,0.0,16
46352,11996,Game Packs,12,0,0.0,12
46353,11996,Kits,33,1,0.030303030303030304,32
46354,11996,Stuff Packs,20,0,0.0,20
46355,11997,Expansion Packs,15,0,0.0,15
46356,11997,Game Packs,12,0,0.0,12
46357,11997,Kits,14,0,0.0,14
46358,11997,Stuff Packs,18,0,0.0,18
46359,11998,Expansion Packs,16,0,0.0,16
46360,11998,Game Packs,12,0,0.0,12
46361,11998,Kits,33,0,0.0,33
46362,11998,Stuff Packs,20,0,0.0,20
46363,11999,Expansion Packs,15,0,0.0,15
46364,11999,Game Packs,12,0,0.0,12
46365,11999,Kits,33,2,0.06060606060606061,31
46366,11999,Stuff Packs,20,0,0.0,20
46367,12000,Expansion Packs,6,0,0.0,6
46368,12000,Game Packs,1,0,0.0,1
46369,12000,Stuff Packs,1,0,0.0,1
46370,12001,Expansion Packs,14,2,0.14285714285714285,12
46371,12001,Game Packs,7,1,0.14285714285714285,6
46372,12001,Kits,13,1,0.07692307692307693,12
46373,12001,Stuff Packs,20,0,0.0,20
46374,12002,Expansion Packs,9,0,0.0,9
46375,12002,Game Packs,4,0,0.0,4
46376,12002,Kits,9,0,0.0,9
46377,12002,Stuff Packs,6,2,0.3333333333333333,4
46378,12003,Expansion Packs,12,0,0.0,12
46379,12003,Game Packs,1,0,0.0,1
46380,12003,Kits,2,2,1.0,0
46381,12003,Stuff Packs,2,0,0.0,2
46382,12004,Expansion Packs,12,0,0.0,12
46383,12004,Game Packs,5,1,0.2,4
46384,12004,Kits,12,3,0.25,9
46385,12004,Stuff Packs,14,3,0.21428571428571427,11
46386,12005,Kits,1,1,1.0,0
46387,12005,Stuff Packs,3,3,1.0,0
46388,12006,Expansion Packs,16,0,0.0,16
46389,12006,Game Packs,12,0,0.0,12
46390,12006,Kits,7,0,0.0,7
46391,12006,Stuff Packs,17,0,0.0,17
46392,12007,Expansion Packs,16,0,0.0,16
46393,12007,Game Packs,10,0,0.0,10
46394,12007,Kits,2,2,1.0,0
46395,12007,Stuff Packs,10,0,0.0,10
46396,12008,Expansion Packs,16,0,0.0,16
46397,12008,Game Packs,10,0,0.0,10
46398,12008,Kits,18,1,0.05555555555555555,17
46399,12008,Stuff Packs,16,2,0.125,14
46400,12009,Expansion Packs,16,0,0.0,16
46401,12009,Game Packs,12,0,0.0,12
46402,12009,Kits,33,0,0.0,33
46403,12009,Stuff Packs,20,0,0.0,20
46404,12010,Expansion Packs,15,0,0.0,15
46405,12010,Game Packs,11,0,0.0,11
46406,12010,Kits,8,1,0.125,7
46407,12010,Stuff Packs,16,0,0.0,16
46408,12011,Expansion Packs,6,0,0.0,6
46409,12011,Game Packs,1,0,0.0,1
46410,12012,Expansion Packs,12,0,0.0,12
46411,12012,Game Packs,3,0,0.0,3
46412,12012,Kits,2,1,0.5,1
46413,12012,Stuff Packs,2,0,0.0,2
46414,12013,Expansion Packs,10,0,0.0,10
46415,12013,Game Packs,1,0,0.0,1
46416,12013,Kits,2,0,0.0,2
46417,12013,Stuff Packs,8,3,0.375,5
46418,12014,Expansion Packs,15,0,0.0,15
46419,12014,Game Packs,6,0,0.0,6
46420,12014,Kits,4,1,0.25,3
46421,12014,Stuff Packs,10,4,0.4,6
46422,12015,Expansion Packs,3,0,0.0,3
46423,12015,Game Packs,4,0,0.0,4
46424,12015,Kits,2,2,1.0,0
46425,12015,Stuff Packs,8,4,0.5,4
46426,12016,Expansion Packs,15,0,0.0,15
46427,12016,Game Packs,11,0,0.0,11
46428,12016,Kits,9,0,0.0,9
46429,12016,Stuff Packs,12,0,0.0,12
46430,12017,Expansion Packs,11,0,0.0,11
46431,12017,Game Packs,10,0,0.0,10
46432,12017,Kits,6,3,0.5,3
46433,12017,Stuff Packs,19,0,0.0,19
46434,12018,Expansion Packs,11,0,0.0,11
46435,12018,Game Packs,8,0,0.0,8
46436,12018,Kits,4,2,0.5,2
46437,12018,Stuff Packs,11,0,0.0,11
46438,12019,Expansion Packs,11,0,0.0,11
46439,12019,Game Packs,7,0,0.0,7
46440,12019,Stuff Packs,4,0,0.0,4
46441,12020,Expansion Packs,16,0,0.0,16
46442,12020,Game Packs,10,0,0.0,10
46443,12020,Kits,5,2,0.4,3
46444,12020,Stuff Packs,13,4,0.3076923076923077,9
46445,12021,Expansion Packs,14,0,0.0,14
46446,12021,Game Packs,11,0,0.0,11
46447,12021,Kits,10,0,0.0,10
46448,12021,Stuff Packs,16,0,0.0,16
46449,12022,Expansion Packs,7,0,0.0,7
46450,12022,Game Packs,2,0,0.0,2
46451,12022,Kits,1,1,1.0,0
46452,12022,Stuff Packs,3,3,1.0,0
46453,12023,Expansion Packs,14,0,0.0,14
46454,12023,Game Packs,12,0,0.0,12
46455,12023,Kits,11,2,0.18181818181818182,9
46456,12023,Stuff Packs,18,0,0.0,18
46457,12024,Expansion Packs,4,0,0.0,4
46458,12024,Game Packs,3,0,0.0,3
46459,12024,Kits,1,0,0.0,1
46460,12024,Stuff Packs,8,0,0.0,8
46461,12025,Expansion Packs,9,0,0.0,9
46462,12025,Game Packs,3,0,0.0,3
46463,12025,Kits,4,2,0.5,2
46464,12025,Stuff Packs,7,3,0.42857142857142855,4
46465,12026,Expansion Packs,14,0,0.0,14
46466,12026,Game Packs,10,0,0.0,10
46467,12026,Kits,5,1,0.2,4
46468,12026,Stuff Packs,16,0,0.0,16
46469,12027,Expansion Packs,16,0,0.0,16
46470,12027,Game Packs,12,0,0.0,12
46471,12027,Kits,31,0,0.0,31
46472,12027,Stuff Packs,20,0,0.0,20
46473,12028,Expansion Packs,15,0,0.0,15
46474,12028,Game Packs,7,0,0.0,7
46475,12028,Kits,4,0,0.0,4
46476,12028,Stuff Packs,7,1,0.14285714285714285,6
46477,12029,Expansion Packs,13,0,0.0,13
46478,12029,Game Packs,7,0,0.0,7
46479,12029,Kits,2,0,0.0,2
46480,12029,Stuff Packs,11,0,0.0,11
46481,12030,Expansion Packs,9,0,0.0,9
46482,12030,Game Packs,5,1,0.2,4
46483,12030,Kits,5,2,0.4,3
46484,12030,Stuff Packs,8,3,0.375,5
46485,12031,Expansion Packs,16,0,0.0,16
46486,12031,Game Packs,11,0,0.0,11
46487,12031,Kits,32,0,0.0,32
46488,12031,Stuff Packs,20,0,0.0,20
46489,12032,Expansion Packs,7,0,0.0,7
46490,12032,Game Packs,6,0,0.0,6
46491,12032,Kits,14,0,0.0,14
46492,12032,Stuff Packs,6,0,0.0,6
46493,12033,Expansion Packs,13,0,0.0,13
46494,12033,Game Packs,5,0,0.0,5
46495,12033,Kits,6,1,0.16666666666666666,5
46496,12033,Stuff Packs,16,0,0.0,16
46497,12034,Expansion Packs,8,0,0.0,8
46498,12034,Game Packs,7,0,0.0,7
46499,12034,Kits,14,0,0.0,14
46500,12034,Stuff Packs,13,0,0.0,13
46501,12035,Expansion Packs,16,0,0.0,16
46502,12035,Game Packs,11,0,0.0,11
46503,12035,Kits,27,1,0.037037037037037035,26
46504,12035,Stuff Packs,18,3,0.16666666666666666,15
46505,12036,Expansion Packs,9,0,0.0,9
46506,12036,Game Packs,5,0,0.0,5
46507,12036,Kits,6,1,0.16666666666666666,5
46508,12036,Stuff Packs,9,3,0.3333333333333333,6
46509,12037,Expansion Packs,16,0,0.0,16
46510,12037,Game Packs,12,0,0.0,12
46511,12037,Kits,33,0,0.0,33
46512,12037,Stuff Packs,20,0,0.0,20
46513,12038,Expansion Packs,16,0,0.0,16
46514,12038,Game Packs,12,0,0.0,12
46515,12038,Kits,19,1,0.05263157894736842,18
46516,12038,Stuff Packs,20,0,0.0,20
46517,12039,Expansion Packs,11,0,0.0,11
46518,12039,Game Packs,7,0,0.0,7
46519,12039,Kits,3,3,1.0,0
46520,12039,Stuff Packs,9,3,0.3333333333333333,6
46521,12040,Expansion Packs,7,0,0.0,7
46522,12040,Game Packs,1,0,0.0,1
46523,12040,Kits,3,2,0.6666666666666666,1
46524,12040,Stuff Packs,3,2,0.6666666666666666,1
46525,12041,Expansion Packs,16,1,0.0625,15
46526,12041,Game Packs,12,0,0.0,12
46527,12041,Kits,22,1,0.045454545454545456,21
46528,12041,Stuff Packs,20,0,0.0,20
46529,12042,Expansion Packs,10,0,0.0,10
46530,12042,Game Packs,8,0,0.0,8
46531,12042,Kits,1,1,1.0,0
46532,12042,Stuff Packs,12,2,0.16666666666666666,10
46533,12043,Expansion Packs,13,0,0.0,13
46534,12043,Game Packs,9,0,0.0,9
46535,12043,Kits,11,1,0.09090909090909091,10
46536,12043,Stuff Packs,8,1,0.125,7
46537,12044,Expansion Packs,16,0,0.0,16
46538,12044,Game Packs,8,0,0.0,8
46539,12044,Kits,18,0,0.0,18
46540,12044,Stuff Packs,18,0,0.0,18
46541,12045,Expansion Packs,15,0,0.0,15
46542,12045,Game Packs,10,0,0.0,10
46543,12045,Kits,4,0,0.0,4
46544,12045,Stuff Packs,8,1,0.125,7
46545,12046,Expansion Packs,14,0,0.0,14
46546,12046,Game Packs,9,0,0.0,9
46547,12046,Kits,17,0,0.0,17
46548,12046,Stuff Packs,14,0,0.0,14
46549,12047,Expansion Packs,4,0,0.0,4
46550,12047,Game Packs,1,1,1.0,0
46551,12047,Kits,3,3,1.0,0
46552,12047,Stuff Packs,5,3,0.6,2
46553,12048,Game Packs,1,0,0.0,1
46554,12049,Expansion Packs,14,0,0.0,14
46555,12049,Game Packs,10,0,0.0,10
46556,12049,Kits,2,2,1.0,0
46557,12049,Stuff Packs,20,0,0.0,20
46558,12050,Expansion Packs,7,0,0.0,7
46559,12050,Game Packs,4,0,0.0,4
46560,12050,Kits,3,1,0.3333333333333333,2
46561,12050,Stuff Packs,4,0,0.0,4
46562,12051,Expansion Packs,16,0,0.0,16
46563,12051,Game Packs,11,0,0.0,11
46564,12051,Kits,9,0,0.0,9
46565,12051,Stuff Packs,20,0,0.0,20
46566,12052,Expansion Packs,16,0,0.0,16
46567,12052,Game Packs,10,0,0.0,10
46568,12052,Kits,16,0,0.0,16
46569,12052,Stuff Packs,16,0,0.0,16
46570,12053,Expansion Packs,10,0,0.0,10
46571,12053,Game Packs,5,0,0.0,5
46572,12053,Kits,3,3,1.0,0
46573,12053,Stuff Packs,8,4,0.5,4
46574,12054,Expansion Packs,14,0,0.0,14
46575,12054,Game Packs,6,0,0.0,6
46576,12054,Kits,7,1,0.14285714285714285,6
46577,12054,Stuff Packs,13,1,0.07692307692307693,12
46578,12055,Expansion Packs,15,0,0.0,15
46579,12055,Game Packs,12,0,0.0,12
46580,12055,Kits,23,2,0.08695652173913043,21
46581,12055,Stuff Packs,20,0,0.0,20
46582,12056,Expansion Packs,16,0,0.0,16
46583,12056,Game Packs,12,0,0.0,12
46584,12056,Kits,33,0,0.0,33
46585,12056,Stuff Packs,20,1,0.05,19
46586,12057,Expansion Packs,15,0,0.0,15
46587,12057,Game Packs,11,0,0.0,11
46588,12057,Kits,14,0,0.0,14
46589,12057,Stuff Packs,20,0,0.0,20
46590,12058,Expansion Packs,16,0,0.0,16
46591,12058,Game Packs,12,0,0.0,12
46592,12058,Kits,29,0,0.0,29
46593,12058,Stuff Packs,20,0,0.0,20
46594,12059,Expansion Packs,6,0,0.0,6
46595,12059,Game Packs,3,1,0.3333333333333333,2
46596,12059,Kits,3,3,1.0,0
46597,12059,Stuff Packs,5,4,0.8,1
46598,12060,Expansion Packs,15,0,0.0,15
46599,12060,Game Packs,12,0,0.0,12
46600,12060,Stuff Packs,20,0,0.0,20
46601,12061,Expansion Packs,16,0,0.0,16
46602,12061,Game Packs,12,0,0.0,12
46603,12061,Kits,33,0,0.0,33
46604,12061,Stuff Packs,20,0,0.0,20
46605,12062,Expansion Packs,16,0,0.0,16
46606,12062,Game Packs,12,0,0.0,12
46607,12062,Kits,33,0,0.0,33
46608,12062,Stuff Packs,20,1,0.05,19
46609,12063,Expansion Packs,15,0,0.0,15
46610,12063,Game Packs,12,0,0.0,12
46611,12063,Kits,22,1,0.045454545454545456,21
46612,12063,Stuff Packs,20,0,0.0,20
46613,12064,Expansion Packs,8,0,0.0,8
46614,12064,Game Packs,4,0,0.0,4
46615,12064,Kits,3,1,0.3333333333333333,2
46616,12064,Stuff Packs,8,2,0.25,6
46617,12065,Expansion Packs,8,0,0.0,8
46618,12065,Game Packs,4,0,0.0,4
46619,12065,Kits,4,2,0.5,2
46620,12065,Stuff Packs,7,3,0.42857142857142855,4
46621,12066,Expansion Packs,14,0,0.0,14
46622,12066,Game Packs,10,0,0.0,10
46623,12066,Kits,5,3,0.6,2
46624,12066,Stuff Packs,19,0,0.0,19
46625,12067,Expansion Packs,13,0,0.0,13
46626,12067,Game Packs,3,0,0.0,3
46627,12067,Stuff Packs,2,0,0.0,2
46628,12068,Expansion Packs,13,0,0.0,13
46629,12068,Game Packs,12,0,0.0,12
46630,12068,Kits,10,0,0.0,10
46631,12068,Stuff Packs,19,0,0.0,19
46632,12069,Expansion Packs,16,0,0.0,16
46633,12069,Game Packs,12,0,0.0,12
46634,12069,Kits,14,0,0.0,14
46635,12069,Stuff Packs,20,0,0.0,20
46636,12070,Expansion Packs,7,0,0.0,7
46637,12070,Game Packs,5,0,0.0,5
46638,12070,Kits,3,3,1.0,0
46639,12070,Stuff Packs,7,0,0.0,7
46640,12071,Expansion Packs,15,0,0.0,15
46641,12071,Game Packs,3,0,0.0,3
46642,12071,Kits,9,0,0.0,9
46643,12071,Stuff Packs,8,0,0.0,8
46644,12072,Expansion Packs,16,0,0.0,16
46645,12072,Game Packs,12,0,0.0,12
46646,12072,Kits,9,2,0.2222222222222222,7
46647,12072,Stuff Packs,19,0,0.0,19
46648,12073,Expansion Packs,16,0,0.0,16
46649,12073,Game Packs,12,0,0.0,12
46650,12073,Kits,33,0,0.0,33
46651,12073,Stuff Packs,20,0,0.0,20
46652,12074,Expansion Packs,16,0,0.0,16
46653,12074,Game Packs,12,0,0.0,12
46654,12074,Kits,33,0,0.0,33
46655,12074,Stuff Packs,20,0,0.0,20
46656,12075,Expansion Packs,11,0,0.0,11
46657,12075,Game Packs,7,0,0.0,7
46658,12075,Kits,2,2,1.0,0
46659,12075,Stuff Packs,10,4,0.4,6
46660,12076,Expansion Packs,9,2,0.2222222222222222,7
46661,12076,Game Packs,2,0,0.0,2
46662,12076,Kits,2,0,0.0,2
46663,12076,Stuff Packs,7,3,0.42857142857142855,4
46664,12077,Expansion Packs,16,0,0.0,16
46665,12077,Game Packs,12,0,0.0,12
46666,12077,Kits,1,1,1.0,0
46667,12077,Stuff Packs,19,0,0.0,19
46668,12078,Expansion Packs,16,0,0.0,16
46669,12078,Game Packs,12,0,0.0,12
46670,12078,Kits,15,1,0.06666666666666667,14
46671,12078,Stuff Packs,16,0,0.0,16
46672,12079,Expansion Packs,12,0,0.0,12
46673,12079,Game Packs,6,0,0.0,6
46674,12079,Kits,1,1,1.0,0
46675,12079,Stuff Packs,6,0,0.0,6
46676,12080,Expansion Packs,10,0,0.0,10
46677,12080,Game Packs,6,1,0.16666666666666666,5
46678,12080,Kits,3,3,1.0,0
46679,12080,Stuff Packs,8,2,0.25,6
46680,12081,Expansion Packs,16,0,0.0,16
46681,12081,Game Packs,12,1,0.08333333333333333,11
46682,12081,Kits,31,1,0.03225806451612903,30
46683,12081,Stuff Packs,20,0,0.0,20
46684,12082,Expansion Packs,7,0,0.0,7
46685,12082,Kits,1,0,0.0,1
46686,12082,Stuff Packs,1,0,0.0,1
46687,12083,Expansion Packs,2,0,0.0,2
46688,12083,Kits,1,1,1.0,0
46689,12084,Expansion Packs,15,0,0.0,15
46690,12084,Game Packs,12,0,0.0,12
46691,12084,Kits,24,2,0.08333333333333333,22
46692,12084,Stuff Packs,20,0,0.0,20
46693,12085,Expansion Packs,16,0,0.0,16
46694,12085,Game Packs,12,0,0.0,12
46695,12085,Kits,33,0,0.0,33
46696,12085,Stuff Packs,20,0,0.0,20
46697,12086,Expansion Packs,11,0,0.0,11
46698,12086,Game Packs,3,0,0.0,3
46699,12086,Kits,2,2,1.0,0
46700,12086,Stuff Packs,5,1,0.2,4
46701,12087,Expansion Packs,12,0,0.0,12
46702,12087,Game Packs,6,0,0.0,6
46703,12087,Kits,6,1,0.16666666666666666,5
46704,12087,Stuff Packs,7,2,0.2857142857142857,5
46705,12088,Expansion Packs,14,0,0.0,14
46706,12088,Game Packs,7,0,0.0,7
46707,12088,Kits,6,1,0.16666666666666666,5
46708,12088,Stuff Packs,12,1,0.08333333333333333,11
46709,12089,Expansion Packs,14,0,0.0,14
46710,12089,Game Packs,10,0,0.0,10
46711,12089,Kits,14,0,0.0,14
46712,12089,Stuff Packs,13,0,0.0,13
46713,12090,Expansion Packs,16,0,0.0,16
46714,12090,Game Packs,10,0,0.0,10
46715,12090,Kits,10,1,0.1,9
46716,12090,Stuff Packs,20,0,0.0,20
46717,12091,Expansion Packs,16,0,0.0,16
46718,12091,Game Packs,12,0,0.0,12
46719,12091,Kits,33,1,0.030303030303030304,32
46720,12091,Stuff Packs,20,1,0.05,19
46721,12092,Expansion Packs,11,0,0.0,11
46722,12092,Game Packs,3,0,0.0,3
46723,12092,Kits,2,1,0.5,1
46724,12092,Stuff Packs,2,0,0.0,2
46725,12093,Expansion Packs,16,0,0.0,16
46726,12093,Game Packs,12,0,0.0,12
46727,12093,Kits,33,0,0.0,33
46728,12093,Stuff Packs,20,0,0.0,20
46729,12094,Expansion Packs,16,0,0.0,16
46730,12094,Game Packs,12,0,0.0,12
46731,12094,Kits,33,1,0.030303030303030304,32
46732,12094,Stuff Packs,20,1,0.05,19
46733,12095,Expansion Packs,14,0,0.0,14
46734,12095,Game Packs,11,0,0.0,11
46735,12095,Kits,10,1,0.1,9
46736,12095,Stuff Packs,17,0,0.0,17
46737,12096,Expansion Packs,16,0,0.0,16
46738,12096,Game Packs,11,0,0.0,11
46739,12096,Kits,9,0,0.0,9
46740,12096,Stuff Packs,20,0,0.0,20
46741,12097,Expansion Packs,15,0,0.0,15
46742,12097,Game Packs,10,0,0.0,10
46743,12097,Kits,6,1,0.16666666666666666,5
46744,12097,Stuff Packs,8,0,0.0,8
46745,12098,Expansion Packs,11,0,0.0,11
46746,12098,Game Packs,6,0,0.0,6
46747,12098,Kits,5,2,0.4,3
46748,12098,Stuff Packs,10,4,0.4,6
46749,12099,Expansion Packs,13,0,0.0,13
46750,12099,Game Packs,7,0,0.0,7
46751,12099,Kits,2,0,0.0,2
46752,12099,Stuff Packs,10,0,0.0,10
46753,12100,Expansion Packs,11,0,0.0,11
46754,12100,Game Packs,3,0,0.0,3
46755,12100,Kits,1,1,1.0,0
46756,12100,Stuff Packs,5,2,0.4,3
46757,12101,Expansion Packs,13,2,0.15384615384615385,11
46758,12101,Game Packs,10,1,0.1,9
46759,12101,Kits,8,1,0.125,7
46760,12101,Stuff Packs,12,2,0.16666666666666666,10
46761,12102,Expansion Packs,16,0,0.0,16
46762,12102,Game Packs,12,0,0.0,12
46763,12102,Kits,23,3,0.13043478260869565,20
46764,12102,Stuff Packs,20,0,0.0,20
46765,12103,Expansion Packs,4,0,0.0,4
46766,12103,Game Packs,2,0,0.0,2
46767,12103,Kits,1,1,1.0,0
46768,12103,Stuff Packs,2,0,0.0,2
46769,12104,Expansion Packs,14,0,0.0,14
46770,12104,Game Packs,7,1,0.14285714285714285,6
46771,12104,Kits,3,3,1.0,0
46772,12104,Stuff Packs,7,3,0.42857142857142855,4
46773,12105,Expansion Packs,3,0,0.0,3
46774,12105,Game Packs,3,0,0.0,3
46775,12105,Kits,2,0,0.0,2
46776,12105,Stuff Packs,2,0,0.0,2
46777,12106,Expansion Packs,16,0,0.0,16
46778,12106,Game Packs,11,0,0.0,11
46779,12106,Kits,17,1,0.058823529411764705,16
46780,12106,Stuff Packs,19,0,0.0,19
46781,12107,Expansion Packs,14,0,0.0,14
46782,12107,Game Packs,7,0,0.0,7
46783,12107,Kits,1,0,0.0,1
46784,12107,Stuff Packs,9,3,0.3333333333333333,6
46785,12108,Expansion Packs,11,0,0.0,11
46786,12108,Game Packs,8,0,0.0,8
46787,12108,Stuff Packs,6,1,0.16666666666666666,5
46788,12109,Expansion Packs,16,0,0.0,16
46789,12109,Game Packs,12,1,0.08333333333333333,11
46790,12109,Kits,31,0,0.0,31
46791,12109,Stuff Packs,20,1,0.05,19
46792,12110,Expansion Packs,11,0,0.0,11
46793,12110,Game Packs,4,0,0.0,4
46794,12110,Kits,10,1,0.1,9
46795,12110,Stuff Packs,7,1,0.14285714285714285,6
46796,12111,Expansion Packs,13,0,0.0,13
46797,12111,Game Packs,12,0,0.0,12
46798,12111,Kits,22,0,0.0,22
46799,12111,Stuff Packs,19,0,0.0,19
46800,12112,Expansion Packs,16,0,0.0,16
46801,12112,Game Packs,12,0,0.0,12
46802,12112,Kits,26,0,0.0,26
46803,12112,Stuff Packs,20,0,0.0,20
46804,12113,Expansion Packs,11,0,0.0,11
46805,12113,Game Packs,3,0,0.0,3
46806,12113,Kits,2,1,0.5,1
46807,12113,Stuff Packs,7,0,0.0,7
46808,12114,Expansion Packs,16,0,0.0,16
46809,12114,Game Packs,12,0,0.0,12
46810,12114,Kits,32,1,0.03125,31
46811,12114,Stuff Packs,20,0,0.0,20
46812,12115,Expansion Packs,8,0,0.0,8
46813,12115,Kits,2,2,1.0,0
46814,12115,Stuff Packs,3,0,0.0,3
46815,12116,Expansion Packs,5,0,0.0,5
46816,12116,Game Packs,1,0,0.0,1
46817,12116,Kits,5,0,0.0,5
46818,12116,Stuff Packs,2,0,0.0,2
46819,12117,Expansion Packs,14,0,0.0,14
46820,12117,Game Packs,9,0,0.0,9
46821,12117,Kits,11,0,0.0,11
46822,12117,Stuff Packs,12,0,0.0,12
46823,12118,Expansion Packs,5,0,0.0,5
46824,12118,Game Packs,4,0,0.0,4
46825,12118,Kits,1,1,1.0,0
46826,12118,Stuff Packs,6,2,0.3333333333333333,4
46827,12119,Expansion Packs,16,0,0.0,16
46828,12119,Game Packs,12,0,0.0,12
46829,12119,Kits,11,3,0.2727272727272727,8
46830,12119,Stuff Packs,20,0,0.0,20
46831,12120,Expansion Packs,16,0,0.0,16
46832,12120,Game Packs,12,0,0.0,12
46833,12120,Kits,33,3,0.09090909090909091,30
46834,12120,Stuff Packs,20,0,0.0,20
46835,12121,Expansion Packs,14,0,0.0,14
46836,12121,Game Packs,5,0,0.0,5
46837,12121,Kits,3,1,0.3333333333333333,2
46838,12121,Stuff Packs,14,0,0.0,14
46839,12122,Expansion Packs,16,0,0.0,16
46840,12122,Game Packs,12,2,0.16666666666666666,10
46841,12122,Kits,33,3,0.09090909090909091,30
46842,12122,Stuff Packs,20,0,0.0,20
46843,12123,Expansion Packs,15,0,0.0,15
46844,12123,Game Packs,10,0,0.0,10
46845,12123,Kits,6,2,0.3333333333333333,4
46846,12123,Stuff Packs,16,0,0.0,16
46847,12124,Expansion Packs,14,0,0.0,14
46848,12124,Game Packs,6,0,0.0,6
46849,12124,Kits,6,2,0.3333333333333333,4
46850,12124,Stuff Packs,9,1,0.1111111111111111,8
46851,12125,Expansion Packs,16,0,0.0,16
46852,12125,Game Packs,12,0,0.0,12
46853,12125,Kits,22,1,0.045454545454545456,21
46854,12125,Stuff Packs,20,0,0.0,20
46855,12126,Expansion Packs,9,0,0.0,9
46856,12126,Game Packs,8,0,0.0,8
46857,12126,Kits,2,2,1.0,0
46858,12126,Stuff Packs,10,1,0.1,9
46859,12127,Expansion Packs,16,0,0.0,16
46860,12127,Game Packs,12,0,0.0,12
46861,12127,Kits,27,0,0.0,27
46862,12127,Stuff Packs,20,1,0.05,19
46863,12128,Expansion Packs,12,1,0.08333333333333333,11
46864,12128,Game Packs,4,0,0.0,4
46865,12128,Kits,6,1,0.16666666666666666,5
46866,12128,Stuff Packs,9,1,0.1111111111111111,8
46867,12129,Expansion Packs,16,0,0.0,16
46868,12129,Game Packs,12,0,0.0,12
46869,12129,Kits,33,0,0.0,33
46870,12129,Stuff Packs,20,0,0.0,20
46871,12130,Expansion Packs,2,0,0.0,2
46872,12131,Expansion Packs,5,1,0.2,4
46873,12131,Game Packs,3,0,0.0,3
46874,12131,Kits,2,0,0.0,2
46875,12131,Stuff Packs,5,1,0.2,4
46876,12132,Expansion Packs,14,0,0.0,14
46877,12132,Game Packs,7,0,0.0,7
46878,12132,Kits,5,1,0.2,4
46879,12132,Stuff Packs,6,0,0.0,6
46880,12133,Expansion Packs,15,0,0.0,15
46881,12133,Game Packs,11,0,0.0,11
46882,12133,Kits,1,1,1.0,0
46883,12133,Stuff Packs,16,1,0.0625,15
46884,12134,Expansion Packs,15,0,0.0,15
46885,12134,Game Packs,10,0,0.0,10
46886,12134,Kits,8,2,0.25,6
46887,12134,Stuff Packs,16,1,0.0625,15
46888,12135,Expansion Packs,16,0,0.0,16
46889,12135,Game Packs,11,0,0.0,11
46890,12135,Kits,2,2,1.0,0
46891,12135,Stuff Packs,18,0,0.0,18
46892,12136,Expansion Packs,10,1,0.1,9
46893,12136,Game Packs,3,0,0.0,3
46894,12136,Kits,1,0,0.0,1
46895,12136,Stuff Packs,5,4,0.8,1
46896,12137,Expansion Packs,13,0,0.0,13
46897,12137,Game Packs,8,0,0.0,8
46898,12137,Kits,4,1,0.25,3
46899,12137,Stuff Packs,10,2,0.2,8
46900,12138,Expansion Packs,16,0,0.0,16
46901,12138,Game Packs,12,0,0.0,12
46902,12138,Kits,32,1,0.03125,31
46903,12138,Stuff Packs,20,0,0.0,20
46904,12139,Expansion Packs,14,0,0.0,14
46905,12139,Game Packs,8,0,0.0,8
46906,12139,Kits,3,1,0.3333333333333333,2
46907,12139,Stuff Packs,6,1,0.16666666666666666,5
46908,12140,Expansion Packs,11,0,0.0,11
46909,12140,Game Packs,1,1,1.0,0
46910,12140,Kits,2,2,1.0,0
46911,12140,Stuff Packs,2,2,1.0,0
46912,12141,Expansion Packs,5,0,0.0,5
46913,12141,Game Packs,1,0,0.0,1
46914,12141,Kits,1,1,1.0,0
46915,12141,Stuff Packs,2,1,0.5,1
46916,12142,Expansion Packs,15,0,0.0,15
46917,12142,Game Packs,10,0,0.0,10
46918,12142,Kits,7,1,0.14285714285714285,6
46919,12142,Stuff Packs,16,1,0.0625,15
46920,12143,Expansion Packs,12,0,0.0,12
46921,12143,Game Packs,5,0,0.0,5
46922,12143,Kits,6,0,0.0,6
46923,12143,Stuff Packs,8,2,0.25,6
46924,12144,Expansion Packs,13,0,0.0,13
46925,12144,Game Packs,8,1,0.125,7
46926,12144,Kits,9,2,0.2222222222222222,7
46927,12144,Stuff Packs,10,0,0.0,10
46928,12145,Expansion Packs,16,0,0.0,16
46929,12145,Game Packs,12,0,0.0,12
46930,12145,Kits,33,0,0.0,33
46931,12145,Stuff Packs,20,0,0.0,20
46932,12146,Expansion Packs,2,0,0.0,2
46933,12146,Game Packs,1,0,0.0,1
46934,12146,Kits,1,1,1.0,0
46935,12147,Expansion Packs,15,0,0.0,15
46936,12147,Game Packs,11,0,0.0,11
46937,12147,Kits,14,1,0.07142857142857142,13
46938,12147,Stuff Packs,9,0,0.0,9
46939,12148,Expansion Packs,13,0,0.0,13
46940,12148,Game Packs,12,0,0.0,12
46941,12148,Kits,21,1,0.047619047619047616,20
46942,12148,Stuff Packs,18,0,0.0,18
46943,12149,Expansion Packs,4,2,0.5,2
46944,12149,Game Packs,2,0,0.0,2
46945,12149,Stuff Packs,5,0,0.0,5
46946,12150,Expansion Packs,14,0,0.0,14
46947,12150,Game Packs,10,0,0.0,10
46948,12150,Kits,17,0,0.0,17
46949,12150,Stuff Packs,17,0,0.0,17
46950,12151,Expansion Packs,13,0,0.0,13
46951,12151,Game Packs,8,0,0.0,8
46952,12151,Kits,1,1,1.0,0
46953,12151,Stuff Packs,9,1,0.1111111111111111,8
46954,12152,Expansion Packs,7,0,0.0,7
46955,12152,Game Packs,2,0,0.0,2
46956,12152,Kits,3,1,0.3333333333333333,2
46957,12152,Stuff Packs,3,0,0.0,3
46958,12153,Expansion Packs,12,0,0.0,12
46959,12153,Game Packs,8,1,0.125,7
46960,12153,Kits,3,2,0.6666666666666666,1
46961,12153,Stuff Packs,12,4,0.3333333333333333,8
46962,12154,Expansion Packs,13,0,0.0,13
46963,12154,Game Packs,8,0,0.0,8
46964,12154,Kits,15,3,0.2,12
46965,12154,Stuff Packs,16,1,0.0625,15
46966,12155,Expansion Packs,16,0,0.0,16
46967,12155,Game Packs,12,0,0.0,12
46968,12155,Kits,10,0,0.0,10
46969,12155,Stuff Packs,19,2,0.10526315789473684,17
46970,12156,Expansion Packs,16,0,0.0,16
46971,12156,Game Packs,12,0,0.0,12
46972,12156,Kits,32,2,0.0625,30
46973,12156,Stuff Packs,20,0,0.0,20
46974,12157,Expansion Packs,16,0,0.0,16
46975,12157,Game Packs,12,0,0.0,12
46976,12157,Kits,6,1,0.16666666666666666,5
46977,12157,Stuff Packs,9,0,0.0,9
46978,12158,Expansion Packs,9,0,0.0,9
46979,12158,Game Packs,5,0,0.0,5
46980,12158,Kits,2,2,1.0,0
46981,12158,Stuff Packs,6,3,0.5,3
46982,12159,Expansion Packs,16,0,0.0,16
46983,12159,Game Packs,12,0,0.0,12
46984,12159,Kits,21,1,0.047619047619047616,20
46985,12159,Stuff Packs,20,0,0.0,20
46986,12160,Expansion Packs,16,0,0.0,16
46987,12160,Game Packs,11,0,0.0,11
46988,12160,Kits,23,0,0.0,23
46989,12160,Stuff Packs,13,0,0.0,13
46990,12161,Expansion Packs,7,0,0.0,7
46991,12161,Game Packs,2,1,0.5,1
46992,12161,Kits,1,1,1.0,0
46993,12161,Stuff Packs,10,3,0.3,7
46994,12162,Expansion Packs,12,0,0.0,12
46995,12162,Game Packs,4,0,0.0,4
46996,12162,Kits,4,3,0.75,1
46997,12162,Stuff Packs,4,0,0.0,4
46998,12163,Expansion Packs,16,0,0.0,16
46999,12163,Game Packs,12,0,0.0,12
47000,12163,Kits,33,1,0.030303030303030304,32
47001,12163,Stuff Packs,20,0,0.0,20
47002,12164,Expansion Packs,3,0,0.0,3
47003,12164,Game Packs,1,0,0.0,1
47004,12164,Kits,1,1,1.0,0
47005,12164,Stuff Packs,2,2,1.0,0
47006,12165,Expansion Packs,12,0,0.0,12
47007,12165,Game Packs,3,1,0.3333333333333333,2
47008,12165,Kits,3,3,1.0,0
47009,12165,Stuff Packs,5,4,0.8,1
47010,12166,Expansion Packs,16,0,0.0,16
47011,12166,Game Packs,12,0,0.0,12
47012,12166,Kits,12,2,0.16666666666666666,10
47013,12166,Stuff Packs,20,0,0.0,20
47014,12167,Expansion Packs,15,0,0.0,15
47015,12167,Game Packs,11,0,0.0,11
47016,12167,Kits,11,1,0.09090909090909091,10
47017,12167,Stuff Packs,14,0,0.0,14
47018,12168,Expansion Packs,16,0,0.0,16
47019,12168,Game Packs,12,0,0.0,12
47020,12168,Kits,33,1,0.030303030303030304,32
47021,12168,Stuff Packs,20,2,0.1,18
47022,12169,Expansion Packs,16,0,0.0,16
47023,12169,Game Packs,9,0,0.0,9
47024,12169,Kits,13,1,0.07692307692307693,12
47025,12169,Stuff Packs,19,0,0.0,19
47026,12170,Expansion Packs,11,0,0.0,11
47027,12170,Game Packs,5,0,0.0,5
47028,12170,Kits,1,1,1.0,0
47029,12170,Stuff Packs,3,2,0.6666666666666666,1
47030,12171,Expansion Packs,16,0,0.0,16
47031,12171,Game Packs,12,0,0.0,12
47032,12171,Kits,13,0,0.0,13
47033,12171,Stuff Packs,19,0,0.0,19
47034,12172,Expansion Packs,12,1,0.08333333333333333,11
47035,12172,Game Packs,5,0,0.0,5
47036,12172,Kits,5,1,0.2,4
47037,12172,Stuff Packs,7,2,0.2857142857142857,5
47038,12173,Expansion Packs,16,0,0.0,16
47039,12173,Game Packs,7,0,0.0,7
47040,12173,Kits,2,1,0.5,1
47041,12173,Stuff Packs,11,1,0.09090909090909091,10
47042,12174,Expansion Packs,9,0,0.0,9
47043,12174,Game Packs,3,0,0.0,3
47044,12174,Kits,2,0,0.0,2
47045,12174,Stuff Packs,5,2,0.4,3
47046,12175,Expansion Packs,16,0,0.0,16
47047,12175,Game Packs,12,0,0.0,12
47048,12175,Kits,33,3,0.09090909090909091,30
47049,12175,Stuff Packs,20,0,0.0,20
47050,12176,Expansion Packs,16,0,0.0,16
47051,12176,Game Packs,12,0,0.0,12
47052,12176,Kits,32,2,0.0625,30
47053,12176,Stuff Packs,20,3,0.15,17
47054,12177,Expansion Packs,3,0,0.0,3
47055,12177,Game Packs,3,1,0.3333333333333333,2
47056,12177,Kits,2,2,1.0,0
47057,12177,Stuff Packs,7,4,0.5714285714285714,3
47058,12178,Expansion Packs,16,0,0.0,16
47059,12178,Game Packs,10,0,0.0,10
47060,12178,Kits,19,0,0.0,19
47061,12178,Stuff Packs,14,0,0.0,14
47062,12179,Expansion Packs,12,0,0.0,12
47063,12179,Game Packs,7,0,0.0,7
47064,12179,Kits,3,2,0.6666666666666666,1
47065,12179,Stuff Packs,8,1,0.125,7
47066,12180,Expansion Packs,14,0,0.0,14
47067,12180,Game Packs,10,1,0.1,9
47068,12180,Kits,5,2,0.4,3
47069,12180,Stuff Packs,20,0,0.0,20
47070,12181,Expansion Packs,6,0,0.0,6
47071,12181,Game Packs,3,0,0.0,3
47072,12181,Stuff Packs,7,3,0.42857142857142855,4
47073,12182,Expansion Packs,14,0,0.0,14
47074,12182,Game Packs,11,0,0.0,11
47075,12182,Kits,3,1,0.3333333333333333,2
47076,12182,Stuff Packs,18,0,0.0,18
47077,12183,Expansion Packs,6,0,0.0,6
47078,12183,Game Packs,4,0,0.0,4
47079,12183,Stuff Packs,6,3,0.5,3
47080,12184,Expansion Packs,16,0,0.0,16
47081,12184,Game Packs,12,0,0.0,12
47082,12184,Kits,31,0,0.0,31
47083,12184,Stuff Packs,20,0,0.0,20
47084,12185,Expansion Packs,13,0,0.0,13
47085,12185,Game Packs,4,0,0.0,4
47086,12185,Kits,2,2,1.0,0
47087,12185,Stuff Packs,8,3,0.375,5
47088,12186,Expansion Packs,16,0,0.0,16
47089,12186,Game Packs,11,0,0.0,11
47090,12186,Kits,10,4,0.4,6
47091,12186,Stuff Packs,13,2,0.15384615384615385,11
47092,12187,Expansion Packs,8,0,0.0,8
47093,12187,Game Packs,2,0,0.0,2
47094,12187,Kits,1,1,1.0,0
47095,12187,Stuff Packs,1,0,0.0,1
47096,12188,Expansion Packs,12,0,0.0,12
47097,12188,Game Packs,3,0,0.0,3
47098,12188,Kits,3,0,0.0,3
47099,12188,Stuff Packs,9,2,0.2222222222222222,7
47100,12189,Expansion Packs,4,0,0.0,4
47101,12189,Game Packs,2,0,0.0,2
47102,12189,Kits,1,0,0.0,1
47103,12189,Stuff Packs,5,2,0.4,3
47104,12190,Expansion Packs,9,0,0.0,9
47105,12190,Game Packs,5,0,0.0,5
47106,12190,Kits,2,2,1.0,0
47107,12190,Stuff Packs,14,2,0.14285714285714285,12
47108,12191,Expansion Packs,16,0,0.0,16
47109,12191,Game Packs,12,0,0.0,12
47110,12191,Kits,16,0,0.0,16
47111,12191,Stuff Packs,20,0,0.0,20
47112,12192,Expansion Packs,7,0,0.0,7
47113,12192,Game Packs,3,0,0.0,3
47114,12192,Kits,5,0,0.0,5
47115,12192,Stuff Packs,14,0,0.0,14
47116,12193,Expansion Packs,8,1,0.125,7
47117,12193,Game Packs,2,1,0.5,1
47118,12193,Kits,2,1,0.5,1
47119,12193,Stuff Packs,5,4,0.8,1
47120,12194,Expansion Packs,15,0,0.0,15
47121,12194,Game Packs,11,0,0.0,11
47122,12194,Kits,14,1,0.07142857142857142,13
47123,12194,Stuff Packs,15,0,0.0,15
47124,12195,Expansion Packs,7,0,0.0,7
47125,12195,Game Packs,2,0,0.0,2
47126,12195,Kits,3,0,0.0,3
47127,12195,Stuff Packs,6,1,0.16666666666666666,5
47128,12196,Expansion Packs,16,0,0.0,16
47129,12196,Game Packs,12,0,0.0,12
47130,12196,Kits,33,1,0.030303030303030304,32
47131,12196,Stuff Packs,20,0,0.0,20
47132,12197,Stuff Packs,2,2,1.0,0
47133,12198,Expansion Packs,9,0,0.0,9
47134,12198,Game Packs,9,0,0.0,9
47135,12198,Kits,2,2,1.0,0
47136,12198,Stuff Packs,13,0,0.0,13
47137,12199,Expansion Packs,12,0,0.0,12
47138,12199,Game Packs,6,0,0.0,6
47139,12199,Kits,4,4,1.0,0
47140,12199,Stuff Packs,6,3,0.5,3
47141,12200,Expansion Packs,9,0,0.0,9
47142,12200,Game Packs,2,0,0.0,2
47143,12200,Kits,2,2,1.0,0
47144,12200,Stuff Packs,4,2,0.5,2
47145,12201,Expansion Packs,16,0,0.0,16
47146,12201,Game Packs,12,0,0.0,12
47147,12201,Kits,11,1,0.09090909090909091,10
47148,12201,Stuff Packs,17,0,0.0,17
47149,12202,Expansion Packs,11,0,0.0,11
47150,12202,Game Packs,8,0,0.0,8
47151,12202,Kits,3,0,0.0,3
47152,12202,Stuff Packs,9,0,0.0,9
47153,12203,Expansion Packs,9,0,0.0,9
47154,12203,Game Packs,4,0,0.0,4
47155,12203,Kits,6,2,0.3333333333333333,4
47156,12203,Stuff Packs,9,3,0.3333333333333333,6
47157,12204,Expansion Packs,13,0,0.0,13
47158,12204,Game Packs,8,0,0.0,8
47159,12204,Kits,13,1,0.07692307692307693,12
47160,12204,Stuff Packs,13,1,0.07692307692307693,12
47161,12205,Expansion Packs,3,0,0.0,3
47162,12205,Game Packs,2,0,0.0,2
47163,12205,Kits,1,1,1.0,0
47164,12205,Stuff Packs,2,2,1.0,0
47165,12206,Expansion Packs,16,0,0.0,16
47166,12206,Game Packs,12,0,0.0,12
47167,12206,Kits,1,1,1.0,0
47168,12206,Stuff Packs,12,0,0.0,12
47169,12207,Expansion Packs,13,1,0.07692307692307693,12
47170,12207,Game Packs,9,0,0.0,9
47171,12207,Kits,6,1,0.16666666666666666,5
47172,12207,Stuff Packs,19,1,0.05263157894736842,18
47173,12208,Expansion Packs,12,0,0.0,12
47174,12208,Game Packs,8,2,0.25,6
47175,12208,Kits,4,4,1.0,0
47176,12208,Stuff Packs,16,2,0.125,14
47177,12209,Expansion Packs,14,0,0.0,14
47178,12209,Game Packs,10,0,0.0,10
47179,12209,Kits,5,0,0.0,5
47180,12209,Stuff Packs,18,0,0.0,18
47181,12210,Expansion Packs,15,0,0.0,15
47182,12210,Game Packs,12,0,0.0,12
47183,12210,Kits,7,1,0.14285714285714285,6
47184,12210,Stuff Packs,15,0,0.0,15
47185,12211,Expansion Packs,7,0,0.0,7
47186,12211,Game Packs,3,0,0.0,3
47187,12211,Kits,1,0,0.0,1
47188,12211,Stuff Packs,5,2,0.4,3
47189,12212,Expansion Packs,5,0,0.0,5
47190,12212,Game Packs,1,1,1.0,0
47191,12212,Kits,3,3,1.0,0
47192,12212,Stuff Packs,4,3,0.75,1
47193,12213,Expansion Packs,16,0,0.0,16
47194,12213,Game Packs,12,0,0.0,12
47195,12213,Kits,33,1,0.030303030303030304,32
47196,12213,Stuff Packs,20,3,0.15,17
47197,12214,Expansion Packs,16,0,0.0,16
47198,12214,Game Packs,10,0,0.0,10
47199,12214,Kits,11,0,0.0,11
47200,12214,Stuff Packs,18,0,0.0,18
47201,12215,Expansion Packs,16,0,0.0,16
47202,12215,Game Packs,11,0,0.0,11
47203,12215,Kits,9,0,0.0,9
47204,12215,Stuff Packs,19,0,0.0,19
47205,12216,Expansion Packs,12,0,0.0,12
47206,12216,Game Packs,10,0,0.0,10
47207,12216,Kits,8,3,0.375,5
47208,12216,Stuff Packs,19,5,0.2631578947368421,14
47209,12217,Expansion Packs,13,0,0.0,13
47210,12217,Game Packs,11,0,0.0,11
47211,12217,Kits,6,1,0.16666666666666666,5
47212,12217,Stuff Packs,16,3,0.1875,13
47213,12218,Expansion Packs,10,5,0.5,5
47214,12218,Game Packs,3,1,0.3333333333333333,2
47215,12218,Kits,5,3,0.6,2
47216,12218,Stuff Packs,2,1,0.5,1
47217,12219,Expansion Packs,7,0,0.0,7
47218,12219,Game Packs,3,0,0.0,3
47219,12219,Kits,10,1,0.1,9
47220,12219,Stuff Packs,5,0,0.0,5
47221,12220,Expansion Packs,15,0,0.0,15
47222,12220,Game Packs,10,1,0.1,9
47223,12220,Kits,11,1,0.09090909090909091,10
47224,12220,Stuff Packs,18,0,0.0,18
47225,12221,Expansion Packs,16,0,0.0,16
47226,12221,Game Packs,12,0,0.0,12
47227,12221,Kits,17,1,0.058823529411764705,16
47228,12221,Stuff Packs,20,0,0.0,20
47229,12222,Expansion Packs,6,0,0.0,6
47230,12222,Game Packs,2,0,0.0,2
47231,12222,Kits,1,1,1.0,0
47232,12222,Stuff Packs,4,4,1.0,0
47233,12223,Expansion Packs,12,0,0.0,12
47234,12223,Game Packs,8,0,0.0,8
47235,12223,Kits,4,2,0.5,2
47236,12223,Stuff Packs,12,3,0.25,9
47237,12224,Expansion Packs,16,0,0.0,16
47238,12224,Game Packs,12,0,0.0,12
47239,12224,Kits,28,1,0.03571428571428571,27
47240,12224,Stuff Packs,20,0,0.0,20
47241,12225,Expansion Packs,16,0,0.0,16
47242,12225,Game Packs,12,0,0.0,12
47243,12225,Kits,33,0,0.0,33
47244,12225,Stuff Packs,20,0,0.0,20
47245,12226,Expansion Packs,16,0,0.0,16
47246,12226,Game Packs,12,0,0.0,12
47247,12226,Kits,7,0,0.0,7
47248,12226,Stuff Packs,15,0,0.0,15
47249,12227,Expansion Packs,15,0,0.0,15
47250,12227,Game Packs,4,0,0.0,4
47251,12227,Stuff Packs,7,4,0.5714285714285714,3
47252,12228,Expansion Packs,15,0,0.0,15
47253,12228,Game Packs,11,0,0.0,11
47254,12228,Kits,6,1,0.16666666666666666,5
47255,12228,Stuff Packs,11,1,0.09090909090909091,10
47256,12229,Expansion Packs,2,0,0.0,2
47257,12229,Game Packs,2,0,0.0,2
47258,12229,Kits,1,1,1.0,0
47259,12229,Stuff Packs,2,2,1.0,0
47260,12230,Game Packs,1,1,1.0,0
47261,12230,Kits,2,1,0.5,1
47262,12230,Stuff Packs,6,5,0.8333333333333334,1
47263,12231,Expansion Packs,16,4,0.25,12
47264,12231,Game Packs,12,1,0.08333333333333333,11
47265,12231,Kits,33,1,0.030303030303030304,32
47266,12231,Stuff Packs,20,0,0.0,20
47267,12232,Expansion Packs,14,0,0.0,14
47268,12232,Game Packs,9,0,0.0,9
47269,12232,Kits,3,0,0.0,3
47270,12232,Stuff Packs,9,3,0.3333333333333333,6
47271,12233,Expansion Packs,6,0,0.0,6
47272,12233,Game Packs,4,0,0.0,4
47273,12233,Kits,2,1,0.5,1
47274,12233,Stuff Packs,5,3,0.6,2
47275,12234,Expansion Packs,11,0,0.0,11
47276,12234,Game Packs,4,1,0.25,3
47277,12234,Kits,4,3,0.75,1
47278,12234,Stuff Packs,7,4,0.5714285714285714,3
47279,12235,Expansion Packs,11,0,0.0,11
47280,12235,Game Packs,5,0,0.0,5
47281,12235,Kits,6,0,0.0,6
47282,12235,Stuff Packs,11,2,0.18181818181818182,9
47283,12236,Expansion Packs,13,0,0.0,13
47284,12236,Game Packs,11,0,0.0,11
47285,12236,Kits,1,0,0.0,1
47286,12236,Stuff Packs,9,0,0.0,9
47287,12237,Expansion Packs,4,1,0.25,3
47288,12237,Game Packs,1,0,0.0,1
47289,12237,Kits,4,0,0.0,4
47290,12237,Stuff Packs,6,3,0.5,3
47291,12238,Expansion Packs,16,0,0.0,16
47292,12238,Game Packs,11,0,0.0,11
47293,12238,Kits,31,0,0.0,31
47294,12238,Stuff Packs,20,0,0.0,20
47295,12239,Expansion Packs,16,0,0.0,16
47296,12239,Game Packs,12,0,0.0,12
47297,12239,Kits,33,1,0.030303030303030304,32
47298,12239,Stuff Packs,20,0,0.0,20
47299,12240,Expansion Packs,15,0,0.0,15
47300,12240,Game Packs,11,0,0.0,11
47301,12240,Kits,26,1,0.038461538461538464,25
47302,12240,Stuff Packs,19,0,0.0,19
47303,12241,Expansion Packs,16,0,0.0,16
47304,12241,Game Packs,12,1,0.08333333333333333,11
47305,12241,Kits,33,2,0.06060606060606061,31
47306,12241,Stuff Packs,20,0,0.0,20
47307,12242,Expansion Packs,16,0,0.0,16
47308,12242,Game Packs,11,0,0.0,11
47309,12242,Kits,11,1,0.09090909090909091,10
47310,12242,Stuff Packs,18,2,0.1111111111111111,16
47311,12243,Expansion Packs,16,0,0.0,16
47312,12243,Game Packs,12,0,0.0,12
47313,12243,Kits,33,1,0.030303030303030304,32
47314,12243,Stuff Packs,20,0,0.0,20
47315,12244,Expansion Packs,6,0,0.0,6
47316,12244,Kits,2,2,1.0,0
47317,12244,Stuff Packs,3,3,1.0,0
47318,12245,Expansion Packs,15,0,0.0,15
47319,12245,Game Packs,9,0,0.0,9
47320,12245,Kits,3,0,0.0,3
47321,12245,Stuff Packs,12,0,0.0,12
47322,12246,Expansion Packs,10,4,0.4,6
47323,12246,Game Packs,7,2,0.2857142857142857,5
47324,12246,Kits,7,3,0.42857142857142855,4
47325,12246,Stuff Packs,8,1,0.125,7
47326,12247,Expansion Packs,16,0,0.0,16
47327,12247,Game Packs,11,0,0.0,11
47328,12247,Kits,3,3,1.0,0
47329,12247,Stuff Packs,17,1,0.058823529411764705,16
47330,12248,Expansion Packs,16,0,0.0,16
47331,12248,Game Packs,11,0,0.0,11
47332,12248,Kits,26,1,0.038461538461538464,25
47333,12248,Stuff Packs,20,0,0.0,20
47334,12249,Expansion Packs,10,0,0.0,10
47335,12249,Game Packs,6,0,0.0,6
47336,12249,Kits,6,0,0.0,6
47337,12249,Stuff Packs,7,3,0.42857142857142855,4
47338,12250,Expansion Packs,13,0,0.0,13
47339,12250,Game Packs,6,0,0.0,6
47340,12250,Kits,11,1,0.09090909090909091,10
47341,12250,Stuff Packs,10,2,0.2,8
47342,12251,Expansion Packs,16,0,0.0,16
47343,12251,Game Packs,11,0,0.0,11
47344,12251,Kits,1,0,0.0,1
47345,12251,Stuff Packs,9,1,0.1111111111111111,8
47346,12252,Expansion Packs,15,0,0.0,15
47347,12252,Game Packs,4,0,0.0,4
47348,12252,Stuff Packs,6,2,0.3333333333333333,4
47349,12253,Expansion Packs,5,0,0.0,5
47350,12253,Game Packs,2,1,0.5,1
47351,12253,Kits,3,2,0.6666666666666666,1
47352,12253,Stuff Packs,5,3,0.6,2
47353,12254,Expansion Packs,8,0,0.0,8
47354,12254,Game Packs,4,0,0.0,4
47355,12254,Kits,3,2,0.6666666666666666,1
47356,12254,Stuff Packs,7,4,0.5714285714285714,3
47357,12255,Expansion Packs,16,0,0.0,16
47358,12255,Game Packs,12,0,0.0,12
47359,12255,Kits,16,1,0.0625,15
47360,12255,Stuff Packs,20,0,0.0,20
47361,12256,Expansion Packs,13,0,0.0,13
47362,12256,Game Packs,5,0,0.0,5
47363,12256,Kits,12,0,0.0,12
47364,12256,Stuff Packs,5,0,0.0,5
47365,12257,Expansion Packs,9,0,0.0,9
47366,12257,Game Packs,4,0,0.0,4
47367,12257,Kits,1,1,1.0,0
47368,12257,Stuff Packs,3,0,0.0,3
47369,12258,Expansion Packs,13,0,0.0,13
47370,12258,Game Packs,4,0,0.0,4
47371,12258,Kits,4,0,0.0,4
47372,12258,Stuff Packs,5,3,0.6,2
47373,12259,Expansion Packs,2,0,0.0,2
47374,12259,Game Packs,1,0,0.0,1
47375,12259,Stuff Packs,1,0,0.0,1
47376,12260,Expansion Packs,2,0,0.0,2
47377,12260,Game Packs,2,1,0.5,1
47378,12260,Kits,3,3,1.0,0
47379,12260,Stuff Packs,4,4,1.0,0
47380,12261,Expansion Packs,13,0,0.0,13
47381,12261,Game Packs,6,0,0.0,6
47382,12261,Stuff Packs,11,2,0.18181818181818182,9
47383,12262,Expansion Packs,4,0,0.0,4
47384,12262,Game Packs,2,0,0.0,2
47385,12262,Stuff Packs,6,2,0.3333333333333333,4
47386,12263,Expansion Packs,11,0,0.0,11
47387,12263,Game Packs,8,0,0.0,8
47388,12263,Kits,3,0,0.0,3
47389,12263,Stuff Packs,11,3,0.2727272727272727,8
47390,12264,Expansion Packs,8,0,0.0,8
47391,12264,Stuff Packs,1,0,0.0,1
47392,12265,Expansion Packs,6,0,0.0,6
47393,12265,Game Packs,1,0,0.0,1
47394,12265,Kits,5,0,0.0,5
47395,12265,Stuff Packs,7,1,0.14285714285714285,6
47396,12266,Expansion Packs,9,0,0.0,9
47397,12266,Game Packs,4,0,0.0,4
47398,12266,Stuff Packs,5,3,0.6,2
47399,12267,Expansion Packs,7,0,0.0,7
47400,12267,Game Packs,3,0,0.0,3
47401,12267,Stuff Packs,6,1,0.16666666666666666,5
47402,12268,Expansion Packs,16,0,0.0,16
47403,12268,Game Packs,12,0,0.0,12
47404,12268,Kits,33,0,0.0,33
47405,12268,Stuff Packs,20,0,0.0,20
47406,12269,Expansion Packs,15,0,0.0,15
47407,12269,Game Packs,10,0,0.0,10
47408,12269,Kits,3,1,0.3333333333333333,2
47409,12269,Stuff Packs,19,0,0.0,19
47410,12270,Expansion Packs,16,0,0.0,16
47411,12270,Game Packs,11,0,0.0,11
47412,12270,Kits,7,1,0.14285714285714285,6
47413,12270,Stuff Packs,19,0,0.0,19
47414,12271,Expansion Packs,10,0,0.0,10
47415,12271,Game Packs,6,0,0.0,6
47416,12271,Kits,7,0,0.0,7
47417,12271,Stuff Packs,10,1,0.1,9
47418,12272,Expansion Packs,16,0,0.0,16
47419,12272,Game Packs,11,0,0.0,11
47420,12272,Kits,12,0,0.0,12
47421,12272,Stuff Packs,17,0,0.0,17
47422,12273,Expansion Packs,7,0,0.0,7
47423,12273,Game Packs,3,0,0.0,3
47424,12273,Kits,3,1,0.3333333333333333,2
47425,12273,Stuff Packs,7,0,0.0,7
47426,12274,Expansion Packs,7,1,0.14285714285714285,6
47427,12274,Game Packs,2,0,0.0,2
47428,12274,Kits,1,1,1.0,0
47429,12274,Stuff Packs,2,0,0.0,2
47430,12275,Expansion Packs,15,0,0.0,15
47431,12275,Game Packs,9,0,0.0,9
47432,12275,Kits,9,0,0.0,9
47433,12275,Stuff Packs,18,0,0.0,18
47434,12276,Expansion Packs,14,0,0.0,14
47435,12276,Game Packs,5,0,0.0,5
47436,12276,Stuff Packs,2,0,0.0,2
47437,12277,Expansion Packs,13,0,0.0,13
47438,12277,Game Packs,9,0,0.0,9
47439,12277,Kits,6,2,0.3333333333333333,4
47440,12277,Stuff Packs,20,0,0.0,20
47441,12278,Expansion Packs,15,0,0.0,15
47442,12278,Game Packs,9,0,0.0,9
47443,12278,Kits,3,1,0.3333333333333333,2
47444,12278,Stuff Packs,9,3,0.3333333333333333,6
47445,12279,Expansion Packs,9,0,0.0,9
47446,12279,Game Packs,7,0,0.0,7
47447,12279,Kits,4,2,0.5,2
47448,12279,Stuff Packs,14,3,0.21428571428571427,11
47449,12280,Expansion Packs,9,0,0.0,9
47450,12280,Game Packs,5,0,0.0,5
47451,12280,Kits,1,1,1.0,0
47452,12280,Stuff Packs,7,3,0.42857142857142855,4
47453,12281,Expansion Packs,9,0,0.0,9
47454,12281,Game Packs,3,0,0.0,3
47455,12281,Kits,9,1,0.1111111111111111,8
47456,12281,Stuff Packs,11,2,0.18181818181818182,9
47457,12282,Expansion Packs,8,0,0.0,8
47458,12282,Game Packs,7,0,0.0,7
47459,12282,Stuff Packs,14,0,0.0,14
47460,12283,Expansion Packs,15,0,0.0,15
47461,12283,Game Packs,11,0,0.0,11
47462,12283,Kits,15,1,0.06666666666666667,14
47463,12283,Stuff Packs,20,0,0.0,20
47464,12284,Expansion Packs,1,0,0.0,1
47465,12284,Game Packs,1,0,0.0,1
47466,12284,Kits,1,0,0.0,1
47467,12284,Stuff Packs,3,2,0.6666666666666666,1
47468,12285,Expansion Packs,16,0,0.0,16
47469,12285,Game Packs,12,0,0.0,12
47470,12285,Kits,33,0,0.0,33
47471,12285,Stuff Packs,20,0,0.0,20
47472,12286,Expansion Packs,14,5,0.35714285714285715,9
47473,12286,Game Packs,10,3,0.3,7
47474,12286,Kits,4,3,0.75,1
47475,12286,Stuff Packs,13,6,0.46153846153846156,7
47476,12287,Expansion Packs,10,0,0.0,10
47477,12287,Game Packs,5,0,0.0,5
47478,12287,Kits,5,1,0.2,4
47479,12287,Stuff Packs,12,1,0.08333333333333333,11
47480,12288,Expansion Packs,11,0,0.0,11
47481,12288,Game Packs,1,0,0.0,1
47482,12288,Stuff Packs,1,0,0.0,1
47483,12289,Expansion Packs,16,0,0.0,16
47484,12289,Game Packs,12,0,0.0,12
47485,12289,Kits,33,0,0.0,33
47486,12289,Stuff Packs,20,0,0.0,20
47487,12290,Expansion Packs,16,0,0.0,16
47488,12290,Game Packs,12,0,0.0,12
47489,12290,Kits,32,0,0.0,32
47490,12290,Stuff Packs,20,0,0.0,20
47491,12291,Expansion Packs,14,0,0.0,14
47492,12291,Game Packs,8,0,0.0,8
47493,12291,Kits,4,1,0.25,3
47494,12291,Stuff Packs,6,1,0.16666666666666666,5
47495,12292,Expansion Packs,5,0,0.0,5
47496,12292,Game Packs,2,0,0.0,2
47497,12292,Kits,1,0,0.0,1
47498,12292,Stuff Packs,3,0,0.0,3
47499,12293,Expansion Packs,12,0,0.0,12
47500,12293,Game Packs,4,0,0.0,4
47501,12293,Kits,3,2,0.6666666666666666,1
47502,12293,Stuff Packs,6,5,0.8333333333333334,1
47503,12294,Expansion Packs,15,0,0.0,15
47504,12294,Game Packs,11,0,0.0,11
47505,12294,Kits,6,2,0.3333333333333333,4
47506,12294,Stuff Packs,19,1,0.05263157894736842,18
47507,12295,Expansion Packs,15,0,0.0,15
47508,12295,Game Packs,9,0,0.0,9
47509,12295,Kits,11,0,0.0,11
47510,12295,Stuff Packs,14,0,0.0,14
47511,12296,Expansion Packs,15,0,0.0,15
47512,12296,Game Packs,12,0,0.0,12
47513,12296,Kits,13,0,0.0,13
47514,12296,Stuff Packs,20,0,0.0,20
47515,12297,Expansion Packs,13,0,0.0,13
47516,12297,Game Packs,7,1,0.14285714285714285,6
47517,12297,Kits,17,2,0.11764705882352941,15
47518,12297,Stuff Packs,13,4,0.3076923076923077,9
47519,12298,Expansion Packs,16,0,0.0,16
47520,12298,Game Packs,12,0,0.0,12
47521,12298,Kits,10,2,0.2,8
47522,12298,Stuff Packs,18,3,0.16666666666666666,15
47523,12299,Expansion Packs,11,0,0.0,11
47524,12299,Game Packs,7,0,0.0,7
47525,12299,Kits,1,1,1.0,0
47526,12299,Stuff Packs,8,1,0.125,7
47527,12300,Expansion Packs,16,0,0.0,16
47528,12300,Game Packs,11,1,0.09090909090909091,10
47529,12300,Kits,6,0,0.0,6
47530,12300,Stuff Packs,12,2,0.16666666666666666,10
47531,12301,Expansion Packs,16,0,0.0,16
47532,12301,Game Packs,11,0,0.0,11
47533,12301,Kits,20,2,0.1,18
47534,12301,Stuff Packs,20,2,0.1,18
47535,12302,Expansion Packs,15,0,0.0,15
47536,12302,Game Packs,9,0,0.0,9
47537,12302,Kits,7,1,0.14285714285714285,6
47538,12302,Stuff Packs,18,1,0.05555555555555555,17
47539,12303,Expansion Packs,10,0,0.0,10
47540,12303,Game Packs,8,0,0.0,8
47541,12303,Kits,11,0,0.0,11
47542,12303,Stuff Packs,5,0,0.0,5
47543,12304,Expansion Packs,9,0,0.0,9
47544,12304,Game Packs,1,0,0.0,1
47545,12304,Kits,2,1,0.5,1
47546,12304,Stuff Packs,3,2,0.6666666666666666,1
47547,12305,Expansion Packs,9,0,0.0,9
47548,12305,Game Packs,3,0,0.0,3
47549,12305,Kits,2,2,1.0,0
47550,12305,Stuff Packs,7,3,0.42857142857142855,4
47551,12306,Expansion Packs,14,0,0.0,14
47552,12306,Game Packs,6,0,0.0,6
47553,12306,Kits,2,1,0.5,1
47554,12306,Stuff Packs,8,0,0.0,8
47555,12307,Expansion Packs,8,0,0.0,8
47556,12307,Game Packs,4,0,0.0,4
47557,12307,Kits,1,0,0.0,1
47558,12307,Stuff Packs,2,0,0.0,2
47559,12308,Expansion Packs,16,0,0.0,16
47560,12308,Game Packs,12,0,0.0,12
47561,12308,Kits,27,0,0.0,27
47562,12308,Stuff Packs,20,0,0.0,20
47563,12309,Expansion Packs,12,0,0.0,12
47564,12309,Game Packs,5,0,0.0,5
47565,12309,Kits,4,0,0.0,4
47566,12309,Stuff Packs,6,1,0.16666666666666666,5
47567,12310,Expansion Packs,16,0,0.0,16
47568,12310,Game Packs,12,0,0.0,12
47569,12310,Kits,33,1,0.030303030303030304,32
47570,12310,Stuff Packs,20,0,0.0,20
47571,12311,Expansion Packs,16,0,0.0,16
47572,12311,Game Packs,12,0,0.0,12
47573,12311,Kits,33,0,0.0,33
47574,12311,Stuff Packs,20,0,0.0,20
47575,12312,Expansion Packs,16,0,0.0,16
47576,12312,Game Packs,10,0,0.0,10
47577,12312,Kits,4,0,0.0,4
47578,12312,Stuff Packs,13,0,0.0,13
47579,12313,Expansion Packs,15,0,0.0,15
47580,12313,Game Packs,8,0,0.0,8
47581,12313,Kits,5,2,0.4,3
47582,12313,Stuff Packs,8,0,0.0,8
47583,12314,Expansion Packs,15,0,0.0,15
47584,12314,Game Packs,9,0,0.0,9
47585,12314,Kits,8,1,0.125,7
47586,12314,Stuff Packs,17,0,0.0,17
47587,12315,Expansion Packs,9,0,0.0,9
47588,12315,Game Packs,3,0,0.0,3
47589,12315,Kits,4,2,0.5,2
47590,12315,Stuff Packs,8,0,0.0,8
47591,12316,Expansion Packs,14,0,0.0,14
47592,12316,Game Packs,5,0,0.0,5
47593,12316,Kits,2,2,1.0,0
47594,12316,Stuff Packs,5,1,0.2,4
47595,12317,Expansion Packs,16,0,0.0,16
47596,12317,Game Packs,12,0,0.0,12
47597,12317,Kits,33,0,0.0,33
47598,12317,Stuff Packs,20,0,0.0,20
47599,12318,Expansion Packs,9,0,0.0,9
47600,12318,Game Packs,2,0,0.0,2
47601,12318,Stuff Packs,5,1,0.2,4
47602,12319,Expansion Packs,9,0,0.0,9
47603,12319,Game Packs,8,0,0.0,8
47604,12319,Kits,2,2,1.0,0
47605,12319,Stuff Packs,11,1,0.09090909090909091,10
47606,12320,Expansion Packs,16,0,0.0,16
47607,12320,Game Packs,10,1,0.1,9
47608,12320,Kits,21,3,0.14285714285714285,18
47609,12320,Stuff Packs,19,0,0.0,19
47610,12321,Expansion Packs,16,0,0.0,16
47611,12321,Game Packs,12,0,0.0,12
47612,12321,Kits,30,0,0.0,30
47613,12321,Stuff Packs,20,0,0.0,20
47614,12322,Expansion Packs,6,0,0.0,6
47615,12322,Game Packs,4,0,0.0,4
47616,12322,Kits,2,2,1.0,0
47617,12322,Stuff Packs,8,2,0.25,6
47618,12323,Expansion Packs,16,0,0.0,16
47619,12323,Game Packs,12,0,0.0,12
47620,12323,Kits,33,0,0.0,33
47621,12323,Stuff Packs,20,0,0.0,20
47622,12324,Expansion Packs,16,0,0.0,16
47623,12324,Game Packs,12,1,0.08333333333333333,11
47624,12324,Kits,31,5,0.16129032258064516,26
47625,12324,Stuff Packs,20,0,0.0,20
47626,12325,Expansion Packs,14,0,0.0,14
47627,12325,Game Packs,10,0,0.0,10
47628,12325,Kits,1,1,1.0,0
47629,12325,Stuff Packs,18,0,0.0,18
47630,12326,Expansion Packs,14,0,0.0,14
47631,12326,Game Packs,11,0,0.0,11
47632,12326,Kits,4,2,0.5,2
47633,12326,Stuff Packs,19,0,0.0,19
47634,12327,Expansion Packs,16,0,0.0,16
47635,12327,Game Packs,12,0,0.0,12
47636,12327,Kits,33,0,0.0,33
47637,12327,Stuff Packs,20,0,0.0,20
47638,12328,Expansion Packs,16,0,0.0,16
47639,12328,Game Packs,11,1,0.09090909090909091,10
47640,12328,Kits,26,1,0.038461538461538464,25
47641,12328,Stuff Packs,14,0,0.0,14
47642,12329,Expansion Packs,11,2,0.18181818181818182,9
47643,12329,Game Packs,9,3,0.3333333333333333,6
47644,12329,Stuff Packs,4,2,0.5,2
47645,12330,Expansion Packs,15,0,0.0,15
47646,12330,Game Packs,11,0,0.0,11
47647,12330,Kits,2,0,0.0,2
47648,12330,Stuff Packs,20,0,0.0,20
47649,12331,Expansion Packs,14,0,0.0,14
47650,12331,Game Packs,6,0,0.0,6
47651,12331,Kits,5,0,0.0,5
47652,12331,Stuff Packs,10,3,0.3,7
47653,12332,Expansion Packs,13,0,0.0,13
47654,12332,Game Packs,9,0,0.0,9
47655,12332,Kits,2,0,0.0,2
47656,12332,Stuff Packs,13,1,0.07692307692307693,12
47657,12333,Expansion Packs,16,0,0.0,16
47658,12333,Game Packs,12,0,0.0,12
47659,12333,Kits,33,0,0.0,33
47660,12333,Stuff Packs,20,0,0.0,20
47661,12334,Expansion Packs,14,1,0.07142857142857142,13
47662,12334,Game Packs,9,0,0.0,9
47663,12334,Kits,12,2,0.16666666666666666,10
47664,12334,Stuff Packs,13,1,0.07692307692307693,12
47665,12335,Expansion Packs,3,0,0.0,3
47666,12335,Game Packs,3,1,0.3333333333333333,2
47667,12335,Kits,4,4,1.0,0
47668,12335,Stuff Packs,4,3,0.75,1
47669,12336,Expansion Packs,13,0,0.0,13
47670,12336,Game Packs,10,0,0.0,10
47671,12336,Kits,4,0,0.0,4
47672,12336,Stuff Packs,14,0,0.0,14
47673,12337,Expansion Packs,12,0,0.0,12
47674,12337,Game Packs,2,1,0.5,1
47675,12337,Kits,9,1,0.1111111111111111,8
47676,12337,Stuff Packs,9,4,0.4444444444444444,5
47677,12338,Expansion Packs,16,1,0.0625,15
47678,12338,Game Packs,12,0,0.0,12
47679,12338,Kits,33,1,0.030303030303030304,32
47680,12338,Stuff Packs,20,1,0.05,19
47681,12339,Expansion Packs,13,0,0.0,13
47682,12339,Game Packs,8,1,0.125,7
47683,12339,Kits,4,0,0.0,4
47684,12339,Stuff Packs,5,3,0.6,2
47685,12340,Expansion Packs,16,0,0.0,16
47686,12340,Game Packs,9,0,0.0,9
47687,12340,Kits,17,1,0.058823529411764705,16
47688,12340,Stuff Packs,19,2,0.10526315789473684,17
47689,12341,Expansion Packs,16,0,0.0,16
47690,12341,Game Packs,12,0,0.0,12
47691,12341,Kits,27,0,0.0,27
47692,12341,Stuff Packs,20,0,0.0,20
47693,12342,Expansion Packs,16,0,0.0,16
47694,12342,Game Packs,12,0,0.0,12
47695,12342,Kits,33,0,0.0,33
47696,12342,Stuff Packs,20,0,0.0,20
47697,12343,Expansion Packs,15,0,0.0,15
47698,12343,Game Packs,5,0,0.0,5
47699,12343,Stuff Packs,6,0,0.0,6
47700,12344,Expansion Packs,15,0,0.0,15
47701,12344,Game Packs,7,0,0.0,7
47702,12344,Kits,1,0,0.0,1
47703,12344,Stuff Packs,9,0,0.0,9
47704,12345,Expansion Packs,15,0,0.0,15
47705,12345,Game Packs,11,0,0.0,11
47706,12345,Kits,26,0,0.0,26
47707,12345,Stuff Packs,19,0,0.0,19
47708,12346,Expansion Packs,6,0,0.0,6
47709,12346,Game Packs,5,0,0.0,5
47710,12346,Kits,3,0,0.0,3
47711,12346,Stuff Packs,5,0,0.0,5
47712,12347,Expansion Packs,7,0,0.0,7
47713,12347,Game Packs,1,0,0.0,1
47714,12347,Kits,2,2,1.0,0
47715,12347,Stuff Packs,4,1,0.25,3
47716,12348,Expansion Packs,11,0,0.0,11
47717,12348,Game Packs,9,0,0.0,9
47718,12348,Stuff Packs,15,0,0.0,15
47719,12349,Expansion Packs,12,0,0.0,12
47720,12349,Game Packs,8,0,0.0,8
47721,12349,Kits,4,0,0.0,4
47722,12349,Stuff Packs,5,0,0.0,5
47723,12350,Expansion Packs,13,0,0.0,13
47724,12350,Game Packs,9,0,0.0,9
47725,12350,Kits,2,2,1.0,0
47726,12350,Stuff Packs,9,1,0.1111111111111111,8
47727,12351,Expansion Packs,5,0,0.0,5
47728,12351,Game Packs,1,0,0.0,1
47729,12351,Kits,2,1,0.5,1
47730,12351,Stuff Packs,6,3,0.5,3
47731,12352,Expansion Packs,16,0,0.0,16
47732,12352,Game Packs,12,0,0.0,12
47733,12352,Kits,33,0,0.0,33
47734,12352,Stuff Packs,20,0,0.0,20
47735,12353,Expansion Packs,4,0,0.0,4
47736,12353,Stuff Packs,4,3,0.75,1
47737,12354,Expansion Packs,6,0,0.0,6
47738,12354,Game Packs,4,1,0.25,3
47739,12354,Kits,4,2,0.5,2
47740,12354,Stuff Packs,5,3,0.6,2
47741,12355,Expansion Packs,16,0,0.0,16
47742,12355,Game Packs,8,0,0.0,8
47743,12355,Kits,32,0,0.0,32
47744,12355,Stuff Packs,20,0,0.0,20
47745,12356,Expansion Packs,11,0,0.0,11
47746,12356,Game Packs,4,0,0.0,4
47747,12356,Kits,2,1,0.5,1
47748,12356,Stuff Packs,6,3,0.5,3
47749,12357,Expansion Packs,16,0,0.0,16
47750,12357,Game Packs,12,0,0.0,12
47751,12357,Kits,33,0,0.0,33
47752,12357,Stuff Packs,20,0,0.0,20
47753,12358,Expansion Packs,16,0,0.0,16
47754,12358,Game Packs,12,1,0.08333333333333333,11
47755,12358,Kits,22,1,0.045454545454545456,21
47756,12358,Stuff Packs,20,5,0.25,15
47757,12359,Expansion Packs,16,0,0.0,16
47758,12359,Game Packs,12,0,0.0,12
47759,12359,Kits,32,0,0.0,32
47760,12359,Stuff Packs,20,0,0.0,20
47761,12360,Expansion Packs,7,0,0.0,7
47762,12360,Game Packs,5,0,0.0,5
47763,12360,Stuff Packs,5,2,0.4,3
47764,12361,Expansion Packs,3,1,0.3333333333333333,2
47765,12361,Game Packs,3,0,0.0,3
47766,12361,Kits,1,1,1.0,0
47767,12361,Stuff Packs,1,1,1.0,0
47768,12362,Expansion Packs,2,0,0.0,2
47769,12362,Game Packs,1,0,0.0,1
47770,12362,Kits,4,0,0.0,4
47771,12362,Stuff Packs,6,0,0.0,6
47772,12363,Expansion Packs,11,0,0.0,11
47773,12363,Game Packs,6,0,0.0,6
47774,12363,Kits,2,0,0.0,2
47775,12363,Stuff Packs,9,1,0.1111111111111111,8
47776,12364,Expansion Packs,16,0,0.0,16
47777,12364,Game Packs,12,0,0.0,12
47778,12364,Kits,17,0,0.0,17
47779,12364,Stuff Packs,17,0,0.0,17
47780,12365,Expansion Packs,14,0,0.0,14
47781,12365,Game Packs,11,0,0.0,11
47782,12365,Kits,2,0,0.0,2
47783,12365,Stuff Packs,15,0,0.0,15
47784,12366,Expansion Packs,15,0,0.0,15
47785,12366,Game Packs,11,2,0.18181818181818182,9
47786,12366,Kits,13,2,0.15384615384615385,11
47787,12366,Stuff Packs,16,3,0.1875,13
47788,12367,Expansion Packs,9,1,0.1111111111111111,8
47789,12367,Game Packs,4,0,0.0,4
47790,12367,Kits,1,1,1.0,0
47791,12367,Stuff Packs,5,2,0.4,3
47792,12368,Expansion Packs,16,0,0.0,16
47793,12368,Game Packs,12,0,0.0,12
47794,12368,Kits,17,2,0.11764705882352941,15
47795,12368,Stuff Packs,19,1,0.05263157894736842,18
47796,12369,Expansion Packs,15,0,0.0,15
47797,12369,Game Packs,11,0,0.0,11
47798,12369,Kits,21,0,0.0,21
47799,12369,Stuff Packs,19,0,0.0,19
47800,12370,Expansion Packs,16,0,0.0,16
47801,12370,Game Packs,12,0,0.0,12
47802,12370,Kits,33,1,0.030303030303030304,32
47803,12370,Stuff Packs,20,0,0.0,20
47804,12371,Expansion Packs,16,0,0.0,16
47805,12371,Game Packs,12,0,0.0,12
47806,12371,Kits,33,0,0.0,33
47807,12371,Stuff Packs,20,0,0.0,20
47808,12372,Expansion Packs,16,0,0.0,16
47809,12372,Game Packs,9,0,0.0,9
47810,12372,Kits,3,1,0.3333333333333333,2
47811,12372,Stuff Packs,16,1,0.0625,15
47812,12373,Game Packs,1,0,0.0,1
47813,12373,Kits,1,1,1.0,0
47814,12373,Stuff Packs,2,2,1.0,0
47815,12374,Expansion Packs,11,0,0.0,11
47816,12374,Game Packs,8,0,0.0,8
47817,12374,Kits,1,1,1.0,0
47818,12374,Stuff Packs,7,3,0.42857142857142855,4
47819,12375,Expansion Packs,9,0,0.0,9
47820,12375,Game Packs,4,0,0.0,4
47821,12375,Kits,1,1,1.0,0
47822,12375,Stuff Packs,7,1,0.14285714285714285,6
47823,12376,Expansion Packs,12,0,0.0,12
47824,12376,Game Packs,3,0,0.0,3
47825,12376,Kits,1,0,0.0,1
47826,12376,Stuff Packs,9,1,0.1111111111111111,8
47827,12377,Expansion Packs,16,0,0.0,16
47828,12377,Game Packs,12,0,0.0,12
47829,12377,Kits,33,0,0.0,33
47830,12377,Stuff Packs,20,0,0.0,20
47831,12378,Expansion Packs,5,0,0.0,5
47832,12378,Game Packs,3,1,0.3333333333333333,2
47833,12378,Kits,1,1,1.0,0
47834,12378,Stuff Packs,3,0,0.0,3
47835,12379,Expansion Packs,13,0,0.0,13
47836,12379,Game Packs,11,0,0.0,11
47837,12379,Kits,1,0,0.0,1
47838,12379,Stuff Packs,19,0,0.0,19
47839,12380,Expansion Packs,6,0,0.0,6
47840,12380,Kits,2,2,1.0,0
47841,12380,Stuff Packs,5,2,0.4,3
47842,12381,Expansion Packs,16,0,0.0,16
47843,12381,Game Packs,12,0,0.0,12
47844,12381,Kits,30,0,0.0,30
47845,12381,Stuff Packs,20,2,0.1,18
47846,12382,Expansion Packs,13,0,0.0,13
47847,12382,Game Packs,8,0,0.0,8
47848,12382,Kits,2,2,1.0,0
47849,12382,Stuff Packs,14,1,0.07142857142857142,13
47850,12383,Expansion Packs,16,0,0.0,16
47851,12383,Game Packs,11,0,0.0,11
47852,12383,Kits,33,0,0.0,33
47853,12383,Stuff Packs,20,0,0.0,20
47854,12384,Expansion Packs,14,0,0.0,14
47855,12384,Game Packs,8,1,0.125,7
47856,12384,Kits,3,3,1.0,0
47857,12384,Stuff Packs,10,4,0.4,6
47858,12385,Expansion Packs,7,2,0.2857142857142857,5
47859,12385,Game Packs,2,0,0.0,2
47860,12385,Kits,1,0,0.0,1
47861,12385,Stuff Packs,2,0,0.0,2
47862,12386,Expansion Packs,16,0,0.0,16
47863,12386,Game Packs,11,0,0.0,11
47864,12386,Kits,33,0,0.0,33
47865,12386,Stuff Packs,20,0,0.0,20
47866,12387,Expansion Packs,10,1,0.1,9
47867,12387,Game Packs,5,0,0.0,5
47868,12387,Kits,10,0,0.0,10
47869,12387,Stuff Packs,9,1,0.1111111111111111,8
47870,12388,Expansion Packs,16,0,0.0,16
47871,12388,Game Packs,5,0,0.0,5
47872,12388,Kits,9,2,0.2222222222222222,7
47873,12388,Stuff Packs,10,3,0.3,7
47874,12389,Expansion Packs,2,0,0.0,2
47875,12389,Stuff Packs,5,0,0.0,5
47876,12390,Expansion Packs,11,0,0.0,11
47877,12390,Game Packs,3,0,0.0,3
47878,12390,Kits,3,1,0.3333333333333333,2
47879,12390,Stuff Packs,6,2,0.3333333333333333,4
47880,12391,Expansion Packs,15,0,0.0,15
47881,12391,Game Packs,7,0,0.0,7
47882,12391,Kits,1,0,0.0,1
47883,12391,Stuff Packs,8,0,0.0,8
47884,12392,Expansion Packs,5,0,0.0,5
47885,12392,Game Packs,1,0,0.0,1
47886,12392,Kits,1,1,1.0,0
47887,12392,Stuff Packs,2,2,1.0,0
47888,12393,Expansion Packs,16,0,0.0,16
47889,12393,Game Packs,11,0,0.0,11
47890,12393,Kits,25,1,0.04,24
47891,12393,Stuff Packs,19,0,0.0,19
47892,12394,Expansion Packs,11,0,0.0,11
47893,12394,Game Packs,6,0,0.0,6
47894,12394,Kits,3,2,0.6666666666666666,1
47895,12394,Stuff Packs,7,1,0.14285714285714285,6
47896,12395,Expansion Packs,10,1,0.1,9
47897,12395,Game Packs,9,0,0.0,9
47898,12395,Kits,2,0,0.0,2
47899,12395,Stuff Packs,16,1,0.0625,15
47900,12396,Expansion Packs,14,0,0.0,14
47901,12396,Game Packs,10,0,0.0,10
47902,12396,Kits,6,0,0.0,6
47903,12396,Stuff Packs,18,0,0.0,18
47904,12397,Expansion Packs,16,0,0.0,16
47905,12397,Game Packs,12,0,0.0,12
47906,12397,Kits,33,1,0.030303030303030304,32
47907,12397,Stuff Packs,20,0,0.0,20
47908,12398,Expansion Packs,6,0,0.0,6
47909,12398,Stuff Packs,2,0,0.0,2
47910,12399,Expansion Packs,6,0,0.0,6
47911,12399,Game Packs,2,0,0.0,2
47912,12399,Stuff Packs,3,2,0.6666666666666666,1
47913,12400,Expansion Packs,7,0,0.0,7
47914,12400,Game Packs,2,0,0.0,2
47915,12400,Stuff Packs,4,0,0.0,4
47916,12401,Expansion Packs,16,0,0.0,16
47917,12401,Game Packs,12,0,0.0,12
47918,12401,Kits,9,0,0.0,9
47919,12401,Stuff Packs,20,0,0.0,20
47920,12402,Expansion Packs,16,0,0.0,16
47921,12402,Game Packs,9,0,0.0,9
47922,12402,Kits,2,2,1.0,0
47923,12402,Stuff Packs,13,1,0.07692307692307693,12
47924,12403,Expansion Packs,16,0,0.0,16
47925,12403,Game Packs,12,0,0.0,12
47926,12403,Kits,30,2,0.06666666666666667,28
47927,12403,Stuff Packs,20,0,0.0,20
47928,12404,Expansion Packs,15,0,0.0,15
47929,12404,Game Packs,10,0,0.0,10
47930,12404,Kits,13,1,0.07692307692307693,12
47931,12404,Stuff Packs,19,2,0.10526315789473684,17
47932,12405,Expansion Packs,6,0,0.0,6
47933,12405,Game Packs,2,0,0.0,2
47934,12405,Kits,1,0,0.0,1
47935,12405,Stuff Packs,6,0,0.0,6
47936,12406,Expansion Packs,16,0,0.0,16
47937,12406,Game Packs,12,0,0.0,12
47938,12406,Kits,33,0,0.0,33
47939,12406,Stuff Packs,20,0,0.0,20
47940,12407,Expansion Packs,3,0,0.0,3
47941,12407,Game Packs,1,0,0.0,1
47942,12407,Kits,3,3,1.0,0
47943,12407,Stuff Packs,4,4,1.0,0
47944,12408,Expansion Packs,15,0,0.0,15
47945,12408,Game Packs,12,0,0.0,12
47946,12408,Kits,14,1,0.07142857142857142,13
47947,12408,Stuff Packs,18,0,0.0,18
47948,12409,Expansion Packs,4,0,0.0,4
47949,12410,Expansion Packs,14,0,0.0,14
47950,12410,Game Packs,9,0,0.0,9
47951,12410,Kits,9,0,0.0,9
47952,12410,Stuff Packs,12,3,0.25,9
47953,12411,Expansion Packs,14,0,0.0,14
47954,12411,Game Packs,10,0,0.0,10
47955,12411,Kits,9,2,0.2222222222222222,7
47956,12411,Stuff Packs,11,1,0.09090909090909091,10
47957,12412,Expansion Packs,2,0,0.0,2
47958,12412,Game Packs,1,1,1.0,0
47959,12412,Kits,3,3,1.0,0
47960,12412,Stuff Packs,4,4,1.0,0
47961,12413,Expansion Packs,8,0,0.0,8
47962,12413,Game Packs,4,0,0.0,4
47963,12413,Kits,7,0,0.0,7
47964,12413,Stuff Packs,13,0,0.0,13
47965,12414,Expansion Packs,6,0,0.0,6
47966,12414,Game Packs,2,0,0.0,2
47967,12414,Kits,1,0,0.0,1
47968,12414,Stuff Packs,3,1,0.3333333333333333,2
47969,12415,Expansion Packs,16,5,0.3125,11
47970,12415,Game Packs,12,1,0.08333333333333333,11
47971,12415,Kits,33,0,0.0,33
47972,12415,Stuff Packs,20,0,0.0,20
47973,12416,Expansion Packs,15,0,0.0,15
47974,12416,Game Packs,9,0,0.0,9
47975,12416,Kits,15,0,0.0,15
47976,12416,Stuff Packs,12,3,0.25,9
47977,12417,Expansion Packs,6,0,0.0,6
47978,12417,Game Packs,1,0,0.0,1
47979,12417,Kits,1,1,1.0,0
47980,12417,Stuff Packs,3,2,0.6666666666666666,1
47981,12418,Expansion Packs,16,0,0.0,16
47982,12418,Game Packs,12,0,0.0,12
47983,12418,Kits,19,2,0.10526315789473684,17
47984,12418,Stuff Packs,20,0,0.0,20
47985,12419,Expansion Packs,13,0,0.0,13
47986,12419,Game Packs,5,0,0.0,5
47987,12419,Kits,2,0,0.0,2
47988,12419,Stuff Packs,8,3,0.375,5
47989,12420,Expansion Packs,16,0,0.0,16
47990,12420,Game Packs,7,0,0.0,7
47991,12420,Kits,5,0,0.0,5
47992,12420,Stuff Packs,7,1,0.14285714285714285,6
47993,12421,Expansion Packs,4,0,0.0,4
47994,12421,Game Packs,1,0,0.0,1
47995,12421,Kits,1,0,0.0,1
47996,12421,Stuff Packs,5,3,0.6,2
47997,12422,Expansion Packs,3,0,0.0,3
47998,12422,Game Packs,1,0,0.0,1
47999,12422,Kits,1,0,0.0,1
48000,12422,Stuff Packs,3,1,0.3333333333333333,2
48001,12423,Expansion Packs,16,0,0.0,16
48002,12423,Game Packs,12,0,0.0,12
48003,12423,Kits,33,0,0.0,33
48004,12423,Stuff Packs,20,0,0.0,20
48005,12424,Expansion Packs,15,0,0.0,15
48006,12424,Game Packs,11,0,0.0,11
48007,12424,Kits,14,0,0.0,14
48008,12424,Stuff Packs,18,0,0.0,18
48009,12425,Expansion Packs,16,0,0.0,16
48010,12425,Game Packs,11,0,0.0,11
48011,12425,Kits,25,1,0.04,24
48012,12425,Stuff Packs,18,0,0.0,18
48013,12426,Expansion Packs,11,0,0.0,11
48014,12426,Game Packs,5,0,0.0,5
48015,12426,Kits,15,0,0.0,15
48016,12426,Stuff Packs,10,0,0.0,10
48017,12427,Expansion Packs,5,0,0.0,5
48018,12427,Game Packs,2,1,0.5,1
48019,12427,Kits,1,1,1.0,0
48020,12427,Stuff Packs,5,2,0.4,3
48021,12428,Expansion Packs,16,0,0.0,16
48022,12428,Game Packs,10,0,0.0,10
48023,12428,Kits,17,2,0.11764705882352941,15
48024,12428,Stuff Packs,16,3,0.1875,13
48025,12429,Expansion Packs,16,0,0.0,16
48026,12429,Game Packs,5,0,0.0,5
48027,12429,Kits,2,2,1.0,0
48028,12429,Stuff Packs,7,3,0.42857142857142855,4
48029,12430,Expansion Packs,14,0,0.0,14
48030,12430,Game Packs,7,0,0.0,7
48031,12430,Kits,3,2,0.6666666666666666,1
48032,12430,Stuff Packs,13,3,0.23076923076923078,10
48033,12431,Expansion Packs,11,0,0.0,11
48034,12431,Game Packs,6,0,0.0,6
48035,12431,Kits,1,1,1.0,0
48036,12431,Stuff Packs,6,1,0.16666666666666666,5
48037,12432,Expansion Packs,7,0,0.0,7
48038,12432,Game Packs,3,0,0.0,3
48039,12432,Stuff Packs,2,2,1.0,0
48040,12433,Expansion Packs,10,0,0.0,10
48041,12433,Game Packs,5,0,0.0,5
48042,12433,Kits,3,1,0.3333333333333333,2
48043,12433,Stuff Packs,5,0,0.0,5
48044,12434,Expansion Packs,4,3,0.75,1
48045,12434,Stuff Packs,5,4,0.8,1
48046,12435,Expansion Packs,7,0,0.0,7
48047,12435,Game Packs,3,0,0.0,3
48048,12435,Kits,6,0,0.0,6
48049,12435,Stuff Packs,5,3,0.6,2
48050,12436,Expansion Packs,6,0,0.0,6
48051,12436,Game Packs,3,0,0.0,3
48052,12436,Kits,2,2,1.0,0
48053,12436,Stuff Packs,3,2,0.6666666666666666,1
48054,12437,Expansion Packs,16,0,0.0,16
48055,12437,Game Packs,9,2,0.2222222222222222,7
48056,12437,Kits,6,4,0.6666666666666666,2
48057,12437,Stuff Packs,10,3,0.3,7
48058,12438,Expansion Packs,10,0,0.0,10
48059,12438,Game Packs,4,0,0.0,4
48060,12438,Kits,7,0,0.0,7
48061,12438,Stuff Packs,7,2,0.2857142857142857,5
48062,12439,Expansion Packs,4,0,0.0,4
48063,12439,Game Packs,2,0,0.0,2
48064,12439,Kits,4,0,0.0,4
48065,12439,Stuff Packs,5,0,0.0,5
48066,12440,Expansion Packs,6,0,0.0,6
48067,12440,Game Packs,3,0,0.0,3
48068,12440,Kits,7,1,0.14285714285714285,6
48069,12440,Stuff Packs,9,0,0.0,9
48070,12441,Expansion Packs,9,0,0.0,9
48071,12441,Game Packs,3,0,0.0,3
48072,12441,Stuff Packs,1,0,0.0,1
48073,12442,Expansion Packs,16,0,0.0,16
48074,12442,Game Packs,12,0,0.0,12
48075,12442,Kits,31,0,0.0,31
48076,12442,Stuff Packs,20,0,0.0,20
48077,12443,Expansion Packs,11,0,0.0,11
48078,12443,Game Packs,4,0,0.0,4
48079,12443,Kits,5,2,0.4,3
48080,12443,Stuff Packs,11,1,0.09090909090909091,10
48081,12444,Expansion Packs,16,0,0.0,16
48082,12444,Game Packs,12,0,0.0,12
48083,12444,Kits,33,0,0.0,33
48084,12444,Stuff Packs,20,0,0.0,20
48085,12445,Expansion Packs,14,0,0.0,14
48086,12445,Game Packs,10,0,0.0,10
48087,12445,Kits,4,2,0.5,2
48088,12445,Stuff Packs,20,1,0.05,19
48089,12446,Expansion Packs,16,0,0.0,16
48090,12446,Game Packs,10,0,0.0,10
48091,12446,Kits,3,1,0.3333333333333333,2
48092,12446,Stuff Packs,12,3,0.25,9
48093,12447,Expansion Packs,9,0,0.0,9
48094,12447,Game Packs,6,0,0.0,6
48095,12447,Kits,1,0,0.0,1
48096,12447,Stuff Packs,3,0,0.0,3
48097,12448,Expansion Packs,16,0,0.0,16
48098,12448,Game Packs,9,0,0.0,9
48099,12448,Kits,20,1,0.05,19
48100,12448,Stuff Packs,17,1,0.058823529411764705,16
48101,12449,Expansion Packs,15,0,0.0,15
48102,12449,Game Packs,11,2,0.18181818181818182,9
48103,12449,Kits,20,0,0.0,20
48104,12449,Stuff Packs,17,2,0.11764705882352941,15
48105,12450,Expansion Packs,3,0,0.0,3
48106,12450,Stuff Packs,1,0,0.0,1
48107,12451,Expansion Packs,2,0,0.0,2
48108,12451,Game Packs,1,0,0.0,1
48109,12451,Kits,1,0,0.0,1
48110,12451,Stuff Packs,1,0,0.0,1
48111,12452,Expansion Packs,16,0,0.0,16
48112,12452,Game Packs,12,0,0.0,12
48113,12452,Kits,33,1,0.030303030303030304,32
48114,12452,Stuff Packs,20,0,0.0,20
48115,12453,Expansion Packs,6,0,0.0,6
48116,12453,Game Packs,3,0,0.0,3
48117,12453,Kits,3,2,0.6666666666666666,1
48118,12453,Stuff Packs,6,4,0.6666666666666666,2
48119,12454,Expansion Packs,16,1,0.0625,15
48120,12454,Game Packs,12,0,0.0,12
48121,12454,Kits,20,0,0.0,20
48122,12454,Stuff Packs,20,0,0.0,20
48123,12455,Expansion Packs,13,0,0.0,13
48124,12455,Game Packs,6,0,0.0,6
48125,12455,Kits,8,1,0.125,7
48126,12455,Stuff Packs,11,1,0.09090909090909091,10
48127,12456,Expansion Packs,13,0,0.0,13
48128,12456,Game Packs,6,0,0.0,6
48129,12456,Kits,3,1,0.3333333333333333,2
48130,12456,Stuff Packs,15,2,0.13333333333333333,13
48131,12457,Expansion Packs,7,0,0.0,7
48132,12457,Game Packs,5,1,0.2,4
48133,12457,Kits,4,2,0.5,2
48134,12457,Stuff Packs,7,2,0.2857142857142857,5
48135,12458,Expansion Packs,11,0,0.0,11
48136,12458,Game Packs,3,0,0.0,3
48137,12458,Kits,5,2,0.4,3
48138,12458,Stuff Packs,10,4,0.4,6
48139,12459,Expansion Packs,7,0,0.0,7
48140,12459,Kits,2,2,1.0,0
48141,12459,Stuff Packs,3,1,0.3333333333333333,2
48142,12460,Expansion Packs,16,0,0.0,16
48143,12460,Game Packs,12,0,0.0,12
48144,12460,Kits,13,1,0.07692307692307693,12
48145,12460,Stuff Packs,20,0,0.0,20
48146,12461,Expansion Packs,16,0,0.0,16
48147,12461,Game Packs,12,0,0.0,12
48148,12461,Kits,33,0,0.0,33
48149,12461,Stuff Packs,20,1,0.05,19
48150,12462,Expansion Packs,6,0,0.0,6
48151,12462,Game Packs,4,1,0.25,3
48152,12462,Kits,1,1,1.0,0
48153,12462,Stuff Packs,9,5,0.5555555555555556,4
48154,12463,Expansion Packs,2,1,0.5,1
48155,12463,Game Packs,2,1,0.5,1
48156,12463,Stuff Packs,2,0,0.0,2
48157,12464,Expansion Packs,16,0,0.0,16
48158,12464,Game Packs,12,1,0.08333333333333333,11
48159,12464,Kits,33,0,0.0,33
48160,12464,Stuff Packs,20,3,0.15,17
48161,12465,Expansion Packs,13,0,0.0,13
48162,12465,Game Packs,7,0,0.0,7
48163,12465,Kits,4,2,0.5,2
48164,12465,Stuff Packs,12,3,0.25,9
48165,12466,Expansion Packs,5,0,0.0,5
48166,12467,Expansion Packs,16,0,0.0,16
48167,12467,Game Packs,11,0,0.0,11
48168,12467,Kits,31,2,0.06451612903225806,29
48169,12467,Stuff Packs,20,1,0.05,19
48170,12468,Expansion Packs,15,0,0.0,15
48171,12468,Game Packs,11,0,0.0,11
48172,12468,Kits,16,2,0.125,14
48173,12468,Stuff Packs,19,5,0.2631578947368421,14
48174,12469,Expansion Packs,9,0,0.0,9
48175,12469,Game Packs,5,0,0.0,5
48176,12469,Kits,3,2,0.6666666666666666,1
48177,12469,Stuff Packs,9,2,0.2222222222222222,7
48178,12470,Expansion Packs,16,0,0.0,16
48179,12470,Game Packs,9,0,0.0,9
48180,12470,Stuff Packs,13,0,0.0,13
48181,12471,Expansion Packs,14,0,0.0,14
48182,12471,Game Packs,7,0,0.0,7
48183,12471,Kits,8,3,0.375,5
48184,12471,Stuff Packs,15,3,0.2,12
48185,12472,Expansion Packs,9,0,0.0,9
48186,12472,Game Packs,5,0,0.0,5
48187,12472,Kits,3,2,0.6666666666666666,1
48188,12472,Stuff Packs,5,2,0.4,3
48189,12473,Expansion Packs,16,0,0.0,16
48190,12473,Game Packs,12,0,0.0,12
48191,12473,Kits,33,0,0.0,33
48192,12473,Stuff Packs,20,0,0.0,20
48193,12474,Expansion Packs,12,0,0.0,12
48194,12474,Game Packs,5,0,0.0,5
48195,12474,Kits,7,1,0.14285714285714285,6
48196,12474,Stuff Packs,8,2,0.25,6
48197,12475,Expansion Packs,1,0,0.0,1
48198,12475,Game Packs,1,0,0.0,1
48199,12475,Stuff Packs,1,0,0.0,1
48200,12476,Kits,1,0,0.0,1
48201,12476,Stuff Packs,1,0,0.0,1
48202,12477,Expansion Packs,14,0,0.0,14
48203,12477,Game Packs,7,0,0.0,7
48204,12477,Kits,4,0,0.0,4
48205,12477,Stuff Packs,16,0,0.0,16
48206,12478,Expansion Packs,14,1,0.07142857142857142,13
48207,12478,Game Packs,5,0,0.0,5
48208,12478,Kits,1,0,0.0,1
48209,12478,Stuff Packs,9,2,0.2222222222222222,7
48210,12479,Expansion Packs,16,0,0.0,16
48211,12479,Game Packs,12,0,0.0,12
48212,12479,Kits,33,0,0.0,33
48213,12479,Stuff Packs,20,0,0.0,20
48214,12480,Expansion Packs,16,0,0.0,16
48215,12480,Game Packs,11,0,0.0,11
48216,12480,Kits,6,0,0.0,6
48217,12480,Stuff Packs,7,0,0.0,7
48218,12481,Expansion Packs,13,0,0.0,13
48219,12481,Game Packs,7,0,0.0,7
48220,12481,Kits,6,2,0.3333333333333333,4
48221,12481,Stuff Packs,8,4,0.5,4
48222,12482,Expansion Packs,4,0,0.0,4
48223,12482,Game Packs,2,0,0.0,2
48224,12482,Stuff Packs,1,0,0.0,1
48225,12483,Expansion Packs,7,0,0.0,7
48226,12483,Game Packs,2,0,0.0,2
48227,12483,Kits,1,0,0.0,1
48228,12483,Stuff Packs,4,1,0.25,3
48229,12484,Expansion Packs,13,0,0.0,13
48230,12484,Game Packs,8,0,0.0,8
48231,12484,Kits,1,0,0.0,1
48232,12484,Stuff Packs,6,1,0.16666666666666666,5
48233,12485,Expansion Packs,12,0,0.0,12
48234,12485,Game Packs,3,0,0.0,3
48235,12485,Stuff Packs,2,0,0.0,2
48236,12486,Expansion Packs,6,0,0.0,6
48237,12486,Game Packs,1,1,1.0,0
48238,12486,Kits,3,3,1.0,0
48239,12486,Stuff Packs,4,4,1.0,0
48240,12487,Expansion Packs,9,0,0.0,9
48241,12487,Game Packs,2,1,0.5,1
48242,12487,Stuff Packs,4,3,0.75,1
48243,12488,Expansion Packs,6,0,0.0,6
48244,12488,Game Packs,4,0,0.0,4
48245,12488,Stuff Packs,5,2,0.4,3
48246,12489,Expansion Packs,7,0,0.0,7
48247,12489,Game Packs,6,1,0.16666666666666666,5
48248,12489,Kits,4,2,0.5,2
48249,12489,Stuff Packs,7,3,0.42857142857142855,4
48250,12490,Expansion Packs,9,0,0.0,9
48251,12490,Game Packs,5,0,0.0,5
48252,12490,Kits,8,2,0.25,6
48253,12490,Stuff Packs,10,1,0.1,9
48254,12491,Expansion Packs,11,0,0.0,11
48255,12491,Stuff Packs,4,3,0.75,1
48256,12492,Expansion Packs,8,1,0.125,7
48257,12492,Game Packs,2,0,0.0,2
48258,12492,Kits,13,1,0.07692307692307693,12
48259,12492,Stuff Packs,5,0,0.0,5
48260,12493,Expansion Packs,14,0,0.0,14
48261,12493,Game Packs,12,0,0.0,12
48262,12493,Kits,26,0,0.0,26
48263,12493,Stuff Packs,20,0,0.0,20
48264,12494,Expansion Packs,14,0,0.0,14
48265,12494,Game Packs,8,0,0.0,8
48266,12494,Kits,21,0,0.0,21
48267,12494,Stuff Packs,18,2,0.1111111111111111,16
48268,12495,Expansion Packs,10,0,0.0,10
48269,12495,Game Packs,6,0,0.0,6
48270,12495,Kits,8,1,0.125,7
48271,12495,Stuff Packs,8,2,0.25,6
48272,12496,Expansion Packs,15,0,0.0,15
48273,12496,Game Packs,10,0,0.0,10
48274,12496,Kits,6,1,0.16666666666666666,5
48275,12496,Stuff Packs,18,0,0.0,18
48276,12497,Expansion Packs,12,0,0.0,12
48277,12497,Game Packs,4,0,0.0,4
48278,12497,Kits,6,0,0.0,6
48279,12497,Stuff Packs,3,0,0.0,3
48280,12498,Expansion Packs,16,0,0.0,16
48281,12498,Game Packs,12,0,0.0,12
48282,12498,Kits,4,1,0.25,3
48283,12498,Stuff Packs,20,0,0.0,20
48284,12499,Expansion Packs,4,0,0.0,4
48285,12499,Game Packs,1,0,0.0,1
48286,12499,Stuff Packs,2,1,0.5,1
48287,12500,Expansion Packs,16,0,0.0,16
48288,12500,Game Packs,12,0,0.0,12
48289,12500,Kits,33,0,0.0,33
48290,12500,Stuff Packs,20,0,0.0,20
48291,12501,Expansion Packs,5,0,0.0,5
48292,12501,Game Packs,3,0,0.0,3
48293,12501,Kits,3,0,0.0,3
48294,12501,Stuff Packs,8,0,0.0,8
48295,12502,Expansion Packs,15,0,0.0,15
48296,12502,Game Packs,8,0,0.0,8
48297,12502,Kits,4,1,0.25,3
48298,12502,Stuff Packs,14,1,0.07142857142857142,13
48299,12503,Expansion Packs,14,0,0.0,14
48300,12503,Game Packs,10,1,0.1,9
48301,12503,Kits,2,2,1.0,0
48302,12503,Stuff Packs,12,3,0.25,9
48303,12504,Expansion Packs,7,0,0.0,7
48304,12504,Game Packs,3,0,0.0,3
48305,12504,Stuff Packs,5,2,0.4,3
48306,12505,Expansion Packs,16,0,0.0,16
48307,12505,Game Packs,12,0,0.0,12
48308,12505,Kits,33,1,0.030303030303030304,32
48309,12505,Stuff Packs,20,0,0.0,20
48310,12506,Expansion Packs,16,0,0.0,16
48311,12506,Game Packs,12,0,0.0,12
48312,12506,Kits,33,0,0.0,33
48313,12506,Stuff Packs,20,0,0.0,20
48314,12507,Expansion Packs,6,0,0.0,6
48315,12507,Game Packs,5,1,0.2,4
48316,12507,Kits,3,2,0.6666666666666666,1
48317,12507,Stuff Packs,6,4,0.6666666666666666,2
48318,12508,Expansion Packs,13,0,0.0,13
48319,12508,Game Packs,8,0,0.0,8
48320,12508,Kits,3,3,1.0,0
48321,12508,Stuff Packs,15,3,0.2,12
48322,12509,Expansion Packs,16,0,0.0,16
48323,12509,Game Packs,12,0,0.0,12
48324,12509,Kits,22,0,0.0,22
48325,12509,Stuff Packs,20,0,0.0,20
48326,12510,Game Packs,2,1,0.5,1
48327,12510,Stuff Packs,2,0,0.0,2
48328,12511,Expansion Packs,16,0,0.0,16
48329,12511,Game Packs,12,0,0.0,12
48330,12511,Kits,33,0,0.0,33
48331,12511,Stuff Packs,20,0,0.0,20
48332,12512,Expansion Packs,16,0,0.0,16
48333,12512,Game Packs,12,0,0.0,12
48334,12512,Kits,19,1,0.05263157894736842,18
48335,12512,Stuff Packs,20,0,0.0,20
48336,12513,Expansion Packs,6,0,0.0,6
48337,12513,Game Packs,2,0,0.0,2
48338,12513,Kits,1,1,1.0,0
48339,12513,Stuff Packs,4,2,0.5,2
48340,12514,Expansion Packs,16,0,0.0,16
48341,12514,Game Packs,12,0,0.0,12
48342,12514,Kits,19,1,0.05263157894736842,18
48343,12514,Stuff Packs,11,0,0.0,11
48344,12515,Expansion Packs,11,0,0.0,11
48345,12515,Game Packs,3,0,0.0,3
48346,12515,Kits,1,1,1.0,0
48347,12515,Stuff Packs,5,3,0.6,2
48348,12516,Expansion Packs,6,0,0.0,6
48349,12516,Game Packs,5,0,0.0,5
48350,12516,Kits,5,1,0.2,4
48351,12516,Stuff Packs,3,0,0.0,3
48352,12517,Expansion Packs,16,0,0.0,16
48353,12517,Game Packs,12,0,0.0,12
48354,12517,Kits,23,1,0.043478260869565216,22
48355,12517,Stuff Packs,20,0,0.0,20
48356,12518,Expansion Packs,6,0,0.0,6
48357,12518,Game Packs,4,0,0.0,4
48358,12518,Kits,1,0,0.0,1
48359,12518,Stuff Packs,2,0,0.0,2
48360,12519,Expansion Packs,16,0,0.0,16
48361,12519,Game Packs,12,0,0.0,12
48362,12519,Kits,33,1,0.030303030303030304,32
48363,12519,Stuff Packs,20,0,0.0,20
48364,12520,Expansion Packs,11,0,0.0,11
48365,12520,Game Packs,8,0,0.0,8
48366,12520,Stuff Packs,5,2,0.4,3
48367,12521,Expansion Packs,16,0,0.0,16
48368,12521,Game Packs,10,1,0.1,9
48369,12521,Kits,9,3,0.3333333333333333,6
48370,12521,Stuff Packs,15,3,0.2,12
48371,12522,Expansion Packs,9,0,0.0,9
48372,12522,Game Packs,4,0,0.0,4
48373,12522,Kits,2,2,1.0,0
48374,12522,Stuff Packs,6,3,0.5,3
48375,12523,Expansion Packs,15,0,0.0,15
48376,12523,Game Packs,10,0,0.0,10
48377,12523,Kits,3,2,0.6666666666666666,1
48378,12523,Stuff Packs,13,2,0.15384615384615385,11
48379,12524,Expansion Packs,15,0,0.0,15
48380,12524,Game Packs,9,0,0.0,9
48381,12524,Kits,14,0,0.0,14
48382,12524,Stuff Packs,10,4,0.4,6
48383,12525,Expansion Packs,8,0,0.0,8
48384,12525,Game Packs,8,0,0.0,8
48385,12525,Kits,6,0,0.0,6
48386,12525,Stuff Packs,7,0,0.0,7
48387,12526,Expansion Packs,7,0,0.0,7
48388,12526,Game Packs,2,0,0.0,2
48389,12526,Kits,5,0,0.0,5
48390,12526,Stuff Packs,6,0,0.0,6
48391,12527,Expansion Packs,15,0,0.0,15
48392,12527,Game Packs,11,0,0.0,11
48393,12527,Kits,2,2,1.0,0
48394,12527,Stuff Packs,20,0,0.0,20
48395,12528,Expansion Packs,6,2,0.3333333333333333,4
48396,12528,Game Packs,3,1,0.3333333333333333,2
48397,12528,Stuff Packs,6,2,0.3333333333333333,4
48398,12529,Expansion Packs,16,0,0.0,16
48399,12529,Game Packs,6,0,0.0,6
48400,12529,Kits,9,0,0.0,9
48401,12529,Stuff Packs,10,0,0.0,10
48402,12530,Expansion Packs,10,1,0.1,9
48403,12530,Game Packs,4,0,0.0,4
48404,12530,Stuff Packs,6,0,0.0,6
48405,12531,Expansion Packs,16,0,0.0,16
48406,12531,Game Packs,12,0,0.0,12
48407,12531,Kits,26,0,0.0,26
48408,12531,Stuff Packs,20,0,0.0,20
48409,12532,Expansion Packs,16,0,0.0,16
48410,12532,Game Packs,12,0,0.0,12
48411,12532,Kits,24,1,0.041666666666666664,23
48412,12532,Stuff Packs,20,0,0.0,20
48413,12533,Expansion Packs,16,0,0.0,16
48414,12533,Game Packs,12,0,0.0,12
48415,12533,Kits,33,3,0.09090909090909091,30
48416,12533,Stuff Packs,20,1,0.05,19
48417,12534,Expansion Packs,15,0,0.0,15
48418,12534,Game Packs,10,0,0.0,10
48419,12534,Kits,8,1,0.125,7
48420,12534,Stuff Packs,17,1,0.058823529411764705,16
48421,12535,Expansion Packs,16,0,0.0,16
48422,12535,Game Packs,11,0,0.0,11
48423,12535,Kits,7,0,0.0,7
48424,12535,Stuff Packs,14,1,0.07142857142857142,13
48425,12536,Expansion Packs,16,0,0.0,16
48426,12536,Game Packs,12,0,0.0,12
48427,12536,Kits,33,0,0.0,33
48428,12536,Stuff Packs,20,0,0.0,20
48429,12537,Expansion Packs,13,1,0.07692307692307693,12
48430,12537,Game Packs,8,0,0.0,8
48431,12537,Kits,3,0,0.0,3
48432,12537,Stuff Packs,16,0,0.0,16
48433,12538,Expansion Packs,5,0,0.0,5
48434,12538,Game Packs,1,1,1.0,0
48435,12538,Kits,2,0,0.0,2
48436,12538,Stuff Packs,3,1,0.3333333333333333,2
48437,12539,Expansion Packs,13,0,0.0,13
48438,12539,Game Packs,11,0,0.0,11
48439,12539,Kits,8,2,0.25,6
48440,12539,Stuff Packs,11,3,0.2727272727272727,8
48441,12540,Expansion Packs,13,0,0.0,13
48442,12540,Game Packs,7,0,0.0,7
48443,12540,Kits,8,0,0.0,8
48444,12540,Stuff Packs,10,1,0.1,9
48445,12541,Expansion Packs,12,0,0.0,12
48446,12541,Game Packs,6,0,0.0,6
48447,12541,Kits,2,0,0.0,2
48448,12541,Stuff Packs,1,0,0.0,1
48449,12542,Expansion Packs,16,0,0.0,16
48450,12542,Game Packs,11,0,0.0,11
48451,12542,Kits,6,0,0.0,6
48452,12542,Stuff Packs,12,0,0.0,12
48453,12543,Expansion Packs,16,0,0.0,16
48454,12543,Game Packs,12,0,0.0,12
48455,12543,Kits,33,0,0.0,33
48456,12543,Stuff Packs,20,0,0.0,20
48457,12544,Expansion Packs,11,0,0.0,11
48458,12544,Game Packs,4,0,0.0,4
48459,12544,Stuff Packs,4,2,0.5,2
48460,12545,Expansion Packs,16,0,0.0,16
48461,12545,Game Packs,11,0,0.0,11
48462,12545,Kits,24,0,0.0,24
48463,12545,Stuff Packs,19,1,0.05263157894736842,18
48464,12546,Expansion Packs,5,0,0.0,5
48465,12546,Stuff Packs,1,0,0.0,1
48466,12547,Expansion Packs,5,0,0.0,5
48467,12547,Game Packs,2,0,0.0,2
48468,12547,Kits,1,1,1.0,0
48469,12547,Stuff Packs,5,3,0.6,2
48470,12548,Kits,1,1,1.0,0
48471,12548,Stuff Packs,3,3,1.0,0
48472,12549,Expansion Packs,16,0,0.0,16
48473,12549,Game Packs,12,0,0.0,12
48474,12549,Kits,17,1,0.058823529411764705,16
48475,12549,Stuff Packs,20,0,0.0,20
48476,12550,Expansion Packs,16,0,0.0,16
48477,12550,Game Packs,12,0,0.0,12
48478,12550,Kits,19,1,0.05263157894736842,18
48479,12550,Stuff Packs,18,0,0.0,18
48480,12551,Expansion Packs,15,0,0.0,15
48481,12551,Game Packs,9,0,0.0,9
48482,12551,Kits,5,1,0.2,4
48483,12551,Stuff Packs,7,1,0.14285714285714285,6
48484,12552,Expansion Packs,7,0,0.0,7
48485,12552,Game Packs,1,0,0.0,1
48486,12552,Kits,1,0,0.0,1
48487,12552,Stuff Packs,1,0,0.0,1
48488,12553,Expansion Packs,15,0,0.0,15
48489,12553,Game Packs,11,0,0.0,11
48490,12553,Kits,23,0,0.0,23
48491,12553,Stuff Packs,20,0,0.0,20
48492,12554,Expansion Packs,10,0,0.0,10
48493,12554,Game Packs,5,0,0.0,5
48494,12554,Stuff Packs,12,0,0.0,12
48495,12555,Expansion Packs,10,0,0.0,10
48496,12555,Game Packs,4,1,0.25,3
48497,12555,Kits,3,1,0.3333333333333333,2
48498,12555,Stuff Packs,7,2,0.2857142857142857,5
48499,12556,Expansion Packs,16,0,0.0,16
48500,12556,Game Packs,12,0,0.0,12
48501,12556,Kits,33,0,0.0,33
48502,12556,Stuff Packs,20,0,0.0,20
48503,12557,Expansion Packs,10,0,0.0,10
48504,12557,Game Packs,8,0,0.0,8
48505,12557,Kits,1,1,1.0,0
48506,12557,Stuff Packs,14,0,0.0,14
48507,12558,Expansion Packs,16,0,0.0,16
48508,12558,Game Packs,12,0,0.0,12
48509,12558,Kits,29,0,0.0,29
48510,12558,Stuff Packs,20,0,0.0,20
48511,12559,Expansion Packs,16,0,0.0,16
48512,12559,Game Packs,11,0,0.0,11
48513,12559,Kits,1,1,1.0,0
48514,12559,Stuff Packs,19,1,0.05263157894736842,18
48515,12560,Expansion Packs,12,0,0.0,12
48516,12560,Game Packs,7,1,0.14285714285714285,6
48517,12560,Kits,11,2,0.18181818181818182,9
48518,12560,Stuff Packs,11,4,0.36363636363636365,7
48519,12561,Expansion Packs,11,0,0.0,11
48520,12561,Game Packs,4,0,0.0,4
48521,12561,Kits,4,2,0.5,2
48522,12561,Stuff Packs,7,2,0.2857142857142857,5
48523,12562,Expansion Packs,16,0,0.0,16
48524,12562,Game Packs,10,0,0.0,10
48525,12562,Kits,24,0,0.0,24
48526,12562,Stuff Packs,18,0,0.0,18
48527,12563,Expansion Packs,13,0,0.0,13
48528,12563,Game Packs,11,0,0.0,11
48529,12563,Kits,2,0,0.0,2
48530,12563,Stuff Packs,18,0,0.0,18
48531,12564,Expansion Packs,9,0,0.0,9
48532,12564,Game Packs,5,0,0.0,5
48533,12564,Kits,2,2,1.0,0
48534,12564,Stuff Packs,3,0,0.0,3
48535,12565,Expansion Packs,6,0,0.0,6
48536,12565,Game Packs,3,0,0.0,3
48537,12565,Stuff Packs,6,0,0.0,6
48538,12566,Expansion Packs,3,0,0.0,3
48539,12566,Game Packs,3,0,0.0,3
48540,12566,Kits,1,0,0.0,1
48541,12566,Stuff Packs,3,0,0.0,3
48542,12567,Expansion Packs,16,0,0.0,16
48543,12567,Game Packs,9,0,0.0,9
48544,12567,Kits,8,1,0.125,7
48545,12567,Stuff Packs,13,0,0.0,13
48546,12568,Expansion Packs,15,0,0.0,15
48547,12568,Game Packs,11,0,0.0,11
48548,12568,Kits,19,1,0.05263157894736842,18
48549,12568,Stuff Packs,19,0,0.0,19
48550,12569,Expansion Packs,15,0,0.0,15
48551,12569,Game Packs,11,0,0.0,11
48552,12569,Kits,9,0,0.0,9
48553,12569,Stuff Packs,17,0,0.0,17
48554,12570,Expansion Packs,5,0,0.0,5
48555,12570,Game Packs,1,0,0.0,1
48556,12570,Stuff Packs,1,0,0.0,1
48557,12571,Expansion Packs,16,0,0.0,16
48558,12571,Game Packs,12,0,0.0,12
48559,12571,Kits,33,1,0.030303030303030304,32
48560,12571,Stuff Packs,20,0,0.0,20
48561,12572,Expansion Packs,16,0,0.0,16
48562,12572,Game Packs,11,0,0.0,11
48563,12572,Kits,19,2,0.10526315789473684,17
48564,12572,Stuff Packs,20,0,0.0,20
48565,12573,Expansion Packs,10,0,0.0,10
48566,12573,Game Packs,7,0,0.0,7
48567,12573,Kits,11,0,0.0,11
48568,12573,Stuff Packs,10,0,0.0,10
48569,12574,Expansion Packs,4,0,0.0,4
48570,12574,Game Packs,5,0,0.0,5
48571,12574,Kits,5,1,0.2,4
48572,12574,Stuff Packs,7,2,0.2857142857142857,5
48573,12575,Expansion Packs,8,0,0.0,8
48574,12575,Game Packs,3,0,0.0,3
48575,12575,Kits,3,2,0.6666666666666666,1
48576,12575,Stuff Packs,5,4,0.8,1
48577,12576,Expansion Packs,7,0,0.0,7
48578,12576,Game Packs,2,0,0.0,2
48579,12576,Kits,1,1,1.0,0
48580,12576,Stuff Packs,4,2,0.5,2
48581,12577,Expansion Packs,16,0,0.0,16
48582,12577,Game Packs,11,0,0.0,11
48583,12577,Kits,28,0,0.0,28
48584,12577,Stuff Packs,18,0,0.0,18
48585,12578,Expansion Packs,14,2,0.14285714285714285,12
48586,12578,Game Packs,9,0,0.0,9
48587,12578,Kits,2,0,0.0,2
48588,12578,Stuff Packs,9,1,0.1111111111111111,8
48589,12579,Expansion Packs,14,0,0.0,14
48590,12579,Game Packs,9,0,0.0,9
48591,12579,Kits,4,2,0.5,2
48592,12579,Stuff Packs,7,3,0.42857142857142855,4
48593,12580,Expansion Packs,11,0,0.0,11
48594,12580,Game Packs,3,0,0.0,3
48595,12580,Kits,1,1,1.0,0
48596,12580,Stuff Packs,4,0,0.0,4
48597,12581,Expansion Packs,16,0,0.0,16
48598,12581,Game Packs,9,0,0.0,9
48599,12581,Kits,13,2,0.15384615384615385,11
48600,12581,Stuff Packs,12,2,0.16666666666666666,10
48601,12582,Expansion Packs,15,0,0.0,15
48602,12582,Game Packs,7,0,0.0,7
48603,12582,Kits,3,1,0.3333333333333333,2
48604,12582,Stuff Packs,9,1,0.1111111111111111,8
48605,12583,Expansion Packs,6,0,0.0,6
48606,12583,Game Packs,1,0,0.0,1
48607,12583,Kits,2,0,0.0,2
48608,12583,Stuff Packs,2,0,0.0,2
48609,12584,Expansion Packs,16,0,0.0,16
48610,12584,Game Packs,12,0,0.0,12
48611,12584,Kits,22,1,0.045454545454545456,21
48612,12584,Stuff Packs,20,0,0.0,20
48613,12585,Expansion Packs,13,0,0.0,13
48614,12585,Game Packs,10,0,0.0,10
48615,12585,Kits,1,1,1.0,0
48616,12585,Stuff Packs,13,0,0.0,13
48617,12586,Expansion Packs,15,0,0.0,15
48618,12586,Game Packs,12,0,0.0,12
48619,12586,Kits,10,2,0.2,8
48620,12586,Stuff Packs,15,1,0.06666666666666667,14
48621,12587,Expansion Packs,16,0,0.0,16
48622,12587,Game Packs,11,0,0.0,11
48623,12587,Kits,2,1,0.5,1
48624,12587,Stuff Packs,14,0,0.0,14
48625,12588,Expansion Packs,14,0,0.0,14
48626,12588,Game Packs,9,0,0.0,9
48627,12588,Kits,2,0,0.0,2
48628,12588,Stuff Packs,17,0,0.0,17
48629,12589,Expansion Packs,3,0,0.0,3
48630,12589,Game Packs,3,1,0.3333333333333333,2
48631,12589,Stuff Packs,1,0,0.0,1
48632,12590,Expansion Packs,11,0,0.0,11
48633,12590,Game Packs,7,1,0.14285714285714285,6
48634,12590,Kits,3,3,1.0,0
48635,12590,Stuff Packs,10,3,0.3,7
48636,12591,Expansion Packs,16,0,0.0,16
48637,12591,Game Packs,12,1,0.08333333333333333,11
48638,12591,Kits,33,1,0.030303030303030304,32
48639,12591,Stuff Packs,20,1,0.05,19
48640,12592,Expansion Packs,13,0,0.0,13
48641,12592,Game Packs,8,0,0.0,8
48642,12592,Kits,12,1,0.08333333333333333,11
48643,12592,Stuff Packs,10,1,0.1,9
48644,12593,Expansion Packs,10,0,0.0,10
48645,12593,Game Packs,8,0,0.0,8
48646,12593,Kits,2,2,1.0,0
48647,12593,Stuff Packs,12,1,0.08333333333333333,11
48648,12594,Expansion Packs,16,0,0.0,16
48649,12594,Game Packs,12,0,0.0,12
48650,12594,Kits,33,0,0.0,33
48651,12594,Stuff Packs,20,0,0.0,20
48652,12595,Expansion Packs,11,0,0.0,11
48653,12595,Game Packs,7,0,0.0,7
48654,12595,Kits,1,0,0.0,1
48655,12595,Stuff Packs,6,0,0.0,6
48656,12596,Expansion Packs,11,0,0.0,11
48657,12596,Game Packs,6,0,0.0,6
48658,12596,Kits,6,0,0.0,6
48659,12596,Stuff Packs,12,1,0.08333333333333333,11
48660,12597,Expansion Packs,13,0,0.0,13
48661,12597,Game Packs,6,0,0.0,6
48662,12597,Kits,4,1,0.25,3
48663,12597,Stuff Packs,9,2,0.2222222222222222,7
48664,12598,Expansion Packs,16,0,0.0,16
48665,12598,Game Packs,12,0,0.0,12
48666,12598,Kits,33,1,0.030303030303030304,32
48667,12598,Stuff Packs,20,0,0.0,20
48668,12599,Expansion Packs,14,0,0.0,14
48669,12599,Game Packs,12,0,0.0,12
48670,12599,Kits,15,1,0.06666666666666667,14
48671,12599,Stuff Packs,19,0,0.0,19
48672,12600,Expansion Packs,6,0,0.0,6
48673,12600,Game Packs,2,0,0.0,2
48674,12600,Kits,2,1,0.5,1
48675,12600,Stuff Packs,3,2,0.6666666666666666,1
48676,12601,Expansion Packs,15,0,0.0,15
48677,12601,Game Packs,7,0,0.0,7
48678,12601,Kits,3,2,0.6666666666666666,1
48679,12601,Stuff Packs,8,1,0.125,7
48680,12602,Expansion Packs,7,1,0.14285714285714285,6
48681,12602,Game Packs,1,0,0.0,1
48682,12602,Kits,2,1,0.5,1
48683,12602,Stuff Packs,4,2,0.5,2
48684,12603,Expansion Packs,16,0,0.0,16
48685,12603,Game Packs,11,0,0.0,11
48686,12603,Kits,30,0,0.0,30
48687,12603,Stuff Packs,20,0,0.0,20
48688,12604,Expansion Packs,15,0,0.0,15
48689,12604,Game Packs,12,1,0.08333333333333333,11
48690,12604,Kits,22,0,0.0,22
48691,12604,Stuff Packs,20,0,0.0,20
48692,12605,Expansion Packs,16,0,0.0,16
48693,12605,Game Packs,12,0,0.0,12
48694,12605,Kits,33,1,0.030303030303030304,32
48695,12605,Stuff Packs,20,0,0.0,20
48696,12606,Expansion Packs,14,0,0.0,14
48697,12606,Game Packs,8,0,0.0,8
48698,12606,Kits,14,0,0.0,14
48699,12606,Stuff Packs,17,0,0.0,17
48700,12607,Expansion Packs,16,0,0.0,16
48701,12607,Game Packs,12,1,0.08333333333333333,11
48702,12607,Kits,33,0,0.0,33
48703,12607,Stuff Packs,20,0,0.0,20
48704,12608,Expansion Packs,16,1,0.0625,15
48705,12608,Game Packs,12,0,0.0,12
48706,12608,Kits,9,0,0.0,9
48707,12608,Stuff Packs,20,2,0.1,18
48708,12609,Expansion Packs,15,0,0.0,15
48709,12609,Game Packs,12,0,0.0,12
48710,12609,Kits,23,0,0.0,23
48711,12609,Stuff Packs,19,0,0.0,19
48712,12610,Expansion Packs,2,0,0.0,2
48713,12610,Game Packs,1,0,0.0,1
48714,12610,Kits,1,0,0.0,1
48715,12610,Stuff Packs,5,3,0.6,2
48716,12611,Expansion Packs,16,0,0.0,16
48717,12611,Game Packs,12,2,0.16666666666666666,10
48718,12611,Kits,33,2,0.06060606060606061,31
48719,12611,Stuff Packs,20,2,0.1,18
48720,12612,Expansion Packs,10,0,0.0,10
48721,12612,Game Packs,6,0,0.0,6
48722,12612,Kits,9,1,0.1111111111111111,8
48723,12612,Stuff Packs,10,2,0.2,8
48724,12613,Expansion Packs,16,0,0.0,16
48725,12613,Game Packs,12,0,0.0,12
48726,12613,Kits,33,1,0.030303030303030304,32
48727,12613,Stuff Packs,20,0,0.0,20
48728,12614,Expansion Packs,16,0,0.0,16
48729,12614,Game Packs,12,0,0.0,12
48730,12614,Kits,33,0,0.0,33
48731,12614,Stuff Packs,20,0,0.0,20
48732,12615,Expansion Packs,10,0,0.0,10
48733,12615,Game Packs,6,1,0.16666666666666666,5
48734,12615,Kits,1,1,1.0,0
48735,12615,Stuff Packs,10,3,0.3,7
48736,12616,Expansion Packs,16,0,0.0,16
48737,12616,Game Packs,9,0,0.0,9
48738,12616,Kits,7,0,0.0,7
48739,12616,Stuff Packs,12,0,0.0,12
48740,12617,Expansion Packs,16,0,0.0,16
48741,12617,Game Packs,12,0,0.0,12
48742,12617,Kits,27,1,0.037037037037037035,26
48743,12617,Stuff Packs,20,0,0.0,20
48744,12618,Expansion Packs,14,0,0.0,14
48745,12618,Game Packs,10,0,0.0,10
48746,12618,Kits,3,2,0.6666666666666666,1
48747,12618,Stuff Packs,19,1,0.05263157894736842,18
48748,12619,Expansion Packs,6,0,0.0,6
48749,12619,Game Packs,4,0,0.0,4
48750,12619,Kits,8,0,0.0,8
48751,12619,Stuff Packs,11,0,0.0,11
48752,12620,Expansion Packs,16,0,0.0,16
48753,12620,Game Packs,12,0,0.0,12
48754,12620,Kits,33,0,0.0,33
48755,12620,Stuff Packs,20,0,0.0,20
48756,12621,Expansion Packs,16,0,0.0,16
48757,12621,Game Packs,12,0,0.0,12
48758,12621,Kits,33,0,0.0,33
48759,12621,Stuff Packs,20,0,0.0,20
48760,12622,Expansion Packs,11,0,0.0,11
48761,12622,Game Packs,10,0,0.0,10
48762,12622,Kits,4,2,0.5,2
48763,12622,Stuff Packs,15,2,0.13333333333333333,13
48764,12623,Expansion Packs,12,0,0.0,12
48765,12623,Game Packs,3,0,0.0,3
48766,12623,Kits,12,2,0.16666666666666666,10
48767,12623,Stuff Packs,14,2,0.14285714285714285,12
48768,12624,Expansion Packs,13,0,0.0,13
48769,12624,Game Packs,5,0,0.0,5
48770,12624,Kits,10,1,0.1,9
48771,12624,Stuff Packs,8,3,0.375,5
48772,12625,Expansion Packs,15,0,0.0,15
48773,12625,Game Packs,8,0,0.0,8
48774,12625,Kits,17,0,0.0,17
48775,12625,Stuff Packs,16,0,0.0,16
48776,12626,Expansion Packs,14,0,0.0,14
48777,12626,Game Packs,11,0,0.0,11
48778,12626,Kits,4,1,0.25,3
48779,12626,Stuff Packs,15,1,0.06666666666666667,14
48780,12627,Expansion Packs,7,0,0.0,7
48781,12627,Game Packs,4,0,0.0,4
48782,12627,Kits,4,4,1.0,0
48783,12627,Stuff Packs,9,2,0.2222222222222222,7
48784,12628,Expansion Packs,7,0,0.0,7
48785,12628,Game Packs,4,0,0.0,4
48786,12628,Kits,8,1,0.125,7
48787,12628,Stuff Packs,2,0,0.0,2
48788,12629,Expansion Packs,16,0,0.0,16
48789,12629,Game Packs,12,0,0.0,12
48790,12629,Kits,33,3,0.09090909090909091,30
48791,12629,Stuff Packs,20,1,0.05,19
48792,12630,Expansion Packs,13,0,0.0,13
48793,12630,Game Packs,5,0,0.0,5
48794,12630,Stuff Packs,10,4,0.4,6
48795,12631,Expansion Packs,8,0,0.0,8
48796,12631,Game Packs,2,0,0.0,2
48797,12631,Kits,1,1,1.0,0
48798,12631,Stuff Packs,6,2,0.3333333333333333,4
48799,12632,Expansion Packs,3,1,0.3333333333333333,2
48800,12632,Game Packs,4,0,0.0,4
48801,12632,Kits,2,1,0.5,1
48802,12632,Stuff Packs,4,3,0.75,1
48803,12633,Expansion Packs,7,0,0.0,7
48804,12633,Game Packs,3,0,0.0,3
48805,12633,Kits,6,0,0.0,6
48806,12633,Stuff Packs,4,0,0.0,4
48807,12634,Expansion Packs,16,0,0.0,16
48808,12634,Game Packs,12,0,0.0,12
48809,12634,Kits,33,0,0.0,33
48810,12634,Stuff Packs,20,1,0.05,19
48811,12635,Expansion Packs,13,0,0.0,13
48812,12635,Game Packs,4,0,0.0,4
48813,12635,Kits,4,1,0.25,3
48814,12635,Stuff Packs,7,1,0.14285714285714285,6
48815,12636,Expansion Packs,15,0,0.0,15
48816,12636,Game Packs,10,0,0.0,10
48817,12636,Kits,19,1,0.05263157894736842,18
48818,12636,Stuff Packs,20,1,0.05,19
48819,12637,Expansion Packs,16,0,0.0,16
48820,12637,Game Packs,6,0,0.0,6
48821,12637,Kits,17,0,0.0,17
48822,12637,Stuff Packs,16,2,0.125,14
48823,12638,Expansion Packs,16,2,0.125,14
48824,12638,Game Packs,9,0,0.0,9
48825,12638,Kits,22,0,0.0,22
48826,12638,Stuff Packs,16,0,0.0,16
48827,12639,Expansion Packs,16,0,0.0,16
48828,12639,Game Packs,12,0,0.0,12
48829,12639,Kits,33,0,0.0,33
48830,12639,Stuff Packs,20,0,0.0,20
48831,12640,Expansion Packs,14,0,0.0,14
48832,12640,Game Packs,10,0,0.0,10
48833,12640,Kits,8,1,0.125,7
48834,12640,Stuff Packs,13,2,0.15384615384615385,11
48835,12641,Expansion Packs,16,0,0.0,16
48836,12641,Game Packs,12,0,0.0,12
48837,12641,Kits,33,0,0.0,33
48838,12641,Stuff Packs,20,0,0.0,20
48839,12642,Expansion Packs,6,0,0.0,6
48840,12642,Game Packs,2,0,0.0,2
48841,12642,Kits,2,0,0.0,2
48842,12642,Stuff Packs,4,2,0.5,2
48843,12643,Expansion Packs,16,0,0.0,16
48844,12643,Game Packs,10,0,0.0,10
48845,12643,Kits,3,1,0.3333333333333333,2
48846,12643,Stuff Packs,18,0,0.0,18
48847,12644,Expansion Packs,16,0,0.0,16
48848,12644,Game Packs,11,0,0.0,11
48849,12644,Kits,9,2,0.2222222222222222,7
48850,12644,Stuff Packs,20,2,0.1,18
48851,12645,Expansion Packs,14,0,0.0,14
48852,12645,Game Packs,12,0,0.0,12
48853,12645,Kits,16,1,0.0625,15
48854,12645,Stuff Packs,19,0,0.0,19
48855,12646,Expansion Packs,15,1,0.06666666666666667,14
48856,12646,Game Packs,9,1,0.1111111111111111,8
48857,12646,Kits,6,2,0.3333333333333333,4
48858,12646,Stuff Packs,9,3,0.3333333333333333,6
48859,12647,Expansion Packs,3,0,0.0,3
48860,12647,Game Packs,2,0,0.0,2
48861,12647,Kits,5,0,0.0,5
48862,12647,Stuff Packs,6,0,0.0,6
48863,12648,Expansion Packs,16,0,0.0,16
48864,12648,Game Packs,11,0,0.0,11
48865,12648,Kits,13,0,0.0,13
48866,12648,Stuff Packs,15,0,0.0,15
48867,12649,Expansion Packs,5,0,0.0,5
48868,12649,Game Packs,3,1,0.3333333333333333,2
48869,12650,Expansion Packs,15,0,0.0,15
48870,12650,Game Packs,8,0,0.0,8
48871,12650,Kits,6,2,0.3333333333333333,4
48872,12650,Stuff Packs,8,0,0.0,8
48873,12651,Expansion Packs,16,0,0.0,16
48874,12651,Game Packs,11,0,0.0,11
48875,12651,Kits,25,0,0.0,25
48876,12651,Stuff Packs,20,0,0.0,20
48877,12652,Expansion Packs,5,0,0.0,5
48878,12652,Game Packs,2,0,0.0,2
48879,12652,Stuff Packs,2,0,0.0,2
48880,12653,Expansion Packs,11,0,0.0,11
48881,12653,Game Packs,5,0,0.0,5
48882,12653,Kits,4,1,0.25,3
48883,12653,Stuff Packs,10,1,0.1,9
48884,12654,Expansion Packs,16,0,0.0,16
48885,12654,Game Packs,12,0,0.0,12
48886,12654,Kits,28,1,0.03571428571428571,27
48887,12654,Stuff Packs,20,0,0.0,20
48888,12655,Expansion Packs,16,0,0.0,16
48889,12655,Game Packs,12,0,0.0,12
48890,12655,Kits,33,0,0.0,33
48891,12655,Stuff Packs,20,0,0.0,20
48892,12656,Expansion Packs,16,1,0.0625,15
48893,12656,Game Packs,12,0,0.0,12
48894,12656,Kits,33,0,0.0,33
48895,12656,Stuff Packs,20,0,0.0,20
48896,12657,Expansion Packs,8,0,0.0,8
48897,12657,Game Packs,4,0,0.0,4
48898,12657,Kits,1,1,1.0,0
48899,12657,Stuff Packs,4,1,0.25,3
48900,12658,Expansion Packs,16,0,0.0,16
48901,12658,Game Packs,11,0,0.0,11
48902,12658,Kits,16,0,0.0,16
48903,12658,Stuff Packs,20,0,0.0,20
48904,12659,Expansion Packs,14,0,0.0,14
48905,12659,Game Packs,11,0,0.0,11
48906,12659,Kits,3,1,0.3333333333333333,2
48907,12659,Stuff Packs,13,0,0.0,13
48908,12660,Expansion Packs,11,1,0.09090909090909091,10
48909,12660,Game Packs,4,0,0.0,4
48910,12660,Kits,1,1,1.0,0
48911,12660,Stuff Packs,8,1,0.125,7
48912,12661,Expansion Packs,4,0,0.0,4
48913,12661,Game Packs,2,0,0.0,2
48914,12661,Stuff Packs,5,0,0.0,5
48915,12662,Expansion Packs,15,0,0.0,15
48916,12662,Game Packs,12,0,0.0,12
48917,12662,Kits,28,0,0.0,28
48918,12662,Stuff Packs,20,0,0.0,20
48919,12663,Expansion Packs,16,0,0.0,16
48920,12663,Game Packs,12,0,0.0,12
48921,12663,Kits,23,0,0.0,23
48922,12663,Stuff Packs,20,0,0.0,20
48923,12664,Expansion Packs,16,0,0.0,16
48924,12664,Game Packs,12,0,0.0,12
48925,12664,Kits,6,1,0.16666666666666666,5
48926,12664,Stuff Packs,20,0,0.0,20
48927,12665,Expansion Packs,16,0,0.0,16
48928,12665,Game Packs,12,0,0.0,12
48929,12665,Kits,12,0,0.0,12
48930,12665,Stuff Packs,16,0,0.0,16
48931,12666,Expansion Packs,16,0,0.0,16
48932,12666,Game Packs,11,0,0.0,11
48933,12666,Kits,16,0,0.0,16
48934,12666,Stuff Packs,18,0,0.0,18
48935,12667,Expansion Packs,15,0,0.0,15
48936,12667,Game Packs,11,0,0.0,11
48937,12667,Kits,4,2,0.5,2
48938,12667,Stuff Packs,16,3,0.1875,13
48939,12668,Expansion Packs,16,0,0.0,16
48940,12668,Game Packs,11,0,0.0,11
48941,12668,Kits,16,1,0.0625,15
48942,12668,Stuff Packs,18,0,0.0,18
48943,12669,Expansion Packs,9,0,0.0,9
48944,12669,Game Packs,2,0,0.0,2
48945,12669,Kits,1,1,1.0,0
48946,12669,Stuff Packs,4,0,0.0,4
48947,12670,Expansion Packs,10,0,0.0,10
48948,12670,Game Packs,5,0,0.0,5
48949,12670,Kits,18,0,0.0,18
48950,12670,Stuff Packs,11,0,0.0,11
48951,12671,Expansion Packs,16,0,0.0,16
48952,12671,Game Packs,12,0,0.0,12
48953,12671,Kits,33,0,0.0,33
48954,12671,Stuff Packs,20,0,0.0,20
48955,12672,Expansion Packs,16,0,0.0,16
48956,12672,Game Packs,11,0,0.0,11
48957,12672,Kits,21,0,0.0,21
48958,12672,Stuff Packs,20,0,0.0,20
48959,12673,Expansion Packs,16,0,0.0,16
48960,12673,Game Packs,11,0,0.0,11
48961,12673,Kits,23,0,0.0,23
48962,12673,Stuff Packs,9,0,0.0,9
48963,12674,Expansion Packs,7,0,0.0,7
48964,12674,Game Packs,4,1,0.25,3
48965,12674,Kits,4,1,0.25,3
48966,12674,Stuff Packs,10,4,0.4,6
48967,12675,Expansion Packs,16,0,0.0,16
48968,12675,Game Packs,12,0,0.0,12
48969,12675,Kits,24,1,0.041666666666666664,23
48970,12675,Stuff Packs,20,1,0.05,19
48971,12676,Expansion Packs,16,0,0.0,16
48972,12676,Game Packs,12,0,0.0,12
48973,12676,Kits,12,0,0.0,12
48974,12676,Stuff Packs,19,0,0.0,19
48975,12677,Expansion Packs,11,0,0.0,11
48976,12677,Game Packs,6,0,0.0,6
48977,12677,Kits,2,0,0.0,2
48978,12677,Stuff Packs,7,0,0.0,7
48979,12678,Expansion Packs,15,0,0.0,15
48980,12678,Game Packs,12,0,0.0,12
48981,12678,Kits,5,1,0.2,4
48982,12678,Stuff Packs,14,1,0.07142857142857142,13
48983,12679,Expansion Packs,13,0,0.0,13
48984,12679,Game Packs,3,0,0.0,3
48985,12679,Kits,11,0,0.0,11
48986,12679,Stuff Packs,8,3,0.375,5
48987,12680,Expansion Packs,10,0,0.0,10
48988,12680,Game Packs,8,0,0.0,8
48989,12680,Kits,3,0,0.0,3
48990,12680,Stuff Packs,11,2,0.18181818181818182,9
48991,12681,Expansion Packs,16,0,0.0,16
48992,12681,Game Packs,9,0,0.0,9
48993,12681,Kits,18,1,0.05555555555555555,17
48994,12681,Stuff Packs,11,0,0.0,11
48995,12682,Expansion Packs,16,0,0.0,16
48996,12682,Game Packs,10,0,0.0,10
48997,12682,Kits,7,1,0.14285714285714285,6
48998,12682,Stuff Packs,16,0,0.0,16
48999,12683,Expansion Packs,16,0,0.0,16
49000,12683,Game Packs,12,0,0.0,12
49001,12683,Kits,30,2,0.06666666666666667,28
49002,12683,Stuff Packs,20,0,0.0,20
49003,12684,Expansion Packs,16,0,0.0,16
49004,12684,Game Packs,12,0,0.0,12
49005,12684,Kits,22,0,0.0,22
49006,12684,Stuff Packs,19,0,0.0,19
49007,12685,Expansion Packs,16,0,0.0,16
49008,12685,Game Packs,11,0,0.0,11
49009,12685,Kits,12,1,0.08333333333333333,11
49010,12685,Stuff Packs,15,4,0.26666666666666666,11
49011,12686,Expansion Packs,3,0,0.0,3
49012,12686,Kits,2,1,0.5,1
49013,12686,Stuff Packs,1,0,0.0,1
49014,12687,Expansion Packs,16,0,0.0,16
49015,12687,Game Packs,11,0,0.0,11
49016,12687,Kits,13,1,0.07692307692307693,12
49017,12687,Stuff Packs,19,0,0.0,19
49018,12688,Expansion Packs,10,0,0.0,10
49019,12688,Game Packs,4,0,0.0,4
49020,12688,Kits,1,1,1.0,0
49021,12688,Stuff Packs,3,2,0.6666666666666666,1
49022,12689,Expansion Packs,5,0,0.0,5
49023,12689,Game Packs,3,0,0.0,3
49024,12689,Kits,2,1,0.5,1
49025,12689,Stuff Packs,9,2,0.2222222222222222,7
49026,12690,Expansion Packs,16,0,0.0,16
49027,12690,Game Packs,11,0,0.0,11
49028,12690,Kits,14,1,0.07142857142857142,13
49029,12690,Stuff Packs,20,0,0.0,20
49030,12691,Expansion Packs,15,0,0.0,15
49031,12691,Game Packs,9,0,0.0,9
49032,12691,Kits,11,1,0.09090909090909091,10
49033,12691,Stuff Packs,18,0,0.0,18
49034,12692,Expansion Packs,16,0,0.0,16
49035,12692,Game Packs,12,0,0.0,12
49036,12692,Kits,30,0,0.0,30
49037,12692,Stuff Packs,20,0,0.0,20
49038,12693,Expansion Packs,16,0,0.0,16
49039,12693,Game Packs,12,0,0.0,12
49040,12693,Kits,33,0,0.0,33
49041,12693,Stuff Packs,20,0,0.0,20
49042,12694,Expansion Packs,16,0,0.0,16
49043,12694,Game Packs,11,0,0.0,11
49044,12694,Kits,13,0,0.0,13
49045,12694,Stuff Packs,20,0,0.0,20
49046,12695,Expansion Packs,4,0,0.0,4
49047,12695,Game Packs,3,0,0.0,3
49048,12695,Kits,1,1,1.0,0
49049,12695,Stuff Packs,2,2,1.0,0
49050,12696,Expansion Packs,13,0,0.0,13
49051,12696,Game Packs,5,0,0.0,5
49052,12696,Kits,3,1,0.3333333333333333,2
49053,12696,Stuff Packs,4,0,0.0,4
49054,12697,Expansion Packs,16,0,0.0,16
49055,12697,Game Packs,12,0,0.0,12
49056,12697,Kits,33,0,0.0,33
49057,12697,Stuff Packs,20,0,0.0,20
49058,12698,Expansion Packs,10,0,0.0,10
49059,12698,Game Packs,4,0,0.0,4
49060,12698,Kits,6,0,0.0,6
49061,12698,Stuff Packs,9,0,0.0,9
49062,12699,Expansion Packs,15,0,0.0,15
49063,12699,Game Packs,12,0,0.0,12
49064,12699,Kits,10,0,0.0,10
49065,12699,Stuff Packs,20,0,0.0,20
49066,12700,Expansion Packs,10,0,0.0,10
49067,12700,Game Packs,2,0,0.0,2
49068,12700,Kits,3,0,0.0,3
49069,12700,Stuff Packs,2,0,0.0,2
49070,12701,Expansion Packs,14,0,0.0,14
49071,12701,Game Packs,6,0,0.0,6
49072,12701,Kits,6,2,0.3333333333333333,4
49073,12701,Stuff Packs,15,4,0.26666666666666666,11
49074,12702,Expansion Packs,13,0,0.0,13
49075,12702,Game Packs,9,0,0.0,9
49076,12702,Kits,4,1,0.25,3
49077,12702,Stuff Packs,11,1,0.09090909090909091,10
49078,12703,Expansion Packs,11,0,0.0,11
49079,12703,Game Packs,8,0,0.0,8
49080,12703,Kits,30,2,0.06666666666666667,28
49081,12703,Stuff Packs,15,0,0.0,15
49082,12704,Expansion Packs,16,0,0.0,16
49083,12704,Game Packs,12,0,0.0,12
49084,12704,Kits,33,0,0.0,33
49085,12704,Stuff Packs,20,0,0.0,20
49086,12705,Expansion Packs,16,0,0.0,16
49087,12705,Game Packs,12,0,0.0,12
49088,12705,Kits,29,0,0.0,29
49089,12705,Stuff Packs,20,0,0.0,20
49090,12706,Expansion Packs,15,0,0.0,15
49091,12706,Game Packs,12,1,0.08333333333333333,11
49092,12706,Kits,32,1,0.03125,31
49093,12706,Stuff Packs,19,0,0.0,19
49094,12707,Expansion Packs,16,0,0.0,16
49095,12707,Game Packs,12,0,0.0,12
49096,12707,Kits,33,1,0.030303030303030304,32
49097,12707,Stuff Packs,20,0,0.0,20
49098,12708,Expansion Packs,16,0,0.0,16
49099,12708,Game Packs,12,0,0.0,12
49100,12708,Kits,33,2,0.06060606060606061,31
49101,12708,Stuff Packs,20,2,0.1,18
49102,12709,Expansion Packs,13,0,0.0,13
49103,12709,Game Packs,5,0,0.0,5
49104,12709,Kits,9,2,0.2222222222222222,7
49105,12709,Stuff Packs,11,3,0.2727272727272727,8
49106,12710,Expansion Packs,8,0,0.0,8
49107,12710,Game Packs,9,1,0.1111111111111111,8
49108,12710,Kits,5,1,0.2,4
49109,12710,Stuff Packs,11,2,0.18181818181818182,9
49110,12711,Expansion Packs,5,0,0.0,5
49111,12711,Game Packs,5,0,0.0,5
49112,12711,Stuff Packs,14,4,0.2857142857142857,10
49113,12712,Expansion Packs,2,0,0.0,2
49114,12712,Game Packs,1,0,0.0,1
49115,12712,Kits,1,1,1.0,0
49116,12712,Stuff Packs,1,0,0.0,1
49117,12713,Expansion Packs,16,0,0.0,16
49118,12713,Game Packs,12,0,0.0,12
49119,12713,Kits,33,0,0.0,33
49120,12713,Stuff Packs,20,0,0.0,20
49121,12714,Expansion Packs,7,0,0.0,7
49122,12714,Game Packs,1,0,0.0,1
49123,12714,Stuff Packs,3,0,0.0,3
49124,12715,Expansion Packs,11,0,0.0,11
49125,12715,Game Packs,5,0,0.0,5
49126,12715,Kits,3,2,0.6666666666666666,1
49127,12715,Stuff Packs,8,1,0.125,7
49128,12716,Expansion Packs,7,0,0.0,7
49129,12716,Game Packs,7,0,0.0,7
49130,12716,Kits,3,0,0.0,3
49131,12716,Stuff Packs,7,0,0.0,7
49132,12717,Expansion Packs,5,0,0.0,5
49133,12717,Game Packs,2,0,0.0,2
49134,12717,Kits,1,0,0.0,1
49135,12717,Stuff Packs,7,1,0.14285714285714285,6
49136,12718,Expansion Packs,16,0,0.0,16
49137,12718,Game Packs,11,0,0.0,11
49138,12718,Kits,12,1,0.08333333333333333,11
49139,12718,Stuff Packs,19,0,0.0,19
49140,12719,Expansion Packs,16,0,0.0,16
49141,12719,Game Packs,12,0,0.0,12
49142,12719,Kits,8,1,0.125,7
49143,12719,Stuff Packs,19,0,0.0,19
49144,12720,Expansion Packs,11,0,0.0,11
49145,12720,Game Packs,7,1,0.14285714285714285,6
49146,12720,Kits,3,3,1.0,0
49147,12720,Stuff Packs,7,4,0.5714285714285714,3
49148,12721,Expansion Packs,3,0,0.0,3
49149,12721,Kits,1,1,1.0,0
49150,12722,Expansion Packs,8,0,0.0,8
49151,12722,Game Packs,3,0,0.0,3
49152,12722,Kits,5,0,0.0,5
49153,12722,Stuff Packs,3,0,0.0,3
49154,12723,Expansion Packs,9,0,0.0,9
49155,12723,Game Packs,6,1,0.16666666666666666,5
49156,12723,Kits,2,2,1.0,0
49157,12723,Stuff Packs,9,4,0.4444444444444444,5
49158,12724,Expansion Packs,10,0,0.0,10
49159,12724,Game Packs,2,0,0.0,2
49160,12724,Kits,1,1,1.0,0
49161,12724,Stuff Packs,6,1,0.16666666666666666,5
49162,12725,Expansion Packs,7,0,0.0,7
49163,12725,Game Packs,4,0,0.0,4
49164,12725,Kits,2,1,0.5,1
49165,12725,Stuff Packs,5,3,0.6,2
49166,12726,Expansion Packs,16,0,0.0,16
49167,12726,Game Packs,12,0,0.0,12
49168,12726,Kits,30,0,0.0,30
49169,12726,Stuff Packs,20,0,0.0,20
49170,12727,Expansion Packs,16,0,0.0,16
49171,12727,Game Packs,12,0,0.0,12
49172,12727,Kits,33,0,0.0,33
49173,12727,Stuff Packs,20,2,0.1,18
49174,12728,Expansion Packs,7,0,0.0,7
49175,12728,Game Packs,4,0,0.0,4
49176,12728,Kits,1,0,0.0,1
49177,12728,Stuff Packs,1,0,0.0,1
49178,12729,Expansion Packs,16,0,0.0,16
49179,12729,Game Packs,12,0,0.0,12
49180,12729,Kits,29,1,0.034482758620689655,28
49181,12729,Stuff Packs,20,1,0.05,19
49182,12730,Expansion Packs,15,0,0.0,15
49183,12730,Game Packs,12,0,0.0,12
49184,12730,Kits,29,0,0.0,29
49185,12730,Stuff Packs,20,0,0.0,20
49186,12731,Expansion Packs,12,0,0.0,12
49187,12731,Game Packs,7,2,0.2857142857142857,5
49188,12731,Stuff Packs,11,0,0.0,11
49189,12732,Expansion Packs,16,0,0.0,16
49190,12732,Game Packs,12,0,0.0,12
49191,12732,Kits,33,1,0.030303030303030304,32
49192,12732,Stuff Packs,20,0,0.0,20
49193,12733,Expansion Packs,12,0,0.0,12
49194,12733,Game Packs,4,0,0.0,4
49195,12733,Kits,9,0,0.0,9
49196,12733,Stuff Packs,7,0,0.0,7
49197,12734,Expansion Packs,15,15,1.0,0
49198,12734,Game Packs,12,12,1.0,0
49199,12734,Kits,26,26,1.0,0
49200,12734,Stuff Packs,20,20,1.0,0
49201,12735,Expansion Packs,3,0,0.0,3
49202,12735,Game Packs,5,1,0.2,4
49203,12735,Kits,1,0,0.0,1
49204,12735,Stuff Packs,6,3,0.5,3
49205,12736,Expansion Packs,9,0,0.0,9
49206,12736,Game Packs,4,0,0.0,4
49207,12736,Kits,17,0,0.0,17
49208,12736,Stuff Packs,9,0,0.0,9
49209,12737,Expansion Packs,3,0,0.0,3
49210,12737,Game Packs,2,0,0.0,2
49211,12737,Kits,3,1,0.3333333333333333,2
49212,12737,Stuff Packs,2,0,0.0,2
49213,12738,Expansion Packs,16,0,0.0,16
49214,12738,Game Packs,12,0,0.0,12
49215,12738,Kits,33,0,0.0,33
49216,12738,Stuff Packs,20,0,0.0,20
49217,12739,Expansion Packs,15,0,0.0,15
49218,12739,Game Packs,7,0,0.0,7
49219,12739,Kits,16,1,0.0625,15
49220,12739,Stuff Packs,9,3,0.3333333333333333,6
49221,12740,Expansion Packs,16,0,0.0,16
49222,12740,Game Packs,12,0,0.0,12
49223,12740,Kits,33,0,0.0,33
49224,12740,Stuff Packs,20,0,0.0,20
49225,12741,Expansion Packs,15,0,0.0,15
49226,12741,Game Packs,9,1,0.1111111111111111,8
49227,12741,Stuff Packs,10,0,0.0,10
49228,12742,Expansion Packs,16,1,0.0625,15
49229,12742,Game Packs,12,0,0.0,12
49230,12742,Kits,30,0,0.0,30
49231,12742,Stuff Packs,20,0,0.0,20
49232,12743,Expansion Packs,16,0,0.0,16
49233,12743,Game Packs,12,0,0.0,12
49234,12743,Kits,33,0,0.0,33
49235,12743,Stuff Packs,20,0,0.0,20
49236,12744,Expansion Packs,16,0,0.0,16
49237,12744,Game Packs,12,0,0.0,12
49238,12744,Kits,28,0,0.0,28
49239,12744,Stuff Packs,20,0,0.0,20
49240,12745,Expansion Packs,16,0,0.0,16
49241,12745,Game Packs,12,1,0.08333333333333333,11
49242,12745,Kits,33,1,0.030303030303030304,32
49243,12745,Stuff Packs,20,1,0.05,19
49244,12746,Expansion Packs,16,0,0.0,16
49245,12746,Game Packs,12,0,0.0,12
49246,12746,Kits,27,0,0.0,27
49247,12746,Stuff Packs,20,0,0.0,20
49248,12747,Expansion Packs,16,0,0.0,16
49249,12747,Game Packs,12,0,0.0,12
49250,12747,Kits,33,0,0.0,33
49251,12747,Stuff Packs,20,0,0.0,20
49252,12748,Expansion Packs,12,0,0.0,12
49253,12748,Game Packs,8,0,0.0,8
49254,12748,Stuff Packs,10,0,0.0,10
49255,12749,Expansion Packs,15,0,0.0,15
49256,12749,Game Packs,12,0,0.0,12
49257,12749,Kits,19,3,0.15789473684210525,16
49258,12749,Stuff Packs,20,0,0.0,20
49259,12750,Expansion Packs,16,0,0.0,16
49260,12750,Game Packs,12,0,0.0,12
49261,12750,Kits,32,0,0.0,32
49262,12750,Stuff Packs,20,0,0.0,20
49263,12751,Expansion Packs,15,0,0.0,15
49264,12751,Game Packs,10,0,0.0,10
49265,12751,Kits,14,1,0.07142857142857142,13
49266,12751,Stuff Packs,19,0,0.0,19
49267,12752,Expansion Packs,11,0,0.0,11
49268,12752,Game Packs,8,0,0.0,8
49269,12752,Kits,2,1,0.5,1
49270,12752,Stuff Packs,18,0,0.0,18
49271,12753,Expansion Packs,15,0,0.0,15
49272,12753,Game Packs,6,0,0.0,6
49273,12753,Kits,11,0,0.0,11
49274,12753,Stuff Packs,10,1,0.1,9
49275,12754,Expansion Packs,12,0,0.0,12
49276,12754,Game Packs,4,0,0.0,4
49277,12754,Kits,3,0,0.0,3
49278,12754,Stuff Packs,5,2,0.4,3
49279,12755,Expansion Packs,14,0,0.0,14
49280,12755,Game Packs,5,0,0.0,5
49281,12755,Kits,3,2,0.6666666666666666,1
49282,12755,Stuff Packs,12,2,0.16666666666666666,10
49283,12756,Expansion Packs,7,0,0.0,7
49284,12756,Game Packs,5,0,0.0,5
49285,12756,Kits,1,1,1.0,0
49286,12756,Stuff Packs,5,0,0.0,5
49287,12757,Expansion Packs,4,0,0.0,4
49288,12758,Expansion Packs,15,10,0.6666666666666666,5
49289,12758,Game Packs,6,5,0.8333333333333334,1
49290,12758,Kits,4,0,0.0,4
49291,12758,Stuff Packs,6,5,0.8333333333333334,1
49292,12759,Expansion Packs,15,0,0.0,15
49293,12759,Game Packs,12,0,0.0,12
49294,12759,Kits,28,0,0.0,28
49295,12759,Stuff Packs,20,1,0.05,19
49296,12760,Expansion Packs,10,9,0.9,1
49297,12760,Game Packs,9,9,1.0,0
49298,12760,Stuff Packs,18,18,1.0,0
49299,12761,Expansion Packs,16,0,0.0,16
49300,12761,Game Packs,11,0,0.0,11
49301,12761,Kits,10,0,0.0,10
49302,12761,Stuff Packs,20,0,0.0,20
49303,12762,Expansion Packs,7,0,0.0,7
49304,12762,Game Packs,4,0,0.0,4
49305,12762,Kits,1,0,0.0,1
49306,12762,Stuff Packs,4,0,0.0,4
49307,12763,Expansion Packs,16,0,0.0,16
49308,12763,Game Packs,12,0,0.0,12
49309,12763,Kits,33,1,0.030303030303030304,32
49310,12763,Stuff Packs,20,2,0.1,18
49311,12764,Expansion Packs,16,0,0.0,16
49312,12764,Game Packs,12,0,0.0,12
49313,12764,Kits,21,0,0.0,21
49314,12764,Stuff Packs,20,0,0.0,20
49315,12765,Expansion Packs,16,0,0.0,16
49316,12765,Game Packs,12,0,0.0,12
49317,12765,Kits,24,1,0.041666666666666664,23
49318,12765,Stuff Packs,20,1,0.05,19
49319,12766,Expansion Packs,11,0,0.0,11
49320,12766,Game Packs,7,0,0.0,7
49321,12766,Kits,2,2,1.0,0
49322,12766,Stuff Packs,5,1,0.2,4
49323,12767,Expansion Packs,16,0,0.0,16
49324,12767,Game Packs,12,0,0.0,12
49325,12767,Kits,22,1,0.045454545454545456,21
49326,12767,Stuff Packs,20,0,0.0,20
49327,12768,Expansion Packs,13,0,0.0,13
49328,12768,Game Packs,11,0,0.0,11
49329,12768,Kits,4,2,0.5,2
49330,12768,Stuff Packs,17,1,0.058823529411764705,16
49331,12769,Expansion Packs,16,0,0.0,16
49332,12769,Game Packs,7,0,0.0,7
49333,12769,Kits,13,0,0.0,13
49334,12769,Stuff Packs,17,0,0.0,17
49335,12770,Expansion Packs,12,0,0.0,12
49336,12770,Game Packs,6,1,0.16666666666666666,5
49337,12770,Kits,12,0,0.0,12
49338,12770,Stuff Packs,7,3,0.42857142857142855,4
49339,12771,Expansion Packs,12,0,0.0,12
49340,12771,Game Packs,10,0,0.0,10
49341,12771,Kits,7,1,0.14285714285714285,6
49342,12771,Stuff Packs,11,0,0.0,11
49343,12772,Expansion Packs,16,0,0.0,16
49344,12772,Game Packs,12,0,0.0,12
49345,12772,Kits,16,1,0.0625,15
49346,12772,Stuff Packs,20,0,0.0,20
49347,12773,Expansion Packs,16,0,0.0,16
49348,12773,Game Packs,12,0,0.0,12
49349,12773,Kits,28,0,0.0,28
49350,12773,Stuff Packs,20,0,0.0,20
49351,12774,Expansion Packs,16,0,0.0,16
49352,12774,Game Packs,5,0,0.0,5
49353,12774,Kits,4,1,0.25,3
49354,12774,Stuff Packs,11,1,0.09090909090909091,10
49355,12775,Expansion Packs,15,0,0.0,15
49356,12775,Game Packs,12,0,0.0,12
49357,12775,Kits,2,1,0.5,1
49358,12775,Stuff Packs,14,3,0.21428571428571427,11
49359,12776,Expansion Packs,12,0,0.0,12
49360,12776,Game Packs,9,0,0.0,9
49361,12776,Kits,3,2,0.6666666666666666,1
49362,12776,Stuff Packs,7,3,0.42857142857142855,4
49363,12777,Expansion Packs,15,0,0.0,15
49364,12777,Game Packs,12,0,0.0,12
49365,12777,Kits,26,1,0.038461538461538464,25
49366,12777,Stuff Packs,20,0,0.0,20
49367,12778,Expansion Packs,11,0,0.0,11
49368,12778,Game Packs,4,0,0.0,4
49369,12778,Kits,4,1,0.25,3
49370,12778,Stuff Packs,8,3,0.375,5
49371,12779,Expansion Packs,12,0,0.0,12
49372,12779,Game Packs,10,0,0.0,10
49373,12779,Kits,14,1,0.07142857142857142,13
49374,12779,Stuff Packs,10,1,0.1,9
49375,12780,Expansion Packs,9,0,0.0,9
49376,12780,Game Packs,4,0,0.0,4
49377,12780,Kits,4,0,0.0,4
49378,12780,Stuff Packs,9,2,0.2222222222222222,7
49379,12781,Expansion Packs,16,1,0.0625,15
49380,12781,Game Packs,12,0,0.0,12
49381,12781,Kits,28,2,0.07142857142857142,26
49382,12781,Stuff Packs,20,3,0.15,17
49383,12782,Expansion Packs,9,0,0.0,9
49384,12782,Game Packs,2,0,0.0,2
49385,12782,Kits,2,1,0.5,1
49386,12782,Stuff Packs,3,1,0.3333333333333333,2
49387,12783,Expansion Packs,16,0,0.0,16
49388,12783,Game Packs,12,0,0.0,12
49389,12783,Kits,33,1,0.030303030303030304,32
49390,12783,Stuff Packs,20,0,0.0,20
49391,12784,Expansion Packs,16,0,0.0,16
49392,12784,Game Packs,5,0,0.0,5
49393,12784,Kits,7,0,0.0,7
49394,12784,Stuff Packs,10,2,0.2,8
49395,12785,Expansion Packs,14,9,0.6428571428571429,5
49396,12785,Game Packs,10,2,0.2,8
49397,12785,Kits,6,2,0.3333333333333333,4
49398,12785,Stuff Packs,9,1,0.1111111111111111,8
49399,12786,Expansion Packs,11,0,0.0,11
49400,12786,Game Packs,3,0,0.0,3
49401,12786,Kits,5,1,0.2,4
49402,12786,Stuff Packs,7,4,0.5714285714285714,3
49403,12787,Expansion Packs,16,0,0.0,16
49404,12787,Game Packs,11,0,0.0,11
49405,12787,Kits,18,2,0.1111111111111111,16
49406,12787,Stuff Packs,18,1,0.05555555555555555,17
49407,12788,Kits,1,1,1.0,0
49408,12788,Stuff Packs,3,3,1.0,0
49409,12789,Expansion Packs,8,0,0.0,8
49410,12789,Game Packs,4,0,0.0,4
49411,12789,Stuff Packs,4,0,0.0,4
49412,12790,Expansion Packs,14,0,0.0,14
49413,12790,Game Packs,9,0,0.0,9
49414,12790,Kits,5,1,0.2,4
49415,12790,Stuff Packs,12,0,0.0,12
49416,12791,Expansion Packs,15,0,0.0,15
49417,12791,Game Packs,12,0,0.0,12
49418,12791,Kits,5,2,0.4,3
49419,12791,Stuff Packs,6,0,0.0,6
49420,12792,Expansion Packs,10,0,0.0,10
49421,12792,Game Packs,6,0,0.0,6
49422,12792,Stuff Packs,4,0,0.0,4
49423,12793,Expansion Packs,16,0,0.0,16
49424,12793,Game Packs,11,0,0.0,11
49425,12793,Kits,22,1,0.045454545454545456,21
49426,12793,Stuff Packs,19,0,0.0,19
49427,12794,Expansion Packs,16,0,0.0,16
49428,12794,Game Packs,11,0,0.0,11
49429,12794,Kits,20,0,0.0,20
49430,12794,Stuff Packs,19,0,0.0,19
49431,12795,Expansion Packs,3,0,0.0,3
49432,12795,Game Packs,1,0,0.0,1
49433,12795,Kits,2,0,0.0,2
49434,12795,Stuff Packs,3,1,0.3333333333333333,2
49435,12796,Expansion Packs,12,0,0.0,12
49436,12796,Game Packs,8,0,0.0,8
49437,12796,Kits,2,0,0.0,2
49438,12796,Stuff Packs,13,0,0.0,13
49439,12797,Expansion Packs,6,0,0.0,6
49440,12797,Game Packs,4,0,0.0,4
49441,12797,Kits,1,0,0.0,1
49442,12797,Stuff Packs,7,2,0.2857142857142857,5
49443,12798,Expansion Packs,7,0,0.0,7
49444,12798,Game Packs,6,1,0.16666666666666666,5
49445,12798,Kits,3,3,1.0,0
49446,12798,Stuff Packs,8,4,0.5,4
49447,12799,Expansion Packs,16,0,0.0,16
49448,12799,Game Packs,12,0,0.0,12
49449,12799,Kits,21,1,0.047619047619047616,20
49450,12799,Stuff Packs,20,0,0.0,20
49451,12800,Expansion Packs,5,0,0.0,5
49452,12800,Game Packs,1,0,0.0,1
49453,12800,Kits,1,1,1.0,0
49454,12800,Stuff Packs,5,2,0.4,3
49455,12801,Expansion Packs,15,0,0.0,15
49456,12801,Game Packs,12,0,0.0,12
49457,12801,Kits,12,3,0.25,9
49458,12801,Stuff Packs,20,0,0.0,20
49459,12802,Expansion Packs,10,0,0.0,10
49460,12802,Game Packs,4,0,0.0,4
49461,12802,Stuff Packs,6,0,0.0,6
49462,12803,Expansion Packs,7,0,0.0,7
49463,12803,Game Packs,6,0,0.0,6
49464,12803,Kits,3,2,0.6666666666666666,1
49465,12803,Stuff Packs,5,2,0.4,3
49466,12804,Expansion Packs,16,0,0.0,16
49467,12804,Game Packs,12,0,0.0,12
49468,12804,Kits,33,0,0.0,33
49469,12804,Stuff Packs,20,0,0.0,20
49470,12805,Expansion Packs,15,0,0.0,15
49471,12805,Game Packs,11,0,0.0,11
49472,12805,Kits,12,1,0.08333333333333333,11
49473,12805,Stuff Packs,19,0,0.0,19
49474,12806,Expansion Packs,15,0,0.0,15
49475,12806,Game Packs,10,0,0.0,10
49476,12806,Kits,9,1,0.1111111111111111,8
49477,12806,Stuff Packs,19,2,0.10526315789473684,17
49478,12807,Expansion Packs,16,0,0.0,16
49479,12807,Game Packs,12,0,0.0,12
49480,12807,Kits,32,0,0.0,32
49481,12807,Stuff Packs,20,0,0.0,20
49482,12808,Expansion Packs,14,0,0.0,14
49483,12808,Game Packs,7,0,0.0,7
49484,12808,Kits,5,0,0.0,5
49485,12808,Stuff Packs,4,0,0.0,4
49486,12809,Expansion Packs,15,0,0.0,15
49487,12809,Game Packs,12,0,0.0,12
49488,12809,Kits,6,0,0.0,6
49489,12809,Stuff Packs,20,0,0.0,20
49490,12810,Expansion Packs,15,0,0.0,15
49491,12810,Game Packs,11,0,0.0,11
49492,12810,Kits,14,1,0.07142857142857142,13
49493,12810,Stuff Packs,14,0,0.0,14
49494,12811,Expansion Packs,16,0,0.0,16
49495,12811,Game Packs,12,0,0.0,12
49496,12811,Kits,33,0,0.0,33
49497,12811,Stuff Packs,20,0,0.0,20
49498,12812,Expansion Packs,12,0,0.0,12
49499,12812,Game Packs,4,0,0.0,4
49500,12812,Kits,2,0,0.0,2
49501,12812,Stuff Packs,6,0,0.0,6
49502,12813,Kits,2,2,1.0,0
49503,12813,Stuff Packs,3,3,1.0,0
49504,12814,Expansion Packs,16,0,0.0,16
49505,12814,Game Packs,12,0,0.0,12
49506,12814,Kits,33,0,0.0,33
49507,12814,Stuff Packs,20,0,0.0,20
49508,12815,Expansion Packs,16,0,0.0,16
49509,12815,Game Packs,12,0,0.0,12
49510,12815,Kits,4,1,0.25,3
49511,12815,Stuff Packs,19,0,0.0,19
49512,12816,Expansion Packs,16,0,0.0,16
49513,12816,Game Packs,12,0,0.0,12
49514,12816,Kits,33,0,0.0,33
49515,12816,Stuff Packs,20,1,0.05,19
49516,12817,Expansion Packs,10,0,0.0,10
49517,12817,Game Packs,9,0,0.0,9
49518,12817,Stuff Packs,15,0,0.0,15
49519,12818,Expansion Packs,13,0,0.0,13
49520,12818,Game Packs,10,0,0.0,10
49521,12818,Kits,2,2,1.0,0
49522,12818,Stuff Packs,18,0,0.0,18
49523,12819,Expansion Packs,15,0,0.0,15
49524,12819,Game Packs,12,0,0.0,12
49525,12819,Kits,5,1,0.2,4
49526,12819,Stuff Packs,19,0,0.0,19
49527,12820,Expansion Packs,6,0,0.0,6
49528,12820,Game Packs,4,0,0.0,4
49529,12820,Kits,3,0,0.0,3
49530,12820,Stuff Packs,8,2,0.25,6
49531,12821,Expansion Packs,16,0,0.0,16
49532,12821,Game Packs,12,0,0.0,12
49533,12821,Kits,22,0,0.0,22
49534,12821,Stuff Packs,20,0,0.0,20
49535,12822,Expansion Packs,16,0,0.0,16
49536,12822,Game Packs,11,0,0.0,11
49537,12822,Kits,15,1,0.06666666666666667,14
49538,12822,Stuff Packs,19,1,0.05263157894736842,18
49539,12823,Expansion Packs,16,0,0.0,16
49540,12823,Game Packs,12,0,0.0,12
49541,12823,Kits,26,1,0.038461538461538464,25
49542,12823,Stuff Packs,20,0,0.0,20
49543,12824,Expansion Packs,8,0,0.0,8
49544,12824,Game Packs,4,0,0.0,4
49545,12824,Kits,3,0,0.0,3
49546,12824,Stuff Packs,8,0,0.0,8
49547,12825,Expansion Packs,14,0,0.0,14
49548,12825,Game Packs,11,0,0.0,11
49549,12825,Kits,2,1,0.5,1
49550,12825,Stuff Packs,15,0,0.0,15
49551,12826,Expansion Packs,16,0,0.0,16
49552,12826,Game Packs,7,0,0.0,7
49553,12826,Kits,17,0,0.0,17
49554,12826,Stuff Packs,17,1,0.058823529411764705,16
49555,12827,Expansion Packs,15,0,0.0,15
49556,12827,Game Packs,12,0,0.0,12
49557,12827,Kits,14,0,0.0,14
49558,12827,Stuff Packs,20,5,0.25,15
49559,12828,Expansion Packs,16,0,0.0,16
49560,12828,Game Packs,12,0,0.0,12
49561,12828,Kits,33,0,0.0,33
49562,12828,Stuff Packs,20,2,0.1,18
49563,12829,Expansion Packs,11,0,0.0,11
49564,12829,Game Packs,6,0,0.0,6
49565,12829,Kits,6,0,0.0,6
49566,12829,Stuff Packs,13,2,0.15384615384615385,11
49567,12830,Expansion Packs,16,0,0.0,16
49568,12830,Game Packs,11,0,0.0,11
49569,12830,Kits,6,0,0.0,6
49570,12830,Stuff Packs,20,0,0.0,20
49571,12831,Expansion Packs,16,0,0.0,16
49572,12831,Game Packs,12,0,0.0,12
49573,12831,Kits,31,0,0.0,31
49574,12831,Stuff Packs,20,0,0.0,20
49575,12832,Expansion Packs,16,0,0.0,16
49576,12832,Game Packs,11,0,0.0,11
49577,12832,Kits,28,0,0.0,28
49578,12832,Stuff Packs,20,0,0.0,20
49579,12833,Expansion Packs,6,0,0.0,6
49580,12833,Game Packs,3,0,0.0,3
49581,12833,Stuff Packs,5,1,0.2,4
49582,12834,Expansion Packs,16,0,0.0,16
49583,12834,Game Packs,12,0,0.0,12
49584,12834,Kits,32,0,0.0,32
49585,12834,Stuff Packs,20,0,0.0,20
49586,12835,Expansion Packs,2,0,0.0,2
49587,12836,Expansion Packs,16,0,0.0,16
49588,12836,Game Packs,12,0,0.0,12
49589,12836,Kits,32,1,0.03125,31
49590,12836,Stuff Packs,20,0,0.0,20
49591,12837,Expansion Packs,3,2,0.6666666666666666,1
49592,12837,Game Packs,3,1,0.3333333333333333,2
49593,12837,Stuff Packs,1,0,0.0,1
49594,12838,Expansion Packs,16,0,0.0,16
49595,12838,Game Packs,10,0,0.0,10
49596,12838,Kits,15,1,0.06666666666666667,14
49597,12838,Stuff Packs,20,0,0.0,20
49598,12839,Expansion Packs,15,1,0.06666666666666667,14
49599,12839,Game Packs,12,0,0.0,12
49600,12839,Kits,11,0,0.0,11
49601,12839,Stuff Packs,16,0,0.0,16
49602,12840,Expansion Packs,15,0,0.0,15
49603,12840,Game Packs,9,0,0.0,9
49604,12840,Kits,5,0,0.0,5
49605,12840,Stuff Packs,11,1,0.09090909090909091,10
49606,12841,Expansion Packs,15,0,0.0,15
49607,12841,Game Packs,9,0,0.0,9
49608,12841,Kits,8,1,0.125,7
49609,12841,Stuff Packs,17,0,0.0,17
49610,12842,Expansion Packs,5,0,0.0,5
49611,12842,Game Packs,5,0,0.0,5
49612,12842,Stuff Packs,8,0,0.0,8
49613,12843,Expansion Packs,16,0,0.0,16
49614,12843,Game Packs,12,0,0.0,12
49615,12843,Kits,20,1,0.05,19
49616,12843,Stuff Packs,17,0,0.0,17
49617,12844,Expansion Packs,16,0,0.0,16
49618,12844,Game Packs,12,0,0.0,12
49619,12844,Kits,20,0,0.0,20
49620,12844,Stuff Packs,20,0,0.0,20
49621,12845,Expansion Packs,16,0,0.0,16
49622,12845,Game Packs,12,0,0.0,12
49623,12845,Kits,33,1,0.030303030303030304,32
49624,12845,Stuff Packs,20,2,0.1,18
49625,12846,Expansion Packs,10,0,0.0,10
49626,12846,Game Packs,5,0,0.0,5
49627,12846,Kits,4,1,0.25,3
49628,12846,Stuff Packs,8,4,0.5,4
49629,12847,Expansion Packs,16,0,0.0,16
49630,12847,Game Packs,12,0,0.0,12
49631,12847,Kits,33,0,0.0,33
49632,12847,Stuff Packs,20,0,0.0,20
49633,12848,Expansion Packs,16,0,0.0,16
49634,12848,Game Packs,8,0,0.0,8
49635,12848,Kits,15,0,0.0,15
49636,12848,Stuff Packs,9,0,0.0,9
49637,12849,Expansion Packs,15,0,0.0,15
49638,12849,Game Packs,12,1,0.08333333333333333,11
49639,12849,Kits,33,0,0.0,33
49640,12849,Stuff Packs,20,0,0.0,20
49641,12850,Expansion Packs,12,0,0.0,12
49642,12850,Game Packs,9,0,0.0,9
49643,12850,Kits,4,0,0.0,4
49644,12850,Stuff Packs,14,1,0.07142857142857142,13
49645,12851,Expansion Packs,16,0,0.0,16
49646,12851,Game Packs,11,0,0.0,11
49647,12851,Kits,31,0,0.0,31
49648,12851,Stuff Packs,19,0,0.0,19
49649,12852,Expansion Packs,13,0,0.0,13
49650,12852,Game Packs,7,0,0.0,7
49651,12852,Kits,7,0,0.0,7
49652,12852,Stuff Packs,9,0,0.0,9
49653,12853,Expansion Packs,16,0,0.0,16
49654,12853,Game Packs,12,0,0.0,12
49655,12853,Kits,33,1,0.030303030303030304,32
49656,12853,Stuff Packs,20,0,0.0,20
49657,12854,Expansion Packs,16,0,0.0,16
49658,12854,Game Packs,12,0,0.0,12
49659,12854,Kits,33,0,0.0,33
49660,12854,Stuff Packs,20,0,0.0,20
49661,12855,Expansion Packs,7,0,0.0,7
49662,12855,Game Packs,6,0,0.0,6
49663,12855,Stuff Packs,9,2,0.2222222222222222,7
49664,12856,Expansion Packs,15,0,0.0,15
49665,12856,Game Packs,10,0,0.0,10
49666,12856,Kits,2,1,0.5,1
49667,12856,Stuff Packs,18,0,0.0,18
49668,12857,Expansion Packs,8,0,0.0,8
49669,12857,Game Packs,2,0,0.0,2
49670,12857,Kits,1,1,1.0,0
49671,12857,Stuff Packs,6,0,0.0,6
49672,12858,Expansion Packs,2,0,0.0,2
49673,12858,Game Packs,3,0,0.0,3
49674,12859,Expansion Packs,6,0,0.0,6
49675,12859,Game Packs,4,0,0.0,4
49676,12859,Kits,2,0,0.0,2
49677,12859,Stuff Packs,4,0,0.0,4
49678,12860,Expansion Packs,15,0,0.0,15
49679,12860,Game Packs,12,0,0.0,12
49680,12860,Kits,16,0,0.0,16
49681,12860,Stuff Packs,18,0,0.0,18
49682,12861,Expansion Packs,16,0,0.0,16
49683,12861,Game Packs,11,0,0.0,11
49684,12861,Kits,25,0,0.0,25
49685,12861,Stuff Packs,19,0,0.0,19
49686,12862,Expansion Packs,7,0,0.0,7
49687,12862,Game Packs,3,0,0.0,3
49688,12862,Kits,2,0,0.0,2
49689,12862,Stuff Packs,5,0,0.0,5
49690,12863,Expansion Packs,14,0,0.0,14
49691,12863,Game Packs,10,0,0.0,10
49692,12863,Kits,11,0,0.0,11
49693,12863,Stuff Packs,9,2,0.2222222222222222,7
49694,12864,Expansion Packs,14,0,0.0,14
49695,12864,Game Packs,9,0,0.0,9
49696,12864,Kits,2,1,0.5,1
49697,12864,Stuff Packs,12,1,0.08333333333333333,11
49698,12865,Expansion Packs,9,0,0.0,9
49699,12865,Game Packs,3,0,0.0,3
49700,12865,Kits,2,2,1.0,0
49701,12865,Stuff Packs,7,0,0.0,7
49702,12866,Expansion Packs,16,0,0.0,16
49703,12866,Game Packs,6,0,0.0,6
49704,12866,Kits,12,0,0.0,12
49705,12866,Stuff Packs,7,1,0.14285714285714285,6
49706,12867,Expansion Packs,8,0,0.0,8
49707,12867,Game Packs,8,0,0.0,8
49708,12867,Kits,18,0,0.0,18
49709,12867,Stuff Packs,6,0,0.0,6
49710,12868,Expansion Packs,14,0,0.0,14
49711,12868,Game Packs,4,0,0.0,4
49712,12868,Kits,14,0,0.0,14
49713,12868,Stuff Packs,16,0,0.0,16
49714,12869,Expansion Packs,16,0,0.0,16
49715,12869,Game Packs,12,0,0.0,12
49716,12869,Kits,33,0,0.0,33
49717,12869,Stuff Packs,20,0,0.0,20
49718,12870,Expansion Packs,16,0,0.0,16
49719,12870,Game Packs,11,0,0.0,11
49720,12870,Kits,26,1,0.038461538461538464,25
49721,12870,Stuff Packs,20,0,0.0,20
49722,12871,Expansion Packs,15,0,0.0,15
49723,12871,Game Packs,7,0,0.0,7
49724,12871,Kits,5,2,0.4,3
49725,12871,Stuff Packs,6,0,0.0,6
49726,12872,Expansion Packs,16,0,0.0,16
49727,12872,Game Packs,12,0,0.0,12
49728,12872,Kits,23,1,0.043478260869565216,22
49729,12872,Stuff Packs,20,3,0.15,17
49730,12873,Expansion Packs,16,0,0.0,16
49731,12873,Game Packs,10,0,0.0,10
49732,12873,Kits,14,2,0.14285714285714285,12
49733,12873,Stuff Packs,18,1,0.05555555555555555,17
49734,12874,Expansion Packs,8,0,0.0,8
49735,12874,Game Packs,5,0,0.0,5
49736,12874,Kits,10,1,0.1,9
49737,12874,Stuff Packs,9,2,0.2222222222222222,7
49738,12875,Expansion Packs,16,0,0.0,16
49739,12875,Game Packs,11,0,0.0,11
49740,12875,Kits,13,1,0.07692307692307693,12
49741,12875,Stuff Packs,15,1,0.06666666666666667,14
49742,12876,Expansion Packs,15,0,0.0,15
49743,12876,Game Packs,12,0,0.0,12
49744,12876,Kits,6,1,0.16666666666666666,5
49745,12876,Stuff Packs,19,0,0.0,19
49746,12877,Expansion Packs,14,0,0.0,14
49747,12877,Game Packs,6,0,0.0,6
49748,12877,Kits,2,1,0.5,1
49749,12877,Stuff Packs,15,2,0.13333333333333333,13
49750,12878,Expansion Packs,15,0,0.0,15
49751,12878,Game Packs,12,0,0.0,12
49752,12878,Kits,6,2,0.3333333333333333,4
49753,12878,Stuff Packs,19,0,0.0,19
49754,12879,Expansion Packs,3,0,0.0,3
49755,12879,Game Packs,3,0,0.0,3
49756,12879,Kits,1,1,1.0,0
49757,12879,Stuff Packs,4,0,0.0,4
49758,12880,Expansion Packs,2,0,0.0,2
49759,12880,Game Packs,2,2,1.0,0
49760,12880,Kits,4,1,0.25,3
49761,12880,Stuff Packs,5,3,0.6,2
49762,12881,Expansion Packs,9,0,0.0,9
49763,12881,Game Packs,3,0,0.0,3
49764,12881,Kits,1,0,0.0,1
49765,12881,Stuff Packs,4,0,0.0,4
49766,12882,Expansion Packs,6,0,0.0,6
49767,12882,Game Packs,6,2,0.3333333333333333,4
49768,12882,Kits,4,3,0.75,1
49769,12882,Stuff Packs,10,3,0.3,7
49770,12883,Expansion Packs,15,0,0.0,15
49771,12883,Game Packs,10,0,0.0,10
49772,12883,Kits,6,1,0.16666666666666666,5
49773,12883,Stuff Packs,19,0,0.0,19
49774,12884,Expansion Packs,14,0,0.0,14
49775,12884,Game Packs,11,0,0.0,11
49776,12884,Kits,6,1,0.16666666666666666,5
49777,12884,Stuff Packs,20,0,0.0,20
49778,12885,Expansion Packs,15,0,0.0,15
49779,12885,Game Packs,9,0,0.0,9
49780,12885,Kits,17,0,0.0,17
49781,12885,Stuff Packs,13,0,0.0,13
49782,12886,Expansion Packs,16,0,0.0,16
49783,12886,Game Packs,12,0,0.0,12
49784,12886,Kits,33,0,0.0,33
49785,12886,Stuff Packs,20,0,0.0,20
49786,12887,Expansion Packs,14,0,0.0,14
49787,12887,Game Packs,10,0,0.0,10
49788,12887,Stuff Packs,5,0,0.0,5
49789,12888,Expansion Packs,9,0,0.0,9
49790,12888,Game Packs,4,0,0.0,4
49791,12888,Kits,7,1,0.14285714285714285,6
49792,12888,Stuff Packs,11,3,0.2727272727272727,8
49793,12889,Expansion Packs,12,0,0.0,12
49794,12889,Game Packs,3,0,0.0,3
49795,12889,Stuff Packs,3,0,0.0,3
49796,12890,Expansion Packs,15,0,0.0,15
49797,12890,Game Packs,12,0,0.0,12
49798,12890,Kits,33,3,0.09090909090909091,30
49799,12890,Stuff Packs,20,1,0.05,19
49800,12891,Expansion Packs,15,0,0.0,15
49801,12891,Game Packs,11,0,0.0,11
49802,12891,Kits,16,1,0.0625,15
49803,12891,Stuff Packs,20,0,0.0,20
49804,12892,Expansion Packs,6,0,0.0,6
49805,12892,Game Packs,3,0,0.0,3
49806,12892,Kits,2,1,0.5,1
49807,12892,Stuff Packs,8,2,0.25,6
49808,12893,Expansion Packs,10,0,0.0,10
49809,12893,Game Packs,8,0,0.0,8
49810,12893,Kits,3,1,0.3333333333333333,2
49811,12893,Stuff Packs,9,0,0.0,9
49812,12894,Expansion Packs,16,0,0.0,16
49813,12894,Game Packs,11,0,0.0,11
49814,12894,Kits,16,0,0.0,16
49815,12894,Stuff Packs,17,0,0.0,17
49816,12895,Expansion Packs,7,1,0.14285714285714285,6
49817,12895,Game Packs,4,0,0.0,4
49818,12895,Stuff Packs,6,2,0.3333333333333333,4
49819,12896,Expansion Packs,14,0,0.0,14
49820,12896,Game Packs,3,0,0.0,3
49821,12896,Kits,1,1,1.0,0
49822,12896,Stuff Packs,4,2,0.5,2
49823,12897,Expansion Packs,6,1,0.16666666666666666,5
49824,12897,Game Packs,1,0,0.0,1
49825,12897,Kits,1,0,0.0,1
49826,12897,Stuff Packs,2,0,0.0,2
49827,12898,Expansion Packs,16,0,0.0,16
49828,12898,Game Packs,8,0,0.0,8
49829,12898,Kits,13,1,0.07692307692307693,12
49830,12898,Stuff Packs,10,2,0.2,8
49831,12899,Expansion Packs,16,0,0.0,16
49832,12899,Game Packs,12,0,0.0,12
49833,12899,Kits,33,0,0.0,33
49834,12899,Stuff Packs,20,0,0.0,20
49835,12900,Expansion Packs,2,0,0.0,2
49836,12900,Game Packs,2,0,0.0,2
49837,12900,Kits,21,0,0.0,21
49838,12900,Stuff Packs,2,0,0.0,2
49839,12901,Expansion Packs,10,0,0.0,10
49840,12901,Game Packs,3,0,0.0,3
49841,12901,Kits,4,3,0.75,1
49842,12901,Stuff Packs,8,4,0.5,4
49843,12902,Expansion Packs,10,0,0.0,10
49844,12902,Game Packs,3,1,0.3333333333333333,2
49845,12902,Kits,4,3,0.75,1
49846,12902,Stuff Packs,6,4,0.6666666666666666,2
49847,12903,Expansion Packs,15,0,0.0,15
49848,12903,Game Packs,11,0,0.0,11
49849,12903,Kits,14,1,0.07142857142857142,13
49850,12903,Stuff Packs,20,0,0.0,20
49851,12904,Expansion Packs,9,0,0.0,9
49852,12904,Game Packs,7,0,0.0,7
49853,12904,Kits,1,1,1.0,0
49854,12904,Stuff Packs,13,0,0.0,13
49855,12905,Expansion Packs,4,0,0.0,4
49856,12905,Game Packs,3,0,0.0,3
49857,12905,Kits,3,1,0.3333333333333333,2
49858,12905,Stuff Packs,7,4,0.5714285714285714,3
49859,12906,Expansion Packs,16,0,0.0,16
49860,12906,Game Packs,9,0,0.0,9
49861,12906,Kits,21,0,0.0,21
49862,12906,Stuff Packs,10,0,0.0,10
49863,12907,Expansion Packs,16,0,0.0,16
49864,12907,Game Packs,12,0,0.0,12
49865,12907,Kits,33,1,0.030303030303030304,32
49866,12907,Stuff Packs,20,0,0.0,20
49867,12908,Expansion Packs,15,0,0.0,15
49868,12908,Game Packs,6,2,0.3333333333333333,4
49869,12908,Kits,14,0,0.0,14
49870,12908,Stuff Packs,13,5,0.38461538461538464,8
49871,12909,Expansion Packs,16,0,0.0,16
49872,12909,Game Packs,12,0,0.0,12
49873,12909,Kits,29,0,0.0,29
49874,12909,Stuff Packs,20,0,0.0,20
49875,12910,Expansion Packs,16,0,0.0,16
49876,12910,Game Packs,12,0,0.0,12
49877,12910,Kits,28,1,0.03571428571428571,27
49878,12910,Stuff Packs,20,0,0.0,20
49879,12911,Expansion Packs,13,0,0.0,13
49880,12911,Game Packs,11,0,0.0,11
49881,12911,Kits,6,1,0.16666666666666666,5
49882,12911,Stuff Packs,17,1,0.058823529411764705,16
49883,12912,Expansion Packs,15,0,0.0,15
49884,12912,Game Packs,11,0,0.0,11
49885,12912,Kits,7,1,0.14285714285714285,6
49886,12912,Stuff Packs,17,4,0.23529411764705882,13
49887,12913,Expansion Packs,16,0,0.0,16
49888,12913,Game Packs,12,0,0.0,12
49889,12913,Kits,32,0,0.0,32
49890,12913,Stuff Packs,20,0,0.0,20
49891,12914,Expansion Packs,13,0,0.0,13
49892,12914,Game Packs,6,0,0.0,6
49893,12914,Kits,2,0,0.0,2
49894,12914,Stuff Packs,4,0,0.0,4
49895,12915,Expansion Packs,6,0,0.0,6
49896,12915,Game Packs,5,0,0.0,5
49897,12915,Stuff Packs,1,0,0.0,1
49898,12916,Expansion Packs,13,0,0.0,13
49899,12916,Game Packs,10,0,0.0,10
49900,12916,Kits,7,2,0.2857142857142857,5
49901,12916,Stuff Packs,18,0,0.0,18
49902,12917,Stuff Packs,5,4,0.8,1
49903,12918,Expansion Packs,16,0,0.0,16
49904,12918,Game Packs,12,0,0.0,12
49905,12918,Kits,33,0,0.0,33
49906,12918,Stuff Packs,20,0,0.0,20
49907,12919,Expansion Packs,16,0,0.0,16
49908,12919,Game Packs,11,0,0.0,11
49909,12919,Kits,10,0,0.0,10
49910,12919,Stuff Packs,18,0,0.0,18
49911,12920,Expansion Packs,6,0,0.0,6
49912,12920,Game Packs,4,0,0.0,4
49913,12920,Kits,2,0,0.0,2
49914,12920,Stuff Packs,6,0,0.0,6
49915,12921,Expansion Packs,4,0,0.0,4
49916,12921,Game Packs,5,0,0.0,5
49917,12921,Kits,1,1,1.0,0
49918,12921,Stuff Packs,4,3,0.75,1
49919,12922,Expansion Packs,14,1,0.07142857142857142,13
49920,12922,Game Packs,11,1,0.09090909090909091,10
49921,12922,Kits,11,0,0.0,11
49922,12922,Stuff Packs,18,0,0.0,18
49923,12923,Expansion Packs,12,0,0.0,12
49924,12923,Game Packs,9,2,0.2222222222222222,7
49925,12923,Kits,8,2,0.25,6
49926,12923,Stuff Packs,10,3,0.3,7
49927,12924,Expansion Packs,16,0,0.0,16
49928,12924,Game Packs,8,0,0.0,8
49929,12924,Kits,24,0,0.0,24
49930,12924,Stuff Packs,17,0,0.0,17
49931,12925,Expansion Packs,14,0,0.0,14
49932,12925,Game Packs,5,0,0.0,5
49933,12925,Kits,4,1,0.25,3
49934,12925,Stuff Packs,6,2,0.3333333333333333,4
49935,12926,Expansion Packs,16,0,0.0,16
49936,12926,Game Packs,11,0,0.0,11
49937,12926,Kits,7,1,0.14285714285714285,6
49938,12926,Stuff Packs,15,3,0.2,12
49939,12927,Expansion Packs,12,0,0.0,12
49940,12927,Game Packs,7,0,0.0,7
49941,12927,Kits,1,1,1.0,0
49942,12927,Stuff Packs,9,1,0.1111111111111111,8
49943,12928,Expansion Packs,2,0,0.0,2
49944,12928,Kits,1,1,1.0,0
49945,12928,Stuff Packs,3,3,1.0,0
49946,12929,Expansion Packs,12,0,0.0,12
49947,12929,Game Packs,11,0,0.0,11
49948,12929,Stuff Packs,17,0,0.0,17
49949,12930,Expansion Packs,15,0,0.0,15
49950,12930,Game Packs,12,0,0.0,12
49951,12930,Kits,14,0,0.0,14
49952,12930,Stuff Packs,16,0,0.0,16
49953,12931,Expansion Packs,16,0,0.0,16
49954,12931,Game Packs,12,1,0.08333333333333333,11
49955,12931,Kits,2,1,0.5,1
49956,12931,Stuff Packs,15,1,0.06666666666666667,14
49957,12932,Expansion Packs,16,0,0.0,16
49958,12932,Game Packs,12,0,0.0,12
49959,12932,Kits,33,0,0.0,33
49960,12932,Stuff Packs,20,0,0.0,20
49961,12933,Expansion Packs,8,0,0.0,8
49962,12933,Game Packs,1,0,0.0,1
49963,12933,Kits,2,2,1.0,0
49964,12933,Stuff Packs,4,2,0.5,2
49965,12934,Expansion Packs,16,0,0.0,16
49966,12934,Game Packs,12,0,0.0,12
49967,12934,Kits,10,1,0.1,9
49968,12934,Stuff Packs,16,0,0.0,16
49969,12935,Expansion Packs,7,0,0.0,7
49970,12935,Game Packs,5,0,0.0,5
49971,12935,Kits,2,0,0.0,2
49972,12935,Stuff Packs,6,0,0.0,6
49973,12936,Expansion Packs,16,0,0.0,16
49974,12936,Game Packs,12,0,0.0,12
49975,12936,Kits,33,0,0.0,33
49976,12936,Stuff Packs,20,0,0.0,20
49977,12937,Expansion Packs,15,0,0.0,15
49978,12937,Game Packs,11,0,0.0,11
49979,12937,Kits,20,0,0.0,20
49980,12937,Stuff Packs,11,0,0.0,11
49981,12938,Expansion Packs,7,0,0.0,7
49982,12938,Game Packs,2,0,0.0,2
49983,12938,Kits,2,1,0.5,1
49984,12939,Expansion Packs,7,1,0.14285714285714285,6
49985,12939,Game Packs,2,0,0.0,2
49986,12939,Kits,8,1,0.125,7
49987,12939,Stuff Packs,9,4,0.4444444444444444,5
49988,12940,Expansion Packs,4,0,0.0,4
49989,12940,Game Packs,2,0,0.0,2
49990,12940,Stuff Packs,1,0,0.0,1
49991,12941,Expansion Packs,7,0,0.0,7
49992,12941,Game Packs,4,0,0.0,4
49993,12941,Kits,9,1,0.1111111111111111,8
49994,12941,Stuff Packs,12,0,0.0,12
49995,12942,Expansion Packs,13,0,0.0,13
49996,12942,Game Packs,4,0,0.0,4
49997,12942,Kits,7,1,0.14285714285714285,6
49998,12942,Stuff Packs,9,2,0.2222222222222222,7
49999,12943,Expansion Packs,11,0,0.0,11
50000,12943,Game Packs,12,1,0.08333333333333333,11
50001,12943,Kits,8,0,0.0,8
50002,12943,Stuff Packs,18,0,0.0,18
50003,12944,Expansion Packs,15,0,0.0,15
50004,12944,Game Packs,11,0,0.0,11
50005,12944,Kits,13,1,0.07692307692307693,12
50006,12944,Stuff Packs,14,1,0.07142857142857142,13
50007,12945,Expansion Packs,16,0,0.0,16
50008,12945,Game Packs,12,0,0.0,12
50009,12945,Kits,32,0,0.0,32
50010,12945,Stuff Packs,20,0,0.0,20
50011,12946,Expansion Packs,16,0,0.0,16
50012,12946,Game Packs,12,0,0.0,12
50013,12946,Kits,33,0,0.0,33
50014,12946,Stuff Packs,20,0,0.0,20
50015,12947,Expansion Packs,16,0,0.0,16
50016,12947,Game Packs,12,0,0.0,12
50017,12947,Kits,33,1,0.030303030303030304,32
50018,12947,Stuff Packs,20,0,0.0,20
50019,12948,Expansion Packs,13,0,0.0,13
50020,12948,Game Packs,6,1,0.16666666666666666,5
50021,12948,Kits,3,1,0.3333333333333333,2
50022,12948,Stuff Packs,11,3,0.2727272727272727,8
50023,12949,Expansion Packs,16,0,0.0,16
50024,12949,Game Packs,12,0,0.0,12
50025,12949,Kits,33,0,0.0,33
50026,12949,Stuff Packs,20,0,0.0,20
50027,12950,Expansion Packs,16,0,0.0,16
50028,12950,Game Packs,12,0,0.0,12
50029,12950,Kits,33,2,0.06060606060606061,31
50030,12950,Stuff Packs,20,0,0.0,20
50031,12951,Expansion Packs,16,0,0.0,16
50032,12951,Game Packs,11,0,0.0,11
50033,12951,Kits,10,2,0.2,8
50034,12951,Stuff Packs,14,0,0.0,14
50035,12952,Expansion Packs,10,0,0.0,10
50036,12952,Game Packs,2,0,0.0,2
50037,12952,Kits,1,0,0.0,1
50038,12952,Stuff Packs,2,0,0.0,2
50039,12953,Expansion Packs,16,0,0.0,16
50040,12953,Game Packs,6,0,0.0,6
50041,12953,Kits,23,1,0.043478260869565216,22
50042,12953,Stuff Packs,17,0,0.0,17
50043,12954,Expansion Packs,10,0,0.0,10
50044,12954,Game Packs,5,0,0.0,5
50045,12954,Kits,1,1,1.0,0
50046,12954,Stuff Packs,8,2,0.25,6
50047,12955,Expansion Packs,16,0,0.0,16
50048,12955,Game Packs,12,0,0.0,12
50049,12955,Kits,31,1,0.03225806451612903,30
50050,12955,Stuff Packs,20,0,0.0,20
50051,12956,Expansion Packs,16,0,0.0,16
50052,12956,Game Packs,12,0,0.0,12
50053,12956,Kits,28,0,0.0,28
50054,12956,Stuff Packs,20,0,0.0,20
50055,12957,Expansion Packs,15,0,0.0,15
50056,12957,Game Packs,11,0,0.0,11
50057,12957,Kits,15,0,0.0,15
50058,12957,Stuff Packs,16,0,0.0,16
50059,12958,Expansion Packs,16,0,0.0,16
50060,12958,Game Packs,10,0,0.0,10
50061,12958,Kits,28,0,0.0,28
50062,12958,Stuff Packs,19,0,0.0,19
50063,12959,Expansion Packs,11,0,0.0,11
50064,12959,Game Packs,4,0,0.0,4
50065,12959,Stuff Packs,7,0,0.0,7
50066,12960,Expansion Packs,8,0,0.0,8
50067,12960,Game Packs,7,0,0.0,7
50068,12960,Kits,8,1,0.125,7
50069,12960,Stuff Packs,8,4,0.5,4
50070,12961,Expansion Packs,8,0,0.0,8
50071,12961,Game Packs,3,0,0.0,3
50072,12961,Kits,2,2,1.0,0
50073,12961,Stuff Packs,4,1,0.25,3
50074,12962,Expansion Packs,5,0,0.0,5
50075,12962,Game Packs,2,0,0.0,2
50076,12962,Kits,1,1,1.0,0
50077,12962,Stuff Packs,3,0,0.0,3
50078,12963,Expansion Packs,14,0,0.0,14
50079,12963,Game Packs,12,0,0.0,12
50080,12963,Kits,20,0,0.0,20
50081,12963,Stuff Packs,19,0,0.0,19
50082,12964,Expansion Packs,15,0,0.0,15
50083,12964,Game Packs,9,0,0.0,9
50084,12964,Kits,8,1,0.125,7
50085,12964,Stuff Packs,16,4,0.25,12
50086,12965,Expansion Packs,16,13,0.8125,3
50087,12965,Game Packs,12,5,0.4166666666666667,7
50088,12965,Kits,33,0,0.0,33
50089,12965,Stuff Packs,20,0,0.0,20
50090,12966,Expansion Packs,14,0,0.0,14
50091,12966,Game Packs,5,0,0.0,5
50092,12966,Kits,7,0,0.0,7
50093,12966,Stuff Packs,10,0,0.0,10
50094,12967,Expansion Packs,9,0,0.0,9
50095,12967,Game Packs,2,0,0.0,2
50096,12967,Stuff Packs,5,2,0.4,3
50097,12968,Expansion Packs,16,0,0.0,16
50098,12968,Game Packs,12,0,0.0,12
50099,12968,Kits,30,1,0.03333333333333333,29
50100,12968,Stuff Packs,20,0,0.0,20
50101,12969,Expansion Packs,16,0,0.0,16
50102,12969,Game Packs,12,0,0.0,12
50103,12969,Kits,20,0,0.0,20
50104,12969,Stuff Packs,20,0,0.0,20
50105,12970,Expansion Packs,1,0,0.0,1
50106,12970,Game Packs,1,0,0.0,1
50107,12970,Kits,1,1,1.0,0
50108,12970,Stuff Packs,4,3,0.75,1
50109,12971,Expansion Packs,16,0,0.0,16
50110,12971,Game Packs,9,0,0.0,9
50111,12971,Kits,16,1,0.0625,15
50112,12971,Stuff Packs,12,2,0.16666666666666666,10
50113,12972,Expansion Packs,14,0,0.0,14
50114,12972,Game Packs,11,0,0.0,11
50115,12972,Kits,9,0,0.0,9
50116,12972,Stuff Packs,19,0,0.0,19
50117,12973,Expansion Packs,15,0,0.0,15
50118,12973,Game Packs,9,0,0.0,9
50119,12973,Kits,14,3,0.21428571428571427,11
50120,12973,Stuff Packs,18,0,0.0,18
50121,12974,Expansion Packs,12,0,0.0,12
50122,12974,Game Packs,11,0,0.0,11
50123,12974,Kits,7,0,0.0,7
50124,12974,Stuff Packs,15,0,0.0,15
50125,12975,Expansion Packs,15,0,0.0,15
50126,12975,Game Packs,9,1,0.1111111111111111,8
50127,12975,Kits,16,2,0.125,14
50128,12975,Stuff Packs,17,5,0.29411764705882354,12
50129,12976,Expansion Packs,16,0,0.0,16
50130,12976,Game Packs,11,0,0.0,11
50131,12976,Kits,12,0,0.0,12
50132,12976,Stuff Packs,20,0,0.0,20
50133,12977,Expansion Packs,7,0,0.0,7
50134,12977,Game Packs,5,0,0.0,5
50135,12977,Kits,6,1,0.16666666666666666,5
50136,12977,Stuff Packs,9,2,0.2222222222222222,7
50137,12978,Expansion Packs,14,0,0.0,14
50138,12978,Game Packs,11,0,0.0,11
50139,12978,Kits,15,1,0.06666666666666667,14
50140,12978,Stuff Packs,19,0,0.0,19
50141,12979,Expansion Packs,9,0,0.0,9
50142,12979,Game Packs,3,1,0.3333333333333333,2
50143,12979,Kits,4,4,1.0,0
50144,12979,Stuff Packs,8,4,0.5,4
50145,12980,Expansion Packs,6,0,0.0,6
50146,12980,Game Packs,6,0,0.0,6
50147,12980,Kits,9,0,0.0,9
50148,12980,Stuff Packs,5,0,0.0,5
50149,12981,Expansion Packs,1,0,0.0,1
50150,12981,Stuff Packs,2,2,1.0,0
50151,12982,Expansion Packs,13,0,0.0,13
50152,12982,Game Packs,7,0,0.0,7
50153,12982,Kits,2,2,1.0,0
50154,12982,Stuff Packs,10,2,0.2,8
50155,12983,Expansion Packs,16,1,0.0625,15
50156,12983,Game Packs,8,0,0.0,8
50157,12983,Kits,13,2,0.15384615384615385,11
50158,12983,Stuff Packs,14,3,0.21428571428571427,11
50159,12984,Expansion Packs,16,0,0.0,16
50160,12984,Game Packs,8,0,0.0,8
50161,12984,Kits,4,1,0.25,3
50162,12984,Stuff Packs,13,0,0.0,13
50163,12985,Expansion Packs,16,0,0.0,16
50164,12985,Game Packs,11,0,0.0,11
50165,12985,Kits,33,0,0.0,33
50166,12985,Stuff Packs,20,0,0.0,20
50167,12986,Expansion Packs,16,0,0.0,16
50168,12986,Game Packs,11,0,0.0,11
50169,12986,Kits,10,0,0.0,10
50170,12986,Stuff Packs,15,4,0.26666666666666666,11
50171,12987,Expansion Packs,16,0,0.0,16
50172,12987,Game Packs,7,1,0.14285714285714285,6
50173,12987,Kits,24,0,0.0,24
50174,12987,Stuff Packs,10,3,0.3,7
50175,12988,Expansion Packs,16,0,0.0,16
50176,12988,Game Packs,10,1,0.1,9
50177,12988,Kits,6,2,0.3333333333333333,4
50178,12988,Stuff Packs,7,4,0.5714285714285714,3
50179,12989,Expansion Packs,16,0,0.0,16
50180,12989,Game Packs,12,0,0.0,12
50181,12989,Kits,33,0,0.0,33
50182,12989,Stuff Packs,20,0,0.0,20
50183,12990,Expansion Packs,16,0,0.0,16
50184,12990,Game Packs,11,1,0.09090909090909091,10
50185,12990,Kits,19,2,0.10526315789473684,17
50186,12990,Stuff Packs,17,3,0.17647058823529413,14
50187,12991,Expansion Packs,14,0,0.0,14
50188,12991,Game Packs,12,0,0.0,12
50189,12991,Kits,24,0,0.0,24
50190,12991,Stuff Packs,20,0,0.0,20
50191,12992,Expansion Packs,16,0,0.0,16
50192,12992,Game Packs,12,0,0.0,12
50193,12992,Kits,33,1,0.030303030303030304,32
50194,12992,Stuff Packs,20,0,0.0,20
50195,12993,Expansion Packs,16,0,0.0,16
50196,12993,Game Packs,12,0,0.0,12
50197,12993,Kits,33,1,0.030303030303030304,32
50198,12993,Stuff Packs,20,0,0.0,20
50199,12994,Expansion Packs,5,0,0.0,5
50200,12994,Game Packs,2,0,0.0,2
50201,12994,Stuff Packs,5,3,0.6,2
50202,12995,Expansion Packs,14,0,0.0,14
50203,12995,Game Packs,11,0,0.0,11
50204,12995,Kits,18,0,0.0,18
50205,12995,Stuff Packs,18,0,0.0,18
50206,12996,Expansion Packs,7,0,0.0,7
50207,12996,Game Packs,2,0,0.0,2
50208,12996,Stuff Packs,4,0,0.0,4
50209,12997,Expansion Packs,14,0,0.0,14
50210,12997,Game Packs,11,0,0.0,11
50211,12997,Kits,5,3,0.6,2
50212,12997,Stuff Packs,20,0,0.0,20
50213,12998,Expansion Packs,16,0,0.0,16
50214,12998,Game Packs,11,0,0.0,11
50215,12998,Kits,13,0,0.0,13
50216,12998,Stuff Packs,20,0,0.0,20
50217,12999,Expansion Packs,14,14,1.0,0
50218,12999,Game Packs,12,12,1.0,0
50219,12999,Kits,16,16,1.0,0
50220,12999,Stuff Packs,19,19,1.0,0
50221,13000,Expansion Packs,14,0,0.0,14
50222,13000,Game Packs,9,0,0.0,9
50223,13000,Kits,1,0,0.0,1
50224,13000,Stuff Packs,4,0,0.0,4
50225,13001,Expansion Packs,7,0,0.0,7
50226,13001,Game Packs,2,0,0.0,2
50227,13001,Kits,10,0,0.0,10
50228,13001,Stuff Packs,10,2,0.2,8
50229,13002,Expansion Packs,15,0,0.0,15
50230,13002,Game Packs,2,0,0.0,2
50231,13002,Kits,11,1,0.09090909090909091,10
50232,13002,Stuff Packs,9,3,0.3333333333333333,6
50233,13003,Expansion Packs,13,0,0.0,13
50234,13003,Game Packs,10,0,0.0,10
50235,13003,Kits,6,0,0.0,6
50236,13003,Stuff Packs,19,0,0.0,19
50237,13004,Expansion Packs,14,0,0.0,14
50238,13004,Game Packs,10,0,0.0,10
50239,13004,Kits,6,1,0.16666666666666666,5
50240,13004,Stuff Packs,18,0,0.0,18
50241,13005,Expansion Packs,16,0,0.0,16
50242,13005,Game Packs,12,0,0.0,12
50243,13005,Kits,33,0,0.0,33
50244,13005,Stuff Packs,20,0,0.0,20
50245,13006,Expansion Packs,12,1,0.08333333333333333,11
50246,13006,Game Packs,6,0,0.0,6
50247,13006,Kits,21,0,0.0,21
50248,13006,Stuff Packs,13,2,0.15384615384615385,11
50249,13007,Expansion Packs,16,0,0.0,16
50250,13007,Game Packs,12,0,0.0,12
50251,13007,Kits,33,0,0.0,33
50252,13007,Stuff Packs,20,0,0.0,20
50253,13008,Expansion Packs,16,0,0.0,16
50254,13008,Game Packs,12,0,0.0,12
50255,13008,Kits,18,0,0.0,18
50256,13008,Stuff Packs,20,0,0.0,20
50257,13009,Expansion Packs,16,0,0.0,16
50258,13009,Game Packs,11,0,0.0,11
50259,13009,Kits,3,0,0.0,3
50260,13009,Stuff Packs,19,0,0.0,19
50261,13010,Expansion Packs,13,0,0.0,13
50262,13010,Game Packs,3,0,0.0,3
50263,13010,Kits,2,1,0.5,1
50264,13010,Stuff Packs,8,2,0.25,6
50265,13011,Expansion Packs,16,0,0.0,16
50266,13011,Game Packs,11,0,0.0,11
50267,13011,Kits,31,2,0.06451612903225806,29
50268,13011,Stuff Packs,19,1,0.05263157894736842,18
50269,13012,Expansion Packs,12,0,0.0,12
50270,13012,Game Packs,7,0,0.0,7
50271,13012,Stuff Packs,8,0,0.0,8
50272,13013,Expansion Packs,15,0,0.0,15
50273,13013,Game Packs,11,0,0.0,11
50274,13013,Kits,5,2,0.4,3
50275,13013,Stuff Packs,15,2,0.13333333333333333,13
50276,13014,Expansion Packs,15,0,0.0,15
50277,13014,Game Packs,8,0,0.0,8
50278,13014,Stuff Packs,14,2,0.14285714285714285,12
50279,13015,Expansion Packs,9,0,0.0,9
50280,13015,Game Packs,8,0,0.0,8
50281,13015,Stuff Packs,7,0,0.0,7
50282,13016,Expansion Packs,9,1,0.1111111111111111,8
50283,13016,Game Packs,3,0,0.0,3
50284,13016,Stuff Packs,3,0,0.0,3
50285,13017,Expansion Packs,16,0,0.0,16
50286,13017,Game Packs,12,0,0.0,12
50287,13017,Kits,31,0,0.0,31
50288,13017,Stuff Packs,20,0,0.0,20
50289,13018,Expansion Packs,12,0,0.0,12
50290,13018,Game Packs,10,0,0.0,10
50291,13018,Kits,12,1,0.08333333333333333,11
50292,13018,Stuff Packs,15,0,0.0,15
50293,13019,Expansion Packs,11,0,0.0,11
50294,13019,Game Packs,9,0,0.0,9
50295,13019,Kits,5,1,0.2,4
50296,13019,Stuff Packs,10,1,0.1,9
50297,13020,Expansion Packs,11,0,0.0,11
50298,13020,Game Packs,10,0,0.0,10
50299,13020,Kits,3,2,0.6666666666666666,1
50300,13020,Stuff Packs,15,1,0.06666666666666667,14
50301,13021,Expansion Packs,12,0,0.0,12
50302,13021,Game Packs,3,0,0.0,3
50303,13021,Kits,6,0,0.0,6
50304,13021,Stuff Packs,3,0,0.0,3
50305,13022,Expansion Packs,9,0,0.0,9
50306,13022,Game Packs,5,0,0.0,5
50307,13022,Kits,2,2,1.0,0
50308,13022,Stuff Packs,9,0,0.0,9
50309,13023,Expansion Packs,16,0,0.0,16
50310,13023,Game Packs,12,0,0.0,12
50311,13023,Kits,33,0,0.0,33
50312,13023,Stuff Packs,20,0,0.0,20
50313,13024,Expansion Packs,5,0,0.0,5
50314,13024,Game Packs,4,0,0.0,4
50315,13024,Stuff Packs,7,3,0.42857142857142855,4
50316,13025,Expansion Packs,14,0,0.0,14
50317,13025,Game Packs,9,1,0.1111111111111111,8
50318,13025,Kits,5,2,0.4,3
50319,13025,Stuff Packs,11,3,0.2727272727272727,8
50320,13026,Expansion Packs,10,1,0.1,9
50321,13026,Game Packs,2,0,0.0,2
50322,13026,Kits,6,1,0.16666666666666666,5
50323,13026,Stuff Packs,3,1,0.3333333333333333,2
50324,13027,Expansion Packs,15,0,0.0,15
50325,13027,Game Packs,11,0,0.0,11
50326,13027,Kits,14,0,0.0,14
50327,13027,Stuff Packs,20,2,0.1,18
50328,13028,Expansion Packs,16,2,0.125,14
50329,13028,Game Packs,12,4,0.3333333333333333,8
50330,13028,Kits,33,33,1.0,0
50331,13028,Stuff Packs,20,12,0.6,8
50332,13029,Expansion Packs,16,0,0.0,16
50333,13029,Game Packs,12,0,0.0,12
50334,13029,Kits,25,0,0.0,25
50335,13029,Stuff Packs,19,0,0.0,19
50336,13030,Expansion Packs,7,0,0.0,7
50337,13030,Game Packs,2,0,0.0,2
50338,13030,Kits,1,1,1.0,0
50339,13030,Stuff Packs,5,0,0.0,5
50340,13031,Expansion Packs,10,0,0.0,10
50341,13031,Game Packs,10,0,0.0,10
50342,13031,Kits,6,0,0.0,6
50343,13031,Stuff Packs,13,0,0.0,13
50344,13032,Expansion Packs,12,0,0.0,12
50345,13032,Game Packs,5,0,0.0,5
50346,13032,Kits,2,0,0.0,2
50347,13032,Stuff Packs,7,2,0.2857142857142857,5
50348,13033,Expansion Packs,15,0,0.0,15
50349,13033,Game Packs,10,0,0.0,10
50350,13033,Kits,1,1,1.0,0
50351,13033,Stuff Packs,11,1,0.09090909090909091,10
50352,13034,Expansion Packs,4,0,0.0,4
50353,13034,Game Packs,3,0,0.0,3
50354,13034,Stuff Packs,2,0,0.0,2
50355,13035,Expansion Packs,8,0,0.0,8
50356,13035,Game Packs,5,0,0.0,5
50357,13035,Kits,3,3,1.0,0
50358,13035,Stuff Packs,4,4,1.0,0
50359,13036,Expansion Packs,15,0,0.0,15
50360,13036,Game Packs,10,0,0.0,10
50361,13036,Kits,6,0,0.0,6
50362,13036,Stuff Packs,19,0,0.0,19
50363,13037,Expansion Packs,16,0,0.0,16
50364,13037,Game Packs,12,0,0.0,12
50365,13037,Kits,16,0,0.0,16
50366,13037,Stuff Packs,20,0,0.0,20
50367,13038,Expansion Packs,1,0,0.0,1
50368,13038,Game Packs,2,0,0.0,2
50369,13038,Stuff Packs,2,2,1.0,0
50370,13039,Expansion Packs,16,0,0.0,16
50371,13039,Game Packs,12,0,0.0,12
50372,13039,Kits,33,0,0.0,33
50373,13039,Stuff Packs,20,0,0.0,20
50374,13040,Expansion Packs,16,0,0.0,16
50375,13040,Game Packs,11,0,0.0,11
50376,13040,Kits,15,0,0.0,15
50377,13040,Stuff Packs,16,0,0.0,16
50378,13041,Expansion Packs,16,0,0.0,16
50379,13041,Game Packs,12,0,0.0,12
50380,13041,Kits,33,1,0.030303030303030304,32
50381,13041,Stuff Packs,20,0,0.0,20
50382,13042,Expansion Packs,6,0,0.0,6
50383,13042,Game Packs,3,0,0.0,3
50384,13042,Kits,4,1,0.25,3
50385,13042,Stuff Packs,6,2,0.3333333333333333,4
50386,13043,Expansion Packs,13,0,0.0,13
50387,13043,Game Packs,9,0,0.0,9
50388,13043,Kits,1,1,1.0,0
50389,13043,Stuff Packs,14,1,0.07142857142857142,13
50390,13044,Expansion Packs,4,0,0.0,4
50391,13044,Game Packs,2,0,0.0,2
50392,13044,Kits,1,0,0.0,1
50393,13044,Stuff Packs,8,3,0.375,5
50394,13045,Expansion Packs,12,0,0.0,12
50395,13045,Game Packs,10,0,0.0,10
50396,13045,Kits,2,1,0.5,1
50397,13045,Stuff Packs,8,0,0.0,8
50398,13046,Expansion Packs,13,0,0.0,13
50399,13046,Game Packs,10,0,0.0,10
50400,13046,Kits,3,3,1.0,0
50401,13046,Stuff Packs,18,0,0.0,18
50402,13047,Expansion Packs,4,0,0.0,4
50403,13047,Game Packs,2,0,0.0,2
50404,13047,Kits,3,1,0.3333333333333333,2
50405,13047,Stuff Packs,5,1,0.2,4
50406,13048,Expansion Packs,16,0,0.0,16
50407,13048,Game Packs,12,0,0.0,12
50408,13048,Kits,28,0,0.0,28
50409,13048,Stuff Packs,20,0,0.0,20
50410,13049,Expansion Packs,15,0,0.0,15
50411,13049,Game Packs,10,0,0.0,10
50412,13049,Kits,2,2,1.0,0
50413,13049,Stuff Packs,12,3,0.25,9
50414,13050,Expansion Packs,16,0,0.0,16
50415,13050,Game Packs,12,0,0.0,12
50416,13050,Kits,33,0,0.0,33
50417,13050,Stuff Packs,20,0,0.0,20
50418,13051,Expansion Packs,7,0,0.0,7
50419,13051,Game Packs,8,0,0.0,8
50420,13051,Kits,4,0,0.0,4
50421,13051,Stuff Packs,16,0,0.0,16
50422,13052,Expansion Packs,16,0,0.0,16
50423,13052,Game Packs,12,0,0.0,12
50424,13052,Kits,13,0,0.0,13
50425,13052,Stuff Packs,20,0,0.0,20
50426,13053,Expansion Packs,16,0,0.0,16
50427,13053,Game Packs,9,0,0.0,9
50428,13053,Kits,3,2,0.6666666666666666,1
50429,13053,Stuff Packs,13,2,0.15384615384615385,11
50430,13054,Expansion Packs,15,0,0.0,15
50431,13054,Game Packs,11,0,0.0,11
50432,13054,Kits,5,1,0.2,4
50433,13054,Stuff Packs,20,0,0.0,20
50434,13055,Expansion Packs,16,0,0.0,16
50435,13055,Game Packs,11,0,0.0,11
50436,13055,Kits,5,2,0.4,3
50437,13055,Stuff Packs,20,3,0.15,17
50438,13056,Expansion Packs,8,0,0.0,8
50439,13056,Game Packs,9,0,0.0,9
50440,13056,Kits,3,2,0.6666666666666666,1
50441,13056,Stuff Packs,13,0,0.0,13
50442,13057,Expansion Packs,15,0,0.0,15
50443,13057,Game Packs,11,0,0.0,11
50444,13057,Kits,4,2,0.5,2
50445,13057,Stuff Packs,10,3,0.3,7
50446,13058,Expansion Packs,16,0,0.0,16
50447,13058,Game Packs,11,0,0.0,11
50448,13058,Kits,14,0,0.0,14
50449,13058,Stuff Packs,20,0,0.0,20
50450,13059,Expansion Packs,16,0,0.0,16
50451,13059,Game Packs,8,0,0.0,8
50452,13059,Kits,18,0,0.0,18
50453,13059,Stuff Packs,13,0,0.0,13
50454,13060,Expansion Packs,16,0,0.0,16
50455,13060,Game Packs,12,0,0.0,12
50456,13060,Kits,33,0,0.0,33
50457,13060,Stuff Packs,20,0,0.0,20
50458,13061,Expansion Packs,7,0,0.0,7
50459,13061,Game Packs,6,0,0.0,6
50460,13061,Kits,8,3,0.375,5
50461,13061,Stuff Packs,6,3,0.5,3
50462,13062,Expansion Packs,16,0,0.0,16
50463,13062,Game Packs,12,0,0.0,12
50464,13062,Kits,33,0,0.0,33
50465,13062,Stuff Packs,20,1,0.05,19
50466,13063,Expansion Packs,13,0,0.0,13
50467,13063,Game Packs,7,0,0.0,7
50468,13063,Kits,4,4,1.0,0
50469,13063,Stuff Packs,10,2,0.2,8
50470,13064,Expansion Packs,15,0,0.0,15
50471,13064,Game Packs,7,0,0.0,7
50472,13064,Kits,10,1,0.1,9
50473,13064,Stuff Packs,7,3,0.42857142857142855,4
50474,13065,Expansion Packs,16,0,0.0,16
50475,13065,Game Packs,12,0,0.0,12
50476,13065,Kits,27,0,0.0,27
50477,13065,Stuff Packs,20,0,0.0,20
50478,13066,Expansion Packs,16,0,0.0,16
50479,13066,Game Packs,8,0,0.0,8
50480,13066,Kits,11,0,0.0,11
50481,13066,Stuff Packs,17,0,0.0,17
50482,13067,Expansion Packs,16,0,0.0,16
50483,13067,Game Packs,12,0,0.0,12
50484,13067,Kits,33,1,0.030303030303030304,32
50485,13067,Stuff Packs,20,0,0.0,20
50486,13068,Expansion Packs,6,0,0.0,6
50487,13068,Game Packs,1,0,0.0,1
50488,13068,Stuff Packs,4,3,0.75,1
50489,13069,Expansion Packs,11,0,0.0,11
50490,13069,Game Packs,3,0,0.0,3
50491,13069,Kits,3,2,0.6666666666666666,1
50492,13069,Stuff Packs,5,3,0.6,2
50493,13070,Expansion Packs,12,0,0.0,12
50494,13070,Game Packs,4,1,0.25,3
50495,13070,Kits,3,2,0.6666666666666666,1
50496,13070,Stuff Packs,5,3,0.6,2
50497,13071,Expansion Packs,16,0,0.0,16
50498,13071,Game Packs,11,0,0.0,11
50499,13071,Kits,17,0,0.0,17
50500,13071,Stuff Packs,17,0,0.0,17
50501,13072,Expansion Packs,15,0,0.0,15
50502,13072,Game Packs,12,0,0.0,12
50503,13072,Kits,28,0,0.0,28
50504,13072,Stuff Packs,20,0,0.0,20
50505,13073,Expansion Packs,16,1,0.0625,15
50506,13073,Game Packs,11,0,0.0,11
50507,13073,Kits,32,0,0.0,32
50508,13073,Stuff Packs,20,0,0.0,20
50509,13074,Expansion Packs,14,0,0.0,14
50510,13074,Game Packs,11,0,0.0,11
50511,13074,Stuff Packs,7,2,0.2857142857142857,5
50512,13075,Expansion Packs,16,0,0.0,16
50513,13075,Game Packs,12,1,0.08333333333333333,11
50514,13075,Kits,33,2,0.06060606060606061,31
50515,13075,Stuff Packs,20,1,0.05,19
50516,13076,Expansion Packs,3,1,0.3333333333333333,2
50517,13076,Game Packs,1,0,0.0,1
50518,13076,Kits,2,0,0.0,2
50519,13076,Stuff Packs,2,0,0.0,2
50520,13077,Expansion Packs,16,0,0.0,16
50521,13077,Game Packs,12,0,0.0,12
50522,13077,Kits,33,1,0.030303030303030304,32
50523,13077,Stuff Packs,20,0,0.0,20
50524,13078,Expansion Packs,16,0,0.0,16
50525,13078,Game Packs,7,0,0.0,7
50526,13078,Kits,2,0,0.0,2
50527,13078,Stuff Packs,9,1,0.1111111111111111,8
50528,13079,Expansion Packs,16,0,0.0,16
50529,13079,Game Packs,12,0,0.0,12
50530,13079,Kits,33,1,0.030303030303030304,32
50531,13079,Stuff Packs,20,0,0.0,20
50532,13080,Expansion Packs,16,0,0.0,16
50533,13080,Game Packs,10,0,0.0,10
50534,13080,Kits,22,1,0.045454545454545456,21
50535,13080,Stuff Packs,18,1,0.05555555555555555,17
50536,13081,Expansion Packs,2,0,0.0,2
50537,13081,Game Packs,2,0,0.0,2
50538,13081,Kits,2,0,0.0,2
50539,13081,Stuff Packs,5,0,0.0,5
50540,13082,Expansion Packs,16,0,0.0,16
50541,13082,Game Packs,9,0,0.0,9
50542,13082,Kits,1,0,0.0,1
50543,13082,Stuff Packs,5,0,0.0,5
50544,13083,Expansion Packs,13,0,0.0,13
50545,13083,Game Packs,7,0,0.0,7
50546,13083,Kits,12,0,0.0,12
50547,13083,Stuff Packs,10,3,0.3,7
50548,13084,Expansion Packs,16,0,0.0,16
50549,13084,Game Packs,12,0,0.0,12
50550,13084,Kits,33,1,0.030303030303030304,32
50551,13084,Stuff Packs,20,0,0.0,20
50552,13085,Expansion Packs,16,0,0.0,16
50553,13085,Game Packs,12,0,0.0,12
50554,13085,Kits,33,1,0.030303030303030304,32
50555,13085,Stuff Packs,20,0,0.0,20
50556,13086,Kits,1,1,1.0,0
50557,13086,Stuff Packs,2,2,1.0,0
50558,13087,Expansion Packs,15,0,0.0,15
50559,13087,Game Packs,6,0,0.0,6
50560,13087,Kits,3,0,0.0,3
50561,13087,Stuff Packs,11,0,0.0,11
50562,13088,Expansion Packs,16,0,0.0,16
50563,13088,Game Packs,12,0,0.0,12
50564,13088,Kits,18,1,0.05555555555555555,17
50565,13088,Stuff Packs,17,1,0.058823529411764705,16
50566,13089,Expansion Packs,3,0,0.0,3
50567,13089,Kits,3,0,0.0,3
50568,13089,Stuff Packs,1,0,0.0,1
50569,13090,Expansion Packs,12,0,0.0,12
50570,13090,Game Packs,6,0,0.0,6
50571,13090,Kits,2,0,0.0,2
50572,13090,Stuff Packs,8,0,0.0,8
50573,13091,Expansion Packs,16,0,0.0,16
50574,13091,Game Packs,12,0,0.0,12
50575,13091,Kits,13,0,0.0,13
50576,13091,Stuff Packs,20,0,0.0,20
50577,13092,Expansion Packs,15,0,0.0,15
50578,13092,Game Packs,12,0,0.0,12
50579,13092,Kits,31,1,0.03225806451612903,30
50580,13092,Stuff Packs,20,1,0.05,19
50581,13093,Expansion Packs,12,0,0.0,12
50582,13093,Game Packs,9,0,0.0,9
50583,13093,Kits,8,2,0.25,6
50584,13093,Stuff Packs,12,2,0.16666666666666666,10
50585,13094,Expansion Packs,16,0,0.0,16
50586,13094,Game Packs,12,0,0.0,12
50587,13094,Kits,31,0,0.0,31
50588,13094,Stuff Packs,20,0,0.0,20
50589,13095,Expansion Packs,16,0,0.0,16
50590,13095,Game Packs,12,0,0.0,12
50591,13095,Kits,33,1,0.030303030303030304,32
50592,13095,Stuff Packs,20,0,0.0,20
50593,13096,Expansion Packs,2,0,0.0,2
50594,13097,Expansion Packs,11,0,0.0,11
50595,13097,Game Packs,9,0,0.0,9
50596,13097,Kits,9,0,0.0,9
50597,13097,Stuff Packs,7,0,0.0,7
50598,13098,Expansion Packs,16,11,0.6875,5
50599,13098,Game Packs,12,6,0.5,6
50600,13098,Kits,33,33,1.0,0
50601,13098,Stuff Packs,20,7,0.35,13
50602,13099,Expansion Packs,9,0,0.0,9
50603,13099,Game Packs,7,0,0.0,7
50604,13099,Kits,1,0,0.0,1
50605,13099,Stuff Packs,5,0,0.0,5
50606,13100,Expansion Packs,14,0,0.0,14
50607,13100,Game Packs,5,1,0.2,4
50608,13100,Kits,4,1,0.25,3
50609,13100,Stuff Packs,14,1,0.07142857142857142,13
50610,13101,Expansion Packs,2,0,0.0,2
50611,13101,Game Packs,2,1,0.5,1
50612,13101,Kits,3,3,1.0,0
50613,13101,Stuff Packs,2,1,0.5,1
50614,13102,Expansion Packs,16,0,0.0,16
50615,13102,Game Packs,12,0,0.0,12
50616,13102,Kits,32,0,0.0,32
50617,13102,Stuff Packs,20,0,0.0,20
50618,13103,Expansion Packs,6,0,0.0,6
50619,13103,Game Packs,5,0,0.0,5
50620,13103,Kits,2,0,0.0,2
50621,13103,Stuff Packs,4,0,0.0,4
50622,13104,Expansion Packs,5,0,0.0,5
50623,13104,Game Packs,2,0,0.0,2
50624,13104,Kits,4,2,0.5,2
50625,13104,Stuff Packs,2,0,0.0,2
50626,13105,Expansion Packs,16,0,0.0,16
50627,13105,Game Packs,11,0,0.0,11
50628,13105,Kits,28,0,0.0,28
50629,13105,Stuff Packs,20,0,0.0,20
50630,13106,Expansion Packs,16,0,0.0,16
50631,13106,Game Packs,12,0,0.0,12
50632,13106,Kits,12,1,0.08333333333333333,11
50633,13106,Stuff Packs,20,0,0.0,20
50634,13107,Expansion Packs,16,0,0.0,16
50635,13107,Game Packs,12,0,0.0,12
50636,13107,Kits,33,1,0.030303030303030304,32
50637,13107,Stuff Packs,20,0,0.0,20
50638,13108,Expansion Packs,5,0,0.0,5
50639,13108,Kits,7,0,0.0,7
50640,13108,Stuff Packs,3,0,0.0,3
50641,13109,Expansion Packs,16,0,0.0,16
50642,13109,Game Packs,11,0,0.0,11
50643,13109,Kits,26,1,0.038461538461538464,25
50644,13109,Stuff Packs,20,0,0.0,20
50645,13110,Expansion Packs,9,0,0.0,9
50646,13110,Game Packs,4,0,0.0,4
50647,13110,Kits,7,2,0.2857142857142857,5
50648,13110,Stuff Packs,8,1,0.125,7
50649,13111,Expansion Packs,15,0,0.0,15
50650,13111,Game Packs,11,0,0.0,11
50651,13111,Kits,13,1,0.07692307692307693,12
50652,13111,Stuff Packs,16,0,0.0,16
50653,13112,Expansion Packs,16,0,0.0,16
50654,13112,Game Packs,12,0,0.0,12
50655,13112,Kits,32,0,0.0,32
50656,13112,Stuff Packs,20,0,0.0,20
50657,13113,Expansion Packs,14,0,0.0,14
50658,13113,Game Packs,10,0,0.0,10
50659,13113,Kits,1,1,1.0,0
50660,13113,Stuff Packs,18,2,0.1111111111111111,16
50661,13114,Expansion Packs,16,0,0.0,16
50662,13114,Game Packs,12,0,0.0,12
50663,13114,Kits,33,0,0.0,33
50664,13114,Stuff Packs,20,0,0.0,20
50665,13115,Expansion Packs,16,0,0.0,16
50666,13115,Game Packs,12,0,0.0,12
50667,13115,Kits,33,0,0.0,33
50668,13115,Stuff Packs,20,0,0.0,20
50669,13116,Expansion Packs,15,0,0.0,15
50670,13116,Game Packs,11,0,0.0,11
50671,13116,Kits,16,1,0.0625,15
50672,13116,Stuff Packs,20,0,0.0,20
50673,13117,Expansion Packs,4,0,0.0,4
50674,13117,Game Packs,1,0,0.0,1
50675,13117,Kits,1,1,1.0,0
50676,13117,Stuff Packs,2,2,1.0,0
50677,13118,Expansion Packs,12,0,0.0,12
50678,13118,Game Packs,8,0,0.0,8
50679,13118,Kits,2,2,1.0,0
50680,13118,Stuff Packs,16,1,0.0625,15
50681,13119,Expansion Packs,11,0,0.0,11
50682,13119,Game Packs,4,0,0.0,4
50683,13119,Kits,7,2,0.2857142857142857,5
50684,13119,Stuff Packs,6,3,0.5,3
50685,13120,Expansion Packs,15,0,0.0,15
50686,13120,Game Packs,12,0,0.0,12
50687,13120,Kits,24,0,0.0,24
50688,13120,Stuff Packs,20,0,0.0,20
50689,13121,Expansion Packs,16,12,0.75,4
50690,13121,Game Packs,9,9,1.0,0
50691,13121,Kits,1,1,1.0,0
50692,13121,Stuff Packs,7,7,1.0,0
50693,13122,Expansion Packs,11,0,0.0,11
50694,13122,Game Packs,4,0,0.0,4
50695,13122,Kits,4,1,0.25,3
50696,13122,Stuff Packs,5,1,0.2,4
50697,13123,Expansion Packs,8,0,0.0,8
50698,13123,Game Packs,1,0,0.0,1
50699,13123,Kits,5,0,0.0,5
50700,13123,Stuff Packs,3,1,0.3333333333333333,2
50701,13124,Game Packs,1,0,0.0,1
50702,13124,Kits,2,2,1.0,0
50703,13124,Stuff Packs,3,3,1.0,0
50704,13125,Expansion Packs,12,0,0.0,12
50705,13125,Game Packs,5,0,0.0,5
50706,13125,Kits,4,1,0.25,3
50707,13125,Stuff Packs,11,1,0.09090909090909091,10
50708,13126,Expansion Packs,13,1,0.07692307692307693,12
50709,13126,Game Packs,7,0,0.0,7
50710,13126,Stuff Packs,3,0,0.0,3
50711,13127,Expansion Packs,16,0,0.0,16
50712,13127,Game Packs,12,0,0.0,12
50713,13127,Kits,24,0,0.0,24
50714,13127,Stuff Packs,20,0,0.0,20
50715,13128,Expansion Packs,16,0,0.0,16
50716,13128,Game Packs,11,1,0.09090909090909091,10
50717,13128,Kits,33,1,0.030303030303030304,32
50718,13128,Stuff Packs,20,2,0.1,18
50719,13129,Expansion Packs,14,0,0.0,14
50720,13129,Game Packs,12,0,0.0,12
50721,13129,Kits,18,1,0.05555555555555555,17
50722,13129,Stuff Packs,19,0,0.0,19
50723,13130,Expansion Packs,7,0,0.0,7
50724,13130,Game Packs,5,0,0.0,5
50725,13130,Kits,2,2,1.0,0
50726,13130,Stuff Packs,7,3,0.42857142857142855,4
50727,13131,Expansion Packs,16,0,0.0,16
50728,13131,Game Packs,12,0,0.0,12
50729,13131,Kits,28,0,0.0,28
50730,13131,Stuff Packs,20,0,0.0,20
50731,13132,Expansion Packs,13,0,0.0,13
50732,13132,Game Packs,5,0,0.0,5
50733,13132,Kits,4,2,0.5,2
50734,13132,Stuff Packs,6,4,0.6666666666666666,2
50735,13133,Expansion Packs,16,0,0.0,16
50736,13133,Game Packs,11,0,0.0,11
50737,13133,Kits,29,0,0.0,29
50738,13133,Stuff Packs,20,0,0.0,20
50739,13134,Expansion Packs,7,1,0.14285714285714285,6
50740,13134,Game Packs,2,1,0.5,1
50741,13134,Kits,1,1,1.0,0
50742,13134,Stuff Packs,1,0,0.0,1
50743,13135,Expansion Packs,16,0,0.0,16
50744,13135,Game Packs,10,0,0.0,10
50745,13135,Kits,6,0,0.0,6
50746,13135,Stuff Packs,9,2,0.2222222222222222,7
50747,13136,Expansion Packs,16,0,0.0,16
50748,13136,Game Packs,11,0,0.0,11
50749,13136,Kits,33,0,0.0,33
50750,13136,Stuff Packs,20,0,0.0,20
50751,13137,Expansion Packs,1,0,0.0,1
50752,13137,Game Packs,2,2,1.0,0
50753,13137,Stuff Packs,2,1,0.5,1
50754,13138,Expansion Packs,16,0,0.0,16
50755,13138,Game Packs,12,0,0.0,12
50756,13138,Kits,33,0,0.0,33
50757,13138,Stuff Packs,20,0,0.0,20
50758,13139,Expansion Packs,12,0,0.0,12
50759,13139,Game Packs,6,0,0.0,6
50760,13139,Kits,14,0,0.0,14
50761,13139,Stuff Packs,9,0,0.0,9
50762,13140,Expansion Packs,16,0,0.0,16
50763,13140,Game Packs,11,0,0.0,11
50764,13140,Kits,22,0,0.0,22
50765,13140,Stuff Packs,20,0,0.0,20
50766,13141,Expansion Packs,16,0,0.0,16
50767,13141,Game Packs,11,0,0.0,11
50768,13141,Kits,33,0,0.0,33
50769,13141,Stuff Packs,20,0,0.0,20
50770,13142,Expansion Packs,8,0,0.0,8
50771,13142,Game Packs,1,0,0.0,1
50772,13142,Kits,1,1,1.0,0
50773,13142,Stuff Packs,4,3,0.75,1
50774,13143,Expansion Packs,16,0,0.0,16
50775,13143,Game Packs,12,0,0.0,12
50776,13143,Kits,33,0,0.0,33
50777,13143,Stuff Packs,20,0,0.0,20
50778,13144,Expansion Packs,16,0,0.0,16
50779,13144,Game Packs,12,0,0.0,12
50780,13144,Kits,33,0,0.0,33
50781,13144,Stuff Packs,20,0,0.0,20
50782,13145,Expansion Packs,2,0,0.0,2
50783,13145,Game Packs,2,1,0.5,1
50784,13145,Kits,2,1,0.5,1
50785,13145,Stuff Packs,5,4,0.8,1
50786,13146,Expansion Packs,16,0,0.0,16
50787,13146,Game Packs,12,0,0.0,12
50788,13146,Kits,11,3,0.2727272727272727,8
50789,13146,Stuff Packs,17,1,0.058823529411764705,16
50790,13147,Expansion Packs,15,0,0.0,15
50791,13147,Game Packs,11,0,0.0,11
50792,13147,Kits,11,1,0.09090909090909091,10
50793,13147,Stuff Packs,14,0,0.0,14
50794,13148,Expansion Packs,2,0,0.0,2
50795,13148,Game Packs,1,0,0.0,1
50796,13148,Kits,2,0,0.0,2
50797,13148,Stuff Packs,4,3,0.75,1
50798,13149,Expansion Packs,16,0,0.0,16
50799,13149,Game Packs,10,0,0.0,10
50800,13149,Kits,2,2,1.0,0
50801,13149,Stuff Packs,17,0,0.0,17
50802,13150,Expansion Packs,11,0,0.0,11
50803,13150,Game Packs,5,0,0.0,5
50804,13150,Kits,1,0,0.0,1
50805,13150,Stuff Packs,4,3,0.75,1
50806,13151,Expansion Packs,14,0,0.0,14
50807,13151,Game Packs,6,0,0.0,6
50808,13151,Stuff Packs,9,1,0.1111111111111111,8
50809,13152,Expansion Packs,13,0,0.0,13
50810,13152,Game Packs,9,1,0.1111111111111111,8
50811,13152,Kits,3,2,0.6666666666666666,1
50812,13152,Stuff Packs,7,3,0.42857142857142855,4
50813,13153,Expansion Packs,6,0,0.0,6
50814,13153,Game Packs,3,0,0.0,3
50815,13153,Kits,4,1,0.25,3
50816,13153,Stuff Packs,6,2,0.3333333333333333,4
50817,13154,Expansion Packs,12,0,0.0,12
50818,13154,Game Packs,8,0,0.0,8
50819,13154,Kits,1,1,1.0,0
50820,13154,Stuff Packs,13,0,0.0,13
50821,13155,Expansion Packs,11,0,0.0,11
50822,13155,Game Packs,6,0,0.0,6
50823,13155,Kits,5,0,0.0,5
50824,13155,Stuff Packs,4,0,0.0,4
50825,13156,Expansion Packs,16,0,0.0,16
50826,13156,Game Packs,7,0,0.0,7
50827,13156,Kits,32,0,0.0,32
50828,13156,Stuff Packs,18,0,0.0,18
50829,13157,Expansion Packs,6,0,0.0,6
50830,13157,Game Packs,4,1,0.25,3
50831,13157,Kits,5,3,0.6,2
50832,13157,Stuff Packs,7,4,0.5714285714285714,3
50833,13158,Expansion Packs,8,0,0.0,8
50834,13158,Game Packs,6,0,0.0,6
50835,13158,Stuff Packs,9,0,0.0,9
50836,13159,Expansion Packs,16,0,0.0,16
50837,13159,Game Packs,12,0,0.0,12
50838,13159,Kits,32,0,0.0,32
50839,13159,Stuff Packs,20,0,0.0,20
50840,13160,Expansion Packs,9,0,0.0,9
50841,13160,Game Packs,6,0,0.0,6
50842,13160,Kits,4,0,0.0,4
50843,13160,Stuff Packs,3,0,0.0,3
50844,13161,Expansion Packs,5,0,0.0,5
50845,13161,Game Packs,2,0,0.0,2
50846,13161,Stuff Packs,1,0,0.0,1
50847,13162,Expansion Packs,3,0,0.0,3
50848,13162,Game Packs,1,0,0.0,1
50849,13162,Stuff Packs,2,0,0.0,2
50850,13163,Expansion Packs,15,0,0.0,15
50851,13163,Game Packs,7,0,0.0,7
50852,13163,Kits,19,0,0.0,19
50853,13163,Stuff Packs,8,0,0.0,8
50854,13164,Expansion Packs,4,0,0.0,4
50855,13164,Stuff Packs,1,1,1.0,0
50856,13165,Expansion Packs,9,0,0.0,9
50857,13165,Game Packs,6,0,0.0,6
50858,13165,Kits,1,1,1.0,0
50859,13165,Stuff Packs,12,0,0.0,12
50860,13166,Expansion Packs,15,0,0.0,15
50861,13166,Game Packs,6,0,0.0,6
50862,13166,Kits,7,2,0.2857142857142857,5
50863,13166,Stuff Packs,10,2,0.2,8
50864,13167,Expansion Packs,16,1,0.0625,15
50865,13167,Game Packs,11,0,0.0,11
50866,13167,Kits,22,0,0.0,22
50867,13167,Stuff Packs,17,0,0.0,17
50868,13168,Expansion Packs,2,1,0.5,1
50869,13168,Game Packs,2,2,1.0,0
50870,13168,Stuff Packs,1,1,1.0,0
50871,13169,Expansion Packs,16,0,0.0,16
50872,13169,Game Packs,12,0,0.0,12
50873,13169,Kits,26,0,0.0,26
50874,13169,Stuff Packs,20,0,0.0,20
50875,13170,Expansion Packs,14,0,0.0,14
50876,13170,Game Packs,10,0,0.0,10
50877,13170,Kits,2,1,0.5,1
50878,13170,Stuff Packs,13,2,0.15384615384615385,11
50879,13171,Expansion Packs,8,0,0.0,8
50880,13171,Game Packs,1,0,0.0,1
50881,13171,Kits,2,1,0.5,1
50882,13171,Stuff Packs,5,3,0.6,2
50883,13172,Expansion Packs,16,0,0.0,16
50884,13172,Game Packs,9,0,0.0,9
50885,13172,Kits,20,0,0.0,20
50886,13172,Stuff Packs,18,0,0.0,18
50887,13173,Expansion Packs,14,0,0.0,14
50888,13173,Game Packs,9,0,0.0,9
50889,13173,Kits,1,0,0.0,1
50890,13173,Stuff Packs,10,0,0.0,10
50891,13174,Expansion Packs,16,1,0.0625,15
50892,13174,Game Packs,12,0,0.0,12
50893,13174,Kits,33,0,0.0,33
50894,13174,Stuff Packs,20,1,0.05,19
50895,13175,Expansion Packs,11,0,0.0,11
50896,13175,Game Packs,3,0,0.0,3
50897,13175,Stuff Packs,7,2,0.2857142857142857,5
50898,13176,Expansion Packs,13,0,0.0,13
50899,13176,Game Packs,9,0,0.0,9
50900,13176,Kits,6,1,0.16666666666666666,5
50901,13176,Stuff Packs,16,0,0.0,16
50902,13177,Expansion Packs,13,0,0.0,13
50903,13177,Game Packs,7,0,0.0,7
50904,13177,Kits,4,1,0.25,3
50905,13177,Stuff Packs,11,2,0.18181818181818182,9
50906,13178,Expansion Packs,16,0,0.0,16
50907,13178,Game Packs,12,0,0.0,12
50908,13178,Kits,33,0,0.0,33
50909,13178,Stuff Packs,20,0,0.0,20
50910,13179,Expansion Packs,9,0,0.0,9
50911,13179,Game Packs,4,0,0.0,4
50912,13179,Kits,1,1,1.0,0
50913,13179,Stuff Packs,8,2,0.25,6
50914,13180,Expansion Packs,16,0,0.0,16
50915,13180,Game Packs,12,0,0.0,12
50916,13180,Kits,9,0,0.0,9
50917,13180,Stuff Packs,20,0,0.0,20
50918,13181,Expansion Packs,2,0,0.0,2
50919,13181,Game Packs,2,0,0.0,2
50920,13181,Stuff Packs,7,2,0.2857142857142857,5
50921,13182,Expansion Packs,6,0,0.0,6
50922,13182,Game Packs,3,0,0.0,3
50923,13182,Kits,2,2,1.0,0
50924,13182,Stuff Packs,6,0,0.0,6
50925,13183,Expansion Packs,8,4,0.5,4
50926,13183,Game Packs,5,2,0.4,3
50927,13183,Stuff Packs,4,1,0.25,3
50928,13184,Expansion Packs,3,0,0.0,3
50929,13184,Game Packs,1,0,0.0,1
50930,13184,Kits,3,1,0.3333333333333333,2
50931,13184,Stuff Packs,3,2,0.6666666666666666,1
50932,13185,Expansion Packs,10,0,0.0,10
50933,13185,Game Packs,5,1,0.2,4
50934,13185,Kits,5,1,0.2,4
50935,13185,Stuff Packs,9,3,0.3333333333333333,6
50936,13186,Expansion Packs,14,0,0.0,14
50937,13186,Game Packs,12,0,0.0,12
50938,13186,Kits,22,0,0.0,22
50939,13186,Stuff Packs,18,0,0.0,18
50940,13187,Expansion Packs,12,0,0.0,12
50941,13187,Game Packs,9,0,0.0,9
50942,13187,Stuff Packs,3,0,0.0,3
50943,13188,Expansion Packs,15,0,0.0,15
50944,13188,Game Packs,8,0,0.0,8
50945,13188,Kits,17,0,0.0,17
50946,13188,Stuff Packs,9,0,0.0,9
50947,13189,Expansion Packs,10,0,0.0,10
50948,13189,Game Packs,4,0,0.0,4
50949,13189,Kits,3,2,0.6666666666666666,1
50950,13189,Stuff Packs,9,3,0.3333333333333333,6
50951,13190,Expansion Packs,6,0,0.0,6
50952,13190,Game Packs,7,0,0.0,7
50953,13190,Kits,13,1,0.07692307692307693,12
50954,13190,Stuff Packs,8,0,0.0,8
50955,13191,Expansion Packs,16,0,0.0,16
50956,13191,Game Packs,11,0,0.0,11
50957,13191,Kits,25,0,0.0,25
50958,13191,Stuff Packs,19,0,0.0,19
50959,13192,Expansion Packs,12,0,0.0,12
50960,13192,Game Packs,6,0,0.0,6
50961,13192,Kits,2,1,0.5,1
50962,13192,Stuff Packs,12,2,0.16666666666666666,10
50963,13193,Expansion Packs,15,0,0.0,15
50964,13193,Game Packs,10,0,0.0,10
50965,13193,Kits,5,0,0.0,5
50966,13193,Stuff Packs,11,1,0.09090909090909091,10
50967,13194,Expansion Packs,16,0,0.0,16
50968,13194,Game Packs,10,0,0.0,10
50969,13194,Kits,12,1,0.08333333333333333,11
50970,13194,Stuff Packs,16,0,0.0,16
50971,13195,Expansion Packs,12,0,0.0,12
50972,13195,Game Packs,10,0,0.0,10
50973,13195,Kits,2,2,1.0,0
50974,13195,Stuff Packs,11,0,0.0,11
50975,13196,Expansion Packs,15,0,0.0,15
50976,13196,Game Packs,11,0,0.0,11
50977,13196,Kits,9,0,0.0,9
50978,13196,Stuff Packs,14,1,0.07142857142857142,13
50979,13197,Expansion Packs,14,0,0.0,14
50980,13197,Game Packs,6,0,0.0,6
50981,13197,Kits,2,1,0.5,1
50982,13197,Stuff Packs,10,0,0.0,10
50983,13198,Expansion Packs,9,0,0.0,9
50984,13198,Game Packs,2,0,0.0,2
50985,13198,Stuff Packs,2,0,0.0,2
50986,13199,Expansion Packs,2,0,0.0,2
50987,13199,Game Packs,1,0,0.0,1
50988,13199,Kits,1,0,0.0,1
50989,13199,Stuff Packs,2,0,0.0,2
50990,13200,Expansion Packs,16,0,0.0,16
50991,13200,Game Packs,11,0,0.0,11
50992,13200,Kits,23,1,0.043478260869565216,22
50993,13200,Stuff Packs,18,0,0.0,18
50994,13201,Expansion Packs,16,0,0.0,16
50995,13201,Game Packs,12,0,0.0,12
50996,13201,Kits,24,0,0.0,24
50997,13201,Stuff Packs,20,0,0.0,20
50998,13202,Expansion Packs,16,0,0.0,16
50999,13202,Game Packs,11,0,0.0,11
51000,13202,Kits,7,0,0.0,7
51001,13202,Stuff Packs,12,3,0.25,9
51002,13203,Expansion Packs,16,0,0.0,16
51003,13203,Game Packs,12,0,0.0,12
51004,13203,Kits,33,2,0.06060606060606061,31
51005,13203,Stuff Packs,20,0,0.0,20
51006,13204,Expansion Packs,3,0,0.0,3
51007,13204,Game Packs,2,0,0.0,2
51008,13204,Kits,2,1,0.5,1
51009,13204,Stuff Packs,2,0,0.0,2
51010,13205,Expansion Packs,16,0,0.0,16
51011,13205,Game Packs,12,0,0.0,12
51012,13205,Kits,33,0,0.0,33
51013,13205,Stuff Packs,20,0,0.0,20
51014,13206,Expansion Packs,11,0,0.0,11
51015,13206,Game Packs,5,0,0.0,5
51016,13206,Kits,1,1,1.0,0
51017,13206,Stuff Packs,5,1,0.2,4
51018,13207,Expansion Packs,15,0,0.0,15
51019,13207,Game Packs,10,0,0.0,10
51020,13207,Kits,15,1,0.06666666666666667,14
51021,13207,Stuff Packs,12,0,0.0,12
51022,13208,Game Packs,2,1,0.5,1
51023,13208,Kits,3,0,0.0,3
51024,13208,Stuff Packs,7,3,0.42857142857142855,4
51025,13209,Game Packs,1,1,1.0,0
51026,13209,Kits,2,2,1.0,0
51027,13209,Stuff Packs,4,4,1.0,0
51028,13210,Expansion Packs,7,0,0.0,7
51029,13210,Game Packs,2,0,0.0,2
51030,13210,Stuff Packs,4,3,0.75,1
51031,13211,Expansion Packs,12,0,0.0,12
51032,13211,Game Packs,4,1,0.25,3
51033,13211,Kits,4,3,0.75,1
51034,13211,Stuff Packs,10,4,0.4,6
51035,13212,Expansion Packs,8,0,0.0,8
51036,13212,Game Packs,2,0,0.0,2
51037,13212,Kits,9,1,0.1111111111111111,8
51038,13212,Stuff Packs,8,4,0.5,4
51039,13213,Expansion Packs,10,0,0.0,10
51040,13213,Game Packs,10,0,0.0,10
51041,13213,Kits,3,1,0.3333333333333333,2
51042,13213,Stuff Packs,5,0,0.0,5
51043,13214,Expansion Packs,2,0,0.0,2
51044,13214,Game Packs,2,1,0.5,1
51045,13214,Kits,3,3,1.0,0
51046,13214,Stuff Packs,5,4,0.8,1
51047,13215,Expansion Packs,16,0,0.0,16
51048,13215,Game Packs,12,0,0.0,12
51049,13215,Kits,23,0,0.0,23
51050,13215,Stuff Packs,20,0,0.0,20
51051,13216,Expansion Packs,16,0,0.0,16
51052,13216,Game Packs,12,0,0.0,12
51053,13216,Kits,33,0,0.0,33
51054,13216,Stuff Packs,20,0,0.0,20
51055,13217,Expansion Packs,16,0,0.0,16
51056,13217,Game Packs,11,0,0.0,11
51057,13217,Kits,25,1,0.04,24
51058,13217,Stuff Packs,20,1,0.05,19
51059,13218,Expansion Packs,16,0,0.0,16
51060,13218,Game Packs,11,0,0.0,11
51061,13218,Kits,33,1,0.030303030303030304,32
51062,13218,Stuff Packs,20,0,0.0,20
51063,13219,Expansion Packs,3,0,0.0,3
51064,13219,Game Packs,2,0,0.0,2
51065,13219,Kits,1,1,1.0,0
51066,13219,Stuff Packs,4,3,0.75,1
51067,13220,Expansion Packs,16,0,0.0,16
51068,13220,Game Packs,12,0,0.0,12
51069,13220,Kits,30,1,0.03333333333333333,29
51070,13220,Stuff Packs,20,0,0.0,20
51071,13221,Expansion Packs,15,0,0.0,15
51072,13221,Game Packs,12,0,0.0,12
51073,13221,Kits,12,0,0.0,12
51074,13221,Stuff Packs,19,1,0.05263157894736842,18
51075,13222,Expansion Packs,13,0,0.0,13
51076,13222,Game Packs,6,0,0.0,6
51077,13222,Kits,1,1,1.0,0
51078,13222,Stuff Packs,10,0,0.0,10
51079,13223,Expansion Packs,16,0,0.0,16
51080,13223,Game Packs,11,0,0.0,11
51081,13223,Kits,33,1,0.030303030303030304,32
51082,13223,Stuff Packs,20,3,0.15,17
51083,13224,Expansion Packs,16,0,0.0,16
51084,13224,Game Packs,12,0,0.0,12
51085,13224,Kits,33,2,0.06060606060606061,31
51086,13224,Stuff Packs,20,0,0.0,20
51087,13225,Expansion Packs,16,0,0.0,16
51088,13225,Game Packs,12,0,0.0,12
51089,13225,Kits,9,0,0.0,9
51090,13225,Stuff Packs,17,0,0.0,17
51091,13226,Expansion Packs,16,0,0.0,16
51092,13226,Game Packs,12,0,0.0,12
51093,13226,Kits,33,1,0.030303030303030304,32
51094,13226,Stuff Packs,20,1,0.05,19
51095,13227,Expansion Packs,14,0,0.0,14
51096,13227,Game Packs,10,0,0.0,10
51097,13227,Kits,4,3,0.75,1
51098,13227,Stuff Packs,13,4,0.3076923076923077,9
51099,13228,Expansion Packs,10,0,0.0,10
51100,13228,Game Packs,8,0,0.0,8
51101,13228,Kits,5,0,0.0,5
51102,13228,Stuff Packs,8,3,0.375,5
51103,13229,Expansion Packs,13,0,0.0,13
51104,13229,Game Packs,6,0,0.0,6
51105,13229,Kits,3,1,0.3333333333333333,2
51106,13229,Stuff Packs,6,1,0.16666666666666666,5
51107,13230,Expansion Packs,16,0,0.0,16
51108,13230,Game Packs,8,0,0.0,8
51109,13230,Kits,10,0,0.0,10
51110,13230,Stuff Packs,17,0,0.0,17
51111,13231,Expansion Packs,10,0,0.0,10
51112,13231,Game Packs,9,1,0.1111111111111111,8
51113,13231,Kits,2,0,0.0,2
51114,13231,Stuff Packs,14,0,0.0,14
51115,13232,Expansion Packs,16,0,0.0,16
51116,13232,Game Packs,12,0,0.0,12
51117,13232,Kits,21,1,0.047619047619047616,20
51118,13232,Stuff Packs,18,0,0.0,18
51119,13233,Expansion Packs,16,0,0.0,16
51120,13233,Game Packs,11,0,0.0,11
51121,13233,Kits,30,1,0.03333333333333333,29
51122,13233,Stuff Packs,20,0,0.0,20
51123,13234,Expansion Packs,16,0,0.0,16
51124,13234,Game Packs,11,0,0.0,11
51125,13234,Kits,17,1,0.058823529411764705,16
51126,13234,Stuff Packs,19,0,0.0,19
51127,13235,Expansion Packs,15,0,0.0,15
51128,13235,Game Packs,6,1,0.16666666666666666,5
51129,13235,Kits,3,2,0.6666666666666666,1
51130,13235,Stuff Packs,6,4,0.6666666666666666,2
51131,13236,Expansion Packs,15,0,0.0,15
51132,13236,Game Packs,12,0,0.0,12
51133,13236,Kits,14,0,0.0,14
51134,13236,Stuff Packs,20,0,0.0,20
51135,13237,Expansion Packs,6,0,0.0,6
51136,13237,Game Packs,3,0,0.0,3
51137,13238,Expansion Packs,8,0,0.0,8
51138,13238,Game Packs,3,0,0.0,3
51139,13238,Kits,4,0,0.0,4
51140,13238,Stuff Packs,5,2,0.4,3
51141,13239,Expansion Packs,14,0,0.0,14
51142,13239,Game Packs,4,0,0.0,4
51143,13239,Kits,3,1,0.3333333333333333,2
51144,13239,Stuff Packs,7,3,0.42857142857142855,4
51145,13240,Expansion Packs,16,0,0.0,16
51146,13240,Game Packs,12,0,0.0,12
51147,13240,Kits,23,0,0.0,23
51148,13240,Stuff Packs,20,0,0.0,20
51149,13241,Expansion Packs,13,0,0.0,13
51150,13241,Game Packs,10,0,0.0,10
51151,13241,Kits,6,2,0.3333333333333333,4
51152,13241,Stuff Packs,18,1,0.05555555555555555,17
51153,13242,Expansion Packs,16,0,0.0,16
51154,13242,Game Packs,11,0,0.0,11
51155,13242,Kits,26,1,0.038461538461538464,25
51156,13242,Stuff Packs,20,0,0.0,20
51157,13243,Expansion Packs,9,0,0.0,9
51158,13243,Game Packs,4,0,0.0,4
51159,13243,Kits,3,2,0.6666666666666666,1
51160,13243,Stuff Packs,6,1,0.16666666666666666,5
51161,13244,Expansion Packs,16,0,0.0,16
51162,13244,Game Packs,12,0,0.0,12
51163,13244,Kits,9,1,0.1111111111111111,8
51164,13244,Stuff Packs,16,0,0.0,16
51165,13245,Expansion Packs,16,0,0.0,16
51166,13245,Game Packs,12,0,0.0,12
51167,13245,Kits,23,1,0.043478260869565216,22
51168,13245,Stuff Packs,20,1,0.05,19
51169,13246,Expansion Packs,16,0,0.0,16
51170,13246,Game Packs,12,0,0.0,12
51171,13246,Kits,33,1,0.030303030303030304,32
51172,13246,Stuff Packs,20,0,0.0,20
51173,13247,Expansion Packs,14,0,0.0,14
51174,13247,Game Packs,8,0,0.0,8
51175,13247,Kits,3,1,0.3333333333333333,2
51176,13247,Stuff Packs,14,1,0.07142857142857142,13
51177,13248,Expansion Packs,1,0,0.0,1
51178,13248,Game Packs,1,0,0.0,1
51179,13248,Kits,2,2,1.0,0
51180,13248,Stuff Packs,3,1,0.3333333333333333,2
51181,13249,Expansion Packs,16,0,0.0,16
51182,13249,Game Packs,12,0,0.0,12
51183,13249,Kits,33,0,0.0,33
51184,13249,Stuff Packs,20,0,0.0,20
51185,13250,Expansion Packs,15,0,0.0,15
51186,13250,Game Packs,8,0,0.0,8
51187,13250,Kits,7,0,0.0,7
51188,13250,Stuff Packs,10,3,0.3,7
51189,13251,Expansion Packs,9,0,0.0,9
51190,13251,Game Packs,5,0,0.0,5
51191,13251,Kits,1,1,1.0,0
51192,13251,Stuff Packs,3,0,0.0,3
51193,13252,Expansion Packs,16,0,0.0,16
51194,13252,Game Packs,11,0,0.0,11
51195,13252,Kits,26,0,0.0,26
51196,13252,Stuff Packs,20,0,0.0,20
51197,13253,Expansion Packs,8,0,0.0,8
51198,13253,Game Packs,8,0,0.0,8
51199,13253,Kits,2,2,1.0,0
51200,13253,Stuff Packs,15,0,0.0,15
51201,13254,Expansion Packs,10,0,0.0,10
51202,13254,Game Packs,7,1,0.14285714285714285,6
51203,13254,Kits,3,2,0.6666666666666666,1
51204,13254,Stuff Packs,8,4,0.5,4
51205,13255,Expansion Packs,13,0,0.0,13
51206,13255,Game Packs,10,2,0.2,8
51207,13255,Kits,8,3,0.375,5
51208,13255,Stuff Packs,13,2,0.15384615384615385,11
51209,13256,Expansion Packs,16,0,0.0,16
51210,13256,Game Packs,12,0,0.0,12
51211,13256,Kits,33,0,0.0,33
51212,13256,Stuff Packs,20,0,0.0,20
51213,13257,Expansion Packs,4,0,0.0,4
51214,13257,Game Packs,1,0,0.0,1
51215,13257,Kits,2,2,1.0,0
51216,13257,Stuff Packs,4,3,0.75,1
51217,13258,Expansion Packs,4,0,0.0,4
51218,13258,Game Packs,1,0,0.0,1
51219,13258,Stuff Packs,1,0,0.0,1
51220,13259,Expansion Packs,9,0,0.0,9
51221,13259,Game Packs,8,0,0.0,8
51222,13259,Stuff Packs,9,0,0.0,9
51223,13260,Expansion Packs,14,0,0.0,14
51224,13260,Game Packs,12,0,0.0,12
51225,13260,Kits,24,0,0.0,24
51226,13260,Stuff Packs,20,0,0.0,20
51227,13261,Expansion Packs,5,0,0.0,5
51228,13261,Game Packs,3,0,0.0,3
51229,13261,Stuff Packs,7,3,0.42857142857142855,4
51230,13262,Expansion Packs,2,0,0.0,2
51231,13262,Game Packs,1,0,0.0,1
51232,13262,Kits,2,2,1.0,0
51233,13262,Stuff Packs,4,3,0.75,1
51234,13263,Expansion Packs,16,0,0.0,16
51235,13263,Game Packs,12,0,0.0,12
51236,13263,Kits,31,0,0.0,31
51237,13263,Stuff Packs,20,0,0.0,20
51238,13264,Expansion Packs,16,0,0.0,16
51239,13264,Game Packs,10,0,0.0,10
51240,13264,Kits,8,1,0.125,7
51241,13264,Stuff Packs,14,0,0.0,14
51242,13265,Expansion Packs,16,0,0.0,16
51243,13265,Game Packs,12,0,0.0,12
51244,13265,Kits,33,0,0.0,33
51245,13265,Stuff Packs,20,0,0.0,20
51246,13266,Expansion Packs,16,0,0.0,16
51247,13266,Game Packs,12,0,0.0,12
51248,13266,Kits,31,1,0.03225806451612903,30
51249,13266,Stuff Packs,20,0,0.0,20
51250,13267,Expansion Packs,16,0,0.0,16
51251,13267,Game Packs,11,0,0.0,11
51252,13267,Kits,28,1,0.03571428571428571,27
51253,13267,Stuff Packs,20,1,0.05,19
51254,13268,Expansion Packs,3,0,0.0,3
51255,13268,Game Packs,2,1,0.5,1
51256,13268,Kits,3,3,1.0,0
51257,13268,Stuff Packs,3,3,1.0,0
51258,13269,Expansion Packs,15,0,0.0,15
51259,13269,Game Packs,12,0,0.0,12
51260,13269,Kits,16,1,0.0625,15
51261,13269,Stuff Packs,20,0,0.0,20
51262,13270,Expansion Packs,16,0,0.0,16
51263,13270,Game Packs,8,0,0.0,8
51264,13270,Kits,2,2,1.0,0
51265,13270,Stuff Packs,13,2,0.15384615384615385,11
51266,13271,Expansion Packs,6,0,0.0,6
51267,13271,Game Packs,3,0,0.0,3
51268,13271,Stuff Packs,3,0,0.0,3
51269,13272,Expansion Packs,7,0,0.0,7
51270,13272,Game Packs,4,1,0.25,3
51271,13272,Kits,3,2,0.6666666666666666,1
51272,13272,Stuff Packs,8,2,0.25,6
51273,13273,Expansion Packs,10,0,0.0,10
51274,13273,Game Packs,2,0,0.0,2
51275,13273,Kits,7,0,0.0,7
51276,13273,Stuff Packs,6,2,0.3333333333333333,4
51277,13274,Expansion Packs,16,1,0.0625,15
51278,13274,Game Packs,12,0,0.0,12
51279,13274,Kits,33,0,0.0,33
51280,13274,Stuff Packs,20,1,0.05,19
51281,13275,Expansion Packs,16,0,0.0,16
51282,13275,Game Packs,5,0,0.0,5
51283,13275,Kits,14,0,0.0,14
51284,13275,Stuff Packs,8,0,0.0,8
51285,13276,Expansion Packs,14,0,0.0,14
51286,13276,Game Packs,10,0,0.0,10
51287,13276,Kits,4,3,0.75,1
51288,13276,Stuff Packs,12,1,0.08333333333333333,11
51289,13277,Expansion Packs,15,0,0.0,15
51290,13277,Game Packs,12,0,0.0,12
51291,13277,Kits,1,0,0.0,1
51292,13277,Stuff Packs,12,1,0.08333333333333333,11
51293,13278,Expansion Packs,12,0,0.0,12
51294,13278,Game Packs,2,0,0.0,2
51295,13278,Kits,1,1,1.0,0
51296,13278,Stuff Packs,5,2,0.4,3
51297,13279,Expansion Packs,11,0,0.0,11
51298,13279,Game Packs,6,0,0.0,6
51299,13279,Kits,9,0,0.0,9
51300,13279,Stuff Packs,11,2,0.18181818181818182,9
51301,13280,Expansion Packs,16,0,0.0,16
51302,13280,Game Packs,11,0,0.0,11
51303,13280,Kits,25,0,0.0,25
51304,13280,Stuff Packs,20,0,0.0,20
51305,13281,Expansion Packs,5,0,0.0,5
51306,13281,Game Packs,3,1,0.3333333333333333,2
51307,13281,Kits,3,3,1.0,0
51308,13281,Stuff Packs,7,4,0.5714285714285714,3
51309,13282,Expansion Packs,16,0,0.0,16
51310,13282,Game Packs,11,0,0.0,11
51311,13282,Stuff Packs,17,0,0.0,17
51312,13283,Expansion Packs,12,0,0.0,12
51313,13283,Game Packs,7,0,0.0,7
51314,13283,Kits,11,1,0.09090909090909091,10
51315,13283,Stuff Packs,12,2,0.16666666666666666,10
51316,13284,Expansion Packs,13,0,0.0,13
51317,13284,Game Packs,4,0,0.0,4
51318,13284,Kits,1,1,1.0,0
51319,13284,Stuff Packs,5,3,0.6,2
51320,13285,Expansion Packs,15,0,0.0,15
51321,13285,Game Packs,12,0,0.0,12
51322,13285,Kits,13,1,0.07692307692307693,12
51323,13285,Stuff Packs,19,0,0.0,19
51324,13286,Expansion Packs,11,0,0.0,11
51325,13286,Game Packs,7,0,0.0,7
51326,13286,Stuff Packs,4,0,0.0,4
51327,13287,Expansion Packs,15,0,0.0,15
51328,13287,Game Packs,12,0,0.0,12
51329,13287,Kits,17,0,0.0,17
51330,13287,Stuff Packs,20,0,0.0,20
51331,13288,Expansion Packs,6,0,0.0,6
51332,13288,Game Packs,5,1,0.2,4
51333,13288,Kits,3,3,1.0,0
51334,13288,Stuff Packs,7,3,0.42857142857142855,4
51335,13289,Expansion Packs,16,0,0.0,16
51336,13289,Game Packs,12,0,0.0,12
51337,13289,Kits,32,1,0.03125,31
51338,13289,Stuff Packs,19,0,0.0,19
51339,13290,Expansion Packs,3,0,0.0,3
51340,13290,Game Packs,1,0,0.0,1
51341,13290,Kits,1,0,0.0,1
51342,13290,Stuff Packs,5,0,0.0,5
51343,13291,Expansion Packs,14,0,0.0,14
51344,13291,Game Packs,9,0,0.0,9
51345,13291,Kits,8,1,0.125,7
51346,13291,Stuff Packs,9,0,0.0,9
51347,13292,Expansion Packs,5,0,0.0,5
51348,13292,Game Packs,5,0,0.0,5
51349,13292,Kits,12,1,0.08333333333333333,11
51350,13292,Stuff Packs,10,1,0.1,9
51351,13293,Expansion Packs,13,0,0.0,13
51352,13293,Game Packs,7,0,0.0,7
51353,13293,Kits,5,3,0.6,2
51354,13293,Stuff Packs,12,4,0.3333333333333333,8
51355,13294,Expansion Packs,4,0,0.0,4
51356,13294,Game Packs,3,1,0.3333333333333333,2
51357,13294,Kits,2,2,1.0,0
51358,13294,Stuff Packs,5,4,0.8,1
51359,13295,Expansion Packs,15,0,0.0,15
51360,13295,Game Packs,8,1,0.125,7
51361,13295,Kits,8,3,0.375,5
51362,13295,Stuff Packs,12,4,0.3333333333333333,8
51363,13296,Expansion Packs,9,0,0.0,9
51364,13296,Game Packs,7,0,0.0,7
51365,13296,Stuff Packs,11,0,0.0,11
51366,13297,Expansion Packs,16,0,0.0,16
51367,13297,Game Packs,12,0,0.0,12
51368,13297,Kits,14,0,0.0,14
51369,13297,Stuff Packs,15,0,0.0,15
51370,13298,Expansion Packs,11,0,0.0,11
51371,13298,Game Packs,4,0,0.0,4
51372,13298,Kits,2,1,0.5,1
51373,13298,Stuff Packs,10,2,0.2,8
51374,13299,Expansion Packs,10,0,0.0,10
51375,13299,Game Packs,6,0,0.0,6
51376,13299,Stuff Packs,7,0,0.0,7
51377,13300,Expansion Packs,16,0,0.0,16
51378,13300,Game Packs,9,0,0.0,9
51379,13300,Kits,7,1,0.14285714285714285,6
51380,13300,Stuff Packs,13,1,0.07692307692307693,12
51381,13301,Expansion Packs,15,0,0.0,15
51382,13301,Game Packs,11,0,0.0,11
51383,13301,Kits,19,1,0.05263157894736842,18
51384,13301,Stuff Packs,20,0,0.0,20
51385,13302,Expansion Packs,13,0,0.0,13
51386,13302,Game Packs,3,0,0.0,3
51387,13302,Kits,1,0,0.0,1
51388,13302,Stuff Packs,8,0,0.0,8
51389,13303,Expansion Packs,13,0,0.0,13
51390,13303,Game Packs,10,0,0.0,10
51391,13303,Stuff Packs,12,0,0.0,12
51392,13304,Expansion Packs,13,13,1.0,0
51393,13304,Game Packs,4,4,1.0,0
51394,13304,Kits,5,5,1.0,0
51395,13304,Stuff Packs,6,6,1.0,0
51396,13305,Expansion Packs,10,0,0.0,10
51397,13305,Game Packs,7,0,0.0,7
51398,13305,Kits,3,1,0.3333333333333333,2
51399,13305,Stuff Packs,9,1,0.1111111111111111,8
51400,13306,Expansion Packs,9,0,0.0,9
51401,13306,Game Packs,4,0,0.0,4
51402,13306,Stuff Packs,4,0,0.0,4
51403,13307,Expansion Packs,7,0,0.0,7
51404,13307,Kits,1,0,0.0,1
51405,13307,Stuff Packs,8,3,0.375,5
51406,13308,Expansion Packs,14,0,0.0,14
51407,13308,Game Packs,10,0,0.0,10
51408,13308,Kits,3,2,0.6666666666666666,1
51409,13308,Stuff Packs,11,2,0.18181818181818182,9
51410,13309,Expansion Packs,4,0,0.0,4
51411,13309,Game Packs,2,0,0.0,2
51412,13309,Kits,2,1,0.5,1
51413,13309,Stuff Packs,4,2,0.5,2
51414,13310,Expansion Packs,16,0,0.0,16
51415,13310,Game Packs,12,0,0.0,12
51416,13310,Kits,33,3,0.09090909090909091,30
51417,13310,Stuff Packs,20,0,0.0,20
51418,13311,Expansion Packs,5,0,0.0,5
51419,13311,Game Packs,2,0,0.0,2
51420,13311,Kits,4,1,0.25,3
51421,13311,Stuff Packs,5,3,0.6,2
51422,13312,Expansion Packs,16,0,0.0,16
51423,13312,Game Packs,12,1,0.08333333333333333,11
51424,13312,Kits,33,1,0.030303030303030304,32
51425,13312,Stuff Packs,20,0,0.0,20
51426,13313,Expansion Packs,8,0,0.0,8
51427,13313,Game Packs,3,0,0.0,3
51428,13313,Kits,3,0,0.0,3
51429,13313,Stuff Packs,4,2,0.5,2
51430,13314,Expansion Packs,16,7,0.4375,9
51431,13314,Game Packs,11,1,0.09090909090909091,10
51432,13314,Kits,33,2,0.06060606060606061,31
51433,13314,Stuff Packs,20,2,0.1,18
51434,13315,Expansion Packs,16,0,0.0,16
51435,13315,Game Packs,11,0,0.0,11
51436,13315,Kits,25,2,0.08,23
51437,13315,Stuff Packs,17,0,0.0,17
51438,13316,Expansion Packs,11,0,0.0,11
51439,13316,Game Packs,4,0,0.0,4
51440,13316,Kits,3,1,0.3333333333333333,2
51441,13316,Stuff Packs,4,1,0.25,3
51442,13317,Expansion Packs,15,0,0.0,15
51443,13317,Game Packs,7,0,0.0,7
51444,13317,Kits,5,2,0.4,3
51445,13317,Stuff Packs,6,2,0.3333333333333333,4
51446,13318,Expansion Packs,16,16,1.0,0
51447,13318,Game Packs,12,12,1.0,0
51448,13318,Kits,33,33,1.0,0
51449,13318,Stuff Packs,20,20,1.0,0
51450,13319,Expansion Packs,10,0,0.0,10
51451,13319,Game Packs,5,0,0.0,5
51452,13319,Kits,1,1,1.0,0
51453,13319,Stuff Packs,3,0,0.0,3
51454,13320,Expansion Packs,3,0,0.0,3
51455,13321,Expansion Packs,16,0,0.0,16
51456,13321,Game Packs,10,0,0.0,10
51457,13321,Kits,13,1,0.07692307692307693,12
51458,13321,Stuff Packs,9,1,0.1111111111111111,8
51459,13322,Expansion Packs,15,0,0.0,15
51460,13322,Game Packs,11,0,0.0,11
51461,13322,Kits,12,1,0.08333333333333333,11
51462,13322,Stuff Packs,17,0,0.0,17
51463,13323,Expansion Packs,13,0,0.0,13
51464,13323,Game Packs,9,0,0.0,9
51465,13323,Kits,5,1,0.2,4
51466,13323,Stuff Packs,17,0,0.0,17
51467,13324,Expansion Packs,13,0,0.0,13
51468,13324,Game Packs,6,0,0.0,6
51469,13324,Kits,13,0,0.0,13
51470,13324,Stuff Packs,16,0,0.0,16
51471,13325,Expansion Packs,16,0,0.0,16
51472,13325,Game Packs,11,0,0.0,11
51473,13325,Kits,29,0,0.0,29
51474,13325,Stuff Packs,19,0,0.0,19
51475,13326,Expansion Packs,10,0,0.0,10
51476,13326,Game Packs,1,0,0.0,1
51477,13326,Kits,5,0,0.0,5
51478,13326,Stuff Packs,4,2,0.5,2
51479,13327,Expansion Packs,13,0,0.0,13
51480,13327,Game Packs,8,0,0.0,8
51481,13327,Kits,4,0,0.0,4
51482,13327,Stuff Packs,14,0,0.0,14
51483,13328,Expansion Packs,15,0,0.0,15
51484,13328,Game Packs,10,0,0.0,10
51485,13328,Kits,11,0,0.0,11
51486,13328,Stuff Packs,11,0,0.0,11
51487,13329,Expansion Packs,16,0,0.0,16
51488,13329,Game Packs,12,0,0.0,12
51489,13329,Kits,32,0,0.0,32
51490,13329,Stuff Packs,20,0,0.0,20
51491,13330,Expansion Packs,16,0,0.0,16
51492,13330,Game Packs,12,0,0.0,12
51493,13330,Kits,27,0,0.0,27
51494,13330,Stuff Packs,20,0,0.0,20
51495,13331,Expansion Packs,16,0,0.0,16
51496,13331,Game Packs,10,0,0.0,10
51497,13331,Stuff Packs,11,0,0.0,11
51498,13332,Expansion Packs,16,0,0.0,16
51499,13332,Game Packs,12,0,0.0,12
51500,13332,Kits,33,0,0.0,33
51501,13332,Stuff Packs,20,0,0.0,20
51502,13333,Expansion Packs,16,0,0.0,16
51503,13333,Game Packs,12,0,0.0,12
51504,13333,Kits,33,0,0.0,33
51505,13333,Stuff Packs,20,0,0.0,20
51506,13334,Expansion Packs,16,1,0.0625,15
51507,13334,Game Packs,12,0,0.0,12
51508,13334,Kits,33,0,0.0,33
51509,13334,Stuff Packs,20,0,0.0,20
51510,13335,Expansion Packs,3,0,0.0,3
51511,13335,Game Packs,1,0,0.0,1
51512,13335,Kits,2,0,0.0,2
51513,13335,Stuff Packs,3,0,0.0,3
51514,13336,Expansion Packs,14,0,0.0,14
51515,13336,Game Packs,6,0,0.0,6
51516,13336,Kits,4,1,0.25,3
51517,13336,Stuff Packs,10,3,0.3,7
51518,13337,Expansion Packs,1,0,0.0,1
51519,13338,Expansion Packs,6,0,0.0,6
51520,13338,Game Packs,5,1,0.2,4
51521,13338,Kits,2,1,0.5,1
51522,13338,Stuff Packs,4,1,0.25,3
51523,13339,Expansion Packs,16,0,0.0,16
51524,13339,Game Packs,12,0,0.0,12
51525,13339,Kits,33,0,0.0,33
51526,13339,Stuff Packs,20,0,0.0,20
51527,13340,Expansion Packs,14,0,0.0,14
51528,13340,Game Packs,4,0,0.0,4
51529,13340,Kits,7,3,0.42857142857142855,4
51530,13340,Stuff Packs,10,2,0.2,8
51531,13341,Expansion Packs,16,0,0.0,16
51532,13341,Game Packs,12,0,0.0,12
51533,13341,Kits,22,0,0.0,22
51534,13341,Stuff Packs,20,0,0.0,20
51535,13342,Expansion Packs,12,0,0.0,12
51536,13342,Game Packs,9,0,0.0,9
51537,13342,Kits,6,1,0.16666666666666666,5
51538,13342,Stuff Packs,15,3,0.2,12
51539,13343,Expansion Packs,13,0,0.0,13
51540,13343,Game Packs,3,0,0.0,3
51541,13343,Kits,11,0,0.0,11
51542,13343,Stuff Packs,9,3,0.3333333333333333,6
51543,13344,Expansion Packs,5,0,0.0,5
51544,13344,Game Packs,3,0,0.0,3
51545,13344,Kits,1,1,1.0,0
51546,13344,Stuff Packs,2,1,0.5,1
51547,13345,Expansion Packs,10,1,0.1,9
51548,13345,Game Packs,7,0,0.0,7
51549,13345,Kits,10,1,0.1,9
51550,13345,Stuff Packs,10,0,0.0,10
51551,13346,Expansion Packs,11,0,0.0,11
51552,13346,Game Packs,5,0,0.0,5
51553,13346,Kits,8,0,0.0,8
51554,13346,Stuff Packs,8,1,0.125,7
51555,13347,Expansion Packs,11,0,0.0,11
51556,13347,Game Packs,10,0,0.0,10
51557,13347,Kits,4,2,0.5,2
51558,13347,Stuff Packs,13,1,0.07692307692307693,12
51559,13348,Expansion Packs,7,0,0.0,7
51560,13348,Game Packs,6,0,0.0,6
51561,13348,Kits,9,3,0.3333333333333333,6
51562,13348,Stuff Packs,10,5,0.5,5
51563,13349,Expansion Packs,16,0,0.0,16
51564,13349,Game Packs,11,0,0.0,11
51565,13349,Stuff Packs,8,0,0.0,8
51566,13350,Expansion Packs,15,1,0.06666666666666667,14
51567,13350,Game Packs,10,1,0.1,9
51568,13350,Kits,31,1,0.03225806451612903,30
51569,13350,Stuff Packs,18,0,0.0,18
51570,13351,Expansion Packs,10,0,0.0,10
51571,13351,Game Packs,6,0,0.0,6
51572,13351,Kits,9,1,0.1111111111111111,8
51573,13351,Stuff Packs,8,2,0.25,6
51574,13352,Expansion Packs,12,0,0.0,12
51575,13352,Game Packs,6,0,0.0,6
51576,13352,Kits,2,0,0.0,2
51577,13352,Stuff Packs,3,0,0.0,3
51578,13353,Expansion Packs,16,0,0.0,16
51579,13353,Game Packs,12,0,0.0,12
51580,13353,Kits,20,1,0.05,19
51581,13353,Stuff Packs,17,1,0.058823529411764705,16
51582,13354,Expansion Packs,14,0,0.0,14
51583,13354,Game Packs,7,0,0.0,7
51584,13354,Stuff Packs,15,0,0.0,15
51585,13355,Expansion Packs,5,0,0.0,5
51586,13355,Stuff Packs,1,0,0.0,1
51587,13356,Expansion Packs,16,0,0.0,16
51588,13356,Game Packs,12,0,0.0,12
51589,13356,Kits,33,0,0.0,33
51590,13356,Stuff Packs,20,0,0.0,20
51591,13357,Expansion Packs,16,0,0.0,16
51592,13357,Game Packs,12,0,0.0,12
51593,13357,Kits,33,0,0.0,33
51594,13357,Stuff Packs,20,0,0.0,20
51595,13358,Expansion Packs,16,0,0.0,16
51596,13358,Game Packs,10,0,0.0,10
51597,13358,Kits,5,0,0.0,5
51598,13358,Stuff Packs,10,2,0.2,8
51599,13359,Expansion Packs,11,0,0.0,11
51600,13359,Game Packs,3,0,0.0,3
51601,13359,Stuff Packs,9,0,0.0,9
51602,13360,Expansion Packs,11,0,0.0,11
51603,13360,Game Packs,7,0,0.0,7
51604,13360,Kits,4,2,0.5,2
51605,13360,Stuff Packs,16,0,0.0,16
51606,13361,Expansion Packs,10,0,0.0,10
51607,13361,Game Packs,4,0,0.0,4
51608,13362,Expansion Packs,16,0,0.0,16
51609,13362,Game Packs,12,0,0.0,12
51610,13362,Kits,33,0,0.0,33
51611,13362,Stuff Packs,20,0,0.0,20
51612,13363,Expansion Packs,15,0,0.0,15
51613,13363,Game Packs,12,0,0.0,12
51614,13363,Kits,9,1,0.1111111111111111,8
51615,13363,Stuff Packs,20,0,0.0,20
51616,13364,Expansion Packs,16,0,0.0,16
51617,13364,Game Packs,12,0,0.0,12
51618,13364,Kits,21,1,0.047619047619047616,20
51619,13364,Stuff Packs,20,0,0.0,20
51620,13365,Expansion Packs,10,0,0.0,10
51621,13365,Game Packs,7,0,0.0,7
51622,13365,Kits,1,0,0.0,1
51623,13365,Stuff Packs,7,2,0.2857142857142857,5
51624,13366,Expansion Packs,6,1,0.16666666666666666,5
51625,13366,Game Packs,6,1,0.16666666666666666,5
51626,13366,Kits,1,1,1.0,0
51627,13366,Stuff Packs,7,2,0.2857142857142857,5
51628,13367,Expansion Packs,14,0,0.0,14
51629,13367,Game Packs,10,0,0.0,10
51630,13367,Kits,3,3,1.0,0
51631,13367,Stuff Packs,17,0,0.0,17
51632,13368,Expansion Packs,9,1,0.1111111111111111,8
51633,13368,Game Packs,4,0,0.0,4
51634,13368,Kits,6,0,0.0,6
51635,13368,Stuff Packs,7,0,0.0,7
51636,13369,Expansion Packs,16,0,0.0,16
51637,13369,Game Packs,11,0,0.0,11
51638,13369,Kits,15,3,0.2,12
51639,13369,Stuff Packs,20,0,0.0,20
51640,13370,Expansion Packs,16,0,0.0,16
51641,13370,Game Packs,12,0,0.0,12
51642,13370,Kits,33,0,0.0,33
51643,13370,Stuff Packs,20,0,0.0,20
51644,13371,Expansion Packs,16,0,0.0,16
51645,13371,Game Packs,10,2,0.2,8
51646,13371,Kits,2,2,1.0,0
51647,13371,Stuff Packs,13,5,0.38461538461538464,8
51648,13372,Expansion Packs,16,0,0.0,16
51649,13372,Game Packs,12,0,0.0,12
51650,13372,Kits,28,0,0.0,28
51651,13372,Stuff Packs,20,0,0.0,20
51652,13373,Expansion Packs,14,0,0.0,14
51653,13373,Game Packs,12,0,0.0,12
51654,13373,Kits,10,0,0.0,10
51655,13373,Stuff Packs,20,0,0.0,20
51656,13374,Expansion Packs,16,0,0.0,16
51657,13374,Game Packs,12,0,0.0,12
51658,13374,Kits,33,0,0.0,33
51659,13374,Stuff Packs,20,0,0.0,20
51660,13375,Expansion Packs,16,0,0.0,16
51661,13375,Game Packs,12,0,0.0,12
51662,13375,Kits,15,0,0.0,15
51663,13375,Stuff Packs,16,0,0.0,16
51664,13376,Expansion Packs,12,0,0.0,12
51665,13376,Game Packs,3,0,0.0,3
51666,13376,Kits,4,1,0.25,3
51667,13376,Stuff Packs,6,1,0.16666666666666666,5
51668,13377,Expansion Packs,2,0,0.0,2
51669,13377,Game Packs,1,0,0.0,1
51670,13377,Kits,3,1,0.3333333333333333,2
51671,13377,Stuff Packs,1,0,0.0,1
51672,13378,Expansion Packs,16,0,0.0,16
51673,13378,Game Packs,11,0,0.0,11
51674,13378,Kits,4,0,0.0,4
51675,13378,Stuff Packs,10,1,0.1,9
51676,13379,Expansion Packs,16,0,0.0,16
51677,13379,Game Packs,11,0,0.0,11
51678,13379,Kits,23,0,0.0,23
51679,13379,Stuff Packs,19,1,0.05263157894736842,18
51680,13380,Expansion Packs,8,0,0.0,8
51681,13380,Game Packs,5,2,0.4,3
51682,13380,Kits,1,0,0.0,1
51683,13380,Stuff Packs,1,1,1.0,0
51684,13381,Expansion Packs,9,0,0.0,9
51685,13381,Game Packs,6,0,0.0,6
51686,13381,Kits,1,1,1.0,0
51687,13381,Stuff Packs,8,1,0.125,7
51688,13382,Expansion Packs,16,2,0.125,14
51689,13382,Game Packs,12,0,0.0,12
51690,13382,Kits,22,2,0.09090909090909091,20
51691,13382,Stuff Packs,20,0,0.0,20
51692,13383,Expansion Packs,16,0,0.0,16
51693,13383,Game Packs,12,0,0.0,12
51694,13383,Kits,20,0,0.0,20
51695,13383,Stuff Packs,20,0,0.0,20
51696,13384,Expansion Packs,16,0,0.0,16
51697,13384,Game Packs,11,0,0.0,11
51698,13384,Kits,14,2,0.14285714285714285,12
51699,13384,Stuff Packs,18,0,0.0,18
51700,13385,Expansion Packs,8,0,0.0,8
51701,13385,Game Packs,3,0,0.0,3
51702,13385,Kits,3,0,0.0,3
51703,13385,Stuff Packs,4,1,0.25,3
51704,13386,Expansion Packs,16,0,0.0,16
51705,13386,Game Packs,11,0,0.0,11
51706,13386,Kits,10,0,0.0,10
51707,13386,Stuff Packs,13,0,0.0,13
51708,13387,Expansion Packs,10,0,0.0,10
51709,13387,Game Packs,4,0,0.0,4
51710,13387,Kits,1,1,1.0,0
51711,13387,Stuff Packs,5,0,0.0,5
51712,13388,Expansion Packs,4,0,0.0,4
51713,13388,Game Packs,2,0,0.0,2
51714,13388,Kits,2,1,0.5,1
51715,13388,Stuff Packs,8,0,0.0,8
51716,13389,Expansion Packs,16,0,0.0,16
51717,13389,Game Packs,12,0,0.0,12
51718,13389,Kits,33,1,0.030303030303030304,32
51719,13389,Stuff Packs,20,0,0.0,20
51720,13390,Expansion Packs,5,0,0.0,5
51721,13390,Game Packs,1,1,1.0,0
51722,13390,Kits,8,2,0.25,6
51723,13390,Stuff Packs,8,5,0.625,3
51724,13391,Expansion Packs,16,0,0.0,16
51725,13391,Game Packs,12,0,0.0,12
51726,13391,Kits,33,0,0.0,33
51727,13391,Stuff Packs,20,0,0.0,20
51728,13392,Expansion Packs,14,0,0.0,14
51729,13392,Game Packs,12,0,0.0,12
51730,13392,Kits,14,1,0.07142857142857142,13
51731,13392,Stuff Packs,20,0,0.0,20
51732,13393,Expansion Packs,16,0,0.0,16
51733,13393,Game Packs,12,0,0.0,12
51734,13393,Kits,25,1,0.04,24
51735,13393,Stuff Packs,19,1,0.05263157894736842,18
51736,13394,Expansion Packs,16,0,0.0,16
51737,13394,Game Packs,12,0,0.0,12
51738,13394,Kits,13,1,0.07692307692307693,12
51739,13394,Stuff Packs,20,0,0.0,20
51740,13395,Expansion Packs,16,0,0.0,16
51741,13395,Game Packs,12,0,0.0,12
51742,13395,Kits,14,0,0.0,14
51743,13395,Stuff Packs,20,0,0.0,20
51744,13396,Expansion Packs,16,0,0.0,16
51745,13396,Game Packs,12,0,0.0,12
51746,13396,Kits,33,0,0.0,33
51747,13396,Stuff Packs,20,0,0.0,20
51748,13397,Expansion Packs,16,0,0.0,16
51749,13397,Game Packs,12,0,0.0,12
51750,13397,Kits,7,0,0.0,7
51751,13397,Stuff Packs,19,1,0.05263157894736842,18
51752,13398,Expansion Packs,15,0,0.0,15
51753,13398,Game Packs,5,0,0.0,5
51754,13398,Kits,1,0,0.0,1
51755,13398,Stuff Packs,2,0,0.0,2
51756,13399,Expansion Packs,16,16,1.0,0
51757,13399,Game Packs,12,12,1.0,0
51758,13399,Kits,33,33,1.0,0
51759,13399,Stuff Packs,20,20,1.0,0
51760,13400,Expansion Packs,16,0,0.0,16
51761,13400,Game Packs,12,0,0.0,12
51762,13400,Kits,7,0,0.0,7
51763,13400,Stuff Packs,10,1,0.1,9
51764,13401,Expansion Packs,12,0,0.0,12
51765,13401,Game Packs,9,0,0.0,9
51766,13401,Stuff Packs,6,2,0.3333333333333333,4
51767,13402,Expansion Packs,12,0,0.0,12
51768,13402,Game Packs,3,0,0.0,3
51769,13402,Stuff Packs,3,1,0.3333333333333333,2
51770,13403,Expansion Packs,1,0,0.0,1
51771,13403,Game Packs,3,0,0.0,3
51772,13404,Expansion Packs,16,0,0.0,16
51773,13404,Game Packs,12,0,0.0,12
51774,13404,Kits,33,1,0.030303030303030304,32
51775,13404,Stuff Packs,20,0,0.0,20
51776,13405,Expansion Packs,15,0,0.0,15
51777,13405,Game Packs,10,0,0.0,10
51778,13405,Kits,8,0,0.0,8
51779,13405,Stuff Packs,19,1,0.05263157894736842,18
51780,13406,Expansion Packs,15,0,0.0,15
51781,13406,Game Packs,10,0,0.0,10
51782,13406,Kits,7,0,0.0,7
51783,13406,Stuff Packs,15,0,0.0,15
51784,13407,Expansion Packs,14,0,0.0,14
51785,13407,Game Packs,8,0,0.0,8
51786,13407,Kits,8,0,0.0,8
51787,13407,Stuff Packs,15,0,0.0,15
51788,13408,Expansion Packs,16,0,0.0,16
51789,13408,Game Packs,12,0,0.0,12
51790,13408,Kits,22,1,0.045454545454545456,21
51791,13408,Stuff Packs,18,0,0.0,18
51792,13409,Expansion Packs,14,0,0.0,14
51793,13409,Game Packs,11,0,0.0,11
51794,13409,Kits,23,0,0.0,23
51795,13409,Stuff Packs,19,0,0.0,19
51796,13410,Expansion Packs,14,0,0.0,14
51797,13410,Game Packs,11,0,0.0,11
51798,13410,Kits,12,0,0.0,12
51799,13410,Stuff Packs,14,1,0.07142857142857142,13
51800,13411,Expansion Packs,16,0,0.0,16
51801,13411,Game Packs,12,0,0.0,12
51802,13411,Kits,26,0,0.0,26
51803,13411,Stuff Packs,20,0,0.0,20
51804,13412,Expansion Packs,14,0,0.0,14
51805,13412,Game Packs,3,0,0.0,3
51806,13412,Kits,2,2,1.0,0
51807,13412,Stuff Packs,6,2,0.3333333333333333,4
51808,13413,Expansion Packs,14,0,0.0,14
51809,13413,Game Packs,5,0,0.0,5
51810,13413,Kits,3,2,0.6666666666666666,1
51811,13413,Stuff Packs,6,1,0.16666666666666666,5
51812,13414,Expansion Packs,7,0,0.0,7
51813,13414,Game Packs,2,0,0.0,2
51814,13414,Kits,4,0,0.0,4
51815,13414,Stuff Packs,4,0,0.0,4
51816,13415,Expansion Packs,16,1,0.0625,15
51817,13415,Game Packs,12,0,0.0,12
51818,13415,Kits,33,1,0.030303030303030304,32
51819,13415,Stuff Packs,20,1,0.05,19
51820,13416,Expansion Packs,15,0,0.0,15
51821,13416,Game Packs,11,0,0.0,11
51822,13416,Kits,23,0,0.0,23
51823,13416,Stuff Packs,19,0,0.0,19
51824,13417,Expansion Packs,6,0,0.0,6
51825,13417,Game Packs,6,0,0.0,6
51826,13417,Kits,5,3,0.6,2
51827,13417,Stuff Packs,5,1,0.2,4
51828,13418,Expansion Packs,16,0,0.0,16
51829,13418,Game Packs,12,0,0.0,12
51830,13418,Kits,33,0,0.0,33
51831,13418,Stuff Packs,20,2,0.1,18
51832,13419,Expansion Packs,13,0,0.0,13
51833,13419,Game Packs,4,0,0.0,4
51834,13419,Kits,1,0,0.0,1
51835,13419,Stuff Packs,7,4,0.5714285714285714,3
51836,13420,Expansion Packs,7,0,0.0,7
51837,13420,Game Packs,4,0,0.0,4
51838,13420,Kits,1,0,0.0,1
51839,13420,Stuff Packs,3,0,0.0,3
51840,13421,Expansion Packs,16,0,0.0,16
51841,13421,Game Packs,12,0,0.0,12
51842,13421,Kits,3,1,0.3333333333333333,2
51843,13421,Stuff Packs,19,0,0.0,19
51844,13422,Expansion Packs,11,0,0.0,11
51845,13422,Game Packs,5,0,0.0,5
51846,13422,Kits,4,0,0.0,4
51847,13422,Stuff Packs,8,0,0.0,8
51848,13423,Expansion Packs,14,0,0.0,14
51849,13423,Game Packs,9,0,0.0,9
51850,13423,Kits,4,2,0.5,2
51851,13423,Stuff Packs,16,0,0.0,16
51852,13424,Expansion Packs,5,0,0.0,5
51853,13424,Game Packs,1,1,1.0,0
51854,13424,Kits,2,0,0.0,2
51855,13424,Stuff Packs,4,1,0.25,3
51856,13425,Expansion Packs,16,2,0.125,14
51857,13425,Game Packs,12,3,0.25,9
51858,13425,Kits,33,0,0.0,33
51859,13425,Stuff Packs,20,9,0.45,11
51860,13426,Expansion Packs,16,0,0.0,16
51861,13426,Game Packs,12,0,0.0,12
51862,13426,Kits,33,0,0.0,33
51863,13426,Stuff Packs,20,0,0.0,20
51864,13427,Expansion Packs,16,0,0.0,16
51865,13427,Game Packs,12,0,0.0,12
51866,13427,Kits,33,0,0.0,33
51867,13427,Stuff Packs,20,0,0.0,20
51868,13428,Expansion Packs,15,0,0.0,15
51869,13428,Game Packs,6,0,0.0,6
51870,13428,Kits,4,0,0.0,4
51871,13428,Stuff Packs,9,0,0.0,9
51872,13429,Expansion Packs,16,0,0.0,16
51873,13429,Game Packs,10,0,0.0,10
51874,13429,Kits,4,0,0.0,4
51875,13429,Stuff Packs,18,2,0.1111111111111111,16
51876,13430,Expansion Packs,9,1,0.1111111111111111,8
51877,13430,Game Packs,1,0,0.0,1
51878,13430,Kits,3,0,0.0,3
51879,13430,Stuff Packs,4,2,0.5,2
51880,13431,Expansion Packs,16,0,0.0,16
51881,13431,Game Packs,12,0,0.0,12
51882,13431,Kits,21,0,0.0,21
51883,13431,Stuff Packs,20,1,0.05,19
51884,13432,Expansion Packs,7,0,0.0,7
51885,13432,Game Packs,5,1,0.2,4
51886,13432,Kits,2,2,1.0,0
51887,13432,Stuff Packs,6,4,0.6666666666666666,2
51888,13433,Expansion Packs,16,0,0.0,16
51889,13433,Game Packs,12,0,0.0,12
51890,13433,Kits,19,1,0.05263157894736842,18
51891,13433,Stuff Packs,17,1,0.058823529411764705,16
51892,13434,Expansion Packs,16,0,0.0,16
51893,13434,Game Packs,12,0,0.0,12
51894,13434,Kits,26,0,0.0,26
51895,13434,Stuff Packs,20,0,0.0,20
51896,13435,Expansion Packs,16,0,0.0,16
51897,13435,Game Packs,12,0,0.0,12
51898,13435,Kits,18,1,0.05555555555555555,17
51899,13435,Stuff Packs,20,0,0.0,20
51900,13436,Expansion Packs,2,0,0.0,2
51901,13436,Kits,1,1,1.0,0
51902,13436,Stuff Packs,3,3,1.0,0
51903,13437,Expansion Packs,16,0,0.0,16
51904,13437,Game Packs,7,0,0.0,7
51905,13437,Kits,6,1,0.16666666666666666,5
51906,13437,Stuff Packs,6,3,0.5,3
51907,13438,Expansion Packs,15,0,0.0,15
51908,13438,Game Packs,12,0,0.0,12
51909,13438,Kits,2,0,0.0,2
51910,13438,Stuff Packs,18,0,0.0,18
51911,13439,Expansion Packs,2,0,0.0,2
51912,13439,Kits,1,0,0.0,1
51913,13439,Stuff Packs,4,2,0.5,2
51914,13440,Expansion Packs,12,0,0.0,12
51915,13440,Game Packs,5,0,0.0,5
51916,13440,Kits,12,1,0.08333333333333333,11
51917,13440,Stuff Packs,9,3,0.3333333333333333,6
51918,13441,Expansion Packs,16,1,0.0625,15
51919,13441,Game Packs,12,0,0.0,12
51920,13441,Kits,28,1,0.03571428571428571,27
51921,13441,Stuff Packs,20,0,0.0,20
51922,13442,Expansion Packs,13,0,0.0,13
51923,13442,Game Packs,6,0,0.0,6
51924,13442,Kits,6,1,0.16666666666666666,5
51925,13442,Stuff Packs,11,1,0.09090909090909091,10
51926,13443,Expansion Packs,16,0,0.0,16
51927,13443,Game Packs,12,0,0.0,12
51928,13443,Kits,28,0,0.0,28
51929,13443,Stuff Packs,20,0,0.0,20
51930,13444,Expansion Packs,12,0,0.0,12
51931,13444,Game Packs,4,0,0.0,4
51932,13444,Kits,2,0,0.0,2
51933,13444,Stuff Packs,9,0,0.0,9
51934,13445,Expansion Packs,6,0,0.0,6
51935,13445,Game Packs,2,0,0.0,2
51936,13445,Kits,2,2,1.0,0
51937,13445,Stuff Packs,5,3,0.6,2
51938,13446,Expansion Packs,15,1,0.06666666666666667,14
51939,13446,Game Packs,9,1,0.1111111111111111,8
51940,13446,Kits,13,1,0.07692307692307693,12
51941,13446,Stuff Packs,13,2,0.15384615384615385,11
51942,13447,Expansion Packs,10,0,0.0,10
51943,13447,Game Packs,9,0,0.0,9
51944,13447,Kits,3,3,1.0,0
51945,13447,Stuff Packs,12,2,0.16666666666666666,10
51946,13448,Expansion Packs,15,0,0.0,15
51947,13448,Game Packs,11,0,0.0,11
51948,13448,Kits,24,1,0.041666666666666664,23
51949,13448,Stuff Packs,13,0,0.0,13
51950,13449,Expansion Packs,10,9,0.9,1
51951,13449,Game Packs,9,9,1.0,0
51952,13449,Stuff Packs,18,18,1.0,0
51953,13450,Expansion Packs,16,0,0.0,16
51954,13450,Game Packs,12,0,0.0,12
51955,13450,Kits,33,0,0.0,33
51956,13450,Stuff Packs,20,0,0.0,20
51957,13451,Expansion Packs,3,0,0.0,3
51958,13451,Game Packs,1,0,0.0,1
51959,13451,Kits,1,1,1.0,0
51960,13451,Stuff Packs,5,1,0.2,4
51961,13452,Expansion Packs,12,0,0.0,12
51962,13452,Game Packs,3,0,0.0,3
51963,13452,Kits,2,1,0.5,1
51964,13452,Stuff Packs,6,0,0.0,6
51965,13453,Expansion Packs,9,0,0.0,9
51966,13453,Game Packs,1,0,0.0,1
51967,13453,Kits,4,2,0.5,2
51968,13453,Stuff Packs,2,0,0.0,2
51969,13454,Expansion Packs,9,0,0.0,9
51970,13454,Game Packs,6,0,0.0,6
51971,13454,Kits,3,2,0.6666666666666666,1
51972,13454,Stuff Packs,6,2,0.3333333333333333,4
51973,13455,Expansion Packs,14,0,0.0,14
51974,13455,Game Packs,7,0,0.0,7
51975,13455,Kits,8,0,0.0,8
51976,13455,Stuff Packs,7,2,0.2857142857142857,5
51977,13456,Expansion Packs,13,0,0.0,13
51978,13456,Game Packs,7,0,0.0,7
51979,13456,Kits,3,1,0.3333333333333333,2
51980,13456,Stuff Packs,7,2,0.2857142857142857,5
51981,13457,Expansion Packs,16,0,0.0,16
51982,13457,Game Packs,12,1,0.08333333333333333,11
51983,13457,Kits,33,1,0.030303030303030304,32
51984,13457,Stuff Packs,20,0,0.0,20
51985,13458,Expansion Packs,16,0,0.0,16
51986,13458,Game Packs,11,0,0.0,11
51987,13458,Kits,33,1,0.030303030303030304,32
51988,13458,Stuff Packs,20,0,0.0,20
51989,13459,Expansion Packs,14,0,0.0,14
51990,13459,Game Packs,6,1,0.16666666666666666,5
51991,13459,Kits,1,1,1.0,0
51992,13459,Stuff Packs,9,1,0.1111111111111111,8
51993,13460,Expansion Packs,12,0,0.0,12
51994,13460,Game Packs,2,0,0.0,2
51995,13460,Kits,2,0,0.0,2
51996,13460,Stuff Packs,4,0,0.0,4
51997,13461,Expansion Packs,11,0,0.0,11
51998,13461,Game Packs,3,0,0.0,3
51999,13461,Kits,3,1,0.3333333333333333,2
52000,13461,Stuff Packs,9,3,0.3333333333333333,6
52001,13462,Expansion Packs,16,0,0.0,16
52002,13462,Game Packs,11,0,0.0,11
52003,13462,Kits,13,0,0.0,13
52004,13462,Stuff Packs,14,0,0.0,14
52005,13463,Expansion Packs,16,0,0.0,16
52006,13463,Game Packs,12,0,0.0,12
52007,13463,Kits,33,0,0.0,33
52008,13463,Stuff Packs,20,0,0.0,20
52009,13464,Expansion Packs,12,0,0.0,12
52010,13464,Game Packs,9,0,0.0,9
52011,13464,Kits,3,1,0.3333333333333333,2
52012,13464,Stuff Packs,9,0,0.0,9
52013,13465,Expansion Packs,16,0,0.0,16
52014,13465,Game Packs,10,0,0.0,10
52015,13465,Kits,18,0,0.0,18
52016,13465,Stuff Packs,16,3,0.1875,13
52017,13466,Expansion Packs,12,0,0.0,12
52018,13466,Game Packs,8,0,0.0,8
52019,13466,Kits,4,0,0.0,4
52020,13466,Stuff Packs,12,3,0.25,9
52021,13467,Expansion Packs,16,0,0.0,16
52022,13467,Game Packs,12,0,0.0,12
52023,13467,Kits,33,0,0.0,33
52024,13467,Stuff Packs,20,0,0.0,20
52025,13468,Expansion Packs,10,0,0.0,10
52026,13468,Game Packs,4,0,0.0,4
52027,13468,Kits,2,1,0.5,1
52028,13468,Stuff Packs,5,3,0.6,2
52029,13469,Expansion Packs,16,0,0.0,16
52030,13469,Game Packs,11,0,0.0,11
52031,13469,Kits,5,1,0.2,4
52032,13469,Stuff Packs,19,1,0.05263157894736842,18
52033,13470,Expansion Packs,10,0,0.0,10
52034,13470,Game Packs,7,0,0.0,7
52035,13470,Kits,4,1,0.25,3
52036,13470,Stuff Packs,7,0,0.0,7
52037,13471,Expansion Packs,16,0,0.0,16
52038,13471,Game Packs,12,0,0.0,12
52039,13471,Kits,33,0,0.0,33
52040,13471,Stuff Packs,20,0,0.0,20
52041,13472,Expansion Packs,10,0,0.0,10
52042,13472,Game Packs,5,0,0.0,5
52043,13472,Kits,7,0,0.0,7
52044,13472,Stuff Packs,2,0,0.0,2
52045,13473,Expansion Packs,16,0,0.0,16
52046,13473,Game Packs,8,0,0.0,8
52047,13473,Kits,7,0,0.0,7
52048,13473,Stuff Packs,9,1,0.1111111111111111,8
52049,13474,Expansion Packs,16,0,0.0,16
52050,13474,Game Packs,12,0,0.0,12
52051,13474,Kits,33,0,0.0,33
52052,13474,Stuff Packs,20,0,0.0,20
52053,13475,Expansion Packs,13,0,0.0,13
52054,13475,Game Packs,4,0,0.0,4
52055,13475,Kits,2,0,0.0,2
52056,13475,Stuff Packs,5,0,0.0,5
52057,13476,Expansion Packs,15,0,0.0,15
52058,13476,Game Packs,11,0,0.0,11
52059,13476,Kits,2,2,1.0,0
52060,13476,Stuff Packs,7,1,0.14285714285714285,6
52061,13477,Expansion Packs,15,4,0.26666666666666666,11
52062,13477,Game Packs,9,6,0.6666666666666666,3
52063,13477,Kits,8,8,1.0,0
52064,13477,Stuff Packs,13,13,1.0,0
52065,13478,Expansion Packs,14,0,0.0,14
52066,13478,Game Packs,9,0,0.0,9
52067,13478,Kits,7,0,0.0,7
52068,13478,Stuff Packs,20,0,0.0,20
52069,13479,Expansion Packs,11,0,0.0,11
52070,13479,Game Packs,6,0,0.0,6
52071,13479,Kits,2,0,0.0,2
52072,13479,Stuff Packs,8,3,0.375,5
52073,13480,Expansion Packs,16,0,0.0,16
52074,13480,Game Packs,12,0,0.0,12
52075,13480,Kits,32,0,0.0,32
52076,13480,Stuff Packs,20,0,0.0,20
52077,13481,Expansion Packs,16,0,0.0,16
52078,13481,Game Packs,12,0,0.0,12
52079,13481,Kits,33,0,0.0,33
52080,13481,Stuff Packs,20,0,0.0,20
52081,13482,Expansion Packs,5,0,0.0,5
52082,13482,Game Packs,4,0,0.0,4
52083,13482,Kits,2,1,0.5,1
52084,13482,Stuff Packs,9,0,0.0,9
52085,13483,Expansion Packs,14,0,0.0,14
52086,13483,Game Packs,12,0,0.0,12
52087,13483,Kits,14,1,0.07142857142857142,13
52088,13483,Stuff Packs,19,0,0.0,19
52089,13484,Expansion Packs,5,1,0.2,4
52090,13484,Game Packs,2,1,0.5,1
52091,13484,Kits,2,1,0.5,1
52092,13484,Stuff Packs,4,2,0.5,2
52093,13485,Expansion Packs,9,0,0.0,9
52094,13485,Game Packs,3,0,0.0,3
52095,13485,Kits,5,1,0.2,4
52096,13485,Stuff Packs,9,1,0.1111111111111111,8
52097,13486,Expansion Packs,16,0,0.0,16
52098,13486,Game Packs,12,0,0.0,12
52099,13486,Kits,29,0,0.0,29
52100,13486,Stuff Packs,20,0,0.0,20
52101,13487,Expansion Packs,13,0,0.0,13
52102,13487,Game Packs,7,0,0.0,7
52103,13487,Kits,2,1,0.5,1
52104,13487,Stuff Packs,7,2,0.2857142857142857,5
52105,13488,Expansion Packs,6,0,0.0,6
52106,13488,Game Packs,5,0,0.0,5
52107,13488,Stuff Packs,7,3,0.42857142857142855,4
52108,13489,Expansion Packs,9,0,0.0,9
52109,13489,Game Packs,7,0,0.0,7
52110,13489,Kits,6,0,0.0,6
52111,13489,Stuff Packs,8,3,0.375,5
52112,13490,Expansion Packs,8,0,0.0,8
52113,13490,Game Packs,4,0,0.0,4
52114,13490,Kits,3,1,0.3333333333333333,2
52115,13490,Stuff Packs,7,1,0.14285714285714285,6
52116,13491,Expansion Packs,16,0,0.0,16
52117,13491,Game Packs,10,0,0.0,10
52118,13491,Kits,12,1,0.08333333333333333,11
52119,13491,Stuff Packs,17,0,0.0,17
52120,13492,Expansion Packs,10,0,0.0,10
52121,13492,Game Packs,7,0,0.0,7
52122,13492,Stuff Packs,9,2,0.2222222222222222,7
52123,13493,Expansion Packs,13,0,0.0,13
52124,13493,Game Packs,10,0,0.0,10
52125,13493,Kits,11,2,0.18181818181818182,9
52126,13493,Stuff Packs,17,0,0.0,17
52127,13494,Expansion Packs,10,0,0.0,10
52128,13494,Game Packs,8,0,0.0,8
52129,13494,Kits,2,1,0.5,1
52130,13494,Stuff Packs,10,0,0.0,10
52131,13495,Expansion Packs,6,0,0.0,6
52132,13495,Game Packs,2,1,0.5,1
52133,13495,Kits,3,3,1.0,0
52134,13495,Stuff Packs,5,4,0.8,1
52135,13496,Expansion Packs,8,0,0.0,8
52136,13496,Game Packs,6,0,0.0,6
52137,13496,Kits,1,0,0.0,1
52138,13496,Stuff Packs,7,0,0.0,7
52139,13497,Expansion Packs,16,0,0.0,16
52140,13497,Game Packs,11,0,0.0,11
52141,13497,Kits,26,1,0.038461538461538464,25
52142,13497,Stuff Packs,20,0,0.0,20
52143,13498,Expansion Packs,3,0,0.0,3
52144,13498,Game Packs,1,0,0.0,1
52145,13498,Kits,2,2,1.0,0
52146,13498,Stuff Packs,2,2,1.0,0
52147,13499,Expansion Packs,16,0,0.0,16
52148,13499,Game Packs,11,0,0.0,11
52149,13499,Kits,33,0,0.0,33
52150,13499,Stuff Packs,20,0,0.0,20
52151,13500,Expansion Packs,16,0,0.0,16
52152,13500,Game Packs,11,0,0.0,11
52153,13500,Kits,15,0,0.0,15
52154,13500,Stuff Packs,19,0,0.0,19
52155,13501,Expansion Packs,13,0,0.0,13
52156,13501,Game Packs,3,0,0.0,3
52157,13501,Kits,3,2,0.6666666666666666,1
52158,13501,Stuff Packs,5,3,0.6,2
52159,13502,Expansion Packs,3,0,0.0,3
52160,13502,Kits,8,0,0.0,8
52161,13502,Stuff Packs,2,0,0.0,2
52162,13503,Expansion Packs,16,0,0.0,16
52163,13503,Game Packs,12,0,0.0,12
52164,13503,Kits,33,1,0.030303030303030304,32
52165,13503,Stuff Packs,20,0,0.0,20
52166,13504,Expansion Packs,11,0,0.0,11
52167,13504,Game Packs,10,0,0.0,10
52168,13504,Kits,5,1,0.2,4
52169,13504,Stuff Packs,10,0,0.0,10
52170,13505,Expansion Packs,7,0,0.0,7
52171,13505,Game Packs,7,1,0.14285714285714285,6
52172,13505,Kits,3,2,0.6666666666666666,1
52173,13505,Stuff Packs,7,3,0.42857142857142855,4
52174,13506,Expansion Packs,14,0,0.0,14
52175,13506,Game Packs,11,0,0.0,11
52176,13506,Kits,14,0,0.0,14
52177,13506,Stuff Packs,18,0,0.0,18
52178,13507,Expansion Packs,10,0,0.0,10
52179,13507,Game Packs,4,0,0.0,4
52180,13507,Kits,2,0,0.0,2
52181,13507,Stuff Packs,7,0,0.0,7
52182,13508,Expansion Packs,5,0,0.0,5
52183,13508,Game Packs,2,1,0.5,1
52184,13508,Kits,1,0,0.0,1
52185,13508,Stuff Packs,5,2,0.4,3
52186,13509,Expansion Packs,9,0,0.0,9
52187,13509,Game Packs,4,0,0.0,4
52188,13509,Kits,8,1,0.125,7
52189,13509,Stuff Packs,4,1,0.25,3
52190,13510,Expansion Packs,16,0,0.0,16
52191,13510,Game Packs,12,0,0.0,12
52192,13510,Kits,26,1,0.038461538461538464,25
52193,13510,Stuff Packs,19,0,0.0,19
52194,13511,Expansion Packs,14,0,0.0,14
52195,13511,Game Packs,8,0,0.0,8
52196,13511,Kits,3,2,0.6666666666666666,1
52197,13511,Stuff Packs,8,1,0.125,7
52198,13512,Expansion Packs,15,0,0.0,15
52199,13512,Game Packs,11,0,0.0,11
52200,13512,Kits,7,0,0.0,7
52201,13512,Stuff Packs,19,0,0.0,19
52202,13513,Expansion Packs,11,0,0.0,11
52203,13513,Game Packs,6,1,0.16666666666666666,5
52204,13513,Kits,10,3,0.3,7
52205,13513,Stuff Packs,7,4,0.5714285714285714,3
52206,13514,Expansion Packs,15,0,0.0,15
52207,13514,Game Packs,11,0,0.0,11
52208,13514,Kits,16,1,0.0625,15
52209,13514,Stuff Packs,20,0,0.0,20
52210,13515,Expansion Packs,3,0,0.0,3
52211,13515,Game Packs,2,0,0.0,2
52212,13515,Stuff Packs,2,2,1.0,0
52213,13516,Expansion Packs,13,0,0.0,13
52214,13516,Game Packs,5,0,0.0,5
52215,13516,Kits,2,1,0.5,1
52216,13516,Stuff Packs,7,2,0.2857142857142857,5
52217,13517,Expansion Packs,16,0,0.0,16
52218,13517,Game Packs,11,0,0.0,11
52219,13517,Kits,3,1,0.3333333333333333,2
52220,13517,Stuff Packs,12,4,0.3333333333333333,8
52221,13518,Expansion Packs,15,0,0.0,15
52222,13518,Game Packs,3,0,0.0,3
52223,13518,Kits,2,2,1.0,0
52224,13518,Stuff Packs,10,3,0.3,7
52225,13519,Expansion Packs,16,0,0.0,16
52226,13519,Game Packs,11,0,0.0,11
52227,13519,Kits,30,0,0.0,30
52228,13519,Stuff Packs,20,0,0.0,20
52229,13520,Expansion Packs,9,0,0.0,9
52230,13520,Game Packs,5,0,0.0,5
52231,13520,Kits,2,2,1.0,0
52232,13520,Stuff Packs,4,0,0.0,4
52233,13521,Expansion Packs,12,0,0.0,12
52234,13521,Game Packs,7,1,0.14285714285714285,6
52235,13521,Kits,5,0,0.0,5
52236,13521,Stuff Packs,10,0,0.0,10
52237,13522,Expansion Packs,16,0,0.0,16
52238,13522,Game Packs,12,0,0.0,12
52239,13522,Kits,33,1,0.030303030303030304,32
52240,13522,Stuff Packs,20,0,0.0,20
52241,13523,Expansion Packs,8,0,0.0,8
52242,13523,Game Packs,2,0,0.0,2
52243,13523,Kits,2,1,0.5,1
52244,13523,Stuff Packs,2,0,0.0,2
52245,13524,Expansion Packs,16,0,0.0,16
52246,13524,Game Packs,12,0,0.0,12
52247,13524,Kits,33,0,0.0,33
52248,13524,Stuff Packs,20,0,0.0,20
52249,13525,Expansion Packs,12,0,0.0,12
52250,13525,Game Packs,3,0,0.0,3
52251,13525,Kits,3,0,0.0,3
52252,13525,Stuff Packs,7,0,0.0,7
52253,13526,Expansion Packs,16,0,0.0,16
52254,13526,Game Packs,9,1,0.1111111111111111,8
52255,13526,Kits,6,2,0.3333333333333333,4
52256,13526,Stuff Packs,9,3,0.3333333333333333,6
52257,13527,Expansion Packs,16,0,0.0,16
52258,13527,Game Packs,12,0,0.0,12
52259,13527,Kits,33,0,0.0,33
52260,13527,Stuff Packs,20,0,0.0,20
52261,13528,Expansion Packs,4,0,0.0,4
52262,13528,Kits,1,0,0.0,1
52263,13528,Stuff Packs,1,0,0.0,1
52264,13529,Expansion Packs,7,0,0.0,7
52265,13529,Game Packs,3,0,0.0,3
52266,13529,Stuff Packs,3,0,0.0,3
52267,13530,Expansion Packs,16,1,0.0625,15
52268,13530,Game Packs,12,0,0.0,12
52269,13530,Kits,26,0,0.0,26
52270,13530,Stuff Packs,20,0,0.0,20
52271,13531,Expansion Packs,13,0,0.0,13
52272,13531,Game Packs,6,0,0.0,6
52273,13531,Kits,7,1,0.14285714285714285,6
52274,13531,Stuff Packs,12,3,0.25,9
52275,13532,Expansion Packs,12,0,0.0,12
52276,13532,Game Packs,10,0,0.0,10
52277,13532,Kits,1,0,0.0,1
52278,13532,Stuff Packs,9,0,0.0,9
52279,13533,Expansion Packs,14,0,0.0,14
52280,13533,Game Packs,8,0,0.0,8
52281,13533,Kits,14,1,0.07142857142857142,13
52282,13533,Stuff Packs,20,1,0.05,19
52283,13534,Expansion Packs,16,0,0.0,16
52284,13534,Game Packs,12,0,0.0,12
52285,13534,Kits,33,2,0.06060606060606061,31
52286,13534,Stuff Packs,20,0,0.0,20
52287,13535,Expansion Packs,16,0,0.0,16
52288,13535,Game Packs,12,0,0.0,12
52289,13535,Kits,19,1,0.05263157894736842,18
52290,13535,Stuff Packs,20,1,0.05,19
52291,13536,Expansion Packs,15,0,0.0,15
52292,13536,Game Packs,9,0,0.0,9
52293,13536,Kits,18,0,0.0,18
52294,13536,Stuff Packs,14,0,0.0,14
52295,13537,Expansion Packs,12,0,0.0,12
52296,13537,Game Packs,11,0,0.0,11
52297,13537,Kits,8,1,0.125,7
52298,13537,Stuff Packs,9,0,0.0,9
52299,13538,Expansion Packs,16,0,0.0,16
52300,13538,Game Packs,12,0,0.0,12
52301,13538,Kits,33,0,0.0,33
52302,13538,Stuff Packs,20,0,0.0,20
52303,13539,Expansion Packs,5,0,0.0,5
52304,13539,Game Packs,3,0,0.0,3
52305,13539,Kits,2,2,1.0,0
52306,13539,Stuff Packs,6,5,0.8333333333333334,1
52307,13540,Expansion Packs,16,0,0.0,16
52308,13540,Game Packs,12,0,0.0,12
52309,13540,Kits,33,1,0.030303030303030304,32
52310,13540,Stuff Packs,20,0,0.0,20
52311,13541,Expansion Packs,7,0,0.0,7
52312,13541,Game Packs,6,0,0.0,6
52313,13541,Kits,2,2,1.0,0
52314,13541,Stuff Packs,6,3,0.5,3
52315,13542,Expansion Packs,12,0,0.0,12
52316,13542,Game Packs,7,0,0.0,7
52317,13542,Kits,1,1,1.0,0
52318,13542,Stuff Packs,9,2,0.2222222222222222,7
52319,13543,Expansion Packs,10,0,0.0,10
52320,13543,Game Packs,7,1,0.14285714285714285,6
52321,13543,Kits,2,1,0.5,1
52322,13543,Stuff Packs,5,0,0.0,5
52323,13544,Expansion Packs,13,0,0.0,13
52324,13544,Game Packs,5,0,0.0,5
52325,13544,Kits,4,2,0.5,2
52326,13544,Stuff Packs,15,1,0.06666666666666667,14
52327,13545,Expansion Packs,16,0,0.0,16
52328,13545,Game Packs,11,0,0.0,11
52329,13545,Kits,21,0,0.0,21
52330,13545,Stuff Packs,19,0,0.0,19
52331,13546,Expansion Packs,16,0,0.0,16
52332,13546,Game Packs,11,0,0.0,11
52333,13546,Kits,21,1,0.047619047619047616,20
52334,13546,Stuff Packs,20,0,0.0,20
52335,13547,Expansion Packs,16,0,0.0,16
52336,13547,Game Packs,11,0,0.0,11
52337,13547,Kits,28,0,0.0,28
52338,13547,Stuff Packs,20,0,0.0,20
52339,13548,Expansion Packs,15,0,0.0,15
52340,13548,Game Packs,5,0,0.0,5
52341,13548,Kits,12,1,0.08333333333333333,11
52342,13548,Stuff Packs,9,2,0.2222222222222222,7
52343,13549,Expansion Packs,16,0,0.0,16
52344,13549,Game Packs,12,0,0.0,12
52345,13549,Kits,20,2,0.1,18
52346,13549,Stuff Packs,20,0,0.0,20
52347,13550,Expansion Packs,14,0,0.0,14
52348,13550,Game Packs,12,0,0.0,12
52349,13550,Kits,22,0,0.0,22
52350,13550,Stuff Packs,19,0,0.0,19
52351,13551,Expansion Packs,5,0,0.0,5
52352,13551,Game Packs,1,0,0.0,1
52353,13551,Stuff Packs,1,0,0.0,1
52354,13552,Expansion Packs,10,0,0.0,10
52355,13552,Game Packs,7,1,0.14285714285714285,6
52356,13552,Kits,4,0,0.0,4
52357,13552,Stuff Packs,7,3,0.42857142857142855,4
52358,13553,Expansion Packs,4,0,0.0,4
52359,13553,Game Packs,3,1,0.3333333333333333,2
52360,13553,Kits,3,3,1.0,0
52361,13553,Stuff Packs,7,3,0.42857142857142855,4
52362,13554,Expansion Packs,16,0,0.0,16
52363,13554,Game Packs,12,0,0.0,12
52364,13554,Kits,27,1,0.037037037037037035,26
52365,13554,Stuff Packs,18,0,0.0,18
52366,13555,Expansion Packs,10,0,0.0,10
52367,13555,Game Packs,6,1,0.16666666666666666,5
52368,13555,Kits,3,1,0.3333333333333333,2
52369,13555,Stuff Packs,7,4,0.5714285714285714,3
52370,13556,Expansion Packs,6,0,0.0,6
52371,13556,Game Packs,3,1,0.3333333333333333,2
52372,13556,Kits,3,3,1.0,0
52373,13556,Stuff Packs,5,4,0.8,1
52374,13557,Expansion Packs,16,0,0.0,16
52375,13557,Game Packs,11,0,0.0,11
52376,13557,Kits,33,1,0.030303030303030304,32
52377,13557,Stuff Packs,20,0,0.0,20
52378,13558,Expansion Packs,15,0,0.0,15
52379,13558,Game Packs,12,0,0.0,12
52380,13558,Kits,19,0,0.0,19
52381,13558,Stuff Packs,20,1,0.05,19
52382,13559,Expansion Packs,16,0,0.0,16
52383,13559,Game Packs,8,0,0.0,8
52384,13559,Kits,18,0,0.0,18
52385,13559,Stuff Packs,10,0,0.0,10
52386,13560,Expansion Packs,16,0,0.0,16
52387,13560,Game Packs,12,0,0.0,12
52388,13560,Kits,22,0,0.0,22
52389,13560,Stuff Packs,20,1,0.05,19
52390,13561,Expansion Packs,1,0,0.0,1
52391,13561,Game Packs,2,1,0.5,1
52392,13561,Kits,3,3,1.0,0
52393,13561,Stuff Packs,4,3,0.75,1
52394,13562,Expansion Packs,5,0,0.0,5
52395,13562,Game Packs,1,0,0.0,1
52396,13562,Kits,2,1,0.5,1
52397,13562,Stuff Packs,6,3,0.5,3
52398,13563,Expansion Packs,9,0,0.0,9
52399,13563,Game Packs,4,0,0.0,4
52400,13563,Stuff Packs,2,0,0.0,2
52401,13564,Expansion Packs,15,0,0.0,15
52402,13564,Game Packs,10,0,0.0,10
52403,13564,Kits,5,0,0.0,5
52404,13564,Stuff Packs,19,0,0.0,19
52405,13565,Expansion Packs,16,0,0.0,16
52406,13565,Game Packs,11,0,0.0,11
52407,13565,Kits,10,1,0.1,9
52408,13565,Stuff Packs,13,0,0.0,13
52409,13566,Expansion Packs,15,0,0.0,15
52410,13566,Game Packs,8,0,0.0,8
52411,13566,Stuff Packs,9,0,0.0,9
52412,13567,Expansion Packs,16,0,0.0,16
52413,13567,Game Packs,7,0,0.0,7
52414,13567,Kits,25,0,0.0,25
52415,13567,Stuff Packs,19,1,0.05263157894736842,18
52416,13568,Expansion Packs,16,0,0.0,16
52417,13568,Game Packs,12,0,0.0,12
52418,13568,Kits,23,0,0.0,23
52419,13568,Stuff Packs,18,0,0.0,18
52420,13569,Expansion Packs,14,0,0.0,14
52421,13569,Game Packs,10,0,0.0,10
52422,13569,Kits,8,1,0.125,7
52423,13569,Stuff Packs,11,3,0.2727272727272727,8
52424,13570,Expansion Packs,6,0,0.0,6
52425,13570,Game Packs,1,0,0.0,1
52426,13570,Kits,1,1,1.0,0
52427,13570,Stuff Packs,2,0,0.0,2
52428,13571,Expansion Packs,4,0,0.0,4
52429,13571,Stuff Packs,1,0,0.0,1
52430,13572,Expansion Packs,16,0,0.0,16
52431,13572,Game Packs,12,0,0.0,12
52432,13572,Kits,17,0,0.0,17
52433,13572,Stuff Packs,16,0,0.0,16
52434,13573,Expansion Packs,13,0,0.0,13
52435,13573,Game Packs,1,0,0.0,1
52436,13573,Stuff Packs,5,3,0.6,2
52437,13574,Expansion Packs,16,0,0.0,16
52438,13574,Game Packs,10,0,0.0,10
52439,13574,Kits,4,0,0.0,4
52440,13574,Stuff Packs,15,0,0.0,15
52441,13575,Expansion Packs,16,0,0.0,16
52442,13575,Game Packs,12,0,0.0,12
52443,13575,Kits,33,0,0.0,33
52444,13575,Stuff Packs,19,0,0.0,19
52445,13576,Expansion Packs,3,0,0.0,3
52446,13576,Stuff Packs,1,0,0.0,1
52447,13577,Expansion Packs,16,0,0.0,16
52448,13577,Game Packs,12,0,0.0,12
52449,13577,Kits,33,1,0.030303030303030304,32
52450,13577,Stuff Packs,20,0,0.0,20
52451,13578,Expansion Packs,16,0,0.0,16
52452,13578,Game Packs,12,0,0.0,12
52453,13578,Kits,32,1,0.03125,31
52454,13578,Stuff Packs,20,0,0.0,20
52455,13579,Expansion Packs,16,0,0.0,16
52456,13579,Game Packs,12,0,0.0,12
52457,13579,Kits,33,0,0.0,33
52458,13579,Stuff Packs,20,0,0.0,20
52459,13580,Expansion Packs,16,0,0.0,16
52460,13580,Game Packs,12,0,0.0,12
52461,13580,Kits,33,0,0.0,33
52462,13580,Stuff Packs,20,0,0.0,20
52463,13581,Expansion Packs,14,0,0.0,14
52464,13581,Game Packs,7,0,0.0,7
52465,13581,Kits,1,1,1.0,0
52466,13581,Stuff Packs,8,2,0.25,6
52467,13582,Expansion Packs,9,0,0.0,9
52468,13582,Game Packs,3,1,0.3333333333333333,2
52469,13582,Kits,5,0,0.0,5
52470,13582,Stuff Packs,7,0,0.0,7
52471,13583,Expansion Packs,4,0,0.0,4
52472,13583,Game Packs,2,0,0.0,2
52473,13583,Kits,2,0,0.0,2
52474,13583,Stuff Packs,4,2,0.5,2
52475,13584,Expansion Packs,16,0,0.0,16
52476,13584,Game Packs,12,0,0.0,12
52477,13584,Kits,31,0,0.0,31
52478,13584,Stuff Packs,20,0,0.0,20
52479,13585,Expansion Packs,14,0,0.0,14
52480,13585,Game Packs,7,0,0.0,7
52481,13585,Kits,15,1,0.06666666666666667,14
52482,13585,Stuff Packs,14,0,0.0,14
52483,13586,Expansion Packs,13,0,0.0,13
52484,13586,Game Packs,10,0,0.0,10
52485,13586,Kits,2,2,1.0,0
52486,13586,Stuff Packs,18,0,0.0,18
52487,13587,Expansion Packs,16,0,0.0,16
52488,13587,Game Packs,12,0,0.0,12
52489,13587,Kits,25,0,0.0,25
52490,13587,Stuff Packs,20,0,0.0,20
52491,13588,Expansion Packs,10,0,0.0,10
52492,13588,Game Packs,3,0,0.0,3
52493,13588,Stuff Packs,4,3,0.75,1
52494,13589,Expansion Packs,14,0,0.0,14
52495,13589,Game Packs,8,0,0.0,8
52496,13589,Kits,10,0,0.0,10
52497,13589,Stuff Packs,16,0,0.0,16
52498,13590,Expansion Packs,16,0,0.0,16
52499,13590,Game Packs,12,0,0.0,12
52500,13590,Kits,19,1,0.05263157894736842,18
52501,13590,Stuff Packs,20,0,0.0,20
52502,13591,Expansion Packs,14,0,0.0,14
52503,13591,Game Packs,10,0,0.0,10
52504,13591,Kits,7,1,0.14285714285714285,6
52505,13591,Stuff Packs,15,0,0.0,15
52506,13592,Expansion Packs,10,0,0.0,10
52507,13592,Game Packs,5,0,0.0,5
52508,13592,Kits,7,0,0.0,7
52509,13592,Stuff Packs,9,0,0.0,9
52510,13593,Expansion Packs,13,0,0.0,13
52511,13593,Game Packs,6,1,0.16666666666666666,5
52512,13593,Kits,5,2,0.4,3
52513,13593,Stuff Packs,9,5,0.5555555555555556,4
52514,13594,Expansion Packs,16,0,0.0,16
52515,13594,Game Packs,12,0,0.0,12
52516,13594,Kits,22,0,0.0,22
52517,13594,Stuff Packs,20,0,0.0,20
52518,13595,Expansion Packs,1,0,0.0,1
52519,13595,Game Packs,2,0,0.0,2
52520,13595,Stuff Packs,2,0,0.0,2
52521,13596,Expansion Packs,13,0,0.0,13
52522,13596,Game Packs,9,0,0.0,9
52523,13596,Kits,1,1,1.0,0
52524,13596,Stuff Packs,14,0,0.0,14
52525,13597,Expansion Packs,16,0,0.0,16
52526,13597,Game Packs,3,0,0.0,3
52527,13597,Kits,3,2,0.6666666666666666,1
52528,13597,Stuff Packs,8,0,0.0,8
52529,13598,Expansion Packs,16,0,0.0,16
52530,13598,Game Packs,12,0,0.0,12
52531,13598,Kits,1,1,1.0,0
52532,13598,Stuff Packs,20,0,0.0,20
52533,13599,Expansion Packs,15,0,0.0,15
52534,13599,Game Packs,12,0,0.0,12
52535,13599,Kits,3,1,0.3333333333333333,2
52536,13599,Stuff Packs,20,0,0.0,20
52537,13600,Expansion Packs,10,0,0.0,10
52538,13600,Game Packs,11,0,0.0,11
52539,13600,Stuff Packs,12,0,0.0,12
52540,13601,Expansion Packs,10,0,0.0,10
52541,13601,Game Packs,6,0,0.0,6
52542,13601,Kits,8,0,0.0,8
52543,13601,Stuff Packs,8,0,0.0,8
52544,13602,Expansion Packs,2,0,0.0,2
52545,13602,Game Packs,1,1,1.0,0
52546,13602,Kits,4,0,0.0,4
52547,13602,Stuff Packs,2,0,0.0,2
52548,13603,Expansion Packs,2,0,0.0,2
52549,13603,Kits,2,0,0.0,2
52550,13603,Stuff Packs,2,0,0.0,2
52551,13604,Expansion Packs,16,0,0.0,16
52552,13604,Game Packs,12,0,0.0,12
52553,13604,Kits,33,1,0.030303030303030304,32
52554,13604,Stuff Packs,20,0,0.0,20
52555,13605,Expansion Packs,8,0,0.0,8
52556,13605,Kits,6,1,0.16666666666666666,5
52557,13605,Stuff Packs,4,0,0.0,4
52558,13606,Expansion Packs,5,0,0.0,5
52559,13606,Game Packs,2,0,0.0,2
52560,13606,Stuff Packs,4,0,0.0,4
52561,13607,Expansion Packs,9,0,0.0,9
52562,13607,Game Packs,4,0,0.0,4
52563,13607,Stuff Packs,2,1,0.5,1
52564,13608,Expansion Packs,1,0,0.0,1
52565,13608,Game Packs,3,0,0.0,3
52566,13608,Kits,3,1,0.3333333333333333,2
52567,13608,Stuff Packs,6,2,0.3333333333333333,4
52568,13609,Expansion Packs,15,0,0.0,15
52569,13609,Game Packs,6,0,0.0,6
52570,13609,Kits,6,2,0.3333333333333333,4
52571,13609,Stuff Packs,11,4,0.36363636363636365,7
52572,13610,Expansion Packs,16,0,0.0,16
52573,13610,Game Packs,9,0,0.0,9
52574,13610,Kits,7,0,0.0,7
52575,13610,Stuff Packs,15,0,0.0,15
52576,13611,Expansion Packs,16,0,0.0,16
52577,13611,Game Packs,12,0,0.0,12
52578,13611,Kits,33,1,0.030303030303030304,32
52579,13611,Stuff Packs,20,0,0.0,20
52580,13612,Expansion Packs,16,0,0.0,16
52581,13612,Game Packs,12,0,0.0,12
52582,13612,Kits,22,0,0.0,22
52583,13612,Stuff Packs,20,0,0.0,20
52584,13613,Expansion Packs,8,0,0.0,8
52585,13613,Game Packs,3,0,0.0,3
52586,13613,Kits,3,1,0.3333333333333333,2
52587,13613,Stuff Packs,5,0,0.0,5
52588,13614,Expansion Packs,16,0,0.0,16
52589,13614,Game Packs,12,0,0.0,12
52590,13614,Kits,29,0,0.0,29
52591,13614,Stuff Packs,20,0,0.0,20
52592,13615,Expansion Packs,6,0,0.0,6
52593,13615,Game Packs,2,0,0.0,2
52594,13615,Kits,10,0,0.0,10
52595,13615,Stuff Packs,6,2,0.3333333333333333,4
52596,13616,Expansion Packs,14,0,0.0,14
52597,13616,Game Packs,6,0,0.0,6
52598,13616,Kits,20,1,0.05,19
52599,13616,Stuff Packs,13,0,0.0,13
52600,13617,Expansion Packs,3,0,0.0,3
52601,13617,Game Packs,1,0,0.0,1
52602,13617,Stuff Packs,1,0,0.0,1
52603,13618,Expansion Packs,11,0,0.0,11
52604,13618,Game Packs,2,0,0.0,2
52605,13618,Kits,1,0,0.0,1
52606,13618,Stuff Packs,3,1,0.3333333333333333,2
52607,13619,Expansion Packs,16,0,0.0,16
52608,13619,Game Packs,11,0,0.0,11
52609,13619,Kits,6,2,0.3333333333333333,4
52610,13619,Stuff Packs,16,1,0.0625,15
52611,13620,Expansion Packs,15,0,0.0,15
52612,13620,Game Packs,4,0,0.0,4
52613,13620,Kits,5,2,0.4,3
52614,13620,Stuff Packs,13,1,0.07692307692307693,12
52615,13621,Expansion Packs,12,0,0.0,12
52616,13621,Game Packs,6,0,0.0,6
52617,13621,Kits,6,1,0.16666666666666666,5
52618,13621,Stuff Packs,18,0,0.0,18
52619,13622,Expansion Packs,4,0,0.0,4
52620,13622,Game Packs,4,0,0.0,4
52621,13622,Kits,3,3,1.0,0
52622,13622,Stuff Packs,7,3,0.42857142857142855,4
52623,13623,Expansion Packs,13,0,0.0,13
52624,13623,Game Packs,12,0,0.0,12
52625,13623,Kits,15,0,0.0,15
52626,13623,Stuff Packs,18,0,0.0,18
52627,13624,Expansion Packs,16,0,0.0,16
52628,13624,Game Packs,12,0,0.0,12
52629,13624,Kits,31,0,0.0,31
52630,13624,Stuff Packs,20,0,0.0,20
52631,13625,Expansion Packs,11,1,0.09090909090909091,10
52632,13625,Game Packs,2,0,0.0,2
52633,13625,Kits,2,2,1.0,0
52634,13625,Stuff Packs,3,3,1.0,0
52635,13626,Expansion Packs,4,0,0.0,4
52636,13626,Game Packs,6,0,0.0,6
52637,13626,Kits,4,1,0.25,3
52638,13626,Stuff Packs,4,1,0.25,3
52639,13627,Expansion Packs,4,0,0.0,4
52640,13627,Game Packs,3,0,0.0,3
52641,13627,Kits,4,4,1.0,0
52642,13627,Stuff Packs,6,3,0.5,3
52643,13628,Expansion Packs,16,0,0.0,16
52644,13628,Game Packs,12,0,0.0,12
52645,13628,Kits,23,0,0.0,23
52646,13628,Stuff Packs,19,0,0.0,19
52647,13629,Expansion Packs,4,0,0.0,4
52648,13629,Game Packs,3,0,0.0,3
52649,13629,Kits,1,1,1.0,0
52650,13629,Stuff Packs,3,0,0.0,3
52651,13630,Expansion Packs,4,0,0.0,4
52652,13630,Game Packs,2,0,0.0,2
52653,13630,Kits,1,1,1.0,0
52654,13630,Stuff Packs,5,3,0.6,2
52655,13631,Expansion Packs,16,0,0.0,16
52656,13631,Game Packs,12,0,0.0,12
52657,13631,Kits,33,0,0.0,33
52658,13631,Stuff Packs,20,0,0.0,20
52659,13632,Expansion Packs,16,0,0.0,16
52660,13632,Game Packs,12,0,0.0,12
52661,13632,Kits,15,0,0.0,15
52662,13632,Stuff Packs,16,0,0.0,16
52663,13633,Expansion Packs,13,0,0.0,13
52664,13633,Game Packs,6,0,0.0,6
52665,13633,Kits,2,1,0.5,1
52666,13633,Stuff Packs,6,3,0.5,3
52667,13634,Expansion Packs,15,0,0.0,15
52668,13634,Game Packs,10,0,0.0,10
52669,13634,Kits,2,0,0.0,2
52670,13634,Stuff Packs,14,0,0.0,14
52671,13635,Expansion Packs,16,0,0.0,16
52672,13635,Game Packs,12,0,0.0,12
52673,13635,Kits,33,0,0.0,33
52674,13635,Stuff Packs,20,1,0.05,19
52675,13636,Expansion Packs,15,0,0.0,15
52676,13636,Game Packs,8,0,0.0,8
52677,13636,Kits,12,1,0.08333333333333333,11
52678,13636,Stuff Packs,11,2,0.18181818181818182,9
52679,13637,Expansion Packs,16,0,0.0,16
52680,13637,Game Packs,8,0,0.0,8
52681,13637,Kits,13,2,0.15384615384615385,11
52682,13637,Stuff Packs,13,3,0.23076923076923078,10
52683,13638,Expansion Packs,8,0,0.0,8
52684,13638,Game Packs,5,0,0.0,5
52685,13638,Kits,2,1,0.5,1
52686,13638,Stuff Packs,12,3,0.25,9
52687,13639,Expansion Packs,14,0,0.0,14
52688,13639,Game Packs,8,0,0.0,8
52689,13639,Kits,10,0,0.0,10
52690,13639,Stuff Packs,12,0,0.0,12
52691,13640,Expansion Packs,5,0,0.0,5
52692,13640,Game Packs,4,0,0.0,4
52693,13640,Stuff Packs,4,1,0.25,3
52694,13641,Expansion Packs,14,0,0.0,14
52695,13641,Game Packs,6,0,0.0,6
52696,13641,Kits,11,0,0.0,11
52697,13641,Stuff Packs,9,0,0.0,9
52698,13642,Expansion Packs,3,0,0.0,3
52699,13642,Game Packs,1,0,0.0,1
52700,13642,Stuff Packs,5,5,1.0,0
52701,13643,Expansion Packs,10,0,0.0,10
52702,13643,Game Packs,4,0,0.0,4
52703,13643,Kits,10,2,0.2,8
52704,13643,Stuff Packs,7,1,0.14285714285714285,6
52705,13644,Expansion Packs,6,0,0.0,6
52706,13644,Game Packs,1,0,0.0,1
52707,13644,Kits,1,1,1.0,0
52708,13644,Stuff Packs,4,2,0.5,2
52709,13645,Expansion Packs,16,0,0.0,16
52710,13645,Game Packs,10,0,0.0,10
52711,13645,Kits,12,0,0.0,12
52712,13645,Stuff Packs,11,1,0.09090909090909091,10
52713,13646,Expansion Packs,6,0,0.0,6
52714,13646,Game Packs,1,1,1.0,0
52715,13646,Stuff Packs,3,3,1.0,0
52716,13647,Expansion Packs,16,0,0.0,16
52717,13647,Game Packs,12,0,0.0,12
52718,13647,Kits,33,0,0.0,33
52719,13647,Stuff Packs,20,0,0.0,20
52720,13648,Expansion Packs,10,0,0.0,10
52721,13648,Game Packs,7,0,0.0,7
52722,13648,Kits,2,2,1.0,0
52723,13648,Stuff Packs,6,3,0.5,3
52724,13649,Expansion Packs,15,0,0.0,15
52725,13649,Game Packs,10,0,0.0,10
52726,13649,Kits,9,1,0.1111111111111111,8
52727,13649,Stuff Packs,16,1,0.0625,15
52728,13650,Expansion Packs,16,0,0.0,16
52729,13650,Game Packs,11,0,0.0,11
52730,13650,Kits,19,1,0.05263157894736842,18
52731,13650,Stuff Packs,19,0,0.0,19
52732,13651,Expansion Packs,16,0,0.0,16
52733,13651,Game Packs,11,0,0.0,11
52734,13651,Kits,17,1,0.058823529411764705,16
52735,13651,Stuff Packs,20,1,0.05,19
52736,13652,Expansion Packs,16,0,0.0,16
52737,13652,Game Packs,12,0,0.0,12
52738,13652,Kits,20,0,0.0,20
52739,13652,Stuff Packs,20,0,0.0,20
52740,13653,Expansion Packs,3,0,0.0,3
52741,13653,Game Packs,1,0,0.0,1
52742,13653,Kits,1,1,1.0,0
52743,13653,Stuff Packs,3,3,1.0,0
52744,13654,Expansion Packs,4,0,0.0,4
52745,13654,Game Packs,1,0,0.0,1
52746,13654,Stuff Packs,2,1,0.5,1
52747,13655,Expansion Packs,13,0,0.0,13
52748,13655,Game Packs,6,0,0.0,6
52749,13655,Kits,10,1,0.1,9
52750,13655,Stuff Packs,13,2,0.15384615384615385,11
52751,13656,Expansion Packs,12,0,0.0,12
52752,13656,Game Packs,5,0,0.0,5
52753,13656,Kits,2,0,0.0,2
52754,13656,Stuff Packs,8,0,0.0,8
52755,13657,Expansion Packs,16,0,0.0,16
52756,13657,Game Packs,11,0,0.0,11
52757,13657,Kits,13,1,0.07692307692307693,12
52758,13657,Stuff Packs,19,0,0.0,19
52759,13658,Expansion Packs,12,0,0.0,12
52760,13658,Game Packs,7,0,0.0,7
52761,13658,Stuff Packs,12,0,0.0,12
52762,13659,Expansion Packs,15,1,0.06666666666666667,14
52763,13659,Game Packs,5,0,0.0,5
52764,13659,Kits,12,0,0.0,12
52765,13659,Stuff Packs,10,2,0.2,8
52766,13660,Expansion Packs,16,0,0.0,16
52767,13660,Game Packs,11,0,0.0,11
52768,13660,Kits,9,0,0.0,9
52769,13660,Stuff Packs,18,0,0.0,18
52770,13661,Expansion Packs,16,0,0.0,16
52771,13661,Game Packs,11,0,0.0,11
52772,13661,Kits,32,0,0.0,32
52773,13661,Stuff Packs,20,0,0.0,20
52774,13662,Expansion Packs,15,0,0.0,15
52775,13662,Game Packs,10,0,0.0,10
52776,13662,Kits,27,0,0.0,27
52777,13662,Stuff Packs,11,2,0.18181818181818182,9
52778,13663,Expansion Packs,9,0,0.0,9
52779,13663,Game Packs,8,0,0.0,8
52780,13663,Kits,3,0,0.0,3
52781,13663,Stuff Packs,15,0,0.0,15
52782,13664,Expansion Packs,16,0,0.0,16
52783,13664,Game Packs,12,0,0.0,12
52784,13664,Kits,28,0,0.0,28
52785,13664,Stuff Packs,20,0,0.0,20
52786,13665,Expansion Packs,14,0,0.0,14
52787,13665,Game Packs,4,0,0.0,4
52788,13665,Kits,3,0,0.0,3
52789,13665,Stuff Packs,8,3,0.375,5
52790,13666,Expansion Packs,9,0,0.0,9
52791,13666,Game Packs,4,0,0.0,4
52792,13666,Kits,7,1,0.14285714285714285,6
52793,13666,Stuff Packs,8,3,0.375,5
52794,13667,Expansion Packs,14,0,0.0,14
52795,13667,Game Packs,8,0,0.0,8
52796,13667,Kits,5,2,0.4,3
52797,13667,Stuff Packs,10,2,0.2,8
52798,13668,Expansion Packs,16,0,0.0,16
52799,13668,Game Packs,12,0,0.0,12
52800,13668,Kits,33,0,0.0,33
52801,13668,Stuff Packs,20,0,0.0,20
52802,13669,Expansion Packs,12,3,0.25,9
52803,13669,Game Packs,8,0,0.0,8
52804,13669,Kits,12,12,1.0,0
52805,13669,Stuff Packs,18,2,0.1111111111111111,16
52806,13670,Expansion Packs,15,0,0.0,15
52807,13670,Game Packs,7,0,0.0,7
52808,13670,Kits,9,2,0.2222222222222222,7
52809,13670,Stuff Packs,11,2,0.18181818181818182,9
52810,13671,Expansion Packs,16,0,0.0,16
52811,13671,Game Packs,12,0,0.0,12
52812,13671,Kits,33,0,0.0,33
52813,13671,Stuff Packs,20,0,0.0,20
52814,13672,Expansion Packs,16,0,0.0,16
52815,13672,Game Packs,11,0,0.0,11
52816,13672,Kits,3,0,0.0,3
52817,13672,Stuff Packs,20,0,0.0,20
52818,13673,Expansion Packs,16,14,0.875,2
52819,13673,Game Packs,12,0,0.0,12
52820,13673,Kits,33,0,0.0,33
52821,13673,Stuff Packs,20,0,0.0,20
52822,13674,Expansion Packs,16,0,0.0,16
52823,13674,Game Packs,12,0,0.0,12
52824,13674,Kits,33,0,0.0,33
52825,13674,Stuff Packs,20,0,0.0,20
52826,13675,Expansion Packs,4,0,0.0,4
52827,13675,Game Packs,1,0,0.0,1
52828,13675,Kits,1,1,1.0,0
52829,13675,Stuff Packs,5,3,0.6,2
52830,13676,Expansion Packs,15,0,0.0,15
52831,13676,Game Packs,11,0,0.0,11
52832,13676,Kits,3,2,0.6666666666666666,1
52833,13676,Stuff Packs,17,1,0.058823529411764705,16
52834,13677,Expansion Packs,10,0,0.0,10
52835,13677,Game Packs,2,0,0.0,2
52836,13677,Kits,2,2,1.0,0
52837,13677,Stuff Packs,3,3,1.0,0
52838,13678,Expansion Packs,12,0,0.0,12
52839,13678,Game Packs,4,0,0.0,4
52840,13678,Kits,9,3,0.3333333333333333,6
52841,13678,Stuff Packs,7,2,0.2857142857142857,5
52842,13679,Expansion Packs,7,0,0.0,7
52843,13679,Game Packs,4,1,0.25,3
52844,13679,Stuff Packs,4,2,0.5,2
52845,13680,Expansion Packs,5,0,0.0,5
52846,13680,Game Packs,1,0,0.0,1
52847,13680,Stuff Packs,2,1,0.5,1
52848,13681,Expansion Packs,16,0,0.0,16
52849,13681,Game Packs,6,0,0.0,6
52850,13681,Kits,4,0,0.0,4
52851,13681,Stuff Packs,4,1,0.25,3
52852,13682,Expansion Packs,13,0,0.0,13
52853,13682,Game Packs,10,0,0.0,10
52854,13682,Kits,2,2,1.0,0
52855,13682,Stuff Packs,18,0,0.0,18
52856,13683,Expansion Packs,11,0,0.0,11
52857,13683,Game Packs,6,0,0.0,6
52858,13683,Kits,3,0,0.0,3
52859,13683,Stuff Packs,9,0,0.0,9
52860,13684,Expansion Packs,15,0,0.0,15
52861,13684,Game Packs,8,0,0.0,8
52862,13684,Kits,8,2,0.25,6
52863,13684,Stuff Packs,20,0,0.0,20
52864,13685,Expansion Packs,11,0,0.0,11
52865,13685,Game Packs,10,2,0.2,8
52866,13685,Kits,6,0,0.0,6
52867,13685,Stuff Packs,16,1,0.0625,15
52868,13686,Expansion Packs,6,0,0.0,6
52869,13686,Game Packs,3,0,0.0,3
52870,13686,Kits,2,0,0.0,2
52871,13686,Stuff Packs,6,0,0.0,6
52872,13687,Expansion Packs,9,0,0.0,9
52873,13687,Game Packs,4,0,0.0,4
52874,13687,Kits,14,1,0.07142857142857142,13
52875,13687,Stuff Packs,9,0,0.0,9
52876,13688,Expansion Packs,7,0,0.0,7
52877,13688,Game Packs,5,0,0.0,5
52878,13688,Kits,1,1,1.0,0
52879,13688,Stuff Packs,7,7,1.0,0
52880,13689,Expansion Packs,15,0,0.0,15
52881,13689,Game Packs,12,0,0.0,12
52882,13689,Kits,11,2,0.18181818181818182,9
52883,13689,Stuff Packs,10,3,0.3,7
52884,13690,Expansion Packs,8,0,0.0,8
52885,13690,Game Packs,6,0,0.0,6
52886,13690,Kits,7,1,0.14285714285714285,6
52887,13690,Stuff Packs,5,1,0.2,4
52888,13691,Expansion Packs,16,1,0.0625,15
52889,13691,Game Packs,10,0,0.0,10
52890,13691,Kits,1,0,0.0,1
52891,13691,Stuff Packs,6,0,0.0,6
52892,13692,Expansion Packs,16,0,0.0,16
52893,13692,Game Packs,12,0,0.0,12
52894,13692,Kits,33,1,0.030303030303030304,32
52895,13692,Stuff Packs,20,0,0.0,20
52896,13693,Expansion Packs,12,0,0.0,12
52897,13693,Game Packs,7,0,0.0,7
52898,13693,Kits,9,0,0.0,9
52899,13693,Stuff Packs,11,2,0.18181818181818182,9
52900,13694,Expansion Packs,10,0,0.0,10
52901,13694,Game Packs,3,0,0.0,3
52902,13694,Kits,4,0,0.0,4
52903,13694,Stuff Packs,6,2,0.3333333333333333,4
52904,13695,Expansion Packs,16,0,0.0,16
52905,13695,Game Packs,12,0,0.0,12
52906,13695,Kits,11,1,0.09090909090909091,10
52907,13695,Stuff Packs,16,0,0.0,16
52908,13696,Expansion Packs,11,0,0.0,11
52909,13696,Game Packs,6,0,0.0,6
52910,13696,Kits,13,0,0.0,13
52911,13696,Stuff Packs,18,0,0.0,18
52912,13697,Expansion Packs,6,0,0.0,6
52913,13697,Game Packs,2,0,0.0,2
52914,13697,Kits,1,0,0.0,1
52915,13697,Stuff Packs,6,0,0.0,6
52916,13698,Expansion Packs,13,0,0.0,13
52917,13698,Game Packs,2,0,0.0,2
52918,13698,Kits,2,0,0.0,2
52919,13698,Stuff Packs,9,0,0.0,9
52920,13699,Expansion Packs,16,0,0.0,16
52921,13699,Game Packs,12,0,0.0,12
52922,13699,Kits,33,0,0.0,33
52923,13699,Stuff Packs,20,0,0.0,20
52924,13700,Expansion Packs,16,0,0.0,16
52925,13700,Game Packs,11,1,0.09090909090909091,10
52926,13700,Kits,12,1,0.08333333333333333,11
52927,13700,Stuff Packs,20,0,0.0,20
52928,13701,Expansion Packs,13,0,0.0,13
52929,13701,Game Packs,5,0,0.0,5
52930,13701,Kits,17,0,0.0,17
52931,13701,Stuff Packs,12,0,0.0,12
52932,13702,Expansion Packs,8,0,0.0,8
52933,13702,Game Packs,4,0,0.0,4
52934,13702,Kits,7,0,0.0,7
52935,13702,Stuff Packs,8,1,0.125,7
52936,13703,Expansion Packs,13,0,0.0,13
52937,13703,Game Packs,7,1,0.14285714285714285,6
52938,13703,Kits,2,2,1.0,0
52939,13703,Stuff Packs,9,4,0.4444444444444444,5
52940,13704,Expansion Packs,11,0,0.0,11
52941,13704,Game Packs,4,0,0.0,4
52942,13704,Kits,2,1,0.5,1
52943,13704,Stuff Packs,1,0,0.0,1
52944,13705,Expansion Packs,14,0,0.0,14
52945,13705,Game Packs,8,0,0.0,8
52946,13705,Kits,1,0,0.0,1
52947,13705,Stuff Packs,8,0,0.0,8
52948,13706,Expansion Packs,12,0,0.0,12
52949,13706,Game Packs,5,0,0.0,5
52950,13706,Kits,5,2,0.4,3
52951,13706,Stuff Packs,6,2,0.3333333333333333,4
52952,13707,Expansion Packs,10,0,0.0,10
52953,13707,Game Packs,4,0,0.0,4
52954,13707,Stuff Packs,4,1,0.25,3
52955,13708,Expansion Packs,16,0,0.0,16
52956,13708,Game Packs,11,0,0.0,11
52957,13708,Kits,28,0,0.0,28
52958,13708,Stuff Packs,18,1,0.05555555555555555,17
52959,13709,Expansion Packs,16,0,0.0,16
52960,13709,Game Packs,12,0,0.0,12
52961,13709,Kits,31,1,0.03225806451612903,30
52962,13709,Stuff Packs,20,2,0.1,18
52963,13710,Expansion Packs,16,0,0.0,16
52964,13710,Game Packs,12,3,0.25,9
52965,13710,Kits,32,0,0.0,32
52966,13710,Stuff Packs,20,4,0.2,16
52967,13711,Expansion Packs,11,0,0.0,11
52968,13711,Game Packs,7,1,0.14285714285714285,6
52969,13711,Kits,5,3,0.6,2
52970,13711,Stuff Packs,7,4,0.5714285714285714,3
52971,13712,Expansion Packs,11,0,0.0,11
52972,13712,Game Packs,5,0,0.0,5
52973,13712,Kits,2,0,0.0,2
52974,13712,Stuff Packs,5,0,0.0,5
52975,13713,Expansion Packs,8,0,0.0,8
52976,13713,Game Packs,1,1,1.0,0
52977,13713,Kits,2,1,0.5,1
52978,13713,Stuff Packs,3,3,1.0,0
52979,13714,Expansion Packs,16,0,0.0,16
52980,13714,Game Packs,7,0,0.0,7
52981,13714,Kits,13,1,0.07692307692307693,12
52982,13714,Stuff Packs,18,2,0.1111111111111111,16
52983,13715,Expansion Packs,7,0,0.0,7
52984,13715,Game Packs,3,0,0.0,3
52985,13715,Kits,4,3,0.75,1
52986,13715,Stuff Packs,8,3,0.375,5
52987,13716,Expansion Packs,15,0,0.0,15
52988,13716,Game Packs,12,0,0.0,12
52989,13716,Kits,27,0,0.0,27
52990,13716,Stuff Packs,19,0,0.0,19
52991,13717,Expansion Packs,4,0,0.0,4
52992,13717,Game Packs,1,0,0.0,1
52993,13717,Kits,1,0,0.0,1
52994,13718,Expansion Packs,13,0,0.0,13
52995,13718,Game Packs,11,0,0.0,11
52996,13718,Kits,8,1,0.125,7
52997,13718,Stuff Packs,16,1,0.0625,15
52998,13719,Game Packs,1,1,1.0,0
52999,13719,Kits,3,3,1.0,0
53000,13719,Stuff Packs,2,2,1.0,0
53001,13720,Expansion Packs,10,0,0.0,10
53002,13720,Game Packs,8,0,0.0,8
53003,13720,Stuff Packs,8,0,0.0,8
53004,13721,Expansion Packs,12,0,0.0,12
53005,13721,Game Packs,8,0,0.0,8
53006,13721,Kits,3,2,0.6666666666666666,1
53007,13721,Stuff Packs,10,2,0.2,8
53008,13722,Expansion Packs,12,0,0.0,12
53009,13722,Game Packs,6,0,0.0,6
53010,13722,Kits,3,1,0.3333333333333333,2
53011,13722,Stuff Packs,6,0,0.0,6
53012,13723,Expansion Packs,10,0,0.0,10
53013,13723,Game Packs,5,0,0.0,5
53014,13723,Kits,5,2,0.4,3
53015,13723,Stuff Packs,8,3,0.375,5
53016,13724,Expansion Packs,9,0,0.0,9
53017,13724,Game Packs,1,0,0.0,1
53018,13724,Kits,4,0,0.0,4
53019,13724,Stuff Packs,3,1,0.3333333333333333,2
53020,13725,Expansion Packs,2,0,0.0,2
53021,13725,Kits,2,2,1.0,0
53022,13725,Stuff Packs,3,3,1.0,0
53023,13726,Expansion Packs,15,0,0.0,15
53024,13726,Game Packs,12,0,0.0,12
53025,13726,Kits,30,0,0.0,30
53026,13726,Stuff Packs,20,0,0.0,20
53027,13727,Expansion Packs,9,0,0.0,9
53028,13727,Game Packs,4,1,0.25,3
53029,13727,Kits,8,0,0.0,8
53030,13727,Stuff Packs,8,3,0.375,5
53031,13728,Expansion Packs,14,0,0.0,14
53032,13728,Game Packs,8,0,0.0,8
53033,13728,Kits,3,1,0.3333333333333333,2
53034,13728,Stuff Packs,10,2,0.2,8
53035,13729,Expansion Packs,16,0,0.0,16
53036,13729,Game Packs,12,0,0.0,12
53037,13729,Kits,33,0,0.0,33
53038,13729,Stuff Packs,20,0,0.0,20
53039,13730,Expansion Packs,16,0,0.0,16
53040,13730,Game Packs,9,0,0.0,9
53041,13730,Kits,3,2,0.6666666666666666,1
53042,13730,Stuff Packs,16,1,0.0625,15
53043,13731,Expansion Packs,16,0,0.0,16
53044,13731,Game Packs,12,0,0.0,12
53045,13731,Kits,33,0,0.0,33
53046,13731,Stuff Packs,20,0,0.0,20
53047,13732,Expansion Packs,16,0,0.0,16
53048,13732,Game Packs,12,0,0.0,12
53049,13732,Kits,16,0,0.0,16
53050,13732,Stuff Packs,19,0,0.0,19
53051,13733,Expansion Packs,14,0,0.0,14
53052,13733,Game Packs,9,0,0.0,9
53053,13733,Kits,6,0,0.0,6
53054,13733,Stuff Packs,18,0,0.0,18
53055,13734,Expansion Packs,15,0,0.0,15
53056,13734,Game Packs,4,0,0.0,4
53057,13734,Kits,3,2,0.6666666666666666,1
53058,13734,Stuff Packs,5,1,0.2,4
53059,13735,Expansion Packs,6,0,0.0,6
53060,13735,Game Packs,3,0,0.0,3
53061,13735,Stuff Packs,9,0,0.0,9
53062,13736,Expansion Packs,16,11,0.6875,5
53063,13736,Game Packs,12,11,0.9166666666666666,1
53064,13736,Kits,25,0,0.0,25
53065,13736,Stuff Packs,20,18,0.9,2
53066,13737,Expansion Packs,15,0,0.0,15
53067,13737,Game Packs,12,0,0.0,12
53068,13737,Kits,17,0,0.0,17
53069,13737,Stuff Packs,16,0,0.0,16
53070,13738,Expansion Packs,8,0,0.0,8
53071,13738,Game Packs,7,0,0.0,7
53072,13738,Kits,3,1,0.3333333333333333,2
53073,13738,Stuff Packs,6,2,0.3333333333333333,4
53074,13739,Expansion Packs,9,0,0.0,9
53075,13739,Game Packs,5,1,0.2,4
53076,13739,Kits,2,2,1.0,0
53077,13739,Stuff Packs,8,4,0.5,4
53078,13740,Expansion Packs,15,0,0.0,15
53079,13740,Game Packs,8,0,0.0,8
53080,13740,Kits,6,1,0.16666666666666666,5
53081,13740,Stuff Packs,12,3,0.25,9
53082,13741,Expansion Packs,11,0,0.0,11
53083,13741,Game Packs,4,1,0.25,3
53084,13741,Kits,2,2,1.0,0
53085,13741,Stuff Packs,5,3,0.6,2
53086,13742,Expansion Packs,4,0,0.0,4
53087,13742,Stuff Packs,3,1,0.3333333333333333,2
53088,13743,Expansion Packs,13,0,0.0,13
53089,13743,Game Packs,5,0,0.0,5
53090,13743,Kits,3,0,0.0,3
53091,13743,Stuff Packs,11,2,0.18181818181818182,9
53092,13744,Expansion Packs,16,0,0.0,16
53093,13744,Game Packs,12,0,0.0,12
53094,13744,Kits,33,2,0.06060606060606061,31
53095,13744,Stuff Packs,20,3,0.15,17
53096,13745,Game Packs,2,0,0.0,2
53097,13745,Kits,1,1,1.0,0
53098,13745,Stuff Packs,5,3,0.6,2
53099,13746,Expansion Packs,16,0,0.0,16
53100,13746,Game Packs,12,0,0.0,12
53101,13746,Kits,33,1,0.030303030303030304,32
53102,13746,Stuff Packs,20,0,0.0,20
53103,13747,Expansion Packs,16,0,0.0,16
53104,13747,Game Packs,12,0,0.0,12
53105,13747,Kits,33,1,0.030303030303030304,32
53106,13747,Stuff Packs,20,0,0.0,20
53107,13748,Expansion Packs,16,0,0.0,16
53108,13748,Game Packs,12,0,0.0,12
53109,13748,Kits,31,1,0.03225806451612903,30
53110,13748,Stuff Packs,20,0,0.0,20
53111,13749,Expansion Packs,7,0,0.0,7
53112,13749,Game Packs,7,0,0.0,7
53113,13749,Kits,2,2,1.0,0
53114,13749,Stuff Packs,8,1,0.125,7
53115,13750,Expansion Packs,8,0,0.0,8
53116,13750,Game Packs,3,0,0.0,3
53117,13750,Stuff Packs,5,2,0.4,3
53118,13751,Expansion Packs,16,0,0.0,16
53119,13751,Game Packs,11,0,0.0,11
53120,13751,Kits,25,1,0.04,24
53121,13751,Stuff Packs,19,0,0.0,19
53122,13752,Expansion Packs,16,0,0.0,16
53123,13752,Game Packs,12,0,0.0,12
53124,13752,Kits,33,0,0.0,33
53125,13752,Stuff Packs,20,0,0.0,20
53126,13753,Expansion Packs,16,0,0.0,16
53127,13753,Game Packs,12,0,0.0,12
53128,13753,Kits,33,0,0.0,33
53129,13753,Stuff Packs,20,0,0.0,20
53130,13754,Expansion Packs,14,0,0.0,14
53131,13754,Game Packs,9,0,0.0,9
53132,13754,Kits,5,3,0.6,2
53133,13754,Stuff Packs,12,4,0.3333333333333333,8
53134,13755,Expansion Packs,16,0,0.0,16
53135,13755,Game Packs,12,0,0.0,12
53136,13755,Kits,33,0,0.0,33
53137,13755,Stuff Packs,20,0,0.0,20
53138,13756,Expansion Packs,8,0,0.0,8
53139,13756,Game Packs,6,0,0.0,6
53140,13756,Kits,2,2,1.0,0
53141,13756,Stuff Packs,8,3,0.375,5
53142,13757,Expansion Packs,13,0,0.0,13
53143,13757,Game Packs,6,1,0.16666666666666666,5
53144,13757,Kits,8,1,0.125,7
53145,13757,Stuff Packs,16,5,0.3125,11
53146,13758,Expansion Packs,6,0,0.0,6
53147,13758,Game Packs,4,1,0.25,3
53148,13758,Kits,5,2,0.4,3
53149,13758,Stuff Packs,5,2,0.4,3
53150,13759,Expansion Packs,11,1,0.09090909090909091,10
53151,13759,Game Packs,2,0,0.0,2
53152,13759,Kits,4,1,0.25,3
53153,13759,Stuff Packs,7,2,0.2857142857142857,5
53154,13760,Expansion Packs,4,0,0.0,4
53155,13760,Game Packs,3,0,0.0,3
53156,13760,Kits,2,2,1.0,0
53157,13760,Stuff Packs,6,3,0.5,3
53158,13761,Expansion Packs,15,0,0.0,15
53159,13761,Game Packs,10,0,0.0,10
53160,13761,Kits,12,0,0.0,12
53161,13761,Stuff Packs,19,0,0.0,19
53162,13762,Expansion Packs,7,0,0.0,7
53163,13762,Game Packs,2,1,0.5,1
53164,13762,Kits,2,2,1.0,0
53165,13762,Stuff Packs,4,3,0.75,1
53166,13763,Expansion Packs,16,0,0.0,16
53167,13763,Game Packs,12,0,0.0,12
53168,13763,Kits,33,0,0.0,33
53169,13763,Stuff Packs,20,0,0.0,20
53170,13764,Expansion Packs,2,0,0.0,2
53171,13764,Game Packs,2,1,0.5,1
53172,13764,Kits,3,0,0.0,3
53173,13764,Stuff Packs,5,4,0.8,1
53174,13765,Expansion Packs,15,0,0.0,15
53175,13765,Game Packs,11,0,0.0,11
53176,13765,Kits,2,1,0.5,1
53177,13765,Stuff Packs,8,3,0.375,5
53178,13766,Expansion Packs,9,9,1.0,0
53179,13766,Game Packs,5,5,1.0,0
53180,13766,Kits,1,1,1.0,0
53181,13766,Stuff Packs,3,2,0.6666666666666666,1
53182,13767,Expansion Packs,13,0,0.0,13
53183,13767,Game Packs,10,0,0.0,10
53184,13767,Kits,6,1,0.16666666666666666,5
53185,13767,Stuff Packs,19,1,0.05263157894736842,18
53186,13768,Expansion Packs,16,0,0.0,16
53187,13768,Game Packs,12,0,0.0,12
53188,13768,Kits,33,0,0.0,33
53189,13768,Stuff Packs,20,0,0.0,20
53190,13769,Expansion Packs,6,0,0.0,6
53191,13769,Game Packs,2,0,0.0,2
53192,13769,Stuff Packs,1,0,0.0,1
53193,13770,Expansion Packs,2,0,0.0,2
53194,13770,Game Packs,1,0,0.0,1
53195,13770,Stuff Packs,3,1,0.3333333333333333,2
53196,13771,Expansion Packs,14,0,0.0,14
53197,13771,Game Packs,11,0,0.0,11
53198,13771,Kits,8,1,0.125,7
53199,13771,Stuff Packs,20,0,0.0,20
53200,13772,Expansion Packs,7,0,0.0,7
53201,13772,Game Packs,5,0,0.0,5
53202,13772,Stuff Packs,7,0,0.0,7
53203,13773,Expansion Packs,7,0,0.0,7
53204,13773,Game Packs,2,0,0.0,2
53205,13773,Kits,10,0,0.0,10
53206,13773,Stuff Packs,8,0,0.0,8
53207,13774,Expansion Packs,9,0,0.0,9
53208,13774,Game Packs,2,0,0.0,2
53209,13774,Kits,1,0,0.0,1
53210,13774,Stuff Packs,4,0,0.0,4
53211,13775,Expansion Packs,16,0,0.0,16
53212,13775,Game Packs,12,0,0.0,12
53213,13775,Kits,33,0,0.0,33
53214,13775,Stuff Packs,20,0,0.0,20
53215,13776,Expansion Packs,16,0,0.0,16
53216,13776,Game Packs,12,0,0.0,12
53217,13776,Kits,33,2,0.06060606060606061,31
53218,13776,Stuff Packs,20,3,0.15,17
53219,13777,Expansion Packs,8,0,0.0,8
53220,13777,Game Packs,6,0,0.0,6
53221,13777,Kits,3,0,0.0,3
53222,13777,Stuff Packs,7,0,0.0,7
53223,13778,Expansion Packs,14,0,0.0,14
53224,13778,Game Packs,6,1,0.16666666666666666,5
53225,13778,Stuff Packs,8,3,0.375,5
53226,13779,Expansion Packs,16,0,0.0,16
53227,13779,Game Packs,12,0,0.0,12
53228,13779,Kits,21,0,0.0,21
53229,13779,Stuff Packs,20,0,0.0,20
53230,13780,Expansion Packs,16,0,0.0,16
53231,13780,Game Packs,12,0,0.0,12
53232,13780,Kits,33,0,0.0,33
53233,13780,Stuff Packs,20,0,0.0,20
53234,13781,Expansion Packs,2,0,0.0,2
53235,13781,Game Packs,2,0,0.0,2
53236,13781,Stuff Packs,2,0,0.0,2
53237,13782,Expansion Packs,7,0,0.0,7
53238,13782,Game Packs,1,0,0.0,1
53239,13782,Stuff Packs,6,3,0.5,3
53240,13783,Expansion Packs,12,0,0.0,12
53241,13783,Game Packs,5,0,0.0,5
53242,13783,Kits,6,1,0.16666666666666666,5
53243,13783,Stuff Packs,9,4,0.4444444444444444,5
53244,13784,Expansion Packs,15,0,0.0,15
53245,13784,Game Packs,9,0,0.0,9
53246,13784,Kits,10,2,0.2,8
53247,13784,Stuff Packs,15,3,0.2,12
53248,13785,Expansion Packs,6,0,0.0,6
53249,13785,Game Packs,1,0,0.0,1
53250,13785,Stuff Packs,4,1,0.25,3
53251,13786,Expansion Packs,9,0,0.0,9
53252,13786,Game Packs,3,0,0.0,3
53253,13786,Stuff Packs,2,0,0.0,2
53254,13787,Expansion Packs,15,0,0.0,15
53255,13787,Game Packs,10,0,0.0,10
53256,13787,Kits,4,1,0.25,3
53257,13787,Stuff Packs,7,0,0.0,7
53258,13788,Expansion Packs,5,0,0.0,5
53259,13788,Game Packs,1,0,0.0,1
53260,13789,Expansion Packs,16,0,0.0,16
53261,13789,Game Packs,12,0,0.0,12
53262,13789,Kits,31,1,0.03225806451612903,30
53263,13789,Stuff Packs,20,0,0.0,20
53264,13790,Expansion Packs,6,0,0.0,6
53265,13790,Game Packs,1,0,0.0,1
53266,13790,Stuff Packs,1,0,0.0,1
53267,13791,Expansion Packs,13,0,0.0,13
53268,13791,Game Packs,7,0,0.0,7
53269,13791,Kits,1,1,1.0,0
53270,13791,Stuff Packs,4,1,0.25,3
53271,13792,Expansion Packs,5,0,0.0,5
53272,13792,Game Packs,3,0,0.0,3
53273,13792,Kits,6,0,0.0,6
53274,13792,Stuff Packs,8,3,0.375,5
53275,13793,Expansion Packs,16,0,0.0,16
53276,13793,Game Packs,12,0,0.0,12
53277,13793,Kits,31,0,0.0,31
53278,13793,Stuff Packs,20,0,0.0,20
53279,13794,Game Packs,2,0,0.0,2
53280,13794,Stuff Packs,3,3,1.0,0
53281,13795,Expansion Packs,7,0,0.0,7
53282,13795,Game Packs,4,0,0.0,4
53283,13795,Stuff Packs,3,0,0.0,3
53284,13796,Expansion Packs,14,0,0.0,14
53285,13796,Game Packs,11,0,0.0,11
53286,13796,Kits,27,2,0.07407407407407407,25
53287,13796,Stuff Packs,17,1,0.058823529411764705,16
53288,13797,Expansion Packs,10,0,0.0,10
53289,13797,Game Packs,7,0,0.0,7
53290,13797,Kits,5,1,0.2,4
53291,13797,Stuff Packs,11,1,0.09090909090909091,10
53292,13798,Expansion Packs,16,0,0.0,16
53293,13798,Game Packs,12,0,0.0,12
53294,13798,Kits,33,0,0.0,33
53295,13798,Stuff Packs,20,0,0.0,20
53296,13799,Expansion Packs,15,0,0.0,15
53297,13799,Game Packs,9,0,0.0,9
53298,13799,Kits,5,1,0.2,4
53299,13799,Stuff Packs,16,1,0.0625,15
53300,13800,Expansion Packs,4,0,0.0,4
53301,13800,Game Packs,4,1,0.25,3
53302,13800,Kits,3,3,1.0,0
53303,13800,Stuff Packs,7,4,0.5714285714285714,3
53304,13801,Expansion Packs,11,0,0.0,11
53305,13801,Game Packs,10,0,0.0,10
53306,13801,Kits,10,0,0.0,10
53307,13801,Stuff Packs,11,2,0.18181818181818182,9
53308,13802,Expansion Packs,5,0,0.0,5
53309,13802,Game Packs,1,0,0.0,1
53310,13802,Kits,8,0,0.0,8
53311,13802,Stuff Packs,2,0,0.0,2
53312,13803,Game Packs,1,1,1.0,0
53313,13803,Kits,3,3,1.0,0
53314,13803,Stuff Packs,4,4,1.0,0
53315,13804,Expansion Packs,16,0,0.0,16
53316,13804,Game Packs,9,0,0.0,9
53317,13804,Kits,6,1,0.16666666666666666,5
53318,13804,Stuff Packs,10,1,0.1,9
53319,13805,Expansion Packs,16,0,0.0,16
53320,13805,Game Packs,12,0,0.0,12
53321,13805,Kits,33,0,0.0,33
53322,13805,Stuff Packs,20,0,0.0,20
53323,13806,Expansion Packs,2,0,0.0,2
53324,13807,Expansion Packs,10,0,0.0,10
53325,13807,Game Packs,4,1,0.25,3
53326,13807,Kits,2,2,1.0,0
53327,13807,Stuff Packs,6,5,0.8333333333333334,1
53328,13808,Expansion Packs,16,0,0.0,16
53329,13808,Game Packs,11,2,0.18181818181818182,9
53330,13808,Kits,20,3,0.15,17
53331,13808,Stuff Packs,19,4,0.21052631578947367,15
53332,13809,Expansion Packs,14,0,0.0,14
53333,13809,Game Packs,7,0,0.0,7
53334,13809,Kits,10,1,0.1,9
53335,13809,Stuff Packs,15,2,0.13333333333333333,13
53336,13810,Expansion Packs,16,0,0.0,16
53337,13810,Game Packs,12,0,0.0,12
53338,13810,Kits,33,0,0.0,33
53339,13810,Stuff Packs,20,0,0.0,20
53340,13811,Expansion Packs,5,0,0.0,5
53341,13811,Game Packs,3,1,0.3333333333333333,2
53342,13811,Kits,3,3,1.0,0
53343,13811,Stuff Packs,4,4,1.0,0
53344,13812,Expansion Packs,12,0,0.0,12
53345,13812,Game Packs,4,0,0.0,4
53346,13812,Kits,4,1,0.25,3
53347,13812,Stuff Packs,9,3,0.3333333333333333,6
53348,13813,Expansion Packs,10,0,0.0,10
53349,13813,Game Packs,4,1,0.25,3
53350,13813,Kits,2,2,1.0,0
53351,13813,Stuff Packs,10,4,0.4,6
53352,13814,Expansion Packs,9,0,0.0,9
53353,13814,Game Packs,6,0,0.0,6
53354,13814,Kits,1,0,0.0,1
53355,13814,Stuff Packs,7,0,0.0,7
53356,13815,Expansion Packs,12,0,0.0,12
53357,13815,Game Packs,5,0,0.0,5
53358,13815,Kits,2,1,0.5,1
53359,13815,Stuff Packs,5,0,0.0,5
53360,13816,Expansion Packs,16,0,0.0,16
53361,13816,Game Packs,11,0,0.0,11
53362,13816,Kits,33,1,0.030303030303030304,32
53363,13816,Stuff Packs,20,0,0.0,20
53364,13817,Expansion Packs,16,0,0.0,16
53365,13817,Game Packs,12,0,0.0,12
53366,13817,Kits,15,0,0.0,15
53367,13817,Stuff Packs,19,0,0.0,19
53368,13818,Expansion Packs,14,0,0.0,14
53369,13818,Game Packs,8,0,0.0,8
53370,13818,Kits,21,0,0.0,21
53371,13818,Stuff Packs,12,3,0.25,9
53372,13819,Expansion Packs,15,0,0.0,15
53373,13819,Game Packs,10,0,0.0,10
53374,13819,Kits,11,1,0.09090909090909091,10
53375,13819,Stuff Packs,17,0,0.0,17
53376,13820,Expansion Packs,16,0,0.0,16
53377,13820,Game Packs,7,0,0.0,7
53378,13820,Kits,16,1,0.0625,15
53379,13820,Stuff Packs,10,2,0.2,8
53380,13821,Expansion Packs,16,0,0.0,16
53381,13821,Game Packs,12,0,0.0,12
53382,13821,Kits,33,0,0.0,33
53383,13821,Stuff Packs,20,0,0.0,20
53384,13822,Expansion Packs,16,0,0.0,16
53385,13822,Game Packs,11,0,0.0,11
53386,13822,Kits,28,0,0.0,28
53387,13822,Stuff Packs,20,0,0.0,20
53388,13823,Expansion Packs,6,0,0.0,6
53389,13823,Game Packs,1,0,0.0,1
53390,13823,Stuff Packs,2,1,0.5,1
53391,13824,Expansion Packs,16,0,0.0,16
53392,13824,Game Packs,12,0,0.0,12
53393,13824,Kits,33,0,0.0,33
53394,13824,Stuff Packs,20,0,0.0,20
53395,13825,Expansion Packs,16,0,0.0,16
53396,13825,Game Packs,11,0,0.0,11
53397,13825,Kits,14,1,0.07142857142857142,13
53398,13825,Stuff Packs,20,0,0.0,20
53399,13826,Expansion Packs,2,0,0.0,2
53400,13826,Game Packs,4,1,0.25,3
53401,13826,Kits,2,2,1.0,0
53402,13826,Stuff Packs,6,4,0.6666666666666666,2
53403,13827,Expansion Packs,8,0,0.0,8
53404,13827,Game Packs,2,0,0.0,2
53405,13827,Kits,4,1,0.25,3
53406,13827,Stuff Packs,2,1,0.5,1
53407,13828,Expansion Packs,2,0,0.0,2
53408,13828,Game Packs,2,1,0.5,1
53409,13828,Kits,2,2,1.0,0
53410,13828,Stuff Packs,5,4,0.8,1
53411,13829,Expansion Packs,11,8,0.7272727272727273,3
53412,13829,Game Packs,7,5,0.7142857142857143,2
53413,13829,Kits,9,1,0.1111111111111111,8
53414,13829,Stuff Packs,13,8,0.6153846153846154,5
53415,13830,Expansion Packs,16,0,0.0,16
53416,13830,Game Packs,8,0,0.0,8
53417,13830,Kits,1,0,0.0,1
53418,13830,Stuff Packs,10,0,0.0,10
53419,13831,Expansion Packs,3,0,0.0,3
53420,13831,Game Packs,2,0,0.0,2
53421,13831,Kits,1,1,1.0,0
53422,13831,Stuff Packs,3,1,0.3333333333333333,2
53423,13832,Expansion Packs,16,0,0.0,16
53424,13832,Game Packs,12,0,0.0,12
53425,13832,Kits,33,0,0.0,33
53426,13832,Stuff Packs,20,0,0.0,20
53427,13833,Expansion Packs,16,0,0.0,16
53428,13833,Game Packs,12,0,0.0,12
53429,13833,Kits,31,1,0.03225806451612903,30
53430,13833,Stuff Packs,20,0,0.0,20
53431,13834,Expansion Packs,6,0,0.0,6
53432,13834,Game Packs,2,0,0.0,2
53433,13834,Stuff Packs,9,2,0.2222222222222222,7
53434,13835,Expansion Packs,6,0,0.0,6
53435,13835,Game Packs,3,0,0.0,3
53436,13835,Kits,1,0,0.0,1
53437,13835,Stuff Packs,5,0,0.0,5
53438,13836,Expansion Packs,16,0,0.0,16
53439,13836,Game Packs,12,0,0.0,12
53440,13836,Kits,33,3,0.09090909090909091,30
53441,13836,Stuff Packs,20,3,0.15,17
53442,13837,Expansion Packs,16,0,0.0,16
53443,13837,Game Packs,12,0,0.0,12
53444,13837,Kits,33,1,0.030303030303030304,32
53445,13837,Stuff Packs,20,0,0.0,20
53446,13838,Expansion Packs,15,0,0.0,15
53447,13838,Game Packs,10,0,0.0,10
53448,13838,Kits,10,2,0.2,8
53449,13838,Stuff Packs,19,0,0.0,19
53450,13839,Expansion Packs,10,1,0.1,9
53451,13839,Game Packs,5,0,0.0,5
53452,13839,Kits,19,5,0.2631578947368421,14
53453,13839,Stuff Packs,6,2,0.3333333333333333,4
53454,13840,Expansion Packs,12,0,0.0,12
53455,13840,Game Packs,9,0,0.0,9
53456,13840,Stuff Packs,8,0,0.0,8
53457,13841,Expansion Packs,8,0,0.0,8
53458,13841,Game Packs,4,1,0.25,3
53459,13841,Kits,4,2,0.5,2
53460,13841,Stuff Packs,3,2,0.6666666666666666,1
53461,13842,Expansion Packs,8,0,0.0,8
53462,13842,Game Packs,7,0,0.0,7
53463,13842,Kits,1,0,0.0,1
53464,13842,Stuff Packs,6,0,0.0,6
53465,13843,Expansion Packs,16,0,0.0,16
53466,13843,Game Packs,11,0,0.0,11
53467,13843,Kits,20,0,0.0,20
53468,13843,Stuff Packs,20,0,0.0,20
53469,13844,Expansion Packs,16,1,0.0625,15
53470,13844,Game Packs,12,3,0.25,9
53471,13844,Kits,11,10,0.9090909090909091,1
53472,13844,Stuff Packs,20,1,0.05,19
53473,13845,Expansion Packs,11,0,0.0,11
53474,13845,Game Packs,7,0,0.0,7
53475,13845,Kits,26,0,0.0,26
53476,13845,Stuff Packs,16,0,0.0,16
53477,13846,Expansion Packs,8,0,0.0,8
53478,13846,Game Packs,6,0,0.0,6
53479,13846,Kits,6,0,0.0,6
53480,13846,Stuff Packs,8,1,0.125,7
53481,13847,Expansion Packs,16,0,0.0,16
53482,13847,Game Packs,12,0,0.0,12
53483,13847,Kits,33,0,0.0,33
53484,13847,Stuff Packs,20,0,0.0,20
53485,13848,Expansion Packs,14,0,0.0,14
53486,13848,Game Packs,11,0,0.0,11
53487,13848,Kits,19,0,0.0,19
53488,13848,Stuff Packs,20,0,0.0,20
53489,13849,Expansion Packs,11,0,0.0,11
53490,13849,Game Packs,7,0,0.0,7
53491,13849,Kits,3,3,1.0,0
53492,13849,Stuff Packs,8,1,0.125,7
53493,13850,Expansion Packs,5,0,0.0,5
53494,13850,Game Packs,1,0,0.0,1
53495,13850,Kits,2,0,0.0,2
53496,13850,Stuff Packs,10,0,0.0,10
53497,13851,Expansion Packs,14,0,0.0,14
53498,13851,Game Packs,10,0,0.0,10
53499,13851,Kits,8,0,0.0,8
53500,13851,Stuff Packs,13,3,0.23076923076923078,10
53501,13852,Expansion Packs,5,0,0.0,5
53502,13852,Game Packs,4,0,0.0,4
53503,13852,Kits,1,0,0.0,1
53504,13852,Stuff Packs,3,0,0.0,3
53505,13853,Expansion Packs,9,0,0.0,9
53506,13853,Game Packs,5,0,0.0,5
53507,13853,Kits,15,0,0.0,15
53508,13853,Stuff Packs,13,3,0.23076923076923078,10
53509,13854,Expansion Packs,16,0,0.0,16
53510,13854,Game Packs,12,0,0.0,12
53511,13854,Kits,31,0,0.0,31
53512,13854,Stuff Packs,20,0,0.0,20
53513,13855,Expansion Packs,12,0,0.0,12
53514,13855,Game Packs,4,0,0.0,4
53515,13855,Kits,4,0,0.0,4
53516,13855,Stuff Packs,5,2,0.4,3
53517,13856,Expansion Packs,16,0,0.0,16
53518,13856,Game Packs,9,0,0.0,9
53519,13856,Kits,13,1,0.07692307692307693,12
53520,13856,Stuff Packs,15,3,0.2,12
53521,13857,Expansion Packs,9,0,0.0,9
53522,13857,Game Packs,1,0,0.0,1
53523,13857,Kits,5,0,0.0,5
53524,13857,Stuff Packs,4,3,0.75,1
53525,13858,Expansion Packs,4,0,0.0,4
53526,13858,Game Packs,3,0,0.0,3
53527,13858,Kits,1,0,0.0,1
53528,13858,Stuff Packs,3,2,0.6666666666666666,1
53529,13859,Expansion Packs,16,0,0.0,16
53530,13859,Game Packs,12,0,0.0,12
53531,13859,Kits,33,5,0.15151515151515152,28
53532,13859,Stuff Packs,20,3,0.15,17
53533,13860,Expansion Packs,11,0,0.0,11
53534,13860,Game Packs,5,0,0.0,5
53535,13860,Kits,1,0,0.0,1
53536,13860,Stuff Packs,7,0,0.0,7
53537,13861,Expansion Packs,15,0,0.0,15
53538,13861,Game Packs,6,0,0.0,6
53539,13861,Stuff Packs,8,0,0.0,8
53540,13862,Expansion Packs,15,0,0.0,15
53541,13862,Game Packs,6,0,0.0,6
53542,13862,Kits,3,0,0.0,3
53543,13862,Stuff Packs,8,0,0.0,8
53544,13863,Expansion Packs,8,0,0.0,8
53545,13863,Game Packs,4,0,0.0,4
53546,13863,Kits,1,1,1.0,0
53547,13863,Stuff Packs,5,1,0.2,4
53548,13864,Expansion Packs,9,0,0.0,9
53549,13864,Game Packs,4,0,0.0,4
53550,13864,Kits,3,1,0.3333333333333333,2
53551,13864,Stuff Packs,6,3,0.5,3
53552,13865,Expansion Packs,16,0,0.0,16
53553,13865,Game Packs,12,0,0.0,12
53554,13865,Kits,12,0,0.0,12
53555,13865,Stuff Packs,16,0,0.0,16
53556,13866,Expansion Packs,1,0,0.0,1
53557,13866,Game Packs,1,0,0.0,1
53558,13866,Kits,1,1,1.0,0
53559,13866,Stuff Packs,5,3,0.6,2
53560,13867,Expansion Packs,14,0,0.0,14
53561,13867,Game Packs,8,0,0.0,8
53562,13867,Kits,9,1,0.1111111111111111,8
53563,13867,Stuff Packs,11,2,0.18181818181818182,9
53564,13868,Expansion Packs,16,0,0.0,16
53565,13868,Game Packs,11,0,0.0,11
53566,13868,Kits,19,0,0.0,19
53567,13868,Stuff Packs,20,0,0.0,20
53568,13869,Expansion Packs,3,0,0.0,3
53569,13869,Game Packs,2,0,0.0,2
53570,13869,Stuff Packs,2,0,0.0,2
53571,13870,Expansion Packs,6,0,0.0,6
53572,13870,Game Packs,3,0,0.0,3
53573,13870,Kits,3,2,0.6666666666666666,1
53574,13870,Stuff Packs,4,3,0.75,1
53575,13871,Expansion Packs,13,0,0.0,13
53576,13871,Game Packs,12,0,0.0,12
53577,13871,Kits,3,0,0.0,3
53578,13871,Stuff Packs,15,0,0.0,15
53579,13872,Expansion Packs,16,0,0.0,16
53580,13872,Game Packs,11,0,0.0,11
53581,13872,Kits,32,0,0.0,32
53582,13872,Stuff Packs,20,0,0.0,20
53583,13873,Expansion Packs,16,0,0.0,16
53584,13873,Game Packs,12,0,0.0,12
53585,13873,Kits,32,0,0.0,32
53586,13873,Stuff Packs,19,1,0.05263157894736842,18
53587,13874,Expansion Packs,9,0,0.0,9
53588,13874,Game Packs,6,1,0.16666666666666666,5
53589,13874,Kits,3,3,1.0,0
53590,13874,Stuff Packs,7,4,0.5714285714285714,3
53591,13875,Expansion Packs,16,0,0.0,16
53592,13875,Game Packs,11,0,0.0,11
53593,13875,Kits,7,0,0.0,7
53594,13875,Stuff Packs,12,1,0.08333333333333333,11
53595,13876,Expansion Packs,16,0,0.0,16
53596,13876,Game Packs,11,0,0.0,11
53597,13876,Kits,21,0,0.0,21
53598,13876,Stuff Packs,20,0,0.0,20
53599,13877,Expansion Packs,8,0,0.0,8
53600,13877,Game Packs,2,0,0.0,2
53601,13877,Kits,2,1,0.5,1
53602,13877,Stuff Packs,6,3,0.5,3
53603,13878,Expansion Packs,14,0,0.0,14
53604,13878,Game Packs,12,0,0.0,12
53605,13878,Kits,8,1,0.125,7
53606,13878,Stuff Packs,18,0,0.0,18
53607,13879,Expansion Packs,15,0,0.0,15
53608,13879,Game Packs,11,0,0.0,11
53609,13879,Kits,29,0,0.0,29
53610,13879,Stuff Packs,20,0,0.0,20
53611,13880,Expansion Packs,14,0,0.0,14
53612,13880,Game Packs,4,0,0.0,4
53613,13880,Kits,13,1,0.07692307692307693,12
53614,13880,Stuff Packs,6,0,0.0,6
53615,13881,Expansion Packs,15,0,0.0,15
53616,13881,Game Packs,10,0,0.0,10
53617,13881,Kits,7,0,0.0,7
53618,13881,Stuff Packs,11,0,0.0,11
53619,13882,Expansion Packs,16,1,0.0625,15
53620,13882,Game Packs,11,0,0.0,11
53621,13882,Kits,21,1,0.047619047619047616,20
53622,13882,Stuff Packs,20,0,0.0,20
53623,13883,Expansion Packs,16,0,0.0,16
53624,13883,Game Packs,12,0,0.0,12
53625,13883,Kits,21,0,0.0,21
53626,13883,Stuff Packs,20,0,0.0,20
53627,13884,Expansion Packs,14,0,0.0,14
53628,13884,Game Packs,8,0,0.0,8
53629,13884,Kits,5,0,0.0,5
53630,13884,Stuff Packs,11,0,0.0,11
53631,13885,Expansion Packs,15,0,0.0,15
53632,13885,Game Packs,11,1,0.09090909090909091,10
53633,13885,Kits,11,2,0.18181818181818182,9
53634,13885,Stuff Packs,19,2,0.10526315789473684,17
53635,13886,Expansion Packs,12,0,0.0,12
53636,13886,Game Packs,5,0,0.0,5
53637,13886,Kits,11,0,0.0,11
53638,13886,Stuff Packs,9,2,0.2222222222222222,7
53639,13887,Expansion Packs,7,0,0.0,7
53640,13887,Game Packs,4,0,0.0,4
53641,13887,Kits,6,1,0.16666666666666666,5
53642,13887,Stuff Packs,6,0,0.0,6
53643,13888,Expansion Packs,9,0,0.0,9
53644,13888,Game Packs,1,0,0.0,1
53645,13888,Stuff Packs,4,1,0.25,3
53646,13889,Expansion Packs,16,0,0.0,16
53647,13889,Game Packs,12,0,0.0,12
53648,13889,Kits,33,0,0.0,33
53649,13889,Stuff Packs,20,0,0.0,20
53650,13890,Expansion Packs,4,0,0.0,4
53651,13890,Game Packs,3,0,0.0,3
53652,13890,Kits,1,1,1.0,0
53653,13890,Stuff Packs,4,3,0.75,1
53654,13891,Expansion Packs,14,0,0.0,14
53655,13891,Game Packs,7,0,0.0,7
53656,13891,Kits,2,0,0.0,2
53657,13891,Stuff Packs,17,0,0.0,17
53658,13892,Expansion Packs,2,0,0.0,2
53659,13892,Stuff Packs,4,3,0.75,1
53660,13893,Expansion Packs,6,0,0.0,6
53661,13893,Game Packs,3,0,0.0,3
53662,13893,Stuff Packs,4,3,0.75,1
53663,13894,Expansion Packs,16,0,0.0,16
53664,13894,Game Packs,12,0,0.0,12
53665,13894,Kits,10,1,0.1,9
53666,13894,Stuff Packs,19,0,0.0,19
53667,13895,Expansion Packs,16,0,0.0,16
53668,13895,Game Packs,11,0,0.0,11
53669,13895,Kits,5,0,0.0,5
53670,13895,Stuff Packs,20,0,0.0,20
53671,13896,Expansion Packs,11,0,0.0,11
53672,13896,Game Packs,7,0,0.0,7
53673,13896,Kits,3,3,1.0,0
53674,13896,Stuff Packs,12,3,0.25,9
53675,13897,Expansion Packs,9,0,0.0,9
53676,13897,Game Packs,3,0,0.0,3
53677,13897,Kits,2,2,1.0,0
53678,13897,Stuff Packs,5,2,0.4,3
53679,13898,Expansion Packs,9,0,0.0,9
53680,13898,Game Packs,3,0,0.0,3
53681,13898,Kits,2,2,1.0,0
53682,13898,Stuff Packs,6,2,0.3333333333333333,4
53683,13899,Expansion Packs,11,0,0.0,11
53684,13899,Game Packs,8,0,0.0,8
53685,13899,Kits,3,0,0.0,3
53686,13899,Stuff Packs,16,0,0.0,16
53687,13900,Expansion Packs,5,1,0.2,4
53688,13900,Game Packs,3,1,0.3333333333333333,2
53689,13900,Stuff Packs,6,3,0.5,3
53690,13901,Expansion Packs,12,0,0.0,12
53691,13901,Game Packs,8,0,0.0,8
53692,13901,Kits,8,1,0.125,7
53693,13901,Stuff Packs,13,1,0.07692307692307693,12
53694,13902,Expansion Packs,8,0,0.0,8
53695,13902,Game Packs,1,0,0.0,1
53696,13902,Kits,1,0,0.0,1
53697,13902,Stuff Packs,6,1,0.16666666666666666,5
53698,13903,Expansion Packs,14,0,0.0,14
53699,13903,Game Packs,11,0,0.0,11
53700,13903,Kits,2,0,0.0,2
53701,13903,Stuff Packs,16,0,0.0,16
53702,13904,Expansion Packs,9,0,0.0,9
53703,13904,Game Packs,6,0,0.0,6
53704,13904,Kits,1,1,1.0,0
53705,13904,Stuff Packs,6,0,0.0,6
53706,13905,Expansion Packs,13,0,0.0,13
53707,13905,Game Packs,8,0,0.0,8
53708,13905,Kits,7,0,0.0,7
53709,13905,Stuff Packs,6,0,0.0,6
53710,13906,Expansion Packs,16,0,0.0,16
53711,13906,Game Packs,9,0,0.0,9
53712,13906,Stuff Packs,14,1,0.07142857142857142,13
53713,13907,Expansion Packs,15,0,0.0,15
53714,13907,Game Packs,10,0,0.0,10
53715,13907,Kits,3,1,0.3333333333333333,2
53716,13907,Stuff Packs,7,4,0.5714285714285714,3
53717,13908,Expansion Packs,15,0,0.0,15
53718,13908,Game Packs,12,0,0.0,12
53719,13908,Kits,6,3,0.5,3
53720,13908,Stuff Packs,18,4,0.2222222222222222,14
53721,13909,Expansion Packs,15,0,0.0,15
53722,13909,Game Packs,8,0,0.0,8
53723,13909,Kits,4,1,0.25,3
53724,13909,Stuff Packs,10,1,0.1,9
53725,13910,Expansion Packs,16,0,0.0,16
53726,13910,Game Packs,10,0,0.0,10
53727,13910,Stuff Packs,14,3,0.21428571428571427,11
53728,13911,Expansion Packs,11,0,0.0,11
53729,13911,Game Packs,5,0,0.0,5
53730,13911,Kits,8,0,0.0,8
53731,13911,Stuff Packs,4,0,0.0,4
53732,13912,Expansion Packs,14,0,0.0,14
53733,13912,Game Packs,11,0,0.0,11
53734,13912,Kits,10,1,0.1,9
53735,13912,Stuff Packs,11,3,0.2727272727272727,8
53736,13913,Expansion Packs,8,0,0.0,8
53737,13913,Game Packs,4,0,0.0,4
53738,13913,Kits,6,1,0.16666666666666666,5
53739,13913,Stuff Packs,12,3,0.25,9
53740,13914,Expansion Packs,11,0,0.0,11
53741,13914,Game Packs,3,0,0.0,3
53742,13914,Kits,7,0,0.0,7
53743,13914,Stuff Packs,6,0,0.0,6
53744,13915,Expansion Packs,11,0,0.0,11
53745,13915,Game Packs,2,0,0.0,2
53746,13915,Kits,1,1,1.0,0
53747,13915,Stuff Packs,9,1,0.1111111111111111,8
53748,13916,Expansion Packs,1,0,0.0,1
53749,13916,Stuff Packs,2,2,1.0,0
53750,13917,Expansion Packs,13,0,0.0,13
53751,13917,Game Packs,6,0,0.0,6
53752,13917,Kits,2,1,0.5,1
53753,13917,Stuff Packs,10,1,0.1,9
53754,13918,Expansion Packs,4,0,0.0,4
53755,13918,Game Packs,1,0,0.0,1
53756,13918,Kits,2,2,1.0,0
53757,13918,Stuff Packs,3,1,0.3333333333333333,2
53758,13919,Expansion Packs,16,1,0.0625,15
53759,13919,Game Packs,8,0,0.0,8
53760,13919,Kits,17,1,0.058823529411764705,16
53761,13919,Stuff Packs,18,1,0.05555555555555555,17
53762,13920,Expansion Packs,16,0,0.0,16
53763,13920,Game Packs,12,0,0.0,12
53764,13920,Kits,18,0,0.0,18
53765,13920,Stuff Packs,12,0,0.0,12
53766,13921,Expansion Packs,3,0,0.0,3
53767,13922,Expansion Packs,4,0,0.0,4
53768,13922,Kits,1,1,1.0,0
53769,13922,Stuff Packs,2,2,1.0,0
53770,13923,Expansion Packs,7,0,0.0,7
53771,13923,Game Packs,2,0,0.0,2
53772,13923,Stuff Packs,4,0,0.0,4
53773,13924,Expansion Packs,16,0,0.0,16
53774,13924,Game Packs,12,1,0.08333333333333333,11
53775,13924,Kits,33,0,0.0,33
53776,13924,Stuff Packs,20,0,0.0,20
53777,13925,Expansion Packs,16,0,0.0,16
53778,13925,Game Packs,12,0,0.0,12
53779,13925,Kits,32,0,0.0,32
53780,13925,Stuff Packs,20,0,0.0,20
53781,13926,Expansion Packs,16,0,0.0,16
53782,13926,Game Packs,12,0,0.0,12
53783,13926,Kits,33,0,0.0,33
53784,13926,Stuff Packs,20,1,0.05,19
53785,13927,Expansion Packs,16,0,0.0,16
53786,13927,Game Packs,6,1,0.16666666666666666,5
53787,13927,Kits,2,2,1.0,0
53788,13927,Stuff Packs,10,4,0.4,6
53789,13928,Expansion Packs,15,0,0.0,15
53790,13928,Game Packs,10,0,0.0,10
53791,13928,Kits,5,2,0.4,3
53792,13928,Stuff Packs,13,2,0.15384615384615385,11
53793,13929,Expansion Packs,12,0,0.0,12
53794,13929,Game Packs,4,1,0.25,3
53795,13929,Kits,3,3,1.0,0
53796,13929,Stuff Packs,4,4,1.0,0
53797,13930,Expansion Packs,12,0,0.0,12
53798,13930,Game Packs,6,0,0.0,6
53799,13931,Expansion Packs,16,0,0.0,16
53800,13931,Game Packs,12,0,0.0,12
53801,13931,Kits,33,1,0.030303030303030304,32
53802,13931,Stuff Packs,20,0,0.0,20
53803,13932,Expansion Packs,15,0,0.0,15
53804,13932,Game Packs,5,0,0.0,5
53805,13932,Kits,1,0,0.0,1
53806,13932,Stuff Packs,7,1,0.14285714285714285,6
53807,13933,Expansion Packs,16,0,0.0,16
53808,13933,Game Packs,12,0,0.0,12
53809,13933,Kits,29,0,0.0,29
53810,13933,Stuff Packs,20,0,0.0,20
53811,13934,Expansion Packs,8,0,0.0,8
53812,13934,Game Packs,4,1,0.25,3
53813,13934,Kits,3,3,1.0,0
53814,13934,Stuff Packs,8,3,0.375,5
53815,13935,Expansion Packs,14,0,0.0,14
53816,13935,Game Packs,12,0,0.0,12
53817,13935,Kits,10,0,0.0,10
53818,13935,Stuff Packs,19,0,0.0,19
53819,13936,Expansion Packs,15,0,0.0,15
53820,13936,Game Packs,12,0,0.0,12
53821,13936,Kits,14,0,0.0,14
53822,13936,Stuff Packs,20,1,0.05,19
53823,13937,Expansion Packs,12,0,0.0,12
53824,13937,Game Packs,9,0,0.0,9
53825,13937,Kits,2,2,1.0,0
53826,13937,Stuff Packs,13,2,0.15384615384615385,11
53827,13938,Expansion Packs,16,0,0.0,16
53828,13938,Game Packs,12,0,0.0,12
53829,13938,Kits,31,0,0.0,31
53830,13938,Stuff Packs,20,0,0.0,20
53831,13939,Expansion Packs,4,0,0.0,4
53832,13939,Stuff Packs,1,0,0.0,1
53833,13940,Expansion Packs,15,0,0.0,15
53834,13940,Game Packs,12,0,0.0,12
53835,13940,Kits,29,0,0.0,29
53836,13940,Stuff Packs,20,0,0.0,20
53837,13941,Expansion Packs,9,0,0.0,9
53838,13941,Game Packs,3,0,0.0,3
53839,13941,Kits,2,1,0.5,1
53840,13941,Stuff Packs,5,3,0.6,2
53841,13942,Expansion Packs,13,0,0.0,13
53842,13942,Game Packs,9,0,0.0,9
53843,13942,Kits,4,1,0.25,3
53844,13942,Stuff Packs,12,0,0.0,12
53845,13943,Expansion Packs,12,0,0.0,12
53846,13943,Game Packs,7,0,0.0,7
53847,13943,Kits,5,0,0.0,5
53848,13943,Stuff Packs,5,0,0.0,5
53849,13944,Expansion Packs,16,0,0.0,16
53850,13944,Game Packs,12,0,0.0,12
53851,13944,Kits,14,2,0.14285714285714285,12
53852,13944,Stuff Packs,20,0,0.0,20
53853,13945,Expansion Packs,9,0,0.0,9
53854,13945,Game Packs,6,0,0.0,6
53855,13945,Kits,3,0,0.0,3
53856,13945,Stuff Packs,7,0,0.0,7
53857,13946,Expansion Packs,16,0,0.0,16
53858,13946,Game Packs,12,0,0.0,12
53859,13946,Kits,25,0,0.0,25
53860,13946,Stuff Packs,20,1,0.05,19
53861,13947,Expansion Packs,16,0,0.0,16
53862,13947,Game Packs,11,0,0.0,11
53863,13947,Kits,31,2,0.06451612903225806,29
53864,13947,Stuff Packs,17,2,0.11764705882352941,15
53865,13948,Expansion Packs,6,0,0.0,6
53866,13948,Game Packs,3,0,0.0,3
53867,13948,Kits,9,1,0.1111111111111111,8
53868,13948,Stuff Packs,6,0,0.0,6
53869,13949,Expansion Packs,8,0,0.0,8
53870,13949,Game Packs,3,0,0.0,3
53871,13949,Kits,1,0,0.0,1
53872,13949,Stuff Packs,3,0,0.0,3
53873,13950,Expansion Packs,16,0,0.0,16
53874,13950,Game Packs,12,0,0.0,12
53875,13950,Kits,25,0,0.0,25
53876,13950,Stuff Packs,20,0,0.0,20
53877,13951,Expansion Packs,14,0,0.0,14
53878,13951,Game Packs,8,1,0.125,7
53879,13951,Kits,6,2,0.3333333333333333,4
53880,13951,Stuff Packs,11,2,0.18181818181818182,9
53881,13952,Expansion Packs,11,0,0.0,11
53882,13952,Game Packs,6,0,0.0,6
53883,13952,Kits,2,2,1.0,0
53884,13952,Stuff Packs,10,1,0.1,9
53885,13953,Expansion Packs,16,0,0.0,16
53886,13953,Game Packs,10,0,0.0,10
53887,13953,Kits,3,3,1.0,0
53888,13953,Stuff Packs,14,3,0.21428571428571427,11
53889,13954,Expansion Packs,16,0,0.0,16
53890,13954,Game Packs,12,0,0.0,12
53891,13954,Kits,33,0,0.0,33
53892,13954,Stuff Packs,20,0,0.0,20
53893,13955,Expansion Packs,8,0,0.0,8
53894,13955,Game Packs,2,0,0.0,2
53895,13955,Kits,3,1,0.3333333333333333,2
53896,13955,Stuff Packs,3,2,0.6666666666666666,1
53897,13956,Expansion Packs,5,0,0.0,5
53898,13956,Game Packs,3,0,0.0,3
53899,13956,Kits,4,0,0.0,4
53900,13956,Stuff Packs,3,0,0.0,3
53901,13957,Expansion Packs,12,0,0.0,12
53902,13957,Game Packs,6,0,0.0,6
53903,13957,Kits,2,2,1.0,0
53904,13957,Stuff Packs,7,3,0.42857142857142855,4
53905,13958,Expansion Packs,16,0,0.0,16
53906,13958,Game Packs,12,0,0.0,12
53907,13958,Kits,33,0,0.0,33
53908,13958,Stuff Packs,20,0,0.0,20
53909,13959,Expansion Packs,5,0,0.0,5
53910,13959,Game Packs,3,0,0.0,3
53911,13959,Kits,6,0,0.0,6
53912,13959,Stuff Packs,5,2,0.4,3
53913,13960,Expansion Packs,16,0,0.0,16
53914,13960,Game Packs,11,0,0.0,11
53915,13960,Kits,9,0,0.0,9
53916,13960,Stuff Packs,20,0,0.0,20
53917,13961,Expansion Packs,15,0,0.0,15
53918,13961,Game Packs,9,0,0.0,9
53919,13961,Kits,8,0,0.0,8
53920,13961,Stuff Packs,16,0,0.0,16
53921,13962,Expansion Packs,2,0,0.0,2
53922,13962,Game Packs,1,0,0.0,1
53923,13962,Kits,2,2,1.0,0
53924,13962,Stuff Packs,4,3,0.75,1
53925,13963,Expansion Packs,5,0,0.0,5
53926,13963,Game Packs,1,0,0.0,1
53927,13963,Kits,2,2,1.0,0
53928,13963,Stuff Packs,5,4,0.8,1
53929,13964,Expansion Packs,10,0,0.0,10
53930,13964,Game Packs,3,0,0.0,3
53931,13964,Kits,2,0,0.0,2
53932,13964,Stuff Packs,7,0,0.0,7
53933,13965,Expansion Packs,16,0,0.0,16
53934,13965,Game Packs,12,0,0.0,12
53935,13965,Kits,33,0,0.0,33
53936,13965,Stuff Packs,20,0,0.0,20
53937,13966,Expansion Packs,16,0,0.0,16
53938,13966,Game Packs,12,0,0.0,12
53939,13966,Kits,33,0,0.0,33
53940,13966,Stuff Packs,20,0,0.0,20
53941,13967,Expansion Packs,8,0,0.0,8
53942,13967,Game Packs,3,0,0.0,3
53943,13967,Kits,2,0,0.0,2
53944,13967,Stuff Packs,8,0,0.0,8
53945,13968,Expansion Packs,16,0,0.0,16
53946,13968,Game Packs,11,0,0.0,11
53947,13968,Kits,4,0,0.0,4
53948,13968,Stuff Packs,19,1,0.05263157894736842,18
53949,13969,Expansion Packs,8,0,0.0,8
53950,13969,Game Packs,3,0,0.0,3
53951,13969,Stuff Packs,2,0,0.0,2
53952,13970,Expansion Packs,14,0,0.0,14
53953,13970,Game Packs,9,0,0.0,9
53954,13970,Kits,7,0,0.0,7
53955,13970,Stuff Packs,16,0,0.0,16
53956,13971,Expansion Packs,1,0,0.0,1
53957,13971,Game Packs,1,0,0.0,1
53958,13971,Kits,1,1,1.0,0
53959,13971,Stuff Packs,2,0,0.0,2
53960,13972,Expansion Packs,4,4,1.0,0
53961,13972,Game Packs,2,2,1.0,0
53962,13972,Stuff Packs,1,1,1.0,0
53963,13973,Expansion Packs,16,0,0.0,16
53964,13973,Game Packs,12,0,0.0,12
53965,13973,Kits,25,1,0.04,24
53966,13973,Stuff Packs,20,0,0.0,20
53967,13974,Expansion Packs,12,0,0.0,12
53968,13974,Game Packs,6,0,0.0,6
53969,13974,Kits,8,0,0.0,8
53970,13974,Stuff Packs,7,0,0.0,7
53971,13975,Expansion Packs,10,0,0.0,10
53972,13975,Game Packs,3,0,0.0,3
53973,13975,Kits,1,0,0.0,1
53974,13975,Stuff Packs,6,1,0.16666666666666666,5
53975,13976,Expansion Packs,11,0,0.0,11
53976,13976,Game Packs,3,0,0.0,3
53977,13976,Kits,3,2,0.6666666666666666,1
53978,13976,Stuff Packs,4,2,0.5,2
53979,13977,Expansion Packs,16,0,0.0,16
53980,13977,Game Packs,11,0,0.0,11
53981,13977,Kits,19,1,0.05263157894736842,18
53982,13977,Stuff Packs,19,0,0.0,19
53983,13978,Expansion Packs,15,0,0.0,15
53984,13978,Game Packs,12,0,0.0,12
53985,13978,Kits,1,1,1.0,0
53986,13978,Stuff Packs,18,0,0.0,18
53987,13979,Expansion Packs,16,0,0.0,16
53988,13979,Game Packs,12,0,0.0,12
53989,13979,Kits,33,1,0.030303030303030304,32
53990,13979,Stuff Packs,20,0,0.0,20
53991,13980,Expansion Packs,12,0,0.0,12
53992,13980,Game Packs,6,0,0.0,6
53993,13980,Kits,9,1,0.1111111111111111,8
53994,13980,Stuff Packs,14,0,0.0,14
53995,13981,Expansion Packs,12,0,0.0,12
53996,13981,Game Packs,3,0,0.0,3
53997,13981,Kits,3,0,0.0,3
53998,13981,Stuff Packs,5,0,0.0,5
53999,13982,Expansion Packs,14,0,0.0,14
54000,13982,Game Packs,9,0,0.0,9
54001,13982,Kits,1,0,0.0,1
54002,13982,Stuff Packs,10,0,0.0,10
54003,13983,Expansion Packs,11,0,0.0,11
54004,13983,Game Packs,6,1,0.16666666666666666,5
54005,13983,Kits,3,2,0.6666666666666666,1
54006,13983,Stuff Packs,7,4,0.5714285714285714,3
54007,13984,Expansion Packs,16,0,0.0,16
54008,13984,Game Packs,12,0,0.0,12
54009,13984,Kits,27,0,0.0,27
54010,13984,Stuff Packs,20,0,0.0,20
54011,13985,Expansion Packs,10,0,0.0,10
54012,13985,Game Packs,5,0,0.0,5
54013,13985,Kits,6,1,0.16666666666666666,5
54014,13985,Stuff Packs,8,0,0.0,8
54015,13986,Expansion Packs,16,0,0.0,16
54016,13986,Game Packs,12,0,0.0,12
54017,13986,Kits,33,0,0.0,33
54018,13986,Stuff Packs,20,0,0.0,20
54019,13987,Expansion Packs,16,1,0.0625,15
54020,13987,Game Packs,7,1,0.14285714285714285,6
54021,13987,Kits,12,2,0.16666666666666666,10
54022,13987,Stuff Packs,9,2,0.2222222222222222,7
54023,13988,Expansion Packs,5,0,0.0,5
54024,13988,Game Packs,2,1,0.5,1
54025,13988,Kits,2,2,1.0,0
54026,13988,Stuff Packs,5,4,0.8,1
54027,13989,Expansion Packs,6,0,0.0,6
54028,13989,Game Packs,1,0,0.0,1
54029,13989,Kits,2,1,0.5,1
54030,13989,Stuff Packs,9,3,0.3333333333333333,6
54031,13990,Expansion Packs,15,0,0.0,15
54032,13990,Game Packs,8,0,0.0,8
54033,13990,Kits,3,0,0.0,3
54034,13990,Stuff Packs,4,1,0.25,3
54035,13991,Expansion Packs,10,0,0.0,10
54036,13991,Game Packs,4,0,0.0,4
54037,13991,Kits,4,1,0.25,3
54038,13991,Stuff Packs,3,0,0.0,3
54039,13992,Expansion Packs,15,0,0.0,15
54040,13992,Game Packs,11,0,0.0,11
54041,13992,Kits,9,1,0.1111111111111111,8
54042,13992,Stuff Packs,20,0,0.0,20
54043,13993,Expansion Packs,11,0,0.0,11
54044,13993,Game Packs,6,0,0.0,6
54045,13993,Kits,4,1,0.25,3
54046,13993,Stuff Packs,7,1,0.14285714285714285,6
54047,13994,Expansion Packs,16,0,0.0,16
54048,13994,Game Packs,12,0,0.0,12
54049,13994,Kits,33,0,0.0,33
54050,13994,Stuff Packs,20,0,0.0,20
54051,13995,Expansion Packs,6,0,0.0,6
54052,13995,Game Packs,3,2,0.6666666666666666,1
54053,13995,Kits,1,0,0.0,1
54054,13995,Stuff Packs,6,1,0.16666666666666666,5
54055,13996,Expansion Packs,16,0,0.0,16
54056,13996,Game Packs,12,0,0.0,12
54057,13996,Kits,32,1,0.03125,31
54058,13996,Stuff Packs,20,0,0.0,20
54059,13997,Expansion Packs,9,0,0.0,9
54060,13997,Game Packs,2,0,0.0,2
54061,13997,Kits,5,1,0.2,4
54062,13997,Stuff Packs,3,1,0.3333333333333333,2
54063,13998,Expansion Packs,16,0,0.0,16
54064,13998,Game Packs,12,0,0.0,12
54065,13998,Kits,33,0,0.0,33
54066,13998,Stuff Packs,20,0,0.0,20
54067,13999,Expansion Packs,11,0,0.0,11
54068,13999,Game Packs,3,0,0.0,3
54069,13999,Kits,9,0,0.0,9
54070,13999,Stuff Packs,7,3,0.42857142857142855,4
54071,14000,Expansion Packs,10,0,0.0,10
54072,14000,Game Packs,7,0,0.0,7
54073,14000,Kits,6,3,0.5,3
54074,14000,Stuff Packs,11,0,0.0,11
54075,14001,Expansion Packs,16,0,0.0,16
54076,14001,Game Packs,9,0,0.0,9
54077,14001,Kits,2,0,0.0,2
54078,14001,Stuff Packs,8,0,0.0,8
54079,14002,Expansion Packs,4,0,0.0,4
54080,14002,Game Packs,1,0,0.0,1
54081,14002,Kits,1,0,0.0,1
54082,14002,Stuff Packs,3,0,0.0,3
54083,14003,Expansion Packs,7,0,0.0,7
54084,14003,Game Packs,3,0,0.0,3
54085,14003,Kits,1,1,1.0,0
54086,14003,Stuff Packs,7,1,0.14285714285714285,6
54087,14004,Expansion Packs,1,1,1.0,0
54088,14005,Expansion Packs,15,0,0.0,15
54089,14005,Game Packs,12,2,0.16666666666666666,10
54090,14005,Kits,5,1,0.2,4
54091,14005,Stuff Packs,12,4,0.3333333333333333,8
54092,14006,Expansion Packs,13,0,0.0,13
54093,14006,Game Packs,6,1,0.16666666666666666,5
54094,14006,Kits,4,3,0.75,1
54095,14006,Stuff Packs,10,4,0.4,6
54096,14007,Expansion Packs,16,0,0.0,16
54097,14007,Game Packs,12,0,0.0,12
54098,14007,Kits,13,1,0.07692307692307693,12
54099,14007,Stuff Packs,20,0,0.0,20
54100,14008,Expansion Packs,16,0,0.0,16
54101,14008,Game Packs,12,0,0.0,12
54102,14008,Kits,14,2,0.14285714285714285,12
54103,14008,Stuff Packs,20,0,0.0,20
54104,14009,Expansion Packs,15,0,0.0,15
54105,14009,Game Packs,11,0,0.0,11
54106,14009,Kits,17,1,0.058823529411764705,16
54107,14009,Stuff Packs,14,2,0.14285714285714285,12
54108,14010,Expansion Packs,16,0,0.0,16
54109,14010,Game Packs,12,0,0.0,12
54110,14010,Kits,33,0,0.0,33
54111,14010,Stuff Packs,20,0,0.0,20
54112,14011,Expansion Packs,14,0,0.0,14
54113,14011,Game Packs,6,0,0.0,6
54114,14011,Kits,1,0,0.0,1
54115,14011,Stuff Packs,5,0,0.0,5
54116,14012,Expansion Packs,16,0,0.0,16
54117,14012,Game Packs,12,0,0.0,12
54118,14012,Kits,32,0,0.0,32
54119,14012,Stuff Packs,20,0,0.0,20
54120,14013,Expansion Packs,16,10,0.625,6
54121,14013,Game Packs,9,4,0.4444444444444444,5
54122,14013,Stuff Packs,13,13,1.0,0
54123,14014,Expansion Packs,14,1,0.07142857142857142,13
54124,14014,Game Packs,7,0,0.0,7
54125,14014,Kits,25,1,0.04,24
54126,14014,Stuff Packs,14,1,0.07142857142857142,13
54127,14015,Expansion Packs,14,4,0.2857142857142857,10
54128,14015,Game Packs,12,0,0.0,12
54129,14015,Kits,11,0,0.0,11
54130,14015,Stuff Packs,19,0,0.0,19
54131,14016,Expansion Packs,16,0,0.0,16
54132,14016,Game Packs,11,0,0.0,11
54133,14016,Kits,25,1,0.04,24
54134,14016,Stuff Packs,20,0,0.0,20
54135,14017,Expansion Packs,16,0,0.0,16
54136,14017,Game Packs,12,0,0.0,12
54137,14017,Kits,30,1,0.03333333333333333,29
54138,14017,Stuff Packs,20,0,0.0,20
54139,14018,Expansion Packs,6,0,0.0,6
54140,14018,Game Packs,4,0,0.0,4
54141,14018,Stuff Packs,4,0,0.0,4
54142,14019,Expansion Packs,16,0,0.0,16
54143,14019,Game Packs,12,0,0.0,12
54144,14019,Kits,33,1,0.030303030303030304,32
54145,14019,Stuff Packs,20,0,0.0,20
54146,14020,Expansion Packs,16,0,0.0,16
54147,14020,Game Packs,11,0,0.0,11
54148,14020,Kits,25,2,0.08,23
54149,14020,Stuff Packs,20,1,0.05,19
54150,14021,Expansion Packs,16,0,0.0,16
54151,14021,Game Packs,11,0,0.0,11
54152,14021,Kits,22,1,0.045454545454545456,21
54153,14021,Stuff Packs,16,0,0.0,16
54154,14022,Expansion Packs,10,0,0.0,10
54155,14022,Game Packs,3,0,0.0,3
54156,14022,Kits,1,1,1.0,0
54157,14023,Expansion Packs,12,0,0.0,12
54158,14023,Game Packs,8,0,0.0,8
54159,14023,Kits,1,1,1.0,0
54160,14023,Stuff Packs,8,2,0.25,6
54161,14024,Expansion Packs,7,0,0.0,7
54162,14024,Game Packs,4,1,0.25,3
54163,14024,Kits,3,1,0.3333333333333333,2
54164,14024,Stuff Packs,11,3,0.2727272727272727,8
54165,14025,Expansion Packs,15,0,0.0,15
54166,14025,Game Packs,10,0,0.0,10
54167,14025,Kits,5,0,0.0,5
54168,14025,Stuff Packs,19,1,0.05263157894736842,18
54169,14026,Expansion Packs,13,0,0.0,13
54170,14026,Game Packs,6,0,0.0,6
54171,14026,Kits,5,0,0.0,5
54172,14026,Stuff Packs,7,1,0.14285714285714285,6
54173,14027,Expansion Packs,14,0,0.0,14
54174,14027,Game Packs,9,1,0.1111111111111111,8
54175,14027,Kits,3,3,1.0,0
54176,14027,Stuff Packs,14,3,0.21428571428571427,11
54177,14028,Expansion Packs,13,0,0.0,13
54178,14028,Game Packs,5,0,0.0,5
54179,14028,Kits,2,2,1.0,0
54180,14028,Stuff Packs,6,2,0.3333333333333333,4
54181,14029,Expansion Packs,16,0,0.0,16
54182,14029,Game Packs,11,0,0.0,11
54183,14029,Kits,14,1,0.07142857142857142,13
54184,14029,Stuff Packs,17,0,0.0,17
54185,14030,Expansion Packs,6,0,0.0,6
54186,14030,Game Packs,3,0,0.0,3
54187,14030,Stuff Packs,1,0,0.0,1
54188,14031,Expansion Packs,12,0,0.0,12
54189,14031,Game Packs,7,0,0.0,7
54190,14031,Kits,14,1,0.07142857142857142,13
54191,14031,Stuff Packs,11,1,0.09090909090909091,10
54192,14032,Expansion Packs,4,0,0.0,4
54193,14032,Game Packs,1,0,0.0,1
54194,14032,Kits,3,2,0.6666666666666666,1
54195,14032,Stuff Packs,2,0,0.0,2
54196,14033,Expansion Packs,16,0,0.0,16
54197,14033,Game Packs,12,0,0.0,12
54198,14033,Kits,13,0,0.0,13
54199,14033,Stuff Packs,16,0,0.0,16
54200,14034,Expansion Packs,16,0,0.0,16
54201,14034,Game Packs,12,0,0.0,12
54202,14034,Kits,33,0,0.0,33
54203,14034,Stuff Packs,20,0,0.0,20
54204,14035,Expansion Packs,10,0,0.0,10
54205,14035,Game Packs,4,0,0.0,4
54206,14035,Kits,1,1,1.0,0
54207,14035,Stuff Packs,6,3,0.5,3
54208,14036,Expansion Packs,13,0,0.0,13
54209,14036,Game Packs,11,0,0.0,11
54210,14036,Kits,15,0,0.0,15
54211,14036,Stuff Packs,12,0,0.0,12
54212,14037,Expansion Packs,12,0,0.0,12
54213,14037,Game Packs,6,0,0.0,6
54214,14037,Kits,6,3,0.5,3
54215,14037,Stuff Packs,9,1,0.1111111111111111,8
54216,14038,Expansion Packs,15,0,0.0,15
54217,14038,Game Packs,5,0,0.0,5
54218,14038,Kits,3,0,0.0,3
54219,14038,Stuff Packs,8,1,0.125,7
54220,14039,Expansion Packs,16,0,0.0,16
54221,14039,Game Packs,12,0,0.0,12
54222,14039,Kits,14,0,0.0,14
54223,14039,Stuff Packs,20,0,0.0,20
54224,14040,Expansion Packs,6,0,0.0,6
54225,14040,Game Packs,4,0,0.0,4
54226,14040,Kits,1,1,1.0,0
54227,14040,Stuff Packs,6,2,0.3333333333333333,4
54228,14041,Expansion Packs,8,0,0.0,8
54229,14041,Game Packs,4,0,0.0,4
54230,14041,Kits,5,1,0.2,4
54231,14041,Stuff Packs,11,3,0.2727272727272727,8
54232,14042,Expansion Packs,16,0,0.0,16
54233,14042,Game Packs,12,0,0.0,12
54234,14042,Kits,33,0,0.0,33
54235,14042,Stuff Packs,20,0,0.0,20
54236,14043,Expansion Packs,2,0,0.0,2
54237,14043,Game Packs,1,0,0.0,1
54238,14043,Kits,2,2,1.0,0
54239,14043,Stuff Packs,4,3,0.75,1
54240,14044,Expansion Packs,16,0,0.0,16
54241,14044,Game Packs,7,0,0.0,7
54242,14044,Kits,3,0,0.0,3
54243,14044,Stuff Packs,11,0,0.0,11
54244,14045,Expansion Packs,16,0,0.0,16
54245,14045,Game Packs,11,0,0.0,11
54246,14045,Kits,18,0,0.0,18
54247,14045,Stuff Packs,20,0,0.0,20
54248,14046,Expansion Packs,15,0,0.0,15
54249,14046,Game Packs,12,0,0.0,12
54250,14046,Kits,29,1,0.034482758620689655,28
54251,14046,Stuff Packs,20,0,0.0,20
54252,14047,Expansion Packs,16,0,0.0,16
54253,14047,Game Packs,12,0,0.0,12
54254,14047,Kits,33,0,0.0,33
54255,14047,Stuff Packs,20,0,0.0,20
54256,14048,Expansion Packs,16,0,0.0,16
54257,14048,Game Packs,8,0,0.0,8
54258,14048,Kits,26,0,0.0,26
54259,14048,Stuff Packs,15,0,0.0,15
54260,14049,Expansion Packs,16,0,0.0,16
54261,14049,Game Packs,12,0,0.0,12
54262,14049,Kits,28,1,0.03571428571428571,27
54263,14049,Stuff Packs,20,1,0.05,19
54264,14050,Expansion Packs,13,0,0.0,13
54265,14050,Game Packs,6,1,0.16666666666666666,5
54266,14050,Kits,3,2,0.6666666666666666,1
54267,14050,Stuff Packs,11,4,0.36363636363636365,7
54268,14051,Expansion Packs,13,0,0.0,13
54269,14051,Game Packs,9,0,0.0,9
54270,14051,Kits,3,2,0.6666666666666666,1
54271,14051,Stuff Packs,17,1,0.058823529411764705,16
54272,14052,Expansion Packs,15,0,0.0,15
54273,14052,Game Packs,11,0,0.0,11
54274,14052,Kits,7,0,0.0,7
54275,14052,Stuff Packs,16,0,0.0,16
54276,14053,Expansion Packs,15,0,0.0,15
54277,14053,Game Packs,12,0,0.0,12
54278,14053,Kits,14,1,0.07142857142857142,13
54279,14053,Stuff Packs,19,0,0.0,19
54280,14054,Expansion Packs,11,0,0.0,11
54281,14054,Game Packs,4,0,0.0,4
54282,14054,Kits,1,0,0.0,1
54283,14054,Stuff Packs,5,0,0.0,5
54284,14055,Expansion Packs,16,1,0.0625,15
54285,14055,Game Packs,10,0,0.0,10
54286,14055,Kits,12,0,0.0,12
54287,14055,Stuff Packs,16,0,0.0,16
54288,14056,Expansion Packs,15,0,0.0,15
54289,14056,Game Packs,11,1,0.09090909090909091,10
54290,14056,Kits,15,0,0.0,15
54291,14056,Stuff Packs,19,0,0.0,19
54292,14057,Expansion Packs,8,0,0.0,8
54293,14057,Game Packs,3,0,0.0,3
54294,14057,Stuff Packs,5,0,0.0,5
54295,14058,Expansion Packs,15,0,0.0,15
54296,14058,Game Packs,11,0,0.0,11
54297,14058,Kits,6,3,0.5,3
54298,14058,Stuff Packs,14,4,0.2857142857142857,10
54299,14059,Expansion Packs,16,0,0.0,16
54300,14059,Game Packs,12,0,0.0,12
54301,14059,Kits,30,1,0.03333333333333333,29
54302,14059,Stuff Packs,20,0,0.0,20
54303,14060,Expansion Packs,16,0,0.0,16
54304,14060,Game Packs,12,0,0.0,12
54305,14060,Kits,23,1,0.043478260869565216,22
54306,14060,Stuff Packs,19,0,0.0,19
54307,14061,Expansion Packs,16,0,0.0,16
54308,14061,Game Packs,12,0,0.0,12
54309,14061,Kits,21,0,0.0,21
54310,14061,Stuff Packs,20,1,0.05,19
54311,14062,Expansion Packs,9,0,0.0,9
54312,14062,Game Packs,4,0,0.0,4
54313,14062,Kits,2,2,1.0,0
54314,14062,Stuff Packs,7,0,0.0,7
54315,14063,Expansion Packs,15,0,0.0,15
54316,14063,Game Packs,10,0,0.0,10
54317,14063,Kits,20,0,0.0,20
54318,14063,Stuff Packs,19,1,0.05263157894736842,18
54319,14064,Expansion Packs,16,2,0.125,14
54320,14064,Game Packs,8,0,0.0,8
54321,14064,Kits,31,0,0.0,31
54322,14064,Stuff Packs,20,0,0.0,20
54323,14065,Expansion Packs,12,0,0.0,12
54324,14065,Game Packs,7,1,0.14285714285714285,6
54325,14065,Kits,2,2,1.0,0
54326,14065,Stuff Packs,12,3,0.25,9
54327,14066,Expansion Packs,4,0,0.0,4
54328,14066,Game Packs,5,2,0.4,3
54329,14066,Kits,1,1,1.0,0
54330,14066,Stuff Packs,5,3,0.6,2
54331,14067,Expansion Packs,8,0,0.0,8
54332,14067,Game Packs,2,0,0.0,2
54333,14067,Kits,2,2,1.0,0
54334,14067,Stuff Packs,3,1,0.3333333333333333,2
54335,14068,Expansion Packs,8,0,0.0,8
54336,14068,Game Packs,1,0,0.0,1
54337,14068,Stuff Packs,3,0,0.0,3
54338,14069,Expansion Packs,9,0,0.0,9
54339,14069,Game Packs,6,0,0.0,6
54340,14069,Kits,2,1,0.5,1
54341,14069,Stuff Packs,8,3,0.375,5
54342,14070,Expansion Packs,16,0,0.0,16
54343,14070,Game Packs,12,0,0.0,12
54344,14070,Stuff Packs,16,0,0.0,16
54345,14071,Expansion Packs,16,0,0.0,16
54346,14071,Game Packs,12,0,0.0,12
54347,14071,Kits,27,0,0.0,27
54348,14071,Stuff Packs,20,0,0.0,20
54349,14072,Expansion Packs,14,0,0.0,14
54350,14072,Game Packs,10,0,0.0,10
54351,14072,Kits,2,1,0.5,1
54352,14072,Stuff Packs,11,2,0.18181818181818182,9
54353,14073,Expansion Packs,16,0,0.0,16
54354,14073,Game Packs,12,0,0.0,12
54355,14073,Kits,32,0,0.0,32
54356,14073,Stuff Packs,20,0,0.0,20
54357,14074,Expansion Packs,13,0,0.0,13
54358,14074,Game Packs,7,0,0.0,7
54359,14074,Kits,3,2,0.6666666666666666,1
54360,14074,Stuff Packs,12,0,0.0,12
54361,14075,Expansion Packs,11,0,0.0,11
54362,14075,Game Packs,10,0,0.0,10
54363,14075,Kits,5,0,0.0,5
54364,14075,Stuff Packs,10,0,0.0,10
54365,14076,Expansion Packs,13,0,0.0,13
54366,14076,Game Packs,6,0,0.0,6
54367,14076,Kits,5,0,0.0,5
54368,14076,Stuff Packs,8,0,0.0,8
54369,14077,Expansion Packs,12,0,0.0,12
54370,14077,Game Packs,5,0,0.0,5
54371,14077,Kits,2,1,0.5,1
54372,14077,Stuff Packs,14,0,0.0,14
54373,14078,Expansion Packs,15,0,0.0,15
54374,14078,Game Packs,7,1,0.14285714285714285,6
54375,14078,Kits,5,1,0.2,4
54376,14078,Stuff Packs,10,1,0.1,9
54377,14079,Expansion Packs,16,0,0.0,16
54378,14079,Game Packs,11,0,0.0,11
54379,14079,Kits,4,0,0.0,4
54380,14079,Stuff Packs,14,0,0.0,14
54381,14080,Expansion Packs,14,0,0.0,14
54382,14080,Game Packs,12,0,0.0,12
54383,14080,Kits,2,2,1.0,0
54384,14080,Stuff Packs,18,0,0.0,18
54385,14081,Expansion Packs,16,0,0.0,16
54386,14081,Game Packs,12,0,0.0,12
54387,14081,Kits,33,0,0.0,33
54388,14081,Stuff Packs,20,0,0.0,20
54389,14082,Expansion Packs,13,0,0.0,13
54390,14082,Game Packs,8,0,0.0,8
54391,14082,Kits,13,0,0.0,13
54392,14082,Stuff Packs,12,0,0.0,12
54393,14083,Expansion Packs,14,0,0.0,14
54394,14083,Game Packs,9,0,0.0,9
54395,14083,Kits,4,1,0.25,3
54396,14083,Stuff Packs,10,0,0.0,10
54397,14084,Expansion Packs,16,0,0.0,16
54398,14084,Game Packs,12,0,0.0,12
54399,14084,Kits,31,1,0.03225806451612903,30
54400,14084,Stuff Packs,20,0,0.0,20
54401,14085,Expansion Packs,5,0,0.0,5
54402,14085,Game Packs,3,0,0.0,3
54403,14085,Kits,1,0,0.0,1
54404,14085,Stuff Packs,8,1,0.125,7
54405,14086,Expansion Packs,15,0,0.0,15
54406,14086,Game Packs,10,0,0.0,10
54407,14086,Kits,5,1,0.2,4
54408,14086,Stuff Packs,14,1,0.07142857142857142,13
54409,14087,Expansion Packs,14,0,0.0,14
54410,14087,Game Packs,10,0,0.0,10
54411,14087,Kits,8,0,0.0,8
54412,14087,Stuff Packs,18,2,0.1111111111111111,16
54413,14088,Expansion Packs,9,0,0.0,9
54414,14088,Game Packs,5,1,0.2,4
54415,14088,Kits,5,2,0.4,3
54416,14088,Stuff Packs,7,4,0.5714285714285714,3
54417,14089,Expansion Packs,12,0,0.0,12
54418,14089,Game Packs,10,0,0.0,10
54419,14089,Stuff Packs,18,0,0.0,18
54420,14090,Expansion Packs,3,0,0.0,3
54421,14090,Game Packs,1,0,0.0,1
54422,14090,Kits,1,1,1.0,0
54423,14090,Stuff Packs,3,3,1.0,0
54424,14091,Expansion Packs,14,0,0.0,14
54425,14091,Game Packs,9,0,0.0,9
54426,14091,Kits,5,0,0.0,5
54427,14091,Stuff Packs,16,0,0.0,16
54428,14092,Expansion Packs,9,0,0.0,9
54429,14092,Game Packs,3,0,0.0,3
54430,14092,Kits,2,1,0.5,1
54431,14092,Stuff Packs,8,1,0.125,7
54432,14093,Expansion Packs,4,0,0.0,4
54433,14093,Game Packs,2,0,0.0,2
54434,14093,Kits,2,2,1.0,0
54435,14093,Stuff Packs,4,3,0.75,1
54436,14094,Expansion Packs,4,0,0.0,4
54437,14094,Game Packs,2,0,0.0,2
54438,14094,Kits,6,0,0.0,6
54439,14094,Stuff Packs,5,0,0.0,5
54440,14095,Expansion Packs,16,0,0.0,16
54441,14095,Game Packs,11,0,0.0,11
54442,14095,Kits,20,0,0.0,20
54443,14095,Stuff Packs,20,0,0.0,20
54444,14096,Expansion Packs,16,0,0.0,16
54445,14096,Game Packs,12,0,0.0,12
54446,14096,Kits,33,0,0.0,33
54447,14096,Stuff Packs,20,0,0.0,20
54448,14097,Expansion Packs,16,0,0.0,16
54449,14097,Game Packs,12,0,0.0,12
54450,14097,Kits,33,0,0.0,33
54451,14097,Stuff Packs,20,1,0.05,19
54452,14098,Expansion Packs,13,0,0.0,13
54453,14098,Game Packs,12,0,0.0,12
54454,14098,Kits,20,1,0.05,19
54455,14098,Stuff Packs,19,0,0.0,19
54456,14099,Expansion Packs,13,0,0.0,13
54457,14099,Game Packs,5,0,0.0,5
54458,14099,Kits,5,2,0.4,3
54459,14099,Stuff Packs,10,3,0.3,7
54460,14100,Expansion Packs,16,0,0.0,16
54461,14100,Game Packs,12,0,0.0,12
54462,14100,Kits,16,2,0.125,14
54463,14100,Stuff Packs,20,1,0.05,19
54464,14101,Expansion Packs,16,0,0.0,16
54465,14101,Game Packs,9,0,0.0,9
54466,14101,Kits,4,0,0.0,4
54467,14101,Stuff Packs,11,2,0.18181818181818182,9
54468,14102,Expansion Packs,7,0,0.0,7
54469,14102,Game Packs,3,0,0.0,3
54470,14102,Kits,5,0,0.0,5
54471,14102,Stuff Packs,7,2,0.2857142857142857,5
54472,14103,Expansion Packs,13,0,0.0,13
54473,14103,Game Packs,6,0,0.0,6
54474,14103,Kits,3,3,1.0,0
54475,14103,Stuff Packs,13,2,0.15384615384615385,11
54476,14104,Expansion Packs,15,0,0.0,15
54477,14104,Game Packs,8,0,0.0,8
54478,14104,Kits,17,1,0.058823529411764705,16
54479,14104,Stuff Packs,11,1,0.09090909090909091,10
54480,14105,Expansion Packs,16,0,0.0,16
54481,14105,Game Packs,11,0,0.0,11
54482,14105,Kits,22,1,0.045454545454545456,21
54483,14105,Stuff Packs,19,1,0.05263157894736842,18
54484,14106,Expansion Packs,16,0,0.0,16
54485,14106,Game Packs,12,0,0.0,12
54486,14106,Kits,33,0,0.0,33
54487,14106,Stuff Packs,20,1,0.05,19
54488,14107,Expansion Packs,16,4,0.25,12
54489,14107,Game Packs,12,0,0.0,12
54490,14107,Kits,33,0,0.0,33
54491,14107,Stuff Packs,20,0,0.0,20
54492,14108,Expansion Packs,4,0,0.0,4
54493,14108,Game Packs,4,1,0.25,3
54494,14108,Kits,3,2,0.6666666666666666,1
54495,14108,Stuff Packs,7,2,0.2857142857142857,5
54496,14109,Expansion Packs,16,0,0.0,16
54497,14109,Game Packs,12,0,0.0,12
54498,14109,Kits,27,0,0.0,27
54499,14109,Stuff Packs,20,0,0.0,20
54500,14110,Expansion Packs,8,0,0.0,8
54501,14110,Game Packs,3,0,0.0,3
54502,14110,Kits,2,1,0.5,1
54503,14110,Stuff Packs,5,1,0.2,4
54504,14111,Expansion Packs,10,0,0.0,10
54505,14111,Game Packs,3,0,0.0,3
54506,14111,Kits,2,0,0.0,2
54507,14111,Stuff Packs,8,1,0.125,7
54508,14112,Expansion Packs,5,0,0.0,5
54509,14112,Kits,1,1,1.0,0
54510,14112,Stuff Packs,3,2,0.6666666666666666,1
54511,14113,Expansion Packs,11,0,0.0,11
54512,14113,Game Packs,8,0,0.0,8
54513,14113,Stuff Packs,16,0,0.0,16
54514,14114,Expansion Packs,9,0,0.0,9
54515,14114,Game Packs,11,0,0.0,11
54516,14114,Kits,6,2,0.3333333333333333,4
54517,14114,Stuff Packs,18,1,0.05555555555555555,17
54518,14115,Expansion Packs,3,0,0.0,3
54519,14115,Game Packs,3,0,0.0,3
54520,14115,Kits,4,2,0.5,2
54521,14115,Stuff Packs,7,2,0.2857142857142857,5
54522,14116,Expansion Packs,15,0,0.0,15
54523,14116,Game Packs,10,0,0.0,10
54524,14116,Kits,9,1,0.1111111111111111,8
54525,14116,Stuff Packs,8,3,0.375,5
54526,14117,Expansion Packs,14,0,0.0,14
54527,14117,Game Packs,5,0,0.0,5
54528,14117,Kits,2,2,1.0,0
54529,14117,Stuff Packs,7,3,0.42857142857142855,4
54530,14118,Expansion Packs,7,0,0.0,7
54531,14118,Game Packs,7,0,0.0,7
54532,14118,Stuff Packs,5,1,0.2,4
54533,14119,Expansion Packs,12,0,0.0,12
54534,14119,Game Packs,8,0,0.0,8
54535,14119,Kits,11,1,0.09090909090909091,10
54536,14119,Stuff Packs,15,3,0.2,12
54537,14120,Expansion Packs,2,0,0.0,2
54538,14120,Game Packs,1,0,0.0,1
54539,14120,Stuff Packs,1,0,0.0,1
54540,14121,Expansion Packs,3,0,0.0,3
54541,14121,Kits,1,1,1.0,0
54542,14121,Stuff Packs,3,2,0.6666666666666666,1
54543,14122,Expansion Packs,16,0,0.0,16
54544,14122,Game Packs,9,0,0.0,9
54545,14122,Kits,14,1,0.07142857142857142,13
54546,14122,Stuff Packs,15,3,0.2,12
54547,14123,Expansion Packs,13,0,0.0,13
54548,14123,Game Packs,3,0,0.0,3
54549,14123,Stuff Packs,4,1,0.25,3
54550,14124,Expansion Packs,15,0,0.0,15
54551,14124,Game Packs,11,0,0.0,11
54552,14124,Kits,10,2,0.2,8
54553,14124,Stuff Packs,19,0,0.0,19
54554,14125,Expansion Packs,16,0,0.0,16
54555,14125,Game Packs,12,0,0.0,12
54556,14125,Kits,33,0,0.0,33
54557,14125,Stuff Packs,20,0,0.0,20
54558,14126,Expansion Packs,5,0,0.0,5
54559,14126,Game Packs,2,0,0.0,2
54560,14126,Kits,2,2,1.0,0
54561,14126,Stuff Packs,3,2,0.6666666666666666,1
54562,14127,Expansion Packs,13,0,0.0,13
54563,14127,Game Packs,3,0,0.0,3
54564,14127,Kits,4,0,0.0,4
54565,14127,Stuff Packs,10,0,0.0,10
54566,14128,Expansion Packs,14,0,0.0,14
54567,14128,Game Packs,8,0,0.0,8
54568,14128,Kits,4,1,0.25,3
54569,14128,Stuff Packs,9,4,0.4444444444444444,5
54570,14129,Expansion Packs,11,0,0.0,11
54571,14129,Game Packs,7,0,0.0,7
54572,14129,Kits,14,1,0.07142857142857142,13
54573,14129,Stuff Packs,16,1,0.0625,15
54574,14130,Expansion Packs,15,0,0.0,15
54575,14130,Game Packs,9,0,0.0,9
54576,14130,Kits,5,0,0.0,5
54577,14130,Stuff Packs,17,0,0.0,17
54578,14131,Expansion Packs,5,0,0.0,5
54579,14131,Game Packs,5,0,0.0,5
54580,14131,Kits,1,0,0.0,1
54581,14131,Stuff Packs,3,0,0.0,3
54582,14132,Expansion Packs,16,0,0.0,16
54583,14132,Game Packs,12,0,0.0,12
54584,14132,Kits,8,1,0.125,7
54585,14132,Stuff Packs,20,0,0.0,20
54586,14133,Expansion Packs,6,0,0.0,6
54587,14133,Game Packs,4,1,0.25,3
54588,14133,Kits,3,3,1.0,0
54589,14133,Stuff Packs,4,0,0.0,4
54590,14134,Expansion Packs,5,0,0.0,5
54591,14134,Game Packs,1,0,0.0,1
54592,14134,Kits,1,0,0.0,1
54593,14134,Stuff Packs,4,2,0.5,2
54594,14135,Expansion Packs,16,0,0.0,16
54595,14135,Game Packs,12,0,0.0,12
54596,14135,Kits,30,1,0.03333333333333333,29
54597,14135,Stuff Packs,20,0,0.0,20
54598,14136,Expansion Packs,15,0,0.0,15
54599,14136,Game Packs,11,0,0.0,11
54600,14136,Kits,10,1,0.1,9
54601,14136,Stuff Packs,16,0,0.0,16
54602,14137,Expansion Packs,12,0,0.0,12
54603,14137,Game Packs,9,0,0.0,9
54604,14137,Kits,22,0,0.0,22
54605,14137,Stuff Packs,10,2,0.2,8
54606,14138,Expansion Packs,10,0,0.0,10
54607,14138,Game Packs,1,0,0.0,1
54608,14138,Stuff Packs,1,0,0.0,1
54609,14139,Expansion Packs,16,0,0.0,16
54610,14139,Game Packs,12,0,0.0,12
54611,14139,Kits,33,0,0.0,33
54612,14139,Stuff Packs,20,0,0.0,20
54613,14140,Expansion Packs,16,1,0.0625,15
54614,14140,Game Packs,12,0,0.0,12
54615,14140,Kits,6,0,0.0,6
54616,14140,Stuff Packs,19,0,0.0,19
54617,14141,Expansion Packs,13,0,0.0,13
54618,14141,Game Packs,10,0,0.0,10
54619,14141,Kits,8,2,0.25,6
54620,14141,Stuff Packs,8,2,0.25,6
54621,14142,Expansion Packs,9,0,0.0,9
54622,14142,Game Packs,7,0,0.0,7
54623,14142,Stuff Packs,3,0,0.0,3
54624,14143,Expansion Packs,3,0,0.0,3
54625,14143,Game Packs,2,1,0.5,1
54626,14143,Kits,3,3,1.0,0
54627,14143,Stuff Packs,5,4,0.8,1
54628,14144,Expansion Packs,15,0,0.0,15
54629,14144,Game Packs,10,0,0.0,10
54630,14144,Kits,9,0,0.0,9
54631,14144,Stuff Packs,19,0,0.0,19
54632,14145,Expansion Packs,14,0,0.0,14
54633,14145,Game Packs,8,0,0.0,8
54634,14145,Kits,15,1,0.06666666666666667,14
54635,14145,Stuff Packs,14,0,0.0,14
54636,14146,Expansion Packs,14,0,0.0,14
54637,14146,Game Packs,5,0,0.0,5
54638,14146,Kits,10,0,0.0,10
54639,14146,Stuff Packs,12,4,0.3333333333333333,8
54640,14147,Expansion Packs,14,0,0.0,14
54641,14147,Game Packs,8,0,0.0,8
54642,14147,Kits,7,1,0.14285714285714285,6
54643,14147,Stuff Packs,10,1,0.1,9
54644,14148,Expansion Packs,15,0,0.0,15
54645,14148,Game Packs,12,0,0.0,12
54646,14148,Kits,22,0,0.0,22
54647,14148,Stuff Packs,20,0,0.0,20
54648,14149,Expansion Packs,16,0,0.0,16
54649,14149,Game Packs,11,1,0.09090909090909091,10
54650,14149,Kits,33,3,0.09090909090909091,30
54651,14149,Stuff Packs,20,2,0.1,18
54652,14150,Expansion Packs,15,0,0.0,15
54653,14150,Game Packs,10,0,0.0,10
54654,14150,Kits,6,0,0.0,6
54655,14150,Stuff Packs,19,0,0.0,19
54656,14151,Expansion Packs,14,0,0.0,14
54657,14151,Game Packs,11,0,0.0,11
54658,14151,Stuff Packs,13,5,0.38461538461538464,8
54659,14152,Expansion Packs,8,0,0.0,8
54660,14152,Game Packs,4,0,0.0,4
54661,14152,Kits,13,0,0.0,13
54662,14152,Stuff Packs,9,0,0.0,9
54663,14153,Expansion Packs,16,0,0.0,16
54664,14153,Game Packs,12,0,0.0,12
54665,14153,Kits,33,1,0.030303030303030304,32
54666,14153,Stuff Packs,20,0,0.0,20
54667,14154,Expansion Packs,6,0,0.0,6
54668,14154,Game Packs,4,0,0.0,4
54669,14154,Kits,3,3,1.0,0
54670,14154,Stuff Packs,9,2,0.2222222222222222,7
54671,14155,Expansion Packs,12,0,0.0,12
54672,14155,Game Packs,7,0,0.0,7
54673,14155,Stuff Packs,13,1,0.07692307692307693,12
54674,14156,Expansion Packs,10,0,0.0,10
54675,14156,Game Packs,8,0,0.0,8
54676,14156,Stuff Packs,17,0,0.0,17
54677,14157,Expansion Packs,6,0,0.0,6
54678,14157,Game Packs,3,0,0.0,3
54679,14157,Kits,10,1,0.1,9
54680,14157,Stuff Packs,9,3,0.3333333333333333,6
54681,14158,Expansion Packs,11,0,0.0,11
54682,14158,Game Packs,9,0,0.0,9
54683,14158,Kits,31,1,0.03225806451612903,30
54684,14158,Stuff Packs,14,0,0.0,14
54685,14159,Expansion Packs,6,0,0.0,6
54686,14159,Game Packs,2,0,0.0,2
54687,14159,Stuff Packs,3,0,0.0,3
54688,14160,Expansion Packs,3,0,0.0,3
54689,14160,Game Packs,2,0,0.0,2
54690,14160,Kits,1,1,1.0,0
54691,14160,Stuff Packs,1,0,0.0,1
54692,14161,Expansion Packs,15,0,0.0,15
54693,14161,Game Packs,9,1,0.1111111111111111,8
54694,14161,Kits,5,3,0.6,2
54695,14161,Stuff Packs,11,3,0.2727272727272727,8
54696,14162,Expansion Packs,11,0,0.0,11
54697,14162,Game Packs,2,1,0.5,1
54698,14162,Kits,3,3,1.0,0
54699,14162,Stuff Packs,5,4,0.8,1
54700,14163,Expansion Packs,16,0,0.0,16
54701,14163,Game Packs,12,0,0.0,12
54702,14163,Kits,33,0,0.0,33
54703,14163,Stuff Packs,20,0,0.0,20
54704,14164,Expansion Packs,16,0,0.0,16
54705,14164,Game Packs,12,1,0.08333333333333333,11
54706,14164,Kits,32,0,0.0,32
54707,14164,Stuff Packs,20,0,0.0,20
54708,14165,Expansion Packs,10,0,0.0,10
54709,14165,Game Packs,3,0,0.0,3
54710,14165,Kits,1,1,1.0,0
54711,14165,Stuff Packs,1,0,0.0,1
54712,14166,Expansion Packs,16,0,0.0,16
54713,14166,Game Packs,12,0,0.0,12
54714,14166,Kits,31,0,0.0,31
54715,14166,Stuff Packs,20,0,0.0,20
54716,14167,Expansion Packs,13,0,0.0,13
54717,14167,Game Packs,8,0,0.0,8
54718,14167,Kits,12,1,0.08333333333333333,11
54719,14167,Stuff Packs,13,0,0.0,13
54720,14168,Expansion Packs,11,0,0.0,11
54721,14168,Game Packs,6,1,0.16666666666666666,5
54722,14168,Kits,3,0,0.0,3
54723,14168,Stuff Packs,8,3,0.375,5
54724,14169,Expansion Packs,16,0,0.0,16
54725,14169,Game Packs,12,0,0.0,12
54726,14169,Kits,33,0,0.0,33
54727,14169,Stuff Packs,20,0,0.0,20
54728,14170,Expansion Packs,15,0,0.0,15
54729,14170,Game Packs,8,1,0.125,7
54730,14170,Kits,9,0,0.0,9
54731,14170,Stuff Packs,11,0,0.0,11
54732,14171,Expansion Packs,16,0,0.0,16
54733,14171,Game Packs,11,0,0.0,11
54734,14171,Kits,22,0,0.0,22
54735,14171,Stuff Packs,18,0,0.0,18
54736,14172,Expansion Packs,16,0,0.0,16
54737,14172,Game Packs,12,0,0.0,12
54738,14172,Kits,32,0,0.0,32
54739,14172,Stuff Packs,20,0,0.0,20
54740,14173,Expansion Packs,16,0,0.0,16
54741,14173,Game Packs,12,0,0.0,12
54742,14173,Kits,33,0,0.0,33
54743,14173,Stuff Packs,20,1,0.05,19
54744,14174,Expansion Packs,10,0,0.0,10
54745,14174,Game Packs,5,0,0.0,5
54746,14174,Kits,4,0,0.0,4
54747,14174,Stuff Packs,10,0,0.0,10
54748,14175,Expansion Packs,13,0,0.0,13
54749,14175,Game Packs,10,0,0.0,10
54750,14175,Kits,14,2,0.14285714285714285,12
54751,14175,Stuff Packs,20,0,0.0,20
54752,14176,Expansion Packs,16,0,0.0,16
54753,14176,Game Packs,12,0,0.0,12
54754,14176,Kits,27,1,0.037037037037037035,26
54755,14176,Stuff Packs,20,0,0.0,20
54756,14177,Expansion Packs,9,0,0.0,9
54757,14177,Kits,1,0,0.0,1
54758,14177,Stuff Packs,2,0,0.0,2
54759,14178,Expansion Packs,14,0,0.0,14
54760,14178,Game Packs,4,0,0.0,4
54761,14178,Stuff Packs,6,0,0.0,6
54762,14179,Expansion Packs,12,0,0.0,12
54763,14179,Game Packs,4,0,0.0,4
54764,14179,Kits,13,0,0.0,13
54765,14179,Stuff Packs,5,0,0.0,5
54766,14180,Expansion Packs,15,0,0.0,15
54767,14180,Game Packs,10,0,0.0,10
54768,14180,Kits,25,0,0.0,25
54769,14180,Stuff Packs,14,1,0.07142857142857142,13
54770,14181,Expansion Packs,15,0,0.0,15
54771,14181,Game Packs,9,0,0.0,9
54772,14181,Stuff Packs,13,0,0.0,13
54773,14182,Expansion Packs,16,0,0.0,16
54774,14182,Game Packs,6,0,0.0,6
54775,14182,Kits,13,2,0.15384615384615385,11
54776,14182,Stuff Packs,16,3,0.1875,13
54777,14183,Expansion Packs,16,0,0.0,16
54778,14183,Game Packs,12,0,0.0,12
54779,14183,Kits,31,0,0.0,31
54780,14183,Stuff Packs,20,0,0.0,20
54781,14184,Expansion Packs,4,0,0.0,4
54782,14184,Game Packs,2,1,0.5,1
54783,14184,Kits,2,2,1.0,0
54784,14184,Stuff Packs,8,4,0.5,4
54785,14185,Expansion Packs,8,0,0.0,8
54786,14185,Game Packs,5,0,0.0,5
54787,14185,Kits,1,1,1.0,0
54788,14185,Stuff Packs,11,0,0.0,11
54789,14186,Expansion Packs,12,0,0.0,12
54790,14186,Game Packs,5,0,0.0,5
54791,14186,Kits,6,1,0.16666666666666666,5
54792,14186,Stuff Packs,8,2,0.25,6
54793,14187,Expansion Packs,16,0,0.0,16
54794,14187,Game Packs,11,0,0.0,11
54795,14187,Kits,22,1,0.045454545454545456,21
54796,14187,Stuff Packs,18,0,0.0,18
54797,14188,Expansion Packs,16,0,0.0,16
54798,14188,Game Packs,11,0,0.0,11
54799,14188,Kits,1,1,1.0,0
54800,14188,Stuff Packs,14,1,0.07142857142857142,13
54801,14189,Expansion Packs,12,0,0.0,12
54802,14189,Game Packs,7,1,0.14285714285714285,6
54803,14189,Stuff Packs,14,1,0.07142857142857142,13
54804,14190,Expansion Packs,4,0,0.0,4
54805,14190,Game Packs,2,0,0.0,2
54806,14190,Kits,1,0,0.0,1
54807,14190,Stuff Packs,5,1,0.2,4
54808,14191,Expansion Packs,15,0,0.0,15
54809,14191,Game Packs,11,0,0.0,11
54810,14191,Kits,10,2,0.2,8
54811,14191,Stuff Packs,20,0,0.0,20
54812,14192,Expansion Packs,16,0,0.0,16
54813,14192,Game Packs,12,0,0.0,12
54814,14192,Kits,17,0,0.0,17
54815,14192,Stuff Packs,10,0,0.0,10
54816,14193,Expansion Packs,16,0,0.0,16
54817,14193,Game Packs,11,0,0.0,11
54818,14193,Kits,21,1,0.047619047619047616,20
54819,14193,Stuff Packs,20,0,0.0,20
54820,14194,Expansion Packs,16,0,0.0,16
54821,14194,Game Packs,12,0,0.0,12
54822,14194,Kits,33,0,0.0,33
54823,14194,Stuff Packs,20,0,0.0,20
54824,14195,Expansion Packs,16,0,0.0,16
54825,14195,Game Packs,11,0,0.0,11
54826,14195,Kits,7,1,0.14285714285714285,6
54827,14195,Stuff Packs,15,2,0.13333333333333333,13
54828,14196,Expansion Packs,9,0,0.0,9
54829,14196,Game Packs,5,1,0.2,4
54830,14196,Kits,1,1,1.0,0
54831,14196,Stuff Packs,7,4,0.5714285714285714,3
54832,14197,Expansion Packs,12,0,0.0,12
54833,14197,Game Packs,3,0,0.0,3
54834,14197,Stuff Packs,7,1,0.14285714285714285,6
54835,14198,Expansion Packs,15,0,0.0,15
54836,14198,Game Packs,12,0,0.0,12
54837,14198,Kits,30,0,0.0,30
54838,14198,Stuff Packs,20,0,0.0,20
54839,14199,Expansion Packs,16,0,0.0,16
54840,14199,Game Packs,12,0,0.0,12
54841,14199,Kits,27,0,0.0,27
54842,14199,Stuff Packs,20,0,0.0,20
54843,14200,Expansion Packs,14,0,0.0,14
54844,14200,Game Packs,7,0,0.0,7
54845,14200,Kits,3,0,0.0,3
54846,14200,Stuff Packs,6,1,0.16666666666666666,5
54847,14201,Expansion Packs,15,0,0.0,15
54848,14201,Game Packs,8,1,0.125,7
54849,14201,Kits,9,0,0.0,9
54850,14201,Stuff Packs,15,1,0.06666666666666667,14
54851,14202,Expansion Packs,16,0,0.0,16
54852,14202,Game Packs,9,0,0.0,9
54853,14202,Kits,22,1,0.045454545454545456,21
54854,14202,Stuff Packs,13,2,0.15384615384615385,11
54855,14203,Expansion Packs,15,0,0.0,15
54856,14203,Game Packs,9,0,0.0,9
54857,14203,Kits,16,0,0.0,16
54858,14203,Stuff Packs,16,0,0.0,16
54859,14204,Expansion Packs,11,0,0.0,11
54860,14204,Game Packs,9,0,0.0,9
54861,14204,Kits,1,1,1.0,0
54862,14204,Stuff Packs,4,0,0.0,4
54863,14205,Expansion Packs,2,0,0.0,2
54864,14205,Game Packs,1,0,0.0,1
54865,14205,Kits,1,0,0.0,1
54866,14205,Stuff Packs,4,3,0.75,1
54867,14206,Expansion Packs,11,9,0.8181818181818182,2
54868,14206,Game Packs,6,5,0.8333333333333334,1
54869,14206,Kits,3,1,0.3333333333333333,2
54870,14206,Stuff Packs,12,5,0.4166666666666667,7
54871,14207,Expansion Packs,10,0,0.0,10
54872,14207,Kits,6,0,0.0,6
54873,14207,Stuff Packs,4,1,0.25,3
54874,14208,Expansion Packs,16,1,0.0625,15
54875,14208,Game Packs,12,0,0.0,12
54876,14208,Kits,19,0,0.0,19
54877,14208,Stuff Packs,18,0,0.0,18
54878,14209,Expansion Packs,14,0,0.0,14
54879,14209,Game Packs,7,0,0.0,7
54880,14209,Kits,4,1,0.25,3
54881,14209,Stuff Packs,6,0,0.0,6
54882,14210,Expansion Packs,16,0,0.0,16
54883,14210,Game Packs,12,0,0.0,12
54884,14210,Kits,15,1,0.06666666666666667,14
54885,14210,Stuff Packs,17,1,0.058823529411764705,16
54886,14211,Expansion Packs,12,0,0.0,12
54887,14211,Game Packs,12,1,0.08333333333333333,11
54888,14211,Stuff Packs,18,1,0.05555555555555555,17
54889,14212,Expansion Packs,10,0,0.0,10
54890,14212,Game Packs,6,0,0.0,6
54891,14212,Stuff Packs,8,0,0.0,8
54892,14213,Expansion Packs,13,0,0.0,13
54893,14213,Game Packs,9,0,0.0,9
54894,14213,Kits,3,1,0.3333333333333333,2
54895,14213,Stuff Packs,10,0,0.0,10
54896,14214,Expansion Packs,10,0,0.0,10
54897,14214,Game Packs,1,0,0.0,1
54898,14214,Stuff Packs,2,0,0.0,2
54899,14215,Expansion Packs,16,0,0.0,16
54900,14215,Game Packs,12,0,0.0,12
54901,14215,Kits,33,1,0.030303030303030304,32
54902,14215,Stuff Packs,20,0,0.0,20
54903,14216,Expansion Packs,5,0,0.0,5
54904,14216,Game Packs,2,0,0.0,2
54905,14216,Stuff Packs,5,2,0.4,3
54906,14217,Expansion Packs,7,0,0.0,7
54907,14217,Game Packs,3,1,0.3333333333333333,2
54908,14217,Kits,5,3,0.6,2
54909,14217,Stuff Packs,5,5,1.0,0
54910,14218,Expansion Packs,12,0,0.0,12
54911,14218,Game Packs,6,0,0.0,6
54912,14218,Kits,2,2,1.0,0
54913,14218,Stuff Packs,17,0,0.0,17
54914,14219,Expansion Packs,15,0,0.0,15
54915,14219,Game Packs,8,0,0.0,8
54916,14219,Kits,2,1,0.5,1
54917,14219,Stuff Packs,14,0,0.0,14
54918,14220,Expansion Packs,16,0,0.0,16
54919,14220,Game Packs,12,0,0.0,12
54920,14220,Kits,18,0,0.0,18
54921,14220,Stuff Packs,13,0,0.0,13
54922,14221,Expansion Packs,16,0,0.0,16
54923,14221,Game Packs,11,0,0.0,11
54924,14221,Kits,11,1,0.09090909090909091,10
54925,14221,Stuff Packs,20,0,0.0,20
54926,14222,Expansion Packs,10,0,0.0,10
54927,14222,Game Packs,6,0,0.0,6
54928,14222,Kits,17,1,0.058823529411764705,16
54929,14222,Stuff Packs,11,3,0.2727272727272727,8
54930,14223,Expansion Packs,9,0,0.0,9
54931,14223,Game Packs,6,0,0.0,6
54932,14223,Kits,1,1,1.0,0
54933,14223,Stuff Packs,6,2,0.3333333333333333,4
54934,14224,Expansion Packs,16,0,0.0,16
54935,14224,Game Packs,11,0,0.0,11
54936,14224,Kits,23,1,0.043478260869565216,22
54937,14224,Stuff Packs,20,1,0.05,19
54938,14225,Expansion Packs,14,0,0.0,14
54939,14225,Game Packs,4,0,0.0,4
54940,14225,Kits,4,0,0.0,4
54941,14225,Stuff Packs,9,1,0.1111111111111111,8
54942,14226,Expansion Packs,5,0,0.0,5
54943,14226,Game Packs,2,0,0.0,2
54944,14226,Kits,1,1,1.0,0
54945,14226,Stuff Packs,3,3,1.0,0
54946,14227,Expansion Packs,15,0,0.0,15
54947,14227,Game Packs,11,1,0.09090909090909091,10
54948,14227,Kits,4,2,0.5,2
54949,14227,Stuff Packs,15,3,0.2,12
54950,14228,Expansion Packs,7,0,0.0,7
54951,14228,Game Packs,3,0,0.0,3
54952,14228,Kits,2,1,0.5,1
54953,14228,Stuff Packs,6,0,0.0,6
54954,14229,Expansion Packs,16,0,0.0,16
54955,14229,Game Packs,12,0,0.0,12
54956,14229,Kits,33,0,0.0,33
54957,14229,Stuff Packs,20,0,0.0,20
54958,14230,Expansion Packs,16,0,0.0,16
54959,14230,Game Packs,12,0,0.0,12
54960,14230,Kits,31,0,0.0,31
54961,14230,Stuff Packs,20,0,0.0,20
54962,14231,Expansion Packs,7,0,0.0,7
54963,14231,Game Packs,5,0,0.0,5
54964,14231,Kits,1,1,1.0,0
54965,14231,Stuff Packs,4,0,0.0,4
54966,14232,Expansion Packs,1,0,0.0,1
54967,14232,Game Packs,2,0,0.0,2
54968,14232,Stuff Packs,2,0,0.0,2
54969,14233,Expansion Packs,9,0,0.0,9
54970,14233,Game Packs,5,0,0.0,5
54971,14233,Kits,3,1,0.3333333333333333,2
54972,14233,Stuff Packs,6,2,0.3333333333333333,4
54973,14234,Game Packs,1,1,1.0,0
54974,14234,Stuff Packs,1,1,1.0,0
54975,14235,Expansion Packs,15,0,0.0,15
54976,14235,Game Packs,8,0,0.0,8
54977,14235,Kits,1,1,1.0,0
54978,14235,Stuff Packs,14,4,0.2857142857142857,10
54979,14236,Expansion Packs,11,0,0.0,11
54980,14236,Game Packs,2,0,0.0,2
54981,14236,Kits,4,0,0.0,4
54982,14236,Stuff Packs,6,1,0.16666666666666666,5
54983,14237,Expansion Packs,9,0,0.0,9
54984,14237,Game Packs,9,0,0.0,9
54985,14237,Kits,1,1,1.0,0
54986,14237,Stuff Packs,9,0,0.0,9
54987,14238,Expansion Packs,11,0,0.0,11
54988,14238,Game Packs,7,0,0.0,7
54989,14238,Kits,1,0,0.0,1
54990,14238,Stuff Packs,7,0,0.0,7
54991,14239,Expansion Packs,15,0,0.0,15
54992,14239,Game Packs,11,0,0.0,11
54993,14239,Kits,7,0,0.0,7
54994,14239,Stuff Packs,18,0,0.0,18
54995,14240,Expansion Packs,10,0,0.0,10
54996,14240,Game Packs,9,1,0.1111111111111111,8
54997,14240,Kits,10,2,0.2,8
54998,14240,Stuff Packs,9,3,0.3333333333333333,6
54999,14241,Expansion Packs,14,0,0.0,14
55000,14241,Game Packs,9,0,0.0,9
55001,14241,Kits,2,2,1.0,0
55002,14241,Stuff Packs,12,2,0.16666666666666666,10
55003,14242,Expansion Packs,10,0,0.0,10
55004,14242,Game Packs,9,0,0.0,9
55005,14242,Stuff Packs,12,0,0.0,12
55006,14243,Expansion Packs,15,0,0.0,15
55007,14243,Game Packs,8,0,0.0,8
55008,14243,Kits,3,1,0.3333333333333333,2
55009,14243,Stuff Packs,5,1,0.2,4
55010,14244,Expansion Packs,16,0,0.0,16
55011,14244,Game Packs,12,0,0.0,12
55012,14244,Kits,33,1,0.030303030303030304,32
55013,14244,Stuff Packs,20,0,0.0,20
55014,14245,Expansion Packs,4,0,0.0,4
55015,14245,Game Packs,2,0,0.0,2
55016,14245,Kits,2,1,0.5,1
55017,14245,Stuff Packs,4,3,0.75,1
55018,14246,Expansion Packs,3,0,0.0,3
55019,14246,Game Packs,1,1,1.0,0
55020,14246,Kits,2,2,1.0,0
55021,14246,Stuff Packs,4,4,1.0,0
55022,14247,Expansion Packs,13,0,0.0,13
55023,14247,Game Packs,4,0,0.0,4
55024,14247,Kits,9,1,0.1111111111111111,8
55025,14247,Stuff Packs,6,3,0.5,3
55026,14248,Expansion Packs,14,0,0.0,14
55027,14248,Game Packs,11,0,0.0,11
55028,14248,Kits,12,2,0.16666666666666666,10
55029,14248,Stuff Packs,19,0,0.0,19
55030,14249,Expansion Packs,15,0,0.0,15
55031,14249,Game Packs,8,1,0.125,7
55032,14249,Kits,2,0,0.0,2
55033,14249,Stuff Packs,6,2,0.3333333333333333,4
55034,14250,Expansion Packs,2,0,0.0,2
55035,14250,Game Packs,1,0,0.0,1
55036,14251,Expansion Packs,7,0,0.0,7
55037,14251,Game Packs,2,0,0.0,2
55038,14251,Kits,2,2,1.0,0
55039,14251,Stuff Packs,3,2,0.6666666666666666,1
55040,14252,Expansion Packs,16,0,0.0,16
55041,14252,Game Packs,11,0,0.0,11
55042,14252,Kits,23,0,0.0,23
55043,14252,Stuff Packs,20,0,0.0,20
55044,14253,Expansion Packs,16,0,0.0,16
55045,14253,Game Packs,12,0,0.0,12
55046,14253,Kits,1,1,1.0,0
55047,14253,Stuff Packs,18,0,0.0,18
55048,14254,Expansion Packs,1,0,0.0,1
55049,14254,Stuff Packs,1,1,1.0,0
55050,14255,Expansion Packs,15,0,0.0,15
55051,14255,Game Packs,11,0,0.0,11
55052,14255,Kits,18,1,0.05555555555555555,17
55053,14255,Stuff Packs,20,1,0.05,19
55054,14256,Expansion Packs,10,0,0.0,10
55055,14256,Game Packs,8,0,0.0,8
55056,14256,Kits,2,2,1.0,0
55057,14256,Stuff Packs,13,1,0.07692307692307693,12
55058,14257,Expansion Packs,9,0,0.0,9
55059,14257,Game Packs,4,0,0.0,4
55060,14257,Stuff Packs,3,0,0.0,3
55061,14258,Expansion Packs,3,0,0.0,3
55062,14258,Game Packs,3,0,0.0,3
55063,14258,Stuff Packs,6,0,0.0,6
55064,14259,Expansion Packs,3,0,0.0,3
55065,14259,Game Packs,3,0,0.0,3
55066,14259,Kits,1,1,1.0,0
55067,14259,Stuff Packs,4,2,0.5,2
55068,14260,Expansion Packs,10,0,0.0,10
55069,14260,Game Packs,9,2,0.2222222222222222,7
55070,14260,Kits,6,1,0.16666666666666666,5
55071,14260,Stuff Packs,12,5,0.4166666666666667,7
55072,14261,Expansion Packs,15,0,0.0,15
55073,14261,Game Packs,10,0,0.0,10
55074,14261,Kits,3,0,0.0,3
55075,14261,Stuff Packs,8,0,0.0,8
55076,14262,Expansion Packs,10,0,0.0,10
55077,14262,Game Packs,9,0,0.0,9
55078,14262,Kits,1,0,0.0,1
55079,14262,Stuff Packs,15,0,0.0,15
55080,14263,Expansion Packs,16,0,0.0,16
55081,14263,Game Packs,12,0,0.0,12
55082,14263,Kits,33,1,0.030303030303030304,32
55083,14263,Stuff Packs,20,0,0.0,20
55084,14264,Expansion Packs,16,0,0.0,16
55085,14264,Game Packs,12,0,0.0,12
55086,14264,Kits,33,1,0.030303030303030304,32
55087,14264,Stuff Packs,20,0,0.0,20
55088,14265,Expansion Packs,13,0,0.0,13
55089,14265,Game Packs,5,1,0.2,4
55090,14265,Kits,4,3,0.75,1
55091,14265,Stuff Packs,8,4,0.5,4
55092,14266,Expansion Packs,13,0,0.0,13
55093,14266,Game Packs,8,0,0.0,8
55094,14266,Kits,2,2,1.0,0
55095,14266,Stuff Packs,14,1,0.07142857142857142,13
55096,14267,Expansion Packs,16,0,0.0,16
55097,14267,Game Packs,8,0,0.0,8
55098,14267,Kits,10,1,0.1,9
55099,14267,Stuff Packs,12,0,0.0,12
55100,14268,Expansion Packs,10,0,0.0,10
55101,14268,Game Packs,3,0,0.0,3
55102,14268,Stuff Packs,4,0,0.0,4
55103,14269,Expansion Packs,8,0,0.0,8
55104,14269,Game Packs,5,0,0.0,5
55105,14269,Kits,3,2,0.6666666666666666,1
55106,14269,Stuff Packs,6,4,0.6666666666666666,2
55107,14270,Expansion Packs,14,0,0.0,14
55108,14270,Game Packs,7,0,0.0,7
55109,14270,Stuff Packs,3,0,0.0,3
55110,14271,Expansion Packs,14,0,0.0,14
55111,14271,Game Packs,9,0,0.0,9
55112,14271,Kits,3,3,1.0,0
55113,14271,Stuff Packs,14,2,0.14285714285714285,12
55114,14272,Expansion Packs,14,0,0.0,14
55115,14272,Game Packs,10,0,0.0,10
55116,14272,Kits,11,1,0.09090909090909091,10
55117,14272,Stuff Packs,15,1,0.06666666666666667,14
55118,14273,Expansion Packs,12,0,0.0,12
55119,14273,Game Packs,1,0,0.0,1
55120,14273,Stuff Packs,1,0,0.0,1
55121,14274,Expansion Packs,11,0,0.0,11
55122,14274,Game Packs,6,0,0.0,6
55123,14274,Stuff Packs,2,0,0.0,2
55124,14275,Expansion Packs,11,0,0.0,11
55125,14275,Game Packs,3,0,0.0,3
55126,14275,Kits,1,0,0.0,1
55127,14275,Stuff Packs,6,2,0.3333333333333333,4
55128,14276,Expansion Packs,2,0,0.0,2
55129,14276,Game Packs,1,0,0.0,1
55130,14276,Stuff Packs,3,0,0.0,3
55131,14277,Expansion Packs,16,0,0.0,16
55132,14277,Game Packs,12,0,0.0,12
55133,14277,Kits,1,1,1.0,0
55134,14277,Stuff Packs,16,0,0.0,16
55135,14278,Expansion Packs,16,0,0.0,16
55136,14278,Game Packs,11,0,0.0,11
55137,14278,Kits,6,2,0.3333333333333333,4
55138,14278,Stuff Packs,17,0,0.0,17
55139,14279,Expansion Packs,8,1,0.125,7
55140,14279,Game Packs,3,0,0.0,3
55141,14279,Kits,1,1,1.0,0
55142,14279,Stuff Packs,7,2,0.2857142857142857,5
55143,14280,Expansion Packs,14,0,0.0,14
55144,14280,Game Packs,11,0,0.0,11
55145,14280,Kits,4,0,0.0,4
55146,14280,Stuff Packs,19,0,0.0,19
55147,14281,Expansion Packs,13,0,0.0,13
55148,14281,Game Packs,11,0,0.0,11
55149,14281,Kits,2,2,1.0,0
55150,14281,Stuff Packs,20,0,0.0,20
55151,14282,Expansion Packs,15,0,0.0,15
55152,14282,Game Packs,10,0,0.0,10
55153,14282,Kits,5,2,0.4,3
55154,14282,Stuff Packs,14,3,0.21428571428571427,11
55155,14283,Expansion Packs,16,0,0.0,16
55156,14283,Game Packs,12,0,0.0,12
55157,14283,Kits,33,0,0.0,33
55158,14283,Stuff Packs,20,0,0.0,20
55159,14284,Expansion Packs,16,0,0.0,16
55160,14284,Game Packs,11,0,0.0,11
55161,14284,Kits,15,2,0.13333333333333333,13
55162,14284,Stuff Packs,20,1,0.05,19
55163,14285,Expansion Packs,7,0,0.0,7
55164,14285,Game Packs,1,0,0.0,1
55165,14285,Kits,1,1,1.0,0
55166,14285,Stuff Packs,5,2,0.4,3
55167,14286,Expansion Packs,15,0,0.0,15
55168,14286,Game Packs,5,1,0.2,4
55169,14286,Kits,5,3,0.6,2
55170,14286,Stuff Packs,8,4,0.5,4
55171,14287,Expansion Packs,16,0,0.0,16
55172,14287,Game Packs,10,0,0.0,10
55173,14287,Kits,9,0,0.0,9
55174,14287,Stuff Packs,17,0,0.0,17
55175,14288,Expansion Packs,12,0,0.0,12
55176,14288,Game Packs,3,0,0.0,3
55177,14288,Kits,2,2,1.0,0
55178,14288,Stuff Packs,7,3,0.42857142857142855,4
55179,14289,Expansion Packs,12,0,0.0,12
55180,14289,Game Packs,8,0,0.0,8
55181,14289,Kits,1,1,1.0,0
55182,14289,Stuff Packs,13,1,0.07692307692307693,12
55183,14290,Expansion Packs,16,0,0.0,16
55184,14290,Game Packs,12,0,0.0,12
55185,14290,Kits,26,0,0.0,26
55186,14290,Stuff Packs,20,1,0.05,19
55187,14291,Expansion Packs,3,0,0.0,3
55188,14291,Game Packs,2,0,0.0,2
55189,14291,Kits,1,1,1.0,0
55190,14291,Stuff Packs,5,1,0.2,4
55191,14292,Expansion Packs,8,1,0.125,7
55192,14292,Game Packs,1,0,0.0,1
55193,14292,Kits,4,0,0.0,4
55194,14292,Stuff Packs,2,0,0.0,2
55195,14293,Expansion Packs,4,0,0.0,4
55196,14293,Stuff Packs,1,0,0.0,1
55197,14294,Expansion Packs,11,0,0.0,11
55198,14294,Game Packs,6,0,0.0,6
55199,14294,Stuff Packs,4,1,0.25,3
55200,14295,Expansion Packs,6,0,0.0,6
55201,14295,Game Packs,4,0,0.0,4
55202,14295,Kits,1,1,1.0,0
55203,14295,Stuff Packs,9,3,0.3333333333333333,6
55204,14296,Expansion Packs,11,0,0.0,11
55205,14296,Game Packs,12,0,0.0,12
55206,14296,Kits,18,0,0.0,18
55207,14296,Stuff Packs,18,0,0.0,18
55208,14297,Expansion Packs,16,0,0.0,16
55209,14297,Game Packs,8,0,0.0,8
55210,14297,Kits,7,1,0.14285714285714285,6
55211,14297,Stuff Packs,11,0,0.0,11
55212,14298,Expansion Packs,12,0,0.0,12
55213,14298,Game Packs,6,0,0.0,6
55214,14298,Kits,17,0,0.0,17
55215,14298,Stuff Packs,14,1,0.07142857142857142,13
55216,14299,Expansion Packs,16,0,0.0,16
55217,14299,Game Packs,11,0,0.0,11
55218,14299,Kits,21,1,0.047619047619047616,20
55219,14299,Stuff Packs,18,1,0.05555555555555555,17
55220,14300,Expansion Packs,14,0,0.0,14
55221,14300,Game Packs,8,0,0.0,8
55222,14300,Kits,8,0,0.0,8
55223,14300,Stuff Packs,8,0,0.0,8
55224,14301,Expansion Packs,16,0,0.0,16
55225,14301,Game Packs,12,0,0.0,12
55226,14301,Kits,30,0,0.0,30
55227,14301,Stuff Packs,20,0,0.0,20
55228,14302,Expansion Packs,7,0,0.0,7
55229,14302,Game Packs,1,0,0.0,1
55230,14302,Stuff Packs,2,0,0.0,2
55231,14303,Expansion Packs,4,1,0.25,3
55232,14303,Game Packs,1,0,0.0,1
55233,14303,Kits,1,1,1.0,0
55234,14303,Stuff Packs,3,2,0.6666666666666666,1
55235,14304,Expansion Packs,12,0,0.0,12
55236,14304,Game Packs,8,0,0.0,8
55237,14304,Kits,5,1,0.2,4
55238,14304,Stuff Packs,13,2,0.15384615384615385,11
55239,14305,Game Packs,12,0,0.0,12
55240,14305,Kits,13,1,0.07692307692307693,12
55241,14305,Stuff Packs,14,3,0.21428571428571427,11
55242,14306,Expansion Packs,7,0,0.0,7
55243,14306,Game Packs,3,1,0.3333333333333333,2
55244,14306,Kits,2,2,1.0,0
55245,14306,Stuff Packs,6,4,0.6666666666666666,2
55246,14307,Expansion Packs,14,0,0.0,14
55247,14307,Game Packs,7,0,0.0,7
55248,14307,Kits,23,0,0.0,23
55249,14307,Stuff Packs,17,1,0.058823529411764705,16
55250,14308,Expansion Packs,15,0,0.0,15
55251,14308,Game Packs,12,0,0.0,12
55252,14308,Kits,8,2,0.25,6
55253,14308,Stuff Packs,15,1,0.06666666666666667,14
55254,14309,Expansion Packs,8,0,0.0,8
55255,14309,Game Packs,1,0,0.0,1
55256,14309,Stuff Packs,2,2,1.0,0
55257,14310,Expansion Packs,16,0,0.0,16
55258,14310,Game Packs,12,0,0.0,12
55259,14310,Kits,33,3,0.09090909090909091,30
55260,14310,Stuff Packs,20,0,0.0,20
55261,14311,Expansion Packs,16,0,0.0,16
55262,14311,Game Packs,12,0,0.0,12
55263,14311,Kits,30,1,0.03333333333333333,29
55264,14311,Stuff Packs,20,0,0.0,20
55265,14312,Expansion Packs,16,0,0.0,16
55266,14312,Game Packs,12,0,0.0,12
55267,14312,Kits,16,2,0.125,14
55268,14312,Stuff Packs,20,0,0.0,20
55269,14313,Expansion Packs,16,0,0.0,16
55270,14313,Game Packs,8,1,0.125,7
55271,14313,Kits,2,0,0.0,2
55272,14313,Stuff Packs,9,0,0.0,9
55273,14314,Expansion Packs,13,0,0.0,13
55274,14314,Game Packs,9,0,0.0,9
55275,14314,Kits,5,1,0.2,4
55276,14314,Stuff Packs,8,0,0.0,8
55277,14315,Expansion Packs,13,0,0.0,13
55278,14315,Game Packs,8,0,0.0,8
55279,14315,Kits,3,2,0.6666666666666666,1
55280,14315,Stuff Packs,11,1,0.09090909090909091,10
55281,14316,Expansion Packs,16,0,0.0,16
55282,14316,Game Packs,6,0,0.0,6
55283,14316,Kits,11,1,0.09090909090909091,10
55284,14316,Stuff Packs,12,2,0.16666666666666666,10
55285,14317,Expansion Packs,16,0,0.0,16
55286,14317,Game Packs,12,1,0.08333333333333333,11
55287,14317,Kits,33,2,0.06060606060606061,31
55288,14317,Stuff Packs,20,0,0.0,20
55289,14318,Expansion Packs,15,0,0.0,15
55290,14318,Game Packs,7,0,0.0,7
55291,14318,Kits,4,0,0.0,4
55292,14318,Stuff Packs,12,0,0.0,12
55293,14319,Expansion Packs,16,1,0.0625,15
55294,14319,Game Packs,11,0,0.0,11
55295,14319,Kits,3,1,0.3333333333333333,2
55296,14319,Stuff Packs,15,4,0.26666666666666666,11
55297,14320,Expansion Packs,12,0,0.0,12
55298,14320,Game Packs,7,0,0.0,7
55299,14320,Stuff Packs,10,0,0.0,10
55300,14321,Expansion Packs,16,0,0.0,16
55301,14321,Game Packs,11,0,0.0,11
55302,14321,Kits,29,1,0.034482758620689655,28
55303,14321,Stuff Packs,20,0,0.0,20
55304,14322,Expansion Packs,16,0,0.0,16
55305,14322,Game Packs,10,0,0.0,10
55306,14322,Kits,8,1,0.125,7
55307,14322,Stuff Packs,17,2,0.11764705882352941,15
55308,14323,Expansion Packs,16,0,0.0,16
55309,14323,Game Packs,8,0,0.0,8
55310,14323,Kits,8,0,0.0,8
55311,14323,Stuff Packs,8,0,0.0,8
55312,14324,Expansion Packs,12,0,0.0,12
55313,14324,Game Packs,4,1,0.25,3
55314,14324,Kits,4,3,0.75,1
55315,14324,Stuff Packs,5,4,0.8,1
55316,14325,Expansion Packs,13,0,0.0,13
55317,14325,Game Packs,6,0,0.0,6
55318,14325,Stuff Packs,4,0,0.0,4
55319,14326,Expansion Packs,16,0,0.0,16
55320,14326,Game Packs,12,0,0.0,12
55321,14326,Kits,33,0,0.0,33
55322,14326,Stuff Packs,20,0,0.0,20
55323,14327,Expansion Packs,11,0,0.0,11
55324,14327,Game Packs,6,0,0.0,6
55325,14327,Kits,27,0,0.0,27
55326,14327,Stuff Packs,15,0,0.0,15
55327,14328,Expansion Packs,16,0,0.0,16
55328,14328,Game Packs,12,0,0.0,12
55329,14328,Kits,30,0,0.0,30
55330,14328,Stuff Packs,20,0,0.0,20
55331,14329,Expansion Packs,5,0,0.0,5
55332,14329,Game Packs,3,0,0.0,3
55333,14329,Kits,1,1,1.0,0
55334,14329,Stuff Packs,5,3,0.6,2
55335,14330,Expansion Packs,16,0,0.0,16
55336,14330,Game Packs,11,0,0.0,11
55337,14330,Kits,8,0,0.0,8
55338,14330,Stuff Packs,13,0,0.0,13
55339,14331,Expansion Packs,15,0,0.0,15
55340,14331,Game Packs,12,0,0.0,12
55341,14331,Kits,29,0,0.0,29
55342,14331,Stuff Packs,20,0,0.0,20
55343,14332,Expansion Packs,4,1,0.25,3
55344,14332,Game Packs,4,0,0.0,4
55345,14332,Kits,3,0,0.0,3
55346,14332,Stuff Packs,4,0,0.0,4
55347,14333,Expansion Packs,11,0,0.0,11
55348,14333,Game Packs,9,0,0.0,9
55349,14333,Kits,1,1,1.0,0
55350,14333,Stuff Packs,15,1,0.06666666666666667,14
55351,14334,Expansion Packs,16,0,0.0,16
55352,14334,Game Packs,11,0,0.0,11
55353,14334,Kits,33,2,0.06060606060606061,31
55354,14334,Stuff Packs,20,0,0.0,20
55355,14335,Expansion Packs,16,0,0.0,16
55356,14335,Game Packs,11,0,0.0,11
55357,14335,Kits,30,0,0.0,30
55358,14335,Stuff Packs,19,1,0.05263157894736842,18
55359,14336,Expansion Packs,13,0,0.0,13
55360,14336,Game Packs,8,0,0.0,8
55361,14336,Kits,6,2,0.3333333333333333,4
55362,14336,Stuff Packs,10,3,0.3,7
55363,14337,Expansion Packs,10,0,0.0,10
55364,14337,Game Packs,5,0,0.0,5
55365,14337,Kits,1,0,0.0,1
55366,14337,Stuff Packs,7,0,0.0,7
55367,14338,Expansion Packs,14,1,0.07142857142857142,13
55368,14338,Game Packs,11,0,0.0,11
55369,14338,Kits,6,0,0.0,6
55370,14338,Stuff Packs,16,0,0.0,16
55371,14339,Expansion Packs,16,0,0.0,16
55372,14339,Game Packs,11,0,0.0,11
55373,14339,Kits,14,1,0.07142857142857142,13
55374,14339,Stuff Packs,14,0,0.0,14
55375,14340,Expansion Packs,5,0,0.0,5
55376,14340,Game Packs,2,0,0.0,2
55377,14341,Expansion Packs,16,0,0.0,16
55378,14341,Game Packs,11,0,0.0,11
55379,14341,Kits,14,0,0.0,14
55380,14341,Stuff Packs,19,0,0.0,19
55381,14342,Expansion Packs,12,0,0.0,12
55382,14342,Game Packs,7,0,0.0,7
55383,14342,Kits,8,1,0.125,7
55384,14342,Stuff Packs,14,0,0.0,14
55385,14343,Expansion Packs,8,0,0.0,8
55386,14343,Game Packs,3,0,0.0,3
55387,14343,Kits,2,0,0.0,2
55388,14343,Stuff Packs,2,0,0.0,2
55389,14344,Expansion Packs,16,0,0.0,16
55390,14344,Game Packs,12,0,0.0,12
55391,14344,Kits,17,0,0.0,17
55392,14344,Stuff Packs,20,0,0.0,20
55393,14345,Expansion Packs,15,0,0.0,15
55394,14345,Game Packs,11,0,0.0,11
55395,14345,Kits,15,0,0.0,15
55396,14345,Stuff Packs,17,0,0.0,17
55397,14346,Expansion Packs,16,0,0.0,16
55398,14346,Game Packs,12,0,0.0,12
55399,14346,Kits,32,3,0.09375,29
55400,14346,Stuff Packs,20,0,0.0,20
55401,14347,Expansion Packs,16,0,0.0,16
55402,14347,Game Packs,12,0,0.0,12
55403,14347,Kits,25,1,0.04,24
55404,14347,Stuff Packs,20,0,0.0,20
55405,14348,Expansion Packs,16,0,0.0,16
55406,14348,Game Packs,12,0,0.0,12
55407,14348,Kits,33,1,0.030303030303030304,32
55408,14348,Stuff Packs,20,0,0.0,20
55409,14349,Expansion Packs,16,0,0.0,16
55410,14349,Game Packs,12,0,0.0,12
55411,14349,Kits,17,1,0.058823529411764705,16
55412,14349,Stuff Packs,20,1,0.05,19
55413,14350,Expansion Packs,14,0,0.0,14
55414,14350,Game Packs,10,0,0.0,10
55415,14350,Kits,1,1,1.0,0
55416,14350,Stuff Packs,10,2,0.2,8
55417,14351,Expansion Packs,14,0,0.0,14
55418,14351,Game Packs,8,0,0.0,8
55419,14351,Kits,13,2,0.15384615384615385,11
55420,14351,Stuff Packs,19,0,0.0,19
55421,14352,Expansion Packs,15,0,0.0,15
55422,14352,Game Packs,11,0,0.0,11
55423,14352,Kits,10,2,0.2,8
55424,14352,Stuff Packs,18,0,0.0,18
55425,14353,Expansion Packs,6,0,0.0,6
55426,14353,Game Packs,2,0,0.0,2
55427,14353,Stuff Packs,3,1,0.3333333333333333,2
55428,14354,Expansion Packs,16,0,0.0,16
55429,14354,Game Packs,12,1,0.08333333333333333,11
55430,14354,Kits,4,0,0.0,4
55431,14354,Stuff Packs,18,3,0.16666666666666666,15
55432,14355,Expansion Packs,4,0,0.0,4
55433,14355,Game Packs,3,1,0.3333333333333333,2
55434,14355,Kits,2,2,1.0,0
55435,14355,Stuff Packs,4,4,1.0,0
55436,14356,Expansion Packs,16,0,0.0,16
55437,14356,Game Packs,11,0,0.0,11
55438,14356,Kits,11,1,0.09090909090909091,10
55439,14356,Stuff Packs,13,2,0.15384615384615385,11
55440,14357,Expansion Packs,16,0,0.0,16
55441,14357,Game Packs,12,0,0.0,12
55442,14357,Kits,33,0,0.0,33
55443,14357,Stuff Packs,20,0,0.0,20
55444,14358,Expansion Packs,6,0,0.0,6
55445,14358,Game Packs,2,0,0.0,2
55446,14358,Stuff Packs,1,0,0.0,1
55447,14359,Expansion Packs,3,0,0.0,3
55448,14359,Game Packs,2,0,0.0,2
55449,14359,Stuff Packs,5,0,0.0,5
55450,14360,Expansion Packs,15,0,0.0,15
55451,14360,Game Packs,12,0,0.0,12
55452,14360,Kits,19,2,0.10526315789473684,17
55453,14360,Stuff Packs,20,1,0.05,19
55454,14361,Expansion Packs,16,0,0.0,16
55455,14361,Game Packs,12,0,0.0,12
55456,14361,Kits,33,0,0.0,33
55457,14361,Stuff Packs,20,0,0.0,20
55458,14362,Expansion Packs,12,0,0.0,12
55459,14362,Game Packs,1,0,0.0,1
55460,14362,Kits,2,1,0.5,1
55461,14362,Stuff Packs,4,2,0.5,2
55462,14363,Expansion Packs,6,0,0.0,6
55463,14363,Game Packs,6,0,0.0,6
55464,14363,Kits,1,0,0.0,1
55465,14363,Stuff Packs,7,3,0.42857142857142855,4
55466,14364,Expansion Packs,10,0,0.0,10
55467,14364,Game Packs,10,0,0.0,10
55468,14364,Kits,3,0,0.0,3
55469,14364,Stuff Packs,16,0,0.0,16
55470,14365,Expansion Packs,7,1,0.14285714285714285,6
55471,14365,Game Packs,3,0,0.0,3
55472,14365,Stuff Packs,7,0,0.0,7
55473,14366,Expansion Packs,16,0,0.0,16
55474,14366,Game Packs,12,0,0.0,12
55475,14366,Kits,13,0,0.0,13
55476,14366,Stuff Packs,16,0,0.0,16
55477,14367,Expansion Packs,12,0,0.0,12
55478,14367,Game Packs,7,0,0.0,7
55479,14367,Kits,3,2,0.6666666666666666,1
55480,14367,Stuff Packs,10,2,0.2,8
55481,14368,Expansion Packs,2,0,0.0,2
55482,14368,Game Packs,1,0,0.0,1
55483,14369,Expansion Packs,16,0,0.0,16
55484,14369,Game Packs,10,0,0.0,10
55485,14369,Kits,16,1,0.0625,15
55486,14369,Stuff Packs,12,2,0.16666666666666666,10
55487,14370,Expansion Packs,11,0,0.0,11
55488,14370,Game Packs,7,0,0.0,7
55489,14370,Kits,13,1,0.07692307692307693,12
55490,14370,Stuff Packs,17,3,0.17647058823529413,14
55491,14371,Expansion Packs,16,0,0.0,16
55492,14371,Game Packs,12,0,0.0,12
55493,14371,Kits,31,2,0.06451612903225806,29
55494,14371,Stuff Packs,20,0,0.0,20
55495,14372,Expansion Packs,13,1,0.07692307692307693,12
55496,14372,Game Packs,6,0,0.0,6
55497,14372,Kits,3,0,0.0,3
55498,14372,Stuff Packs,13,1,0.07692307692307693,12
55499,14373,Expansion Packs,2,0,0.0,2
55500,14373,Game Packs,1,1,1.0,0
55501,14373,Kits,2,2,1.0,0
55502,14373,Stuff Packs,6,4,0.6666666666666666,2
55503,14374,Expansion Packs,9,0,0.0,9
55504,14374,Game Packs,3,1,0.3333333333333333,2
55505,14374,Kits,4,0,0.0,4
55506,14374,Stuff Packs,4,2,0.5,2
55507,14375,Expansion Packs,3,0,0.0,3
55508,14375,Game Packs,1,0,0.0,1
55509,14375,Kits,1,1,1.0,0
55510,14375,Stuff Packs,2,2,1.0,0
55511,14376,Expansion Packs,7,0,0.0,7
55512,14376,Game Packs,2,0,0.0,2
55513,14376,Stuff Packs,6,3,0.5,3
55514,14377,Expansion Packs,11,0,0.0,11
55515,14377,Game Packs,6,0,0.0,6
55516,14377,Kits,2,0,0.0,2
55517,14377,Stuff Packs,7,0,0.0,7
55518,14378,Expansion Packs,1,0,0.0,1
55519,14378,Game Packs,1,0,0.0,1
55520,14378,Kits,2,0,0.0,2
55521,14378,Stuff Packs,4,0,0.0,4
55522,14379,Expansion Packs,16,0,0.0,16
55523,14379,Game Packs,12,0,0.0,12
55524,14379,Kits,32,0,0.0,32
55525,14379,Stuff Packs,20,0,0.0,20
55526,14380,Expansion Packs,16,0,0.0,16
55527,14380,Game Packs,11,0,0.0,11
55528,14380,Kits,20,1,0.05,19
55529,14380,Stuff Packs,20,0,0.0,20
55530,14381,Expansion Packs,15,2,0.13333333333333333,13
55531,14381,Game Packs,8,0,0.0,8
55532,14381,Kits,5,2,0.4,3
55533,14381,Stuff Packs,14,1,0.07142857142857142,13
55534,14382,Expansion Packs,14,0,0.0,14
55535,14382,Game Packs,7,0,0.0,7
55536,14382,Kits,1,0,0.0,1
55537,14382,Stuff Packs,13,0,0.0,13
55538,14383,Expansion Packs,15,0,0.0,15
55539,14383,Game Packs,8,0,0.0,8
55540,14383,Stuff Packs,15,0,0.0,15
55541,14384,Expansion Packs,7,0,0.0,7
55542,14384,Game Packs,5,0,0.0,5
55543,14384,Kits,2,0,0.0,2
55544,14384,Stuff Packs,4,0,0.0,4
55545,14385,Expansion Packs,12,0,0.0,12
55546,14385,Game Packs,11,0,0.0,11
55547,14385,Kits,3,0,0.0,3
55548,14385,Stuff Packs,17,0,0.0,17
55549,14386,Expansion Packs,5,0,0.0,5
55550,14386,Game Packs,2,0,0.0,2
55551,14386,Kits,2,2,1.0,0
55552,14386,Stuff Packs,10,0,0.0,10
55553,14387,Expansion Packs,11,0,0.0,11
55554,14387,Game Packs,6,0,0.0,6
55555,14387,Kits,9,0,0.0,9
55556,14387,Stuff Packs,3,1,0.3333333333333333,2
55557,14388,Expansion Packs,16,0,0.0,16
55558,14388,Game Packs,7,0,0.0,7
55559,14388,Kits,18,0,0.0,18
55560,14388,Stuff Packs,14,0,0.0,14
55561,14389,Expansion Packs,11,0,0.0,11
55562,14389,Game Packs,10,0,0.0,10
55563,14389,Kits,1,0,0.0,1
55564,14389,Stuff Packs,15,0,0.0,15
55565,14390,Expansion Packs,12,1,0.08333333333333333,11
55566,14390,Game Packs,4,0,0.0,4
55567,14390,Stuff Packs,5,0,0.0,5
55568,14391,Expansion Packs,13,0,0.0,13
55569,14391,Game Packs,9,0,0.0,9
55570,14391,Kits,2,1,0.5,1
55571,14391,Stuff Packs,9,0,0.0,9
55572,14392,Expansion Packs,16,0,0.0,16
55573,14392,Game Packs,12,0,0.0,12
55574,14392,Kits,33,0,0.0,33
55575,14392,Stuff Packs,20,0,0.0,20
55576,14393,Expansion Packs,13,0,0.0,13
55577,14393,Game Packs,9,0,0.0,9
55578,14393,Kits,6,4,0.6666666666666666,2
55579,14393,Stuff Packs,11,1,0.09090909090909091,10
55580,14394,Expansion Packs,16,0,0.0,16
55581,14394,Game Packs,11,0,0.0,11
55582,14394,Kits,5,0,0.0,5
55583,14394,Stuff Packs,20,0,0.0,20
55584,14395,Expansion Packs,12,0,0.0,12
55585,14395,Game Packs,6,0,0.0,6
55586,14395,Kits,18,0,0.0,18
55587,14395,Stuff Packs,13,0,0.0,13
55588,14396,Expansion Packs,9,0,0.0,9
55589,14396,Game Packs,9,0,0.0,9
55590,14396,Kits,9,1,0.1111111111111111,8
55591,14396,Stuff Packs,13,1,0.07692307692307693,12
55592,14397,Expansion Packs,16,0,0.0,16
55593,14397,Game Packs,9,0,0.0,9
55594,14397,Kits,12,0,0.0,12
55595,14397,Stuff Packs,15,0,0.0,15
55596,14398,Expansion Packs,13,0,0.0,13
55597,14398,Game Packs,3,0,0.0,3
55598,14398,Kits,18,1,0.05555555555555555,17
55599,14398,Stuff Packs,16,2,0.125,14
55600,14399,Expansion Packs,16,0,0.0,16
55601,14399,Game Packs,8,1,0.125,7
55602,14399,Kits,10,2,0.2,8
55603,14399,Stuff Packs,15,1,0.06666666666666667,14
55604,14400,Expansion Packs,13,0,0.0,13
55605,14400,Game Packs,6,0,0.0,6
55606,14400,Kits,15,0,0.0,15
55607,14400,Stuff Packs,13,2,0.15384615384615385,11
55608,14401,Expansion Packs,16,0,0.0,16
55609,14401,Game Packs,11,0,0.0,11
55610,14401,Kits,25,1,0.04,24
55611,14401,Stuff Packs,19,0,0.0,19
55612,14402,Expansion Packs,14,0,0.0,14
55613,14402,Game Packs,10,0,0.0,10
55614,14402,Kits,7,1,0.14285714285714285,6
55615,14402,Stuff Packs,16,7,0.4375,9
55616,14403,Expansion Packs,15,0,0.0,15
55617,14403,Game Packs,11,1,0.09090909090909091,10
55618,14403,Kits,8,0,0.0,8
55619,14403,Stuff Packs,19,0,0.0,19
55620,14404,Expansion Packs,14,0,0.0,14
55621,14404,Game Packs,6,0,0.0,6
55622,14404,Kits,5,1,0.2,4
55623,14404,Stuff Packs,18,0,0.0,18
55624,14405,Expansion Packs,15,0,0.0,15
55625,14405,Game Packs,11,0,0.0,11
55626,14405,Kits,3,1,0.3333333333333333,2
55627,14405,Stuff Packs,19,0,0.0,19
55628,14406,Expansion Packs,16,0,0.0,16
55629,14406,Game Packs,12,0,0.0,12
55630,14406,Kits,25,0,0.0,25
55631,14406,Stuff Packs,20,0,0.0,20
55632,14407,Expansion Packs,15,0,0.0,15
55633,14407,Game Packs,10,0,0.0,10
55634,14407,Kits,5,0,0.0,5
55635,14407,Stuff Packs,15,1,0.06666666666666667,14
55636,14408,Expansion Packs,15,0,0.0,15
55637,14408,Game Packs,11,0,0.0,11
55638,14408,Kits,11,0,0.0,11
55639,14408,Stuff Packs,14,1,0.07142857142857142,13
55640,14409,Expansion Packs,15,0,0.0,15
55641,14409,Game Packs,8,0,0.0,8
55642,14409,Kits,12,1,0.08333333333333333,11
55643,14409,Stuff Packs,13,1,0.07692307692307693,12
55644,14410,Expansion Packs,12,0,0.0,12
55645,14410,Game Packs,7,0,0.0,7
55646,14410,Kits,1,1,1.0,0
55647,14410,Stuff Packs,9,1,0.1111111111111111,8
55648,14411,Expansion Packs,14,0,0.0,14
55649,14411,Game Packs,12,0,0.0,12
55650,14411,Kits,3,0,0.0,3
55651,14411,Stuff Packs,18,0,0.0,18
55652,14412,Expansion Packs,10,0,0.0,10
55653,14412,Game Packs,9,0,0.0,9
55654,14412,Kits,2,2,1.0,0
55655,14412,Stuff Packs,12,0,0.0,12
55656,14413,Expansion Packs,14,0,0.0,14
55657,14413,Game Packs,7,0,0.0,7
55658,14413,Kits,3,1,0.3333333333333333,2
55659,14413,Stuff Packs,12,0,0.0,12
55660,14414,Expansion Packs,16,0,0.0,16
55661,14414,Game Packs,11,0,0.0,11
55662,14414,Kits,14,0,0.0,14
55663,14414,Stuff Packs,20,0,0.0,20
55664,14415,Expansion Packs,9,0,0.0,9
55665,14415,Game Packs,4,0,0.0,4
55666,14415,Stuff Packs,5,3,0.6,2
55667,14416,Expansion Packs,16,0,0.0,16
55668,14416,Game Packs,11,1,0.09090909090909091,10
55669,14416,Kits,2,0,0.0,2
55670,14416,Stuff Packs,9,3,0.3333333333333333,6
55671,14417,Expansion Packs,16,0,0.0,16
55672,14417,Game Packs,10,1,0.1,9
55673,14417,Kits,1,0,0.0,1
55674,14417,Stuff Packs,16,1,0.0625,15
55675,14418,Expansion Packs,4,0,0.0,4
55676,14418,Game Packs,3,1,0.3333333333333333,2
55677,14418,Kits,2,1,0.5,1
55678,14418,Stuff Packs,2,0,0.0,2
55679,14419,Expansion Packs,13,1,0.07692307692307693,12
55680,14419,Game Packs,4,0,0.0,4
55681,14419,Kits,3,0,0.0,3
55682,14419,Stuff Packs,9,0,0.0,9
55683,14420,Expansion Packs,16,0,0.0,16
55684,14420,Game Packs,12,0,0.0,12
55685,14420,Kits,15,2,0.13333333333333333,13
55686,14420,Stuff Packs,20,0,0.0,20
55687,14421,Expansion Packs,3,0,0.0,3
55688,14421,Game Packs,2,0,0.0,2
55689,14421,Stuff Packs,1,0,0.0,1
55690,14422,Expansion Packs,16,0,0.0,16
55691,14422,Game Packs,12,0,0.0,12
55692,14422,Kits,33,0,0.0,33
55693,14422,Stuff Packs,20,0,0.0,20
55694,14423,Expansion Packs,15,1,0.06666666666666667,14
55695,14423,Game Packs,10,3,0.3,7
55696,14423,Kits,3,1,0.3333333333333333,2
55697,14423,Stuff Packs,15,1,0.06666666666666667,14
55698,14424,Expansion Packs,8,0,0.0,8
55699,14424,Game Packs,3,1,0.3333333333333333,2
55700,14424,Kits,4,1,0.25,3
55701,14424,Stuff Packs,10,7,0.7,3
55702,14425,Expansion Packs,16,0,0.0,16
55703,14425,Game Packs,12,0,0.0,12
55704,14425,Kits,33,0,0.0,33
55705,14425,Stuff Packs,20,0,0.0,20
55706,14426,Expansion Packs,14,0,0.0,14
55707,14426,Game Packs,11,0,0.0,11
55708,14426,Kits,24,3,0.125,21
55709,14426,Stuff Packs,18,0,0.0,18
55710,14427,Expansion Packs,16,0,0.0,16
55711,14427,Game Packs,12,0,0.0,12
55712,14427,Kits,33,0,0.0,33
55713,14427,Stuff Packs,20,0,0.0,20
55714,14428,Expansion Packs,16,0,0.0,16
55715,14428,Game Packs,12,1,0.08333333333333333,11
55716,14428,Kits,21,0,0.0,21
55717,14428,Stuff Packs,20,0,0.0,20
55718,14429,Expansion Packs,16,0,0.0,16
55719,14429,Game Packs,11,0,0.0,11
55720,14429,Kits,8,1,0.125,7
55721,14429,Stuff Packs,17,2,0.11764705882352941,15
55722,14430,Expansion Packs,16,0,0.0,16
55723,14430,Game Packs,12,0,0.0,12
55724,14430,Kits,33,1,0.030303030303030304,32
55725,14430,Stuff Packs,20,0,0.0,20
55726,14431,Expansion Packs,16,0,0.0,16
55727,14431,Game Packs,11,0,0.0,11
55728,14431,Kits,16,0,0.0,16
55729,14431,Stuff Packs,19,0,0.0,19
55730,14432,Expansion Packs,13,0,0.0,13
55731,14432,Game Packs,7,0,0.0,7
55732,14432,Kits,1,1,1.0,0
55733,14432,Stuff Packs,4,1,0.25,3
55734,14433,Expansion Packs,15,0,0.0,15
55735,14433,Game Packs,9,0,0.0,9
55736,14433,Kits,14,0,0.0,14
55737,14433,Stuff Packs,20,0,0.0,20
55738,14434,Expansion Packs,16,0,0.0,16
55739,14434,Game Packs,9,0,0.0,9
55740,14434,Kits,8,1,0.125,7
55741,14434,Stuff Packs,10,0,0.0,10
55742,14435,Expansion Packs,6,1,0.16666666666666666,5
55743,14435,Game Packs,2,0,0.0,2
55744,14435,Kits,5,0,0.0,5
55745,14435,Stuff Packs,7,0,0.0,7
55746,14436,Expansion Packs,7,0,0.0,7
55747,14436,Game Packs,7,0,0.0,7
55748,14436,Kits,1,1,1.0,0
55749,14436,Stuff Packs,10,1,0.1,9
55750,14437,Expansion Packs,13,0,0.0,13
55751,14437,Game Packs,4,0,0.0,4
55752,14437,Kits,18,1,0.05555555555555555,17
55753,14437,Stuff Packs,6,0,0.0,6
55754,14438,Expansion Packs,16,0,0.0,16
55755,14438,Game Packs,12,0,0.0,12
55756,14438,Kits,33,0,0.0,33
55757,14438,Stuff Packs,20,0,0.0,20
55758,14439,Expansion Packs,14,0,0.0,14
55759,14439,Game Packs,11,0,0.0,11
55760,14439,Kits,9,1,0.1111111111111111,8
55761,14439,Stuff Packs,16,1,0.0625,15
55762,14440,Expansion Packs,12,0,0.0,12
55763,14440,Game Packs,7,0,0.0,7
55764,14440,Kits,6,2,0.3333333333333333,4
55765,14440,Stuff Packs,12,1,0.08333333333333333,11
55766,14441,Expansion Packs,9,0,0.0,9
55767,14441,Game Packs,6,0,0.0,6
55768,14441,Kits,2,2,1.0,0
55769,14441,Stuff Packs,7,1,0.14285714285714285,6
55770,14442,Expansion Packs,14,0,0.0,14
55771,14442,Game Packs,9,0,0.0,9
55772,14442,Kits,6,3,0.5,3
55773,14442,Stuff Packs,15,3,0.2,12
55774,14443,Expansion Packs,16,0,0.0,16
55775,14443,Game Packs,12,0,0.0,12
55776,14443,Kits,33,0,0.0,33
55777,14443,Stuff Packs,20,0,0.0,20
55778,14444,Expansion Packs,14,0,0.0,14
55779,14444,Game Packs,10,0,0.0,10
55780,14444,Kits,3,1,0.3333333333333333,2
55781,14444,Stuff Packs,18,0,0.0,18
55782,14445,Expansion Packs,16,0,0.0,16
55783,14445,Game Packs,12,0,0.0,12
55784,14445,Kits,33,0,0.0,33
55785,14445,Stuff Packs,20,0,0.0,20
55786,14446,Expansion Packs,15,0,0.0,15
55787,14446,Game Packs,10,0,0.0,10
55788,14446,Kits,12,0,0.0,12
55789,14446,Stuff Packs,14,0,0.0,14
55790,14447,Expansion Packs,2,1,0.5,1
55791,14447,Game Packs,1,0,0.0,1
55792,14447,Kits,1,0,0.0,1
55793,14447,Stuff Packs,1,0,0.0,1
55794,14448,Expansion Packs,16,0,0.0,16
55795,14448,Game Packs,12,0,0.0,12
55796,14448,Kits,33,0,0.0,33
55797,14448,Stuff Packs,20,0,0.0,20
55798,14449,Expansion Packs,15,0,0.0,15
55799,14449,Game Packs,3,0,0.0,3
55800,14449,Kits,4,0,0.0,4
55801,14449,Stuff Packs,7,2,0.2857142857142857,5
55802,14450,Expansion Packs,13,0,0.0,13
55803,14450,Game Packs,11,0,0.0,11
55804,14450,Kits,2,0,0.0,2
55805,14450,Stuff Packs,18,0,0.0,18
55806,14451,Expansion Packs,3,0,0.0,3
55807,14451,Game Packs,2,1,0.5,1
55808,14451,Kits,2,2,1.0,0
55809,14451,Stuff Packs,7,4,0.5714285714285714,3
55810,14452,Expansion Packs,13,0,0.0,13
55811,14452,Game Packs,7,0,0.0,7
55812,14452,Kits,6,1,0.16666666666666666,5
55813,14452,Stuff Packs,9,0,0.0,9
55814,14453,Expansion Packs,16,0,0.0,16
55815,14453,Game Packs,12,0,0.0,12
55816,14453,Kits,33,0,0.0,33
55817,14453,Stuff Packs,20,0,0.0,20
55818,14454,Expansion Packs,16,0,0.0,16
55819,14454,Game Packs,12,0,0.0,12
55820,14454,Kits,33,0,0.0,33
55821,14454,Stuff Packs,20,0,0.0,20
55822,14455,Expansion Packs,13,0,0.0,13
55823,14455,Game Packs,9,0,0.0,9
55824,14455,Kits,6,0,0.0,6
55825,14455,Stuff Packs,17,0,0.0,17
55826,14456,Expansion Packs,16,0,0.0,16
55827,14456,Game Packs,12,0,0.0,12
55828,14456,Kits,24,0,0.0,24
55829,14456,Stuff Packs,20,0,0.0,20
55830,14457,Expansion Packs,4,0,0.0,4
55831,14457,Game Packs,4,0,0.0,4
55832,14457,Kits,2,0,0.0,2
55833,14457,Stuff Packs,4,0,0.0,4
55834,14458,Expansion Packs,10,1,0.1,9
55835,14458,Game Packs,5,0,0.0,5
55836,14458,Kits,3,0,0.0,3
55837,14458,Stuff Packs,10,5,0.5,5
55838,14459,Expansion Packs,11,1,0.09090909090909091,10
55839,14459,Game Packs,4,1,0.25,3
55840,14459,Stuff Packs,2,1,0.5,1
55841,14460,Expansion Packs,16,0,0.0,16
55842,14460,Game Packs,12,0,0.0,12
55843,14460,Kits,33,2,0.06060606060606061,31
55844,14460,Stuff Packs,20,0,0.0,20
55845,14461,Expansion Packs,16,0,0.0,16
55846,14461,Game Packs,12,0,0.0,12
55847,14461,Kits,33,0,0.0,33
55848,14461,Stuff Packs,20,0,0.0,20
55849,14462,Expansion Packs,16,0,0.0,16
55850,14462,Game Packs,11,0,0.0,11
55851,14462,Kits,14,1,0.07142857142857142,13
55852,14462,Stuff Packs,19,0,0.0,19
55853,14463,Expansion Packs,8,0,0.0,8
55854,14463,Game Packs,3,0,0.0,3
55855,14463,Kits,1,1,1.0,0
55856,14463,Stuff Packs,6,1,0.16666666666666666,5
55857,14464,Expansion Packs,16,0,0.0,16
55858,14464,Game Packs,11,0,0.0,11
55859,14464,Kits,27,0,0.0,27
55860,14464,Stuff Packs,20,0,0.0,20
55861,14465,Expansion Packs,13,0,0.0,13
55862,14465,Game Packs,11,0,0.0,11
55863,14465,Kits,14,1,0.07142857142857142,13
55864,14465,Stuff Packs,17,1,0.058823529411764705,16
55865,14466,Expansion Packs,12,0,0.0,12
55866,14466,Game Packs,2,0,0.0,2
55867,14466,Kits,1,1,1.0,0
55868,14466,Stuff Packs,3,0,0.0,3
55869,14467,Expansion Packs,8,0,0.0,8
55870,14467,Game Packs,3,0,0.0,3
55871,14467,Stuff Packs,6,0,0.0,6
55872,14468,Expansion Packs,6,0,0.0,6
55873,14468,Game Packs,2,1,0.5,1
55874,14468,Kits,3,2,0.6666666666666666,1
55875,14468,Stuff Packs,4,3,0.75,1
55876,14469,Expansion Packs,6,0,0.0,6
55877,14469,Game Packs,4,0,0.0,4
55878,14469,Kits,2,0,0.0,2
55879,14469,Stuff Packs,3,0,0.0,3
55880,14470,Expansion Packs,10,0,0.0,10
55881,14470,Game Packs,8,0,0.0,8
55882,14470,Stuff Packs,7,0,0.0,7
55883,14471,Expansion Packs,7,0,0.0,7
55884,14471,Game Packs,3,0,0.0,3
55885,14471,Kits,8,0,0.0,8
55886,14471,Stuff Packs,5,0,0.0,5
55887,14472,Expansion Packs,7,0,0.0,7
55888,14472,Game Packs,3,0,0.0,3
55889,14472,Kits,2,2,1.0,0
55890,14472,Stuff Packs,5,3,0.6,2
55891,14473,Expansion Packs,7,0,0.0,7
55892,14473,Game Packs,4,0,0.0,4
55893,14473,Kits,3,0,0.0,3
55894,14473,Stuff Packs,4,0,0.0,4
55895,14474,Expansion Packs,1,0,0.0,1
55896,14474,Game Packs,1,0,0.0,1
55897,14474,Stuff Packs,4,0,0.0,4
55898,14475,Expansion Packs,12,0,0.0,12
55899,14475,Game Packs,8,0,0.0,8
55900,14475,Kits,1,1,1.0,0
55901,14475,Stuff Packs,11,1,0.09090909090909091,10
55902,14476,Expansion Packs,16,0,0.0,16
55903,14476,Game Packs,11,0,0.0,11
55904,14476,Kits,19,1,0.05263157894736842,18
55905,14476,Stuff Packs,18,0,0.0,18
55906,14477,Expansion Packs,11,0,0.0,11
55907,14477,Game Packs,8,0,0.0,8
55908,14477,Kits,1,0,0.0,1
55909,14477,Stuff Packs,8,1,0.125,7
55910,14478,Expansion Packs,12,0,0.0,12
55911,14478,Game Packs,2,0,0.0,2
55912,14478,Stuff Packs,1,0,0.0,1
55913,14479,Expansion Packs,14,0,0.0,14
55914,14479,Game Packs,4,1,0.25,3
55915,14479,Kits,4,2,0.5,2
55916,14479,Stuff Packs,9,3,0.3333333333333333,6
55917,14480,Expansion Packs,12,0,0.0,12
55918,14480,Game Packs,3,0,0.0,3
55919,14480,Kits,4,0,0.0,4
55920,14480,Stuff Packs,8,3,0.375,5
55921,14481,Expansion Packs,4,1,0.25,3
55922,14481,Stuff Packs,2,1,0.5,1
55923,14482,Expansion Packs,13,0,0.0,13
55924,14482,Game Packs,9,1,0.1111111111111111,8
55925,14482,Kits,17,0,0.0,17
55926,14482,Stuff Packs,16,2,0.125,14
55927,14483,Expansion Packs,14,0,0.0,14
55928,14483,Game Packs,5,0,0.0,5
55929,14483,Kits,12,1,0.08333333333333333,11
55930,14483,Stuff Packs,13,0,0.0,13
55931,14484,Expansion Packs,11,0,0.0,11
55932,14484,Game Packs,7,0,0.0,7
55933,14484,Kits,2,0,0.0,2
55934,14484,Stuff Packs,5,2,0.4,3
55935,14485,Expansion Packs,7,0,0.0,7
55936,14485,Stuff Packs,3,2,0.6666666666666666,1
55937,14486,Expansion Packs,10,0,0.0,10
55938,14486,Game Packs,6,0,0.0,6
55939,14486,Kits,4,1,0.25,3
55940,14486,Stuff Packs,12,2,0.16666666666666666,10
55941,14487,Expansion Packs,15,0,0.0,15
55942,14487,Game Packs,6,0,0.0,6
55943,14487,Kits,3,1,0.3333333333333333,2
55944,14487,Stuff Packs,17,1,0.058823529411764705,16
55945,14488,Expansion Packs,11,0,0.0,11
55946,14488,Game Packs,6,0,0.0,6
55947,14488,Kits,11,1,0.09090909090909091,10
55948,14488,Stuff Packs,9,0,0.0,9
55949,14489,Expansion Packs,8,0,0.0,8
55950,14489,Game Packs,4,1,0.25,3
55951,14489,Kits,2,1,0.5,1
55952,14489,Stuff Packs,3,3,1.0,0
55953,14490,Expansion Packs,15,0,0.0,15
55954,14490,Game Packs,7,0,0.0,7
55955,14490,Kits,14,0,0.0,14
55956,14490,Stuff Packs,18,0,0.0,18
55957,14491,Expansion Packs,9,0,0.0,9
55958,14491,Game Packs,7,0,0.0,7
55959,14491,Stuff Packs,8,0,0.0,8
55960,14492,Expansion Packs,7,0,0.0,7
55961,14492,Game Packs,7,0,0.0,7
55962,14492,Stuff Packs,8,0,0.0,8
55963,14493,Expansion Packs,15,0,0.0,15
55964,14493,Game Packs,9,0,0.0,9
55965,14493,Kits,12,0,0.0,12
55966,14493,Stuff Packs,19,1,0.05263157894736842,18
55967,14494,Expansion Packs,15,0,0.0,15
55968,14494,Game Packs,12,0,0.0,12
55969,14494,Kits,26,1,0.038461538461538464,25
55970,14494,Stuff Packs,20,0,0.0,20
55971,14495,Expansion Packs,6,0,0.0,6
55972,14495,Game Packs,2,0,0.0,2
55973,14495,Kits,7,0,0.0,7
55974,14495,Stuff Packs,6,0,0.0,6
55975,14496,Expansion Packs,11,0,0.0,11
55976,14496,Game Packs,7,0,0.0,7
55977,14496,Kits,9,1,0.1111111111111111,8
55978,14496,Stuff Packs,8,0,0.0,8
55979,14497,Expansion Packs,16,0,0.0,16
55980,14497,Game Packs,11,0,0.0,11
55981,14497,Kits,18,1,0.05555555555555555,17
55982,14497,Stuff Packs,20,0,0.0,20
55983,14498,Expansion Packs,3,0,0.0,3
55984,14498,Game Packs,2,0,0.0,2
55985,14498,Kits,10,0,0.0,10
55986,14498,Stuff Packs,7,3,0.42857142857142855,4
55987,14499,Expansion Packs,16,0,0.0,16
55988,14499,Game Packs,12,0,0.0,12
55989,14499,Kits,33,0,0.0,33
55990,14499,Stuff Packs,20,0,0.0,20
55991,14500,Expansion Packs,16,0,0.0,16
55992,14500,Game Packs,11,0,0.0,11
55993,14500,Kits,7,1,0.14285714285714285,6
55994,14500,Stuff Packs,18,0,0.0,18
55995,14501,Expansion Packs,16,0,0.0,16
55996,14501,Game Packs,12,0,0.0,12
55997,14501,Kits,31,1,0.03225806451612903,30
55998,14501,Stuff Packs,20,0,0.0,20
55999,14502,Expansion Packs,9,0,0.0,9
56000,14502,Game Packs,7,0,0.0,7
56001,14502,Stuff Packs,17,0,0.0,17
56002,14503,Expansion Packs,15,0,0.0,15
56003,14503,Game Packs,6,0,0.0,6
56004,14503,Kits,4,1,0.25,3
56005,14503,Stuff Packs,9,0,0.0,9
56006,14504,Expansion Packs,4,0,0.0,4
56007,14504,Game Packs,2,1,0.5,1
56008,14504,Kits,1,1,1.0,0
56009,14504,Stuff Packs,4,2,0.5,2
56010,14505,Expansion Packs,16,0,0.0,16
56011,14505,Game Packs,12,0,0.0,12
56012,14505,Kits,2,2,1.0,0
56013,14505,Stuff Packs,18,0,0.0,18
56014,14506,Expansion Packs,13,1,0.07692307692307693,12
56015,14506,Game Packs,8,1,0.125,7
56016,14506,Kits,3,3,1.0,0
56017,14506,Stuff Packs,13,1,0.07692307692307693,12
56018,14507,Expansion Packs,13,0,0.0,13
56019,14507,Game Packs,8,0,0.0,8
56020,14507,Kits,3,0,0.0,3
56021,14507,Stuff Packs,11,0,0.0,11
56022,14508,Expansion Packs,6,0,0.0,6
56023,14508,Game Packs,6,1,0.16666666666666666,5
56024,14508,Kits,5,2,0.4,3
56025,14508,Stuff Packs,8,3,0.375,5
56026,14509,Expansion Packs,15,0,0.0,15
56027,14509,Game Packs,6,0,0.0,6
56028,14509,Kits,21,0,0.0,21
56029,14509,Stuff Packs,14,0,0.0,14
56030,14510,Expansion Packs,6,0,0.0,6
56031,14510,Game Packs,4,0,0.0,4
56032,14510,Kits,1,0,0.0,1
56033,14511,Expansion Packs,11,0,0.0,11
56034,14511,Game Packs,4,0,0.0,4
56035,14511,Stuff Packs,4,1,0.25,3
56036,14512,Expansion Packs,16,0,0.0,16
56037,14512,Game Packs,12,0,0.0,12
56038,14512,Kits,22,1,0.045454545454545456,21
56039,14512,Stuff Packs,18,0,0.0,18
56040,14513,Expansion Packs,16,0,0.0,16
56041,14513,Game Packs,12,0,0.0,12
56042,14513,Kits,24,0,0.0,24
56043,14513,Stuff Packs,20,0,0.0,20
56044,14514,Expansion Packs,1,0,0.0,1
56045,14514,Kits,2,1,0.5,1
56046,14514,Stuff Packs,1,1,1.0,0
56047,14515,Expansion Packs,14,0,0.0,14
56048,14515,Game Packs,8,0,0.0,8
56049,14515,Kits,5,0,0.0,5
56050,14515,Stuff Packs,7,2,0.2857142857142857,5
56051,14516,Expansion Packs,7,0,0.0,7
56052,14516,Game Packs,1,0,0.0,1
56053,14516,Stuff Packs,4,2,0.5,2
56054,14517,Expansion Packs,16,0,0.0,16
56055,14517,Game Packs,7,0,0.0,7
56056,14517,Kits,13,0,0.0,13
56057,14517,Stuff Packs,7,0,0.0,7
56058,14518,Expansion Packs,13,0,0.0,13
56059,14518,Game Packs,10,0,0.0,10
56060,14518,Kits,5,2,0.4,3
56061,14518,Stuff Packs,10,3,0.3,7
56062,14519,Expansion Packs,14,0,0.0,14
56063,14519,Game Packs,9,0,0.0,9
56064,14519,Kits,8,0,0.0,8
56065,14519,Stuff Packs,10,3,0.3,7
56066,14520,Expansion Packs,9,0,0.0,9
56067,14520,Game Packs,6,0,0.0,6
56068,14520,Kits,1,0,0.0,1
56069,14520,Stuff Packs,9,0,0.0,9
56070,14521,Expansion Packs,16,1,0.0625,15
56071,14521,Game Packs,10,0,0.0,10
56072,14521,Kits,14,0,0.0,14
56073,14521,Stuff Packs,9,2,0.2222222222222222,7
56074,14522,Expansion Packs,6,0,0.0,6
56075,14522,Game Packs,4,0,0.0,4
56076,14522,Kits,3,0,0.0,3
56077,14522,Stuff Packs,11,0,0.0,11
56078,14523,Expansion Packs,16,0,0.0,16
56079,14523,Game Packs,12,0,0.0,12
56080,14523,Kits,33,1,0.030303030303030304,32
56081,14523,Stuff Packs,20,0,0.0,20
56082,14524,Expansion Packs,14,0,0.0,14
56083,14524,Game Packs,11,0,0.0,11
56084,14524,Kits,13,2,0.15384615384615385,11
56085,14524,Stuff Packs,13,0,0.0,13
56086,14525,Expansion Packs,8,0,0.0,8
56087,14525,Game Packs,7,1,0.14285714285714285,6
56088,14525,Kits,1,1,1.0,0
56089,14525,Stuff Packs,9,1,0.1111111111111111,8
56090,14526,Expansion Packs,12,0,0.0,12
56091,14526,Game Packs,12,0,0.0,12
56092,14526,Kits,2,2,1.0,0
56093,14526,Stuff Packs,13,0,0.0,13
56094,14527,Expansion Packs,12,0,0.0,12
56095,14527,Game Packs,7,1,0.14285714285714285,6
56096,14527,Kits,6,2,0.3333333333333333,4
56097,14527,Stuff Packs,13,2,0.15384615384615385,11
56098,14528,Expansion Packs,16,0,0.0,16
56099,14528,Game Packs,12,0,0.0,12
56100,14528,Kits,33,0,0.0,33
56101,14528,Stuff Packs,20,0,0.0,20
56102,14529,Expansion Packs,15,0,0.0,15
56103,14529,Game Packs,3,1,0.3333333333333333,2
56104,14529,Kits,4,1,0.25,3
56105,14529,Stuff Packs,8,2,0.25,6
56106,14530,Expansion Packs,13,0,0.0,13
56107,14530,Game Packs,6,0,0.0,6
56108,14530,Stuff Packs,10,0,0.0,10
56109,14531,Expansion Packs,12,0,0.0,12
56110,14531,Game Packs,6,0,0.0,6
56111,14531,Kits,2,0,0.0,2
56112,14531,Stuff Packs,13,0,0.0,13
56113,14532,Expansion Packs,13,0,0.0,13
56114,14532,Game Packs,4,0,0.0,4
56115,14532,Kits,12,0,0.0,12
56116,14532,Stuff Packs,5,0,0.0,5
56117,14533,Expansion Packs,11,0,0.0,11
56118,14533,Game Packs,9,0,0.0,9
56119,14533,Kits,8,2,0.25,6
56120,14533,Stuff Packs,10,3,0.3,7
56121,14534,Expansion Packs,14,0,0.0,14
56122,14534,Game Packs,11,0,0.0,11
56123,14534,Kits,15,11,0.7333333333333333,4
56124,14534,Stuff Packs,18,0,0.0,18
56125,14535,Expansion Packs,11,0,0.0,11
56126,14535,Game Packs,7,0,0.0,7
56127,14535,Kits,2,1,0.5,1
56128,14535,Stuff Packs,11,4,0.36363636363636365,7
56129,14536,Expansion Packs,10,1,0.1,9
56130,14536,Game Packs,5,1,0.2,4
56131,14536,Kits,7,1,0.14285714285714285,6
56132,14536,Stuff Packs,10,3,0.3,7
56133,14537,Expansion Packs,16,0,0.0,16
56134,14537,Game Packs,12,0,0.0,12
56135,14537,Kits,33,1,0.030303030303030304,32
56136,14537,Stuff Packs,20,0,0.0,20
56137,14538,Expansion Packs,16,0,0.0,16
56138,14538,Game Packs,10,0,0.0,10
56139,14538,Kits,2,0,0.0,2
56140,14538,Stuff Packs,13,0,0.0,13
56141,14539,Expansion Packs,2,0,0.0,2
56142,14539,Game Packs,1,0,0.0,1
56143,14539,Stuff Packs,4,1,0.25,3
56144,14540,Expansion Packs,14,0,0.0,14
56145,14540,Game Packs,7,0,0.0,7
56146,14540,Kits,2,0,0.0,2
56147,14540,Stuff Packs,9,0,0.0,9
56148,14541,Expansion Packs,16,0,0.0,16
56149,14541,Game Packs,6,0,0.0,6
56150,14541,Kits,20,1,0.05,19
56151,14541,Stuff Packs,8,1,0.125,7
56152,14542,Expansion Packs,10,0,0.0,10
56153,14542,Game Packs,5,0,0.0,5
56154,14542,Kits,3,1,0.3333333333333333,2
56155,14542,Stuff Packs,9,0,0.0,9
56156,14543,Expansion Packs,16,0,0.0,16
56157,14543,Game Packs,12,0,0.0,12
56158,14543,Kits,33,1,0.030303030303030304,32
56159,14543,Stuff Packs,20,1,0.05,19
56160,14544,Expansion Packs,11,0,0.0,11
56161,14544,Game Packs,8,0,0.0,8
56162,14544,Kits,9,1,0.1111111111111111,8
56163,14544,Stuff Packs,12,0,0.0,12
56164,14545,Game Packs,1,0,0.0,1
56165,14545,Kits,3,0,0.0,3
56166,14545,Stuff Packs,3,0,0.0,3
56167,14546,Expansion Packs,11,0,0.0,11
56168,14546,Game Packs,5,0,0.0,5
56169,14546,Stuff Packs,2,0,0.0,2
56170,14547,Expansion Packs,15,0,0.0,15
56171,14547,Game Packs,7,0,0.0,7
56172,14547,Kits,5,0,0.0,5
56173,14547,Stuff Packs,7,0,0.0,7
56174,14548,Expansion Packs,16,0,0.0,16
56175,14548,Game Packs,12,0,0.0,12
56176,14548,Kits,33,0,0.0,33
56177,14548,Stuff Packs,20,0,0.0,20
56178,14549,Expansion Packs,8,0,0.0,8
56179,14549,Game Packs,3,0,0.0,3
56180,14549,Kits,9,1,0.1111111111111111,8
56181,14549,Stuff Packs,10,2,0.2,8
56182,14550,Expansion Packs,16,0,0.0,16
56183,14550,Game Packs,12,0,0.0,12
56184,14550,Kits,33,0,0.0,33
56185,14550,Stuff Packs,20,0,0.0,20
56186,14551,Expansion Packs,3,0,0.0,3
56187,14551,Game Packs,2,0,0.0,2
56188,14552,Expansion Packs,12,0,0.0,12
56189,14552,Game Packs,7,0,0.0,7
56190,14552,Kits,1,1,1.0,0
56191,14552,Stuff Packs,8,1,0.125,7
56192,14553,Expansion Packs,16,2,0.125,14
56193,14553,Game Packs,12,1,0.08333333333333333,11
56194,14553,Kits,4,3,0.75,1
56195,14553,Stuff Packs,17,6,0.35294117647058826,11
56196,14554,Expansion Packs,12,0,0.0,12
56197,14554,Game Packs,8,0,0.0,8
56198,14554,Kits,4,0,0.0,4
56199,14554,Stuff Packs,10,0,0.0,10
56200,14555,Expansion Packs,11,0,0.0,11
56201,14555,Game Packs,4,0,0.0,4
56202,14555,Stuff Packs,1,0,0.0,1
56203,14556,Expansion Packs,3,0,0.0,3
56204,14556,Game Packs,1,0,0.0,1
56205,14556,Kits,3,0,0.0,3
56206,14556,Stuff Packs,4,1,0.25,3
56207,14557,Expansion Packs,12,0,0.0,12
56208,14557,Game Packs,8,0,0.0,8
56209,14557,Stuff Packs,13,0,0.0,13
56210,14558,Expansion Packs,12,0,0.0,12
56211,14558,Game Packs,10,0,0.0,10
56212,14558,Kits,3,2,0.6666666666666666,1
56213,14558,Stuff Packs,19,0,0.0,19
56214,14559,Expansion Packs,6,0,0.0,6
56215,14559,Game Packs,3,0,0.0,3
56216,14559,Kits,2,2,1.0,0
56217,14559,Stuff Packs,3,1,0.3333333333333333,2
56218,14560,Expansion Packs,3,0,0.0,3
56219,14560,Game Packs,2,0,0.0,2
56220,14560,Stuff Packs,4,0,0.0,4
56221,14561,Expansion Packs,2,0,0.0,2
56222,14561,Kits,2,2,1.0,0
56223,14561,Stuff Packs,3,3,1.0,0
56224,14562,Expansion Packs,16,0,0.0,16
56225,14562,Game Packs,12,0,0.0,12
56226,14562,Kits,33,0,0.0,33
56227,14562,Stuff Packs,20,0,0.0,20
56228,14563,Expansion Packs,16,0,0.0,16
56229,14563,Game Packs,11,0,0.0,11
56230,14563,Kits,8,0,0.0,8
56231,14563,Stuff Packs,7,0,0.0,7
56232,14564,Expansion Packs,7,0,0.0,7
56233,14564,Game Packs,2,0,0.0,2
56234,14564,Stuff Packs,4,0,0.0,4
56235,14565,Expansion Packs,16,0,0.0,16
56236,14565,Game Packs,11,0,0.0,11
56237,14565,Kits,29,0,0.0,29
56238,14565,Stuff Packs,20,0,0.0,20
56239,14566,Expansion Packs,4,0,0.0,4
56240,14566,Game Packs,5,0,0.0,5
56241,14566,Stuff Packs,5,1,0.2,4
56242,14567,Expansion Packs,14,0,0.0,14
56243,14567,Game Packs,7,0,0.0,7
56244,14567,Kits,1,1,1.0,0
56245,14567,Stuff Packs,7,1,0.14285714285714285,6
56246,14568,Expansion Packs,16,0,0.0,16
56247,14568,Game Packs,11,1,0.09090909090909091,10
56248,14568,Kits,4,0,0.0,4
56249,14568,Stuff Packs,13,1,0.07692307692307693,12
56250,14569,Expansion Packs,8,0,0.0,8
56251,14569,Game Packs,6,1,0.16666666666666666,5
56252,14569,Kits,3,3,1.0,0
56253,14569,Stuff Packs,10,4,0.4,6
56254,14570,Expansion Packs,16,0,0.0,16
56255,14570,Game Packs,11,0,0.0,11
56256,14570,Kits,25,1,0.04,24
56257,14570,Stuff Packs,20,1,0.05,19
56258,14571,Expansion Packs,10,0,0.0,10
56259,14571,Game Packs,7,0,0.0,7
56260,14571,Stuff Packs,11,0,0.0,11
56261,14572,Expansion Packs,16,0,0.0,16
56262,14572,Game Packs,12,0,0.0,12
56263,14572,Kits,7,3,0.42857142857142855,4
56264,14572,Stuff Packs,20,0,0.0,20
56265,14573,Expansion Packs,16,0,0.0,16
56266,14573,Game Packs,12,0,0.0,12
56267,14573,Kits,33,1,0.030303030303030304,32
56268,14573,Stuff Packs,20,0,0.0,20
56269,14574,Expansion Packs,16,0,0.0,16
56270,14574,Game Packs,12,0,0.0,12
56271,14574,Kits,32,2,0.0625,30
56272,14574,Stuff Packs,20,0,0.0,20
56273,14575,Expansion Packs,13,0,0.0,13
56274,14575,Game Packs,10,0,0.0,10
56275,14575,Kits,2,0,0.0,2
56276,14575,Stuff Packs,18,0,0.0,18
56277,14576,Expansion Packs,13,0,0.0,13
56278,14576,Game Packs,4,0,0.0,4
56279,14576,Kits,1,1,1.0,0
56280,14576,Stuff Packs,2,0,0.0,2
56281,14577,Expansion Packs,16,5,0.3125,11
56282,14577,Game Packs,12,3,0.25,9
56283,14577,Kits,33,24,0.7272727272727273,9
56284,14577,Stuff Packs,20,4,0.2,16
56285,14578,Expansion Packs,14,0,0.0,14
56286,14578,Game Packs,10,0,0.0,10
56287,14578,Kits,1,1,1.0,0
56288,14578,Stuff Packs,16,1,0.0625,15
56289,14579,Expansion Packs,1,0,0.0,1
56290,14579,Game Packs,2,0,0.0,2
56291,14579,Stuff Packs,1,0,0.0,1
56292,14580,Expansion Packs,4,0,0.0,4
56293,14580,Kits,2,2,1.0,0
56294,14580,Stuff Packs,4,2,0.5,2
56295,14581,Expansion Packs,12,0,0.0,12
56296,14581,Game Packs,4,0,0.0,4
56297,14581,Kits,9,1,0.1111111111111111,8
56298,14581,Stuff Packs,7,2,0.2857142857142857,5
56299,14582,Expansion Packs,13,0,0.0,13
56300,14582,Game Packs,9,0,0.0,9
56301,14582,Kits,9,0,0.0,9
56302,14582,Stuff Packs,12,1,0.08333333333333333,11
56303,14583,Expansion Packs,3,0,0.0,3
56304,14583,Game Packs,2,0,0.0,2
56305,14583,Stuff Packs,2,0,0.0,2
56306,14584,Kits,1,1,1.0,0
56307,14584,Stuff Packs,3,3,1.0,0
56308,14585,Expansion Packs,15,0,0.0,15
56309,14585,Game Packs,10,0,0.0,10
56310,14585,Kits,7,3,0.42857142857142855,4
56311,14585,Stuff Packs,13,4,0.3076923076923077,9
56312,14586,Expansion Packs,16,0,0.0,16
56313,14586,Game Packs,12,0,0.0,12
56314,14586,Kits,32,1,0.03125,31
56315,14586,Stuff Packs,20,0,0.0,20
56316,14587,Expansion Packs,7,0,0.0,7
56317,14587,Game Packs,5,0,0.0,5
56318,14587,Kits,3,1,0.3333333333333333,2
56319,14587,Stuff Packs,11,4,0.36363636363636365,7
56320,14588,Expansion Packs,16,0,0.0,16
56321,14588,Game Packs,12,0,0.0,12
56322,14588,Kits,15,0,0.0,15
56323,14588,Stuff Packs,19,0,0.0,19
56324,14589,Expansion Packs,16,0,0.0,16
56325,14589,Game Packs,12,0,0.0,12
56326,14589,Kits,22,0,0.0,22
56327,14589,Stuff Packs,20,0,0.0,20
56328,14590,Expansion Packs,11,0,0.0,11
56329,14590,Game Packs,4,0,0.0,4
56330,14590,Kits,4,2,0.5,2
56331,14590,Stuff Packs,6,2,0.3333333333333333,4
56332,14591,Expansion Packs,16,0,0.0,16
56333,14591,Game Packs,12,0,0.0,12
56334,14591,Kits,32,0,0.0,32
56335,14591,Stuff Packs,20,0,0.0,20
56336,14592,Expansion Packs,11,0,0.0,11
56337,14592,Game Packs,5,0,0.0,5
56338,14592,Kits,1,1,1.0,0
56339,14592,Stuff Packs,12,2,0.16666666666666666,10
56340,14593,Expansion Packs,10,0,0.0,10
56341,14593,Game Packs,2,0,0.0,2
56342,14594,Expansion Packs,15,0,0.0,15
56343,14594,Game Packs,11,0,0.0,11
56344,14594,Kits,13,0,0.0,13
56345,14594,Stuff Packs,14,0,0.0,14
56346,14595,Expansion Packs,8,0,0.0,8
56347,14595,Game Packs,7,0,0.0,7
56348,14595,Kits,3,0,0.0,3
56349,14595,Stuff Packs,9,1,0.1111111111111111,8
56350,14596,Expansion Packs,16,0,0.0,16
56351,14596,Game Packs,12,0,0.0,12
56352,14596,Kits,16,0,0.0,16
56353,14596,Stuff Packs,20,0,0.0,20
56354,14597,Expansion Packs,16,1,0.0625,15
56355,14597,Game Packs,10,0,0.0,10
56356,14597,Kits,6,1,0.16666666666666666,5
56357,14597,Stuff Packs,14,0,0.0,14
56358,14598,Expansion Packs,14,0,0.0,14
56359,14598,Game Packs,6,0,0.0,6
56360,14598,Kits,3,1,0.3333333333333333,2
56361,14598,Stuff Packs,8,3,0.375,5
56362,14599,Expansion Packs,10,0,0.0,10
56363,14599,Game Packs,6,0,0.0,6
56364,14599,Kits,4,0,0.0,4
56365,14599,Stuff Packs,9,0,0.0,9
56366,14600,Expansion Packs,16,0,0.0,16
56367,14600,Game Packs,12,0,0.0,12
56368,14600,Kits,33,0,0.0,33
56369,14600,Stuff Packs,20,1,0.05,19
56370,14601,Expansion Packs,16,0,0.0,16
56371,14601,Game Packs,12,0,0.0,12
56372,14601,Kits,13,0,0.0,13
56373,14601,Stuff Packs,19,0,0.0,19
56374,14602,Expansion Packs,16,0,0.0,16
56375,14602,Game Packs,12,0,0.0,12
56376,14602,Kits,33,1,0.030303030303030304,32
56377,14602,Stuff Packs,20,0,0.0,20
56378,14603,Expansion Packs,10,0,0.0,10
56379,14603,Game Packs,7,1,0.14285714285714285,6
56380,14603,Kits,5,0,0.0,5
56381,14603,Stuff Packs,11,1,0.09090909090909091,10
56382,14604,Expansion Packs,7,0,0.0,7
56383,14604,Game Packs,3,0,0.0,3
56384,14604,Kits,5,1,0.2,4
56385,14604,Stuff Packs,2,2,1.0,0
56386,14605,Expansion Packs,3,0,0.0,3
56387,14605,Game Packs,2,0,0.0,2
56388,14605,Kits,1,1,1.0,0
56389,14605,Stuff Packs,4,3,0.75,1
56390,14606,Expansion Packs,5,0,0.0,5
56391,14606,Game Packs,3,0,0.0,3
56392,14606,Kits,8,2,0.25,6
56393,14606,Stuff Packs,5,0,0.0,5
56394,14607,Expansion Packs,4,0,0.0,4
56395,14607,Game Packs,3,0,0.0,3
56396,14607,Kits,1,0,0.0,1
56397,14607,Stuff Packs,4,0,0.0,4
56398,14608,Expansion Packs,16,0,0.0,16
56399,14608,Game Packs,12,0,0.0,12
56400,14608,Kits,23,1,0.043478260869565216,22
56401,14608,Stuff Packs,20,0,0.0,20
56402,14609,Expansion Packs,16,0,0.0,16
56403,14609,Game Packs,12,0,0.0,12
56404,14609,Kits,25,1,0.04,24
56405,14609,Stuff Packs,19,0,0.0,19
56406,14610,Expansion Packs,11,0,0.0,11
56407,14610,Game Packs,6,0,0.0,6
56408,14610,Kits,4,1,0.25,3
56409,14610,Stuff Packs,6,1,0.16666666666666666,5
56410,14611,Expansion Packs,12,1,0.08333333333333333,11
56411,14611,Game Packs,6,0,0.0,6
56412,14611,Stuff Packs,2,0,0.0,2
56413,14612,Expansion Packs,11,0,0.0,11
56414,14612,Game Packs,9,0,0.0,9
56415,14612,Kits,2,2,1.0,0
56416,14612,Stuff Packs,18,1,0.05555555555555555,17
56417,14613,Expansion Packs,7,0,0.0,7
56418,14613,Game Packs,6,0,0.0,6
56419,14613,Kits,1,1,1.0,0
56420,14613,Stuff Packs,7,2,0.2857142857142857,5
56421,14614,Expansion Packs,16,0,0.0,16
56422,14614,Game Packs,12,0,0.0,12
56423,14614,Kits,19,0,0.0,19
56424,14614,Stuff Packs,20,0,0.0,20
56425,14615,Expansion Packs,4,0,0.0,4
56426,14615,Stuff Packs,2,1,0.5,1
56427,14616,Expansion Packs,15,0,0.0,15
56428,14616,Game Packs,9,2,0.2222222222222222,7
56429,14616,Kits,6,2,0.3333333333333333,4
56430,14616,Stuff Packs,12,1,0.08333333333333333,11
56431,14617,Expansion Packs,16,0,0.0,16
56432,14617,Game Packs,12,0,0.0,12
56433,14617,Kits,18,0,0.0,18
56434,14617,Stuff Packs,20,0,0.0,20
56435,14618,Expansion Packs,16,0,0.0,16
56436,14618,Game Packs,12,1,0.08333333333333333,11
56437,14618,Kits,33,2,0.06060606060606061,31
56438,14618,Stuff Packs,20,0,0.0,20
56439,14619,Expansion Packs,8,2,0.25,6
56440,14619,Game Packs,6,0,0.0,6
56441,14619,Kits,16,0,0.0,16
56442,14619,Stuff Packs,8,0,0.0,8
56443,14620,Expansion Packs,12,0,0.0,12
56444,14620,Game Packs,6,0,0.0,6
56445,14620,Stuff Packs,6,0,0.0,6
56446,14621,Expansion Packs,3,0,0.0,3
56447,14621,Game Packs,2,1,0.5,1
56448,14621,Kits,1,0,0.0,1
56449,14621,Stuff Packs,5,2,0.4,3
56450,14622,Expansion Packs,8,0,0.0,8
56451,14622,Game Packs,7,0,0.0,7
56452,14622,Kits,2,2,1.0,0
56453,14622,Stuff Packs,12,0,0.0,12
56454,14623,Expansion Packs,13,0,0.0,13
56455,14623,Game Packs,4,0,0.0,4
56456,14623,Kits,30,2,0.06666666666666667,28
56457,14623,Stuff Packs,11,0,0.0,11
56458,14624,Expansion Packs,16,0,0.0,16
56459,14624,Game Packs,12,0,0.0,12
56460,14624,Kits,6,1,0.16666666666666666,5
56461,14624,Stuff Packs,20,0,0.0,20
56462,14625,Expansion Packs,10,0,0.0,10
56463,14625,Game Packs,8,0,0.0,8
56464,14625,Kits,7,1,0.14285714285714285,6
56465,14625,Stuff Packs,18,0,0.0,18
56466,14626,Expansion Packs,13,0,0.0,13
56467,14626,Game Packs,3,0,0.0,3
56468,14626,Kits,1,0,0.0,1
56469,14626,Stuff Packs,4,0,0.0,4
56470,14627,Expansion Packs,11,0,0.0,11
56471,14627,Game Packs,11,0,0.0,11
56472,14627,Kits,7,0,0.0,7
56473,14627,Stuff Packs,18,0,0.0,18
56474,14628,Expansion Packs,12,0,0.0,12
56475,14628,Game Packs,8,0,0.0,8
56476,14628,Stuff Packs,13,1,0.07692307692307693,12
56477,14629,Expansion Packs,15,0,0.0,15
56478,14629,Game Packs,12,0,0.0,12
56479,14629,Kits,33,0,0.0,33
56480,14629,Stuff Packs,20,0,0.0,20
56481,14630,Expansion Packs,14,0,0.0,14
56482,14630,Game Packs,6,0,0.0,6
56483,14630,Kits,2,2,1.0,0
56484,14630,Stuff Packs,4,3,0.75,1
56485,14631,Expansion Packs,16,0,0.0,16
56486,14631,Game Packs,11,0,0.0,11
56487,14631,Kits,17,1,0.058823529411764705,16
56488,14631,Stuff Packs,20,0,0.0,20
56489,14632,Expansion Packs,16,0,0.0,16
56490,14632,Game Packs,10,0,0.0,10
56491,14632,Kits,19,0,0.0,19
56492,14632,Stuff Packs,20,2,0.1,18
56493,14633,Expansion Packs,2,1,0.5,1
56494,14633,Kits,1,1,1.0,0
56495,14633,Stuff Packs,4,4,1.0,0
56496,14634,Expansion Packs,11,0,0.0,11
56497,14634,Game Packs,7,0,0.0,7
56498,14634,Stuff Packs,5,0,0.0,5
56499,14635,Expansion Packs,15,1,0.06666666666666667,14
56500,14635,Game Packs,10,0,0.0,10
56501,14635,Stuff Packs,5,0,0.0,5
56502,14636,Expansion Packs,14,0,0.0,14
56503,14636,Game Packs,10,0,0.0,10
56504,14636,Stuff Packs,9,0,0.0,9
56505,14637,Expansion Packs,7,0,0.0,7
56506,14637,Game Packs,5,0,0.0,5
56507,14637,Kits,1,1,1.0,0
56508,14637,Stuff Packs,4,0,0.0,4
56509,14638,Expansion Packs,16,0,0.0,16
56510,14638,Game Packs,7,0,0.0,7
56511,14639,Expansion Packs,9,0,0.0,9
56512,14639,Game Packs,7,0,0.0,7
56513,14639,Kits,26,0,0.0,26
56514,14639,Stuff Packs,10,0,0.0,10
56515,14640,Expansion Packs,11,0,0.0,11
56516,14640,Game Packs,5,0,0.0,5
56517,14641,Expansion Packs,8,0,0.0,8
56518,14641,Game Packs,8,0,0.0,8
56519,14641,Kits,1,1,1.0,0
56520,14641,Stuff Packs,16,0,0.0,16
56521,14642,Expansion Packs,5,0,0.0,5
56522,14642,Game Packs,4,0,0.0,4
56523,14642,Kits,3,2,0.6666666666666666,1
56524,14642,Stuff Packs,6,3,0.5,3
56525,14643,Expansion Packs,9,0,0.0,9
56526,14643,Stuff Packs,1,1,1.0,0
56527,14644,Expansion Packs,3,0,0.0,3
56528,14644,Kits,1,1,1.0,0
56529,14645,Expansion Packs,16,0,0.0,16
56530,14645,Game Packs,11,0,0.0,11
56531,14645,Kits,17,1,0.058823529411764705,16
56532,14645,Stuff Packs,20,0,0.0,20
56533,14646,Expansion Packs,16,0,0.0,16
56534,14646,Game Packs,12,0,0.0,12
56535,14646,Kits,7,0,0.0,7
56536,14646,Stuff Packs,20,0,0.0,20
56537,14647,Expansion Packs,16,0,0.0,16
56538,14647,Game Packs,12,0,0.0,12
56539,14647,Kits,33,0,0.0,33
56540,14647,Stuff Packs,20,0,0.0,20
56541,14648,Expansion Packs,16,0,0.0,16
56542,14648,Game Packs,8,0,0.0,8
56543,14648,Kits,3,0,0.0,3
56544,14648,Stuff Packs,4,0,0.0,4
56545,14649,Expansion Packs,15,0,0.0,15
56546,14649,Game Packs,9,0,0.0,9
56547,14649,Kits,3,2,0.6666666666666666,1
56548,14649,Stuff Packs,20,0,0.0,20
56549,14650,Expansion Packs,5,0,0.0,5
56550,14650,Game Packs,2,0,0.0,2
56551,14650,Stuff Packs,2,0,0.0,2
56552,14651,Expansion Packs,10,0,0.0,10
56553,14651,Game Packs,2,0,0.0,2
56554,14651,Kits,4,0,0.0,4
56555,14651,Stuff Packs,7,3,0.42857142857142855,4
56556,14652,Expansion Packs,16,0,0.0,16
56557,14652,Game Packs,12,0,0.0,12
56558,14652,Kits,14,2,0.14285714285714285,12
56559,14652,Stuff Packs,20,0,0.0,20
56560,14653,Expansion Packs,16,0,0.0,16
56561,14653,Game Packs,12,0,0.0,12
56562,14653,Kits,18,0,0.0,18
56563,14653,Stuff Packs,17,0,0.0,17
56564,14654,Expansion Packs,16,0,0.0,16
56565,14654,Game Packs,12,0,0.0,12
56566,14654,Kits,31,1,0.03225806451612903,30
56567,14654,Stuff Packs,20,0,0.0,20
56568,14655,Expansion Packs,8,0,0.0,8
56569,14655,Game Packs,1,0,0.0,1
56570,14655,Stuff Packs,5,1,0.2,4
56571,14656,Expansion Packs,16,0,0.0,16
56572,14656,Game Packs,11,0,0.0,11
56573,14656,Kits,10,0,0.0,10
56574,14656,Stuff Packs,17,0,0.0,17
56575,14657,Expansion Packs,16,0,0.0,16
56576,14657,Game Packs,12,0,0.0,12
56577,14657,Kits,33,0,0.0,33
56578,14657,Stuff Packs,20,0,0.0,20
56579,14658,Expansion Packs,14,0,0.0,14
56580,14658,Game Packs,3,1,0.3333333333333333,2
56581,14658,Kits,4,2,0.5,2
56582,14658,Stuff Packs,9,3,0.3333333333333333,6
56583,14659,Expansion Packs,11,0,0.0,11
56584,14659,Game Packs,3,0,0.0,3
56585,14659,Kits,4,1,0.25,3
56586,14659,Stuff Packs,5,3,0.6,2
56587,14660,Expansion Packs,16,0,0.0,16
56588,14660,Game Packs,12,0,0.0,12
56589,14660,Kits,24,0,0.0,24
56590,14660,Stuff Packs,20,0,0.0,20
56591,14661,Expansion Packs,16,0,0.0,16
56592,14661,Game Packs,12,0,0.0,12
56593,14661,Kits,33,0,0.0,33
56594,14661,Stuff Packs,20,0,0.0,20
56595,14662,Expansion Packs,16,0,0.0,16
56596,14662,Game Packs,11,0,0.0,11
56597,14662,Kits,30,1,0.03333333333333333,29
56598,14662,Stuff Packs,19,0,0.0,19
56599,14663,Expansion Packs,16,0,0.0,16
56600,14663,Game Packs,12,0,0.0,12
56601,14663,Kits,26,0,0.0,26
56602,14663,Stuff Packs,20,0,0.0,20
56603,14664,Expansion Packs,5,1,0.2,4
56604,14664,Game Packs,2,0,0.0,2
56605,14664,Kits,1,0,0.0,1
56606,14664,Stuff Packs,6,3,0.5,3
56607,14665,Expansion Packs,16,0,0.0,16
56608,14665,Game Packs,10,0,0.0,10
56609,14665,Kits,16,1,0.0625,15
56610,14665,Stuff Packs,14,0,0.0,14
56611,14666,Expansion Packs,16,0,0.0,16
56612,14666,Game Packs,4,0,0.0,4
56613,14666,Kits,6,2,0.3333333333333333,4
56614,14666,Stuff Packs,9,3,0.3333333333333333,6
56615,14667,Expansion Packs,5,0,0.0,5
56616,14667,Kits,2,1,0.5,1
56617,14667,Stuff Packs,1,1,1.0,0
56618,14668,Expansion Packs,14,1,0.07142857142857142,13
56619,14668,Game Packs,3,1,0.3333333333333333,2
56620,14668,Kits,3,3,1.0,0
56621,14668,Stuff Packs,7,4,0.5714285714285714,3
56622,14669,Expansion Packs,16,0,0.0,16
56623,14669,Game Packs,12,0,0.0,12
56624,14669,Kits,17,0,0.0,17
56625,14669,Stuff Packs,20,0,0.0,20
56626,14670,Expansion Packs,15,0,0.0,15
56627,14670,Game Packs,11,0,0.0,11
56628,14670,Kits,1,1,1.0,0
56629,14670,Stuff Packs,18,0,0.0,18
56630,14671,Expansion Packs,14,0,0.0,14
56631,14671,Game Packs,10,0,0.0,10
56632,14671,Kits,5,2,0.4,3
56633,14671,Stuff Packs,19,0,0.0,19
56634,14672,Expansion Packs,2,0,0.0,2
56635,14672,Game Packs,1,0,0.0,1
56636,14672,Kits,2,0,0.0,2
56637,14672,Stuff Packs,2,2,1.0,0
56638,14673,Expansion Packs,7,0,0.0,7
56639,14673,Game Packs,4,0,0.0,4
56640,14673,Kits,7,1,0.14285714285714285,6
56641,14673,Stuff Packs,7,2,0.2857142857142857,5
56642,14674,Expansion Packs,16,0,0.0,16
56643,14674,Game Packs,12,0,0.0,12
56644,14674,Kits,30,1,0.03333333333333333,29
56645,14674,Stuff Packs,20,0,0.0,20
56646,14675,Expansion Packs,16,0,0.0,16
56647,14675,Game Packs,8,0,0.0,8
56648,14675,Kits,20,2,0.1,18
56649,14675,Stuff Packs,20,3,0.15,17
56650,14676,Expansion Packs,16,0,0.0,16
56651,14676,Game Packs,11,0,0.0,11
56652,14676,Kits,13,0,0.0,13
56653,14676,Stuff Packs,16,0,0.0,16
56654,14677,Expansion Packs,15,0,0.0,15
56655,14677,Game Packs,9,0,0.0,9
56656,14677,Kits,2,2,1.0,0
56657,14677,Stuff Packs,17,0,0.0,17
56658,14678,Expansion Packs,14,0,0.0,14
56659,14678,Game Packs,7,0,0.0,7
56660,14678,Kits,6,1,0.16666666666666666,5
56661,14678,Stuff Packs,7,0,0.0,7
56662,14679,Expansion Packs,16,0,0.0,16
56663,14679,Game Packs,12,0,0.0,12
56664,14679,Kits,24,0,0.0,24
56665,14679,Stuff Packs,20,0,0.0,20
56666,14680,Expansion Packs,14,0,0.0,14
56667,14680,Game Packs,10,0,0.0,10
56668,14680,Stuff Packs,18,0,0.0,18
56669,14681,Expansion Packs,13,0,0.0,13
56670,14681,Game Packs,8,0,0.0,8
56671,14681,Kits,7,1,0.14285714285714285,6
56672,14681,Stuff Packs,14,2,0.14285714285714285,12
56673,14682,Expansion Packs,16,0,0.0,16
56674,14682,Game Packs,11,0,0.0,11
56675,14682,Kits,3,2,0.6666666666666666,1
56676,14682,Stuff Packs,20,0,0.0,20
56677,14683,Expansion Packs,15,0,0.0,15
56678,14683,Game Packs,10,0,0.0,10
56679,14683,Kits,4,1,0.25,3
56680,14683,Stuff Packs,19,0,0.0,19
56681,14684,Expansion Packs,11,0,0.0,11
56682,14684,Game Packs,6,0,0.0,6
56683,14684,Kits,5,1,0.2,4
56684,14684,Stuff Packs,9,0,0.0,9
56685,14685,Expansion Packs,16,0,0.0,16
56686,14685,Game Packs,12,0,0.0,12
56687,14685,Kits,15,1,0.06666666666666667,14
56688,14685,Stuff Packs,20,0,0.0,20
56689,14686,Expansion Packs,9,0,0.0,9
56690,14686,Game Packs,5,0,0.0,5
56691,14686,Kits,2,1,0.5,1
56692,14686,Stuff Packs,8,0,0.0,8
56693,14687,Expansion Packs,10,0,0.0,10
56694,14687,Game Packs,4,0,0.0,4
56695,14687,Kits,1,0,0.0,1
56696,14687,Stuff Packs,4,0,0.0,4
56697,14688,Expansion Packs,12,0,0.0,12
56698,14688,Game Packs,1,0,0.0,1
56699,14688,Kits,2,0,0.0,2
56700,14688,Stuff Packs,5,1,0.2,4
56701,14689,Expansion Packs,16,0,0.0,16
56702,14689,Game Packs,11,0,0.0,11
56703,14689,Kits,8,0,0.0,8
56704,14689,Stuff Packs,10,2,0.2,8
56705,14690,Expansion Packs,16,0,0.0,16
56706,14690,Game Packs,12,0,0.0,12
56707,14690,Kits,13,1,0.07692307692307693,12
56708,14690,Stuff Packs,14,0,0.0,14
56709,14691,Expansion Packs,10,0,0.0,10
56710,14691,Game Packs,3,0,0.0,3
56711,14691,Kits,3,2,0.6666666666666666,1
56712,14691,Stuff Packs,3,0,0.0,3
56713,14692,Expansion Packs,16,0,0.0,16
56714,14692,Game Packs,12,0,0.0,12
56715,14692,Kits,5,2,0.4,3
56716,14692,Stuff Packs,20,0,0.0,20
56717,14693,Expansion Packs,13,0,0.0,13
56718,14693,Game Packs,5,0,0.0,5
56719,14693,Kits,6,1,0.16666666666666666,5
56720,14693,Stuff Packs,12,1,0.08333333333333333,11
56721,14694,Expansion Packs,12,0,0.0,12
56722,14694,Game Packs,5,0,0.0,5
56723,14694,Kits,1,0,0.0,1
56724,14694,Stuff Packs,10,4,0.4,6
56725,14695,Expansion Packs,16,0,0.0,16
56726,14695,Game Packs,11,0,0.0,11
56727,14695,Kits,13,1,0.07692307692307693,12
56728,14695,Stuff Packs,20,0,0.0,20
56729,14696,Expansion Packs,11,0,0.0,11
56730,14696,Game Packs,6,0,0.0,6
56731,14696,Stuff Packs,14,1,0.07142857142857142,13
56732,14697,Expansion Packs,5,0,0.0,5
56733,14697,Game Packs,1,0,0.0,1
56734,14698,Expansion Packs,1,0,0.0,1
56735,14698,Game Packs,1,0,0.0,1
56736,14698,Stuff Packs,2,0,0.0,2
56737,14699,Expansion Packs,15,0,0.0,15
56738,14699,Game Packs,11,0,0.0,11
56739,14699,Kits,8,1,0.125,7
56740,14699,Stuff Packs,12,0,0.0,12
56741,14700,Expansion Packs,15,0,0.0,15
56742,14700,Game Packs,12,0,0.0,12
56743,14700,Kits,22,1,0.045454545454545456,21
56744,14700,Stuff Packs,20,0,0.0,20
56745,14701,Expansion Packs,14,0,0.0,14
56746,14701,Game Packs,10,0,0.0,10
56747,14701,Kits,5,0,0.0,5
56748,14701,Stuff Packs,17,0,0.0,17
56749,14702,Expansion Packs,16,0,0.0,16
56750,14702,Game Packs,11,0,0.0,11
56751,14702,Kits,26,1,0.038461538461538464,25
56752,14702,Stuff Packs,19,1,0.05263157894736842,18
56753,14703,Expansion Packs,1,0,0.0,1
56754,14703,Game Packs,1,1,1.0,0
56755,14703,Kits,2,2,1.0,0
56756,14703,Stuff Packs,3,3,1.0,0
56757,14704,Expansion Packs,9,0,0.0,9
56758,14704,Game Packs,8,0,0.0,8
56759,14704,Kits,1,1,1.0,0
56760,14704,Stuff Packs,14,0,0.0,14
56761,14705,Expansion Packs,15,0,0.0,15
56762,14705,Game Packs,10,0,0.0,10
56763,14705,Kits,3,0,0.0,3
56764,14705,Stuff Packs,6,0,0.0,6
56765,14706,Expansion Packs,7,0,0.0,7
56766,14706,Game Packs,4,0,0.0,4
56767,14706,Stuff Packs,3,1,0.3333333333333333,2
56768,14707,Expansion Packs,15,0,0.0,15
56769,14707,Game Packs,7,1,0.14285714285714285,6
56770,14707,Kits,5,1,0.2,4
56771,14707,Stuff Packs,10,2,0.2,8
56772,14708,Expansion Packs,16,0,0.0,16
56773,14708,Game Packs,11,0,0.0,11
56774,14708,Kits,33,4,0.12121212121212122,29
56775,14708,Stuff Packs,19,0,0.0,19
56776,14709,Expansion Packs,16,0,0.0,16
56777,14709,Game Packs,11,0,0.0,11
56778,14709,Kits,25,0,0.0,25
56779,14709,Stuff Packs,19,1,0.05263157894736842,18
56780,14710,Expansion Packs,10,0,0.0,10
56781,14710,Game Packs,5,0,0.0,5
56782,14710,Kits,1,1,1.0,0
56783,14710,Stuff Packs,7,3,0.42857142857142855,4
56784,14711,Expansion Packs,16,0,0.0,16
56785,14711,Game Packs,11,0,0.0,11
56786,14711,Kits,30,0,0.0,30
56787,14711,Stuff Packs,20,1,0.05,19
56788,14712,Expansion Packs,8,0,0.0,8
56789,14712,Game Packs,5,1,0.2,4
56790,14712,Kits,3,3,1.0,0
56791,14712,Stuff Packs,9,4,0.4444444444444444,5
56792,14713,Expansion Packs,16,0,0.0,16
56793,14713,Game Packs,12,0,0.0,12
56794,14713,Kits,27,0,0.0,27
56795,14713,Stuff Packs,20,0,0.0,20
56796,14714,Expansion Packs,8,0,0.0,8
56797,14714,Game Packs,4,0,0.0,4
56798,14714,Kits,3,1,0.3333333333333333,2
56799,14714,Stuff Packs,7,3,0.42857142857142855,4
56800,14715,Expansion Packs,15,0,0.0,15
56801,14715,Game Packs,10,0,0.0,10
56802,14715,Kits,4,1,0.25,3
56803,14715,Stuff Packs,14,0,0.0,14
56804,14716,Expansion Packs,6,0,0.0,6
56805,14716,Game Packs,1,0,0.0,1
56806,14716,Kits,1,1,1.0,0
56807,14716,Stuff Packs,2,0,0.0,2
56808,14717,Expansion Packs,14,0,0.0,14
56809,14717,Game Packs,10,0,0.0,10
56810,14717,Kits,12,1,0.08333333333333333,11
56811,14717,Stuff Packs,18,0,0.0,18
56812,14718,Expansion Packs,16,0,0.0,16
56813,14718,Game Packs,12,0,0.0,12
56814,14718,Kits,33,0,0.0,33
56815,14718,Stuff Packs,20,0,0.0,20
56816,14719,Expansion Packs,16,0,0.0,16
56817,14719,Game Packs,12,0,0.0,12
56818,14719,Kits,33,0,0.0,33
56819,14719,Stuff Packs,20,0,0.0,20
56820,14720,Expansion Packs,15,0,0.0,15
56821,14720,Game Packs,9,0,0.0,9
56822,14720,Kits,6,2,0.3333333333333333,4
56823,14720,Stuff Packs,11,1,0.09090909090909091,10
56824,14721,Expansion Packs,13,0,0.0,13
56825,14721,Game Packs,7,0,0.0,7
56826,14721,Kits,12,1,0.08333333333333333,11
56827,14721,Stuff Packs,11,3,0.2727272727272727,8
56828,14722,Expansion Packs,13,0,0.0,13
56829,14722,Game Packs,11,0,0.0,11
56830,14722,Kits,10,0,0.0,10
56831,14722,Stuff Packs,17,0,0.0,17
56832,14723,Expansion Packs,13,0,0.0,13
56833,14723,Game Packs,10,0,0.0,10
56834,14723,Kits,3,2,0.6666666666666666,1
56835,14723,Stuff Packs,16,0,0.0,16
56836,14724,Expansion Packs,10,0,0.0,10
56837,14724,Game Packs,6,0,0.0,6
56838,14724,Kits,5,1,0.2,4
56839,14724,Stuff Packs,8,1,0.125,7
56840,14725,Expansion Packs,14,0,0.0,14
56841,14725,Game Packs,8,1,0.125,7
56842,14725,Kits,1,1,1.0,0
56843,14725,Stuff Packs,4,1,0.25,3
56844,14726,Expansion Packs,14,0,0.0,14
56845,14726,Game Packs,8,0,0.0,8
56846,14726,Kits,7,0,0.0,7
56847,14726,Stuff Packs,6,0,0.0,6
56848,14727,Expansion Packs,13,0,0.0,13
56849,14727,Game Packs,8,0,0.0,8
56850,14727,Kits,1,0,0.0,1
56851,14727,Stuff Packs,12,0,0.0,12
56852,14728,Expansion Packs,12,0,0.0,12
56853,14728,Game Packs,6,0,0.0,6
56854,14728,Kits,1,1,1.0,0
56855,14728,Stuff Packs,5,0,0.0,5
56856,14729,Expansion Packs,9,0,0.0,9
56857,14729,Game Packs,7,1,0.14285714285714285,6
56858,14729,Kits,4,0,0.0,4
56859,14729,Stuff Packs,4,0,0.0,4
56860,14730,Expansion Packs,1,0,0.0,1
56861,14730,Game Packs,1,0,0.0,1
56862,14730,Stuff Packs,2,1,0.5,1
56863,14731,Expansion Packs,16,0,0.0,16
56864,14731,Game Packs,7,0,0.0,7
56865,14731,Kits,14,1,0.07142857142857142,13
56866,14731,Stuff Packs,13,0,0.0,13
56867,14732,Expansion Packs,4,0,0.0,4
56868,14732,Game Packs,2,0,0.0,2
56869,14732,Kits,1,1,1.0,0
56870,14732,Stuff Packs,4,2,0.5,2
56871,14733,Expansion Packs,15,0,0.0,15
56872,14733,Game Packs,10,0,0.0,10
56873,14733,Kits,5,2,0.4,3
56874,14733,Stuff Packs,13,2,0.15384615384615385,11
56875,14734,Expansion Packs,8,0,0.0,8
56876,14734,Game Packs,1,0,0.0,1
56877,14734,Kits,2,1,0.5,1
56878,14734,Stuff Packs,3,0,0.0,3
56879,14735,Expansion Packs,10,0,0.0,10
56880,14735,Game Packs,7,0,0.0,7
56881,14735,Kits,1,1,1.0,0
56882,14735,Stuff Packs,8,1,0.125,7
56883,14736,Expansion Packs,16,0,0.0,16
56884,14736,Game Packs,12,0,0.0,12
56885,14736,Kits,33,0,0.0,33
56886,14736,Stuff Packs,20,0,0.0,20
56887,14737,Expansion Packs,12,0,0.0,12
56888,14737,Game Packs,6,0,0.0,6
56889,14737,Kits,9,1,0.1111111111111111,8
56890,14737,Stuff Packs,11,0,0.0,11
56891,14738,Expansion Packs,11,0,0.0,11
56892,14738,Game Packs,8,1,0.125,7
56893,14738,Kits,4,2,0.5,2
56894,14738,Stuff Packs,8,2,0.25,6
56895,14739,Expansion Packs,16,0,0.0,16
56896,14739,Game Packs,12,0,0.0,12
56897,14739,Kits,33,1,0.030303030303030304,32
56898,14739,Stuff Packs,20,1,0.05,19
56899,14740,Expansion Packs,14,0,0.0,14
56900,14740,Game Packs,9,0,0.0,9
56901,14740,Stuff Packs,17,0,0.0,17
56902,14741,Expansion Packs,16,0,0.0,16
56903,14741,Game Packs,11,0,0.0,11
56904,14741,Kits,6,3,0.5,3
56905,14741,Stuff Packs,16,2,0.125,14
56906,14742,Expansion Packs,15,0,0.0,15
56907,14742,Game Packs,12,0,0.0,12
56908,14742,Kits,1,0,0.0,1
56909,14742,Stuff Packs,19,0,0.0,19
56910,14743,Expansion Packs,16,0,0.0,16
56911,14743,Game Packs,12,0,0.0,12
56912,14743,Kits,31,0,0.0,31
56913,14743,Stuff Packs,20,0,0.0,20
56914,14744,Expansion Packs,15,0,0.0,15
56915,14744,Game Packs,8,0,0.0,8
56916,14744,Stuff Packs,10,2,0.2,8
56917,14745,Expansion Packs,8,0,0.0,8
56918,14745,Game Packs,4,0,0.0,4
56919,14745,Kits,7,0,0.0,7
56920,14745,Stuff Packs,5,3,0.6,2
56921,14746,Expansion Packs,16,0,0.0,16
56922,14746,Game Packs,12,0,0.0,12
56923,14746,Kits,33,0,0.0,33
56924,14746,Stuff Packs,20,0,0.0,20
56925,14747,Expansion Packs,4,0,0.0,4
56926,14747,Game Packs,2,0,0.0,2
56927,14747,Kits,1,0,0.0,1
56928,14747,Stuff Packs,2,0,0.0,2
56929,14748,Expansion Packs,5,0,0.0,5
56930,14748,Game Packs,3,0,0.0,3
56931,14748,Stuff Packs,1,0,0.0,1
56932,14749,Expansion Packs,15,0,0.0,15
56933,14749,Game Packs,8,0,0.0,8
56934,14749,Kits,3,1,0.3333333333333333,2
56935,14749,Stuff Packs,13,0,0.0,13
56936,14750,Expansion Packs,3,0,0.0,3
56937,14750,Game Packs,1,0,0.0,1
56938,14750,Kits,1,0,0.0,1
56939,14750,Stuff Packs,3,3,1.0,0
56940,14751,Expansion Packs,11,0,0.0,11
56941,14751,Game Packs,5,0,0.0,5
56942,14751,Stuff Packs,6,0,0.0,6
56943,14752,Expansion Packs,1,0,0.0,1
56944,14752,Game Packs,2,0,0.0,2
56945,14752,Kits,6,2,0.3333333333333333,4
56946,14752,Stuff Packs,5,3,0.6,2
56947,14753,Expansion Packs,15,0,0.0,15
56948,14753,Game Packs,12,0,0.0,12
56949,14753,Kits,11,1,0.09090909090909091,10
56950,14753,Stuff Packs,18,0,0.0,18
56951,14754,Expansion Packs,9,0,0.0,9
56952,14754,Game Packs,2,0,0.0,2
56953,14754,Kits,1,1,1.0,0
56954,14754,Stuff Packs,3,0,0.0,3
56955,14755,Expansion Packs,6,0,0.0,6
56956,14755,Game Packs,1,0,0.0,1
56957,14755,Stuff Packs,1,0,0.0,1
56958,14756,Expansion Packs,11,0,0.0,11
56959,14756,Game Packs,7,1,0.14285714285714285,6
56960,14756,Kits,3,3,1.0,0
56961,14756,Stuff Packs,7,3,0.42857142857142855,4
56962,14757,Expansion Packs,8,0,0.0,8
56963,14757,Game Packs,2,0,0.0,2
56964,14757,Kits,2,0,0.0,2
56965,14757,Stuff Packs,4,2,0.5,2
56966,14758,Expansion Packs,16,0,0.0,16
56967,14758,Game Packs,12,0,0.0,12
56968,14758,Kits,26,0,0.0,26
56969,14758,Stuff Packs,20,1,0.05,19
56970,14759,Expansion Packs,9,0,0.0,9
56971,14759,Game Packs,3,0,0.0,3
56972,14759,Stuff Packs,2,0,0.0,2
56973,14760,Expansion Packs,15,0,0.0,15
56974,14760,Game Packs,12,0,0.0,12
56975,14760,Kits,15,1,0.06666666666666667,14
56976,14760,Stuff Packs,17,1,0.058823529411764705,16
56977,14761,Expansion Packs,16,1,0.0625,15
56978,14761,Game Packs,10,0,0.0,10
56979,14761,Kits,2,2,1.0,0
56980,14761,Stuff Packs,18,2,0.1111111111111111,16
56981,14762,Expansion Packs,16,0,0.0,16
56982,14762,Game Packs,9,0,0.0,9
56983,14762,Kits,19,1,0.05263157894736842,18
56984,14762,Stuff Packs,12,1,0.08333333333333333,11
56985,14763,Expansion Packs,3,1,0.3333333333333333,2
56986,14763,Game Packs,1,0,0.0,1
56987,14763,Stuff Packs,1,0,0.0,1
56988,14764,Expansion Packs,6,0,0.0,6
56989,14764,Game Packs,1,0,0.0,1
56990,14764,Kits,2,0,0.0,2
56991,14764,Stuff Packs,5,2,0.4,3
56992,14765,Expansion Packs,16,0,0.0,16
56993,14765,Game Packs,12,1,0.08333333333333333,11
56994,14765,Kits,28,2,0.07142857142857142,26
56995,14765,Stuff Packs,17,3,0.17647058823529413,14
56996,14766,Expansion Packs,15,0,0.0,15
56997,14766,Game Packs,11,0,0.0,11
56998,14766,Kits,14,1,0.07142857142857142,13
56999,14766,Stuff Packs,15,0,0.0,15
57000,14767,Expansion Packs,11,0,0.0,11
57001,14767,Game Packs,4,0,0.0,4
57002,14767,Kits,3,2,0.6666666666666666,1
57003,14767,Stuff Packs,6,2,0.3333333333333333,4
57004,14768,Expansion Packs,14,0,0.0,14
57005,14768,Game Packs,10,0,0.0,10
57006,14768,Kits,2,1,0.5,1
57007,14768,Stuff Packs,8,2,0.25,6
57008,14769,Expansion Packs,16,0,0.0,16
57009,14769,Game Packs,11,0,0.0,11
57010,14769,Kits,28,0,0.0,28
57011,14769,Stuff Packs,20,0,0.0,20
57012,14770,Expansion Packs,16,0,0.0,16
57013,14770,Game Packs,11,1,0.09090909090909091,10
57014,14770,Kits,5,1,0.2,4
57015,14770,Stuff Packs,16,2,0.125,14
57016,14771,Expansion Packs,5,1,0.2,4
57017,14771,Stuff Packs,3,1,0.3333333333333333,2
57018,14772,Expansion Packs,16,0,0.0,16
57019,14772,Game Packs,12,0,0.0,12
57020,14772,Kits,33,0,0.0,33
57021,14772,Stuff Packs,20,0,0.0,20
57022,14773,Expansion Packs,16,0,0.0,16
57023,14773,Game Packs,11,0,0.0,11
57024,14773,Kits,27,0,0.0,27
57025,14773,Stuff Packs,18,1,0.05555555555555555,17
57026,14774,Expansion Packs,11,0,0.0,11
57027,14774,Game Packs,2,0,0.0,2
57028,14774,Kits,2,2,1.0,0
57029,14774,Stuff Packs,4,3,0.75,1
57030,14775,Expansion Packs,11,0,0.0,11
57031,14775,Game Packs,5,0,0.0,5
57032,14775,Kits,5,0,0.0,5
57033,14775,Stuff Packs,7,0,0.0,7
57034,14776,Expansion Packs,16,0,0.0,16
57035,14776,Game Packs,12,0,0.0,12
57036,14776,Kits,18,1,0.05555555555555555,17
57037,14776,Stuff Packs,20,0,0.0,20
57038,14777,Expansion Packs,16,0,0.0,16
57039,14777,Game Packs,12,0,0.0,12
57040,14777,Kits,33,0,0.0,33
57041,14777,Stuff Packs,20,1,0.05,19
57042,14778,Expansion Packs,14,0,0.0,14
57043,14778,Game Packs,8,1,0.125,7
57044,14778,Kits,16,2,0.125,14
57045,14778,Stuff Packs,14,3,0.21428571428571427,11
57046,14779,Expansion Packs,16,0,0.0,16
57047,14779,Game Packs,9,0,0.0,9
57048,14779,Stuff Packs,7,0,0.0,7
57049,14780,Expansion Packs,16,0,0.0,16
57050,14780,Game Packs,12,0,0.0,12
57051,14780,Kits,22,1,0.045454545454545456,21
57052,14780,Stuff Packs,20,0,0.0,20
57053,14781,Expansion Packs,5,0,0.0,5
57054,14781,Game Packs,3,0,0.0,3
57055,14781,Kits,1,0,0.0,1
57056,14781,Stuff Packs,6,0,0.0,6
57057,14782,Expansion Packs,12,0,0.0,12
57058,14782,Game Packs,5,0,0.0,5
57059,14782,Kits,5,1,0.2,4
57060,14782,Stuff Packs,6,1,0.16666666666666666,5
57061,14783,Expansion Packs,13,0,0.0,13
57062,14783,Game Packs,9,0,0.0,9
57063,14783,Kits,2,0,0.0,2
57064,14783,Stuff Packs,17,0,0.0,17
57065,14784,Expansion Packs,15,0,0.0,15
57066,14784,Game Packs,9,0,0.0,9
57067,14784,Kits,17,1,0.058823529411764705,16
57068,14784,Stuff Packs,19,0,0.0,19
57069,14785,Expansion Packs,11,0,0.0,11
57070,14785,Game Packs,10,0,0.0,10
57071,14785,Kits,6,1,0.16666666666666666,5
57072,14785,Stuff Packs,11,3,0.2727272727272727,8
57073,14786,Expansion Packs,2,0,0.0,2
57074,14786,Game Packs,2,1,0.5,1
57075,14786,Kits,1,1,1.0,0
57076,14786,Stuff Packs,2,2,1.0,0
57077,14787,Expansion Packs,10,0,0.0,10
57078,14787,Game Packs,2,0,0.0,2
57079,14787,Kits,7,1,0.14285714285714285,6
57080,14787,Stuff Packs,8,1,0.125,7
57081,14788,Expansion Packs,11,0,0.0,11
57082,14788,Game Packs,4,0,0.0,4
57083,14788,Kits,1,0,0.0,1
57084,14788,Stuff Packs,2,0,0.0,2
57085,14789,Expansion Packs,5,0,0.0,5
57086,14789,Game Packs,3,0,0.0,3
57087,14789,Stuff Packs,1,0,0.0,1
57088,14790,Expansion Packs,8,0,0.0,8
57089,14790,Game Packs,9,0,0.0,9
57090,14790,Kits,1,1,1.0,0
57091,14790,Stuff Packs,5,1,0.2,4
57092,14791,Expansion Packs,5,0,0.0,5
57093,14791,Game Packs,5,1,0.2,4
57094,14791,Kits,3,2,0.6666666666666666,1
57095,14791,Stuff Packs,8,4,0.5,4
57096,14792,Expansion Packs,15,0,0.0,15
57097,14792,Game Packs,6,0,0.0,6
57098,14792,Kits,5,0,0.0,5
57099,14792,Stuff Packs,14,0,0.0,14
57100,14793,Expansion Packs,16,0,0.0,16
57101,14793,Game Packs,12,0,0.0,12
57102,14793,Kits,8,0,0.0,8
57103,14793,Stuff Packs,20,0,0.0,20
57104,14794,Expansion Packs,16,0,0.0,16
57105,14794,Game Packs,9,0,0.0,9
57106,14794,Kits,25,1,0.04,24
57107,14794,Stuff Packs,20,4,0.2,16
57108,14795,Expansion Packs,16,0,0.0,16
57109,14795,Game Packs,12,0,0.0,12
57110,14795,Kits,33,1,0.030303030303030304,32
57111,14795,Stuff Packs,20,0,0.0,20
57112,14796,Expansion Packs,16,0,0.0,16
57113,14796,Game Packs,12,0,0.0,12
57114,14796,Kits,23,0,0.0,23
57115,14796,Stuff Packs,19,0,0.0,19
57116,14797,Expansion Packs,14,0,0.0,14
57117,14797,Game Packs,11,0,0.0,11
57118,14797,Kits,23,0,0.0,23
57119,14797,Stuff Packs,20,0,0.0,20
57120,14798,Expansion Packs,11,0,0.0,11
57121,14798,Game Packs,9,1,0.1111111111111111,8
57122,14798,Stuff Packs,12,1,0.08333333333333333,11
57123,14799,Expansion Packs,16,0,0.0,16
57124,14799,Game Packs,12,0,0.0,12
57125,14799,Kits,33,0,0.0,33
57126,14799,Stuff Packs,20,0,0.0,20
57127,14800,Expansion Packs,10,0,0.0,10
57128,14800,Game Packs,3,0,0.0,3
57129,14800,Kits,1,0,0.0,1
57130,14800,Stuff Packs,3,0,0.0,3
57131,14801,Expansion Packs,16,0,0.0,16
57132,14801,Game Packs,12,0,0.0,12
57133,14801,Kits,10,0,0.0,10
57134,14801,Stuff Packs,13,1,0.07692307692307693,12
57135,14802,Expansion Packs,16,0,0.0,16
57136,14802,Game Packs,12,0,0.0,12
57137,14802,Kits,33,0,0.0,33
57138,14802,Stuff Packs,20,0,0.0,20
57139,14803,Expansion Packs,15,0,0.0,15
57140,14803,Game Packs,7,0,0.0,7
57141,14803,Kits,2,0,0.0,2
57142,14803,Stuff Packs,8,2,0.25,6
57143,14804,Expansion Packs,2,0,0.0,2
57144,14804,Game Packs,1,1,1.0,0
57145,14804,Kits,2,1,0.5,1
57146,14804,Stuff Packs,3,3,1.0,0
57147,14805,Expansion Packs,10,0,0.0,10
57148,14805,Game Packs,7,1,0.14285714285714285,6
57149,14805,Kits,4,2,0.5,2
57150,14805,Stuff Packs,7,2,0.2857142857142857,5
57151,14806,Expansion Packs,14,0,0.0,14
57152,14806,Game Packs,6,0,0.0,6
57153,14806,Kits,5,1,0.2,4
57154,14806,Stuff Packs,4,2,0.5,2
57155,14807,Expansion Packs,14,0,0.0,14
57156,14807,Game Packs,11,0,0.0,11
57157,14807,Kits,2,1,0.5,1
57158,14807,Stuff Packs,15,1,0.06666666666666667,14
57159,14808,Expansion Packs,7,0,0.0,7
57160,14808,Game Packs,2,1,0.5,1
57161,14808,Kits,5,2,0.4,3
57162,14808,Stuff Packs,10,4,0.4,6
57163,14809,Expansion Packs,16,0,0.0,16
57164,14809,Game Packs,11,0,0.0,11
57165,14809,Kits,30,0,0.0,30
57166,14809,Stuff Packs,20,0,0.0,20
57167,14810,Expansion Packs,16,0,0.0,16
57168,14810,Game Packs,11,0,0.0,11
57169,14810,Kits,13,2,0.15384615384615385,11
57170,14810,Stuff Packs,19,1,0.05263157894736842,18
57171,14811,Expansion Packs,12,0,0.0,12
57172,14811,Game Packs,4,0,0.0,4
57173,14811,Kits,3,3,1.0,0
57174,14811,Stuff Packs,8,4,0.5,4
57175,14812,Expansion Packs,16,6,0.375,10
57176,14812,Game Packs,12,5,0.4166666666666667,7
57177,14812,Kits,33,19,0.5757575757575758,14
57178,14812,Stuff Packs,20,8,0.4,12
57179,14813,Expansion Packs,16,0,0.0,16
57180,14813,Game Packs,11,0,0.0,11
57181,14813,Kits,33,1,0.030303030303030304,32
57182,14813,Stuff Packs,20,0,0.0,20
57183,14814,Expansion Packs,15,0,0.0,15
57184,14814,Game Packs,12,0,0.0,12
57185,14814,Stuff Packs,20,0,0.0,20
57186,14815,Expansion Packs,12,0,0.0,12
57187,14815,Game Packs,6,2,0.3333333333333333,4
57188,14815,Kits,4,1,0.25,3
57189,14815,Stuff Packs,8,1,0.125,7
57190,14816,Expansion Packs,15,0,0.0,15
57191,14816,Game Packs,9,0,0.0,9
57192,14816,Kits,7,1,0.14285714285714285,6
57193,14816,Stuff Packs,20,1,0.05,19
57194,14817,Expansion Packs,4,1,0.25,3
57195,14817,Game Packs,1,0,0.0,1
57196,14817,Stuff Packs,2,0,0.0,2
57197,14818,Expansion Packs,16,0,0.0,16
57198,14818,Game Packs,7,0,0.0,7
57199,14818,Kits,9,2,0.2222222222222222,7
57200,14818,Stuff Packs,16,3,0.1875,13
57201,14819,Expansion Packs,3,0,0.0,3
57202,14819,Game Packs,2,0,0.0,2
57203,14819,Kits,2,2,1.0,0
57204,14819,Stuff Packs,5,3,0.6,2
57205,14820,Expansion Packs,9,0,0.0,9
57206,14820,Game Packs,3,0,0.0,3
57207,14820,Stuff Packs,5,0,0.0,5
57208,14821,Expansion Packs,16,0,0.0,16
57209,14821,Game Packs,12,0,0.0,12
57210,14821,Kits,32,1,0.03125,31
57211,14821,Stuff Packs,20,0,0.0,20
57212,14822,Expansion Packs,6,0,0.0,6
57213,14822,Game Packs,2,1,0.5,1
57214,14822,Kits,1,0,0.0,1
57215,14822,Stuff Packs,3,1,0.3333333333333333,2
57216,14823,Expansion Packs,10,0,0.0,10
57217,14823,Game Packs,3,0,0.0,3
57218,14823,Kits,3,0,0.0,3
57219,14823,Stuff Packs,2,0,0.0,2
57220,14824,Expansion Packs,15,0,0.0,15
57221,14824,Game Packs,11,1,0.09090909090909091,10
57222,14824,Kits,17,0,0.0,17
57223,14824,Stuff Packs,8,3,0.375,5
57224,14825,Expansion Packs,9,0,0.0,9
57225,14825,Game Packs,3,0,0.0,3
57226,14825,Stuff Packs,5,0,0.0,5
57227,14826,Expansion Packs,16,0,0.0,16
57228,14826,Game Packs,11,0,0.0,11
57229,14826,Kits,10,1,0.1,9
57230,14826,Stuff Packs,19,0,0.0,19
57231,14827,Expansion Packs,5,0,0.0,5
57232,14827,Game Packs,1,0,0.0,1
57233,14827,Kits,3,0,0.0,3
57234,14827,Stuff Packs,3,2,0.6666666666666666,1
57235,14828,Expansion Packs,14,1,0.07142857142857142,13
57236,14828,Game Packs,5,0,0.0,5
57237,14828,Kits,16,1,0.0625,15
57238,14828,Stuff Packs,11,0,0.0,11
57239,14829,Expansion Packs,16,0,0.0,16
57240,14829,Game Packs,12,0,0.0,12
57241,14829,Kits,20,0,0.0,20
57242,14829,Stuff Packs,20,0,0.0,20
57243,14830,Expansion Packs,16,0,0.0,16
57244,14830,Game Packs,12,0,0.0,12
57245,14830,Kits,24,2,0.08333333333333333,22
57246,14830,Stuff Packs,20,0,0.0,20
57247,14831,Expansion Packs,15,0,0.0,15
57248,14831,Game Packs,12,0,0.0,12
57249,14831,Kits,8,0,0.0,8
57250,14831,Stuff Packs,20,0,0.0,20
57251,14832,Expansion Packs,15,0,0.0,15
57252,14832,Game Packs,6,0,0.0,6
57253,14832,Kits,3,1,0.3333333333333333,2
57254,14832,Stuff Packs,10,2,0.2,8
57255,14833,Expansion Packs,3,0,0.0,3
57256,14833,Game Packs,1,0,0.0,1
57257,14833,Kits,1,1,1.0,0
57258,14833,Stuff Packs,2,2,1.0,0
57259,14834,Stuff Packs,3,3,1.0,0
57260,14835,Expansion Packs,12,0,0.0,12
57261,14835,Game Packs,5,0,0.0,5
57262,14835,Kits,18,0,0.0,18
57263,14835,Stuff Packs,10,0,0.0,10
57264,14836,Expansion Packs,3,0,0.0,3
57265,14836,Game Packs,2,0,0.0,2
57266,14836,Kits,1,0,0.0,1
57267,14836,Stuff Packs,3,0,0.0,3
57268,14837,Expansion Packs,4,0,0.0,4
57269,14837,Game Packs,1,0,0.0,1
57270,14838,Expansion Packs,12,0,0.0,12
57271,14838,Game Packs,6,0,0.0,6
57272,14838,Kits,4,0,0.0,4
57273,14838,Stuff Packs,12,3,0.25,9
57274,14839,Expansion Packs,7,0,0.0,7
57275,14839,Game Packs,2,0,0.0,2
57276,14839,Kits,1,1,1.0,0
57277,14839,Stuff Packs,5,5,1.0,0
57278,14840,Expansion Packs,8,0,0.0,8
57279,14840,Game Packs,5,0,0.0,5
57280,14840,Stuff Packs,2,0,0.0,2
57281,14841,Expansion Packs,16,0,0.0,16
57282,14841,Game Packs,8,1,0.125,7
57283,14841,Kits,18,1,0.05555555555555555,17
57284,14841,Stuff Packs,11,3,0.2727272727272727,8
57285,14842,Expansion Packs,14,0,0.0,14
57286,14842,Game Packs,9,0,0.0,9
57287,14842,Kits,3,2,0.6666666666666666,1
57288,14842,Stuff Packs,8,0,0.0,8
57289,14843,Expansion Packs,7,0,0.0,7
57290,14843,Game Packs,6,1,0.16666666666666666,5
57291,14843,Kits,2,2,1.0,0
57292,14843,Stuff Packs,7,2,0.2857142857142857,5
57293,14844,Expansion Packs,13,0,0.0,13
57294,14844,Game Packs,7,0,0.0,7
57295,14844,Kits,5,2,0.4,3
57296,14844,Stuff Packs,9,1,0.1111111111111111,8
57297,14845,Expansion Packs,5,0,0.0,5
57298,14845,Game Packs,2,0,0.0,2
57299,14845,Kits,1,1,1.0,0
57300,14845,Stuff Packs,4,3,0.75,1
57301,14846,Expansion Packs,3,0,0.0,3
57302,14846,Game Packs,2,0,0.0,2
57303,14846,Kits,4,3,0.75,1
57304,14846,Stuff Packs,5,3,0.6,2
57305,14847,Expansion Packs,16,0,0.0,16
57306,14847,Game Packs,12,0,0.0,12
57307,14847,Kits,21,0,0.0,21
57308,14847,Stuff Packs,20,0,0.0,20
57309,14848,Expansion Packs,16,0,0.0,16
57310,14848,Game Packs,12,0,0.0,12
57311,14848,Kits,29,0,0.0,29
57312,14848,Stuff Packs,20,1,0.05,19
57313,14849,Expansion Packs,9,0,0.0,9
57314,14849,Game Packs,2,0,0.0,2
57315,14849,Kits,1,0,0.0,1
57316,14849,Stuff Packs,2,0,0.0,2
57317,14850,Expansion Packs,15,0,0.0,15
57318,14850,Game Packs,10,0,0.0,10
57319,14850,Kits,5,1,0.2,4
57320,14850,Stuff Packs,15,0,0.0,15
57321,14851,Expansion Packs,15,0,0.0,15
57322,14851,Game Packs,11,0,0.0,11
57323,14851,Kits,1,0,0.0,1
57324,14851,Stuff Packs,12,0,0.0,12
57325,14852,Expansion Packs,16,0,0.0,16
57326,14852,Game Packs,8,0,0.0,8
57327,14852,Kits,19,1,0.05263157894736842,18
57328,14852,Stuff Packs,18,1,0.05555555555555555,17
57329,14853,Expansion Packs,16,0,0.0,16
57330,14853,Game Packs,12,0,0.0,12
57331,14853,Kits,33,0,0.0,33
57332,14853,Stuff Packs,20,0,0.0,20
57333,14854,Expansion Packs,13,0,0.0,13
57334,14854,Game Packs,3,0,0.0,3
57335,14854,Kits,6,0,0.0,6
57336,14854,Stuff Packs,10,0,0.0,10
57337,14855,Expansion Packs,16,0,0.0,16
57338,14855,Game Packs,10,0,0.0,10
57339,14855,Kits,17,0,0.0,17
57340,14855,Stuff Packs,14,0,0.0,14
57341,14856,Expansion Packs,16,0,0.0,16
57342,14856,Game Packs,12,0,0.0,12
57343,14856,Kits,3,0,0.0,3
57344,14856,Stuff Packs,20,1,0.05,19
57345,14857,Expansion Packs,12,0,0.0,12
57346,14857,Game Packs,7,0,0.0,7
57347,14857,Kits,3,2,0.6666666666666666,1
57348,14857,Stuff Packs,8,3,0.375,5
57349,14858,Expansion Packs,16,0,0.0,16
57350,14858,Game Packs,12,0,0.0,12
57351,14858,Kits,32,2,0.0625,30
57352,14858,Stuff Packs,20,0,0.0,20
57353,14859,Expansion Packs,15,0,0.0,15
57354,14859,Game Packs,9,0,0.0,9
57355,14859,Kits,5,0,0.0,5
57356,14859,Stuff Packs,17,0,0.0,17
57357,14860,Expansion Packs,4,0,0.0,4
57358,14860,Game Packs,1,0,0.0,1
57359,14860,Stuff Packs,3,1,0.3333333333333333,2
57360,14861,Expansion Packs,14,1,0.07142857142857142,13
57361,14861,Game Packs,11,0,0.0,11
57362,14861,Kits,3,1,0.3333333333333333,2
57363,14861,Stuff Packs,20,0,0.0,20
57364,14862,Expansion Packs,12,0,0.0,12
57365,14862,Game Packs,4,0,0.0,4
57366,14862,Kits,6,1,0.16666666666666666,5
57367,14862,Stuff Packs,13,1,0.07692307692307693,12
57368,14863,Expansion Packs,14,0,0.0,14
57369,14863,Game Packs,8,0,0.0,8
57370,14863,Kits,3,2,0.6666666666666666,1
57371,14863,Stuff Packs,9,1,0.1111111111111111,8
57372,14864,Expansion Packs,16,0,0.0,16
57373,14864,Game Packs,11,0,0.0,11
57374,14864,Kits,33,0,0.0,33
57375,14864,Stuff Packs,20,0,0.0,20
57376,14865,Expansion Packs,16,0,0.0,16
57377,14865,Game Packs,8,0,0.0,8
57378,14865,Kits,12,1,0.08333333333333333,11
57379,14865,Stuff Packs,19,0,0.0,19
57380,14866,Expansion Packs,16,0,0.0,16
57381,14866,Game Packs,11,0,0.0,11
57382,14866,Kits,28,1,0.03571428571428571,27
57383,14866,Stuff Packs,20,4,0.2,16
57384,14867,Expansion Packs,3,0,0.0,3
57385,14867,Game Packs,1,1,1.0,0
57386,14867,Kits,2,2,1.0,0
57387,14867,Stuff Packs,4,4,1.0,0
57388,14868,Expansion Packs,16,0,0.0,16
57389,14868,Game Packs,12,0,0.0,12
57390,14868,Kits,27,2,0.07407407407407407,25
57391,14868,Stuff Packs,20,0,0.0,20
57392,14869,Expansion Packs,16,0,0.0,16
57393,14869,Game Packs,7,0,0.0,7
57394,14869,Kits,6,2,0.3333333333333333,4
57395,14869,Stuff Packs,9,4,0.4444444444444444,5
57396,14870,Expansion Packs,15,0,0.0,15
57397,14870,Game Packs,12,0,0.0,12
57398,14870,Kits,6,1,0.16666666666666666,5
57399,14870,Stuff Packs,18,0,0.0,18
57400,14871,Expansion Packs,10,0,0.0,10
57401,14871,Game Packs,5,0,0.0,5
57402,14871,Kits,5,0,0.0,5
57403,14871,Stuff Packs,7,1,0.14285714285714285,6
57404,14872,Expansion Packs,15,0,0.0,15
57405,14872,Game Packs,7,0,0.0,7
57406,14872,Kits,8,2,0.25,6
57407,14872,Stuff Packs,10,0,0.0,10
57408,14873,Expansion Packs,7,0,0.0,7
57409,14873,Game Packs,3,0,0.0,3
57410,14873,Kits,1,0,0.0,1
57411,14873,Stuff Packs,7,0,0.0,7
57412,14874,Expansion Packs,7,0,0.0,7
57413,14874,Game Packs,3,0,0.0,3
57414,14874,Kits,1,0,0.0,1
57415,14874,Stuff Packs,4,0,0.0,4
57416,14875,Expansion Packs,9,0,0.0,9
57417,14875,Game Packs,1,0,0.0,1
57418,14875,Stuff Packs,5,3,0.6,2
57419,14876,Expansion Packs,4,0,0.0,4
57420,14876,Game Packs,4,1,0.25,3
57421,14876,Kits,2,2,1.0,0
57422,14876,Stuff Packs,8,4,0.5,4
57423,14877,Expansion Packs,16,0,0.0,16
57424,14877,Game Packs,11,0,0.0,11
57425,14877,Kits,33,0,0.0,33
57426,14877,Stuff Packs,20,0,0.0,20
57427,14878,Expansion Packs,15,0,0.0,15
57428,14878,Game Packs,12,0,0.0,12
57429,14878,Kits,2,0,0.0,2
57430,14878,Stuff Packs,19,0,0.0,19
57431,14879,Expansion Packs,14,0,0.0,14
57432,14879,Game Packs,9,0,0.0,9
57433,14879,Kits,6,3,0.5,3
57434,14879,Stuff Packs,8,4,0.5,4
57435,14880,Expansion Packs,16,0,0.0,16
57436,14880,Game Packs,12,0,0.0,12
57437,14880,Kits,33,0,0.0,33
57438,14880,Stuff Packs,20,0,0.0,20
57439,14881,Expansion Packs,16,0,0.0,16
57440,14881,Game Packs,12,0,0.0,12
57441,14881,Kits,33,0,0.0,33
57442,14881,Stuff Packs,20,0,0.0,20
57443,14882,Expansion Packs,12,0,0.0,12
57444,14882,Game Packs,4,1,0.25,3
57445,14882,Kits,1,0,0.0,1
57446,14882,Stuff Packs,6,0,0.0,6
57447,14883,Expansion Packs,15,0,0.0,15
57448,14883,Game Packs,11,0,0.0,11
57449,14883,Kits,3,3,1.0,0
57450,14883,Stuff Packs,17,2,0.11764705882352941,15
57451,14884,Expansion Packs,16,0,0.0,16
57452,14884,Game Packs,12,0,0.0,12
57453,14884,Kits,22,1,0.045454545454545456,21
57454,14884,Stuff Packs,20,0,0.0,20
57455,14885,Expansion Packs,5,0,0.0,5
57456,14885,Game Packs,2,0,0.0,2
57457,14885,Kits,4,1,0.25,3
57458,14885,Stuff Packs,8,3,0.375,5
57459,14886,Expansion Packs,16,0,0.0,16
57460,14886,Game Packs,11,0,0.0,11
57461,14886,Kits,1,1,1.0,0
57462,14886,Stuff Packs,20,0,0.0,20
57463,14887,Expansion Packs,13,0,0.0,13
57464,14887,Game Packs,3,0,0.0,3
57465,14887,Kits,3,0,0.0,3
57466,14887,Stuff Packs,9,1,0.1111111111111111,8
57467,14888,Expansion Packs,15,0,0.0,15
57468,14888,Game Packs,9,0,0.0,9
57469,14888,Kits,17,0,0.0,17
57470,14888,Stuff Packs,16,0,0.0,16
57471,14889,Expansion Packs,13,0,0.0,13
57472,14889,Game Packs,12,0,0.0,12
57473,14889,Kits,18,0,0.0,18
57474,14889,Stuff Packs,18,0,0.0,18
57475,14890,Expansion Packs,8,0,0.0,8
57476,14890,Game Packs,3,0,0.0,3
57477,14890,Kits,3,1,0.3333333333333333,2
57478,14890,Stuff Packs,6,1,0.16666666666666666,5
57479,14891,Expansion Packs,10,0,0.0,10
57480,14891,Game Packs,7,0,0.0,7
57481,14891,Kits,2,0,0.0,2
57482,14891,Stuff Packs,3,0,0.0,3
57483,14892,Expansion Packs,15,1,0.06666666666666667,14
57484,14892,Game Packs,6,2,0.3333333333333333,4
57485,14892,Stuff Packs,5,2,0.4,3
57486,14893,Expansion Packs,16,0,0.0,16
57487,14893,Game Packs,12,0,0.0,12
57488,14893,Kits,33,1,0.030303030303030304,32
57489,14893,Stuff Packs,20,0,0.0,20
57490,14894,Expansion Packs,16,0,0.0,16
57491,14894,Game Packs,12,0,0.0,12
57492,14894,Kits,30,1,0.03333333333333333,29
57493,14894,Stuff Packs,20,0,0.0,20
57494,14895,Expansion Packs,15,0,0.0,15
57495,14895,Game Packs,12,0,0.0,12
57496,14895,Kits,25,1,0.04,24
57497,14895,Stuff Packs,19,0,0.0,19
57498,14896,Expansion Packs,15,0,0.0,15
57499,14896,Game Packs,8,0,0.0,8
57500,14896,Kits,19,1,0.05263157894736842,18
57501,14896,Stuff Packs,17,3,0.17647058823529413,14
57502,14897,Expansion Packs,14,0,0.0,14
57503,14897,Game Packs,3,0,0.0,3
57504,14897,Kits,1,0,0.0,1
57505,14897,Stuff Packs,5,0,0.0,5
57506,14898,Expansion Packs,13,0,0.0,13
57507,14898,Game Packs,11,0,0.0,11
57508,14898,Kits,10,2,0.2,8
57509,14898,Stuff Packs,13,0,0.0,13
57510,14899,Expansion Packs,15,0,0.0,15
57511,14899,Game Packs,10,0,0.0,10
57512,14899,Kits,1,0,0.0,1
57513,14899,Stuff Packs,6,2,0.3333333333333333,4
57514,14900,Expansion Packs,16,0,0.0,16
57515,14900,Game Packs,12,0,0.0,12
57516,14900,Kits,32,0,0.0,32
57517,14900,Stuff Packs,20,0,0.0,20
57518,14901,Expansion Packs,5,0,0.0,5
57519,14901,Game Packs,1,0,0.0,1
57520,14901,Kits,1,0,0.0,1
57521,14901,Stuff Packs,2,0,0.0,2
57522,14902,Expansion Packs,15,0,0.0,15
57523,14902,Game Packs,10,1,0.1,9
57524,14902,Kits,5,4,0.8,1
57525,14902,Stuff Packs,9,3,0.3333333333333333,6
57526,14903,Expansion Packs,16,0,0.0,16
57527,14903,Game Packs,5,1,0.2,4
57528,14903,Kits,14,2,0.14285714285714285,12
57529,14903,Stuff Packs,8,3,0.375,5
57530,14904,Expansion Packs,3,1,0.3333333333333333,2
57531,14904,Game Packs,4,0,0.0,4
57532,14904,Stuff Packs,3,1,0.3333333333333333,2
57533,14905,Expansion Packs,15,0,0.0,15
57534,14905,Game Packs,11,0,0.0,11
57535,14905,Kits,5,2,0.4,3
57536,14905,Stuff Packs,17,1,0.058823529411764705,16
57537,14906,Expansion Packs,14,0,0.0,14
57538,14906,Game Packs,12,0,0.0,12
57539,14906,Kits,2,2,1.0,0
57540,14906,Stuff Packs,20,1,0.05,19
57541,14907,Expansion Packs,13,0,0.0,13
57542,14907,Game Packs,7,0,0.0,7
57543,14907,Kits,1,1,1.0,0
57544,14907,Stuff Packs,8,2,0.25,6
57545,14908,Expansion Packs,13,0,0.0,13
57546,14908,Game Packs,5,0,0.0,5
57547,14908,Kits,15,1,0.06666666666666667,14
57548,14908,Stuff Packs,11,2,0.18181818181818182,9
57549,14909,Expansion Packs,13,0,0.0,13
57550,14909,Game Packs,2,0,0.0,2
57551,14909,Kits,3,0,0.0,3
57552,14909,Stuff Packs,1,0,0.0,1
57553,14910,Expansion Packs,15,0,0.0,15
57554,14910,Game Packs,12,0,0.0,12
57555,14910,Kits,16,0,0.0,16
57556,14910,Stuff Packs,18,1,0.05555555555555555,17
57557,14911,Expansion Packs,13,0,0.0,13
57558,14911,Game Packs,8,0,0.0,8
57559,14911,Kits,3,0,0.0,3
57560,14911,Stuff Packs,11,2,0.18181818181818182,9
57561,14912,Expansion Packs,16,0,0.0,16
57562,14912,Game Packs,11,0,0.0,11
57563,14912,Kits,26,1,0.038461538461538464,25
57564,14912,Stuff Packs,13,0,0.0,13
57565,14913,Expansion Packs,5,0,0.0,5
57566,14913,Game Packs,2,1,0.5,1
57567,14913,Kits,1,1,1.0,0
57568,14913,Stuff Packs,4,4,1.0,0
57569,14914,Expansion Packs,16,0,0.0,16
57570,14914,Game Packs,11,0,0.0,11
57571,14914,Kits,16,1,0.0625,15
57572,14914,Stuff Packs,19,1,0.05263157894736842,18
57573,14915,Expansion Packs,16,1,0.0625,15
57574,14915,Game Packs,11,0,0.0,11
57575,14915,Kits,4,1,0.25,3
57576,14915,Stuff Packs,18,0,0.0,18
57577,14916,Expansion Packs,3,0,0.0,3
57578,14916,Game Packs,2,0,0.0,2
57579,14916,Kits,5,0,0.0,5
57580,14916,Stuff Packs,4,0,0.0,4
57581,14917,Expansion Packs,16,0,0.0,16
57582,14917,Game Packs,12,0,0.0,12
57583,14917,Kits,20,1,0.05,19
57584,14917,Stuff Packs,20,0,0.0,20
57585,14918,Expansion Packs,16,0,0.0,16
57586,14918,Game Packs,12,0,0.0,12
57587,14918,Kits,33,1,0.030303030303030304,32
57588,14918,Stuff Packs,20,2,0.1,18
57589,14919,Expansion Packs,6,0,0.0,6
57590,14919,Game Packs,4,0,0.0,4
57591,14919,Stuff Packs,4,0,0.0,4
57592,14920,Expansion Packs,13,0,0.0,13
57593,14920,Game Packs,10,0,0.0,10
57594,14920,Kits,15,1,0.06666666666666667,14
57595,14920,Stuff Packs,18,0,0.0,18
57596,14921,Expansion Packs,10,0,0.0,10
57597,14921,Game Packs,3,0,0.0,3
57598,14921,Stuff Packs,9,1,0.1111111111111111,8
57599,14922,Expansion Packs,16,0,0.0,16
57600,14922,Game Packs,12,0,0.0,12
57601,14922,Kits,22,1,0.045454545454545456,21
57602,14922,Stuff Packs,20,1,0.05,19
57603,14923,Expansion Packs,14,0,0.0,14
57604,14923,Game Packs,6,0,0.0,6
57605,14923,Kits,2,2,1.0,0
57606,14923,Stuff Packs,14,1,0.07142857142857142,13
57607,14924,Expansion Packs,15,0,0.0,15
57608,14924,Game Packs,6,0,0.0,6
57609,14924,Kits,17,1,0.058823529411764705,16
57610,14924,Stuff Packs,17,0,0.0,17
57611,14925,Expansion Packs,15,0,0.0,15
57612,14925,Game Packs,9,0,0.0,9
57613,14925,Kits,6,1,0.16666666666666666,5
57614,14925,Stuff Packs,17,1,0.058823529411764705,16
57615,14926,Expansion Packs,1,0,0.0,1
57616,14927,Expansion Packs,12,0,0.0,12
57617,14927,Game Packs,6,1,0.16666666666666666,5
57618,14927,Kits,1,1,1.0,0
57619,14927,Stuff Packs,5,0,0.0,5
57620,14928,Expansion Packs,7,0,0.0,7
57621,14928,Game Packs,3,0,0.0,3
57622,14928,Stuff Packs,6,2,0.3333333333333333,4
57623,14929,Expansion Packs,14,0,0.0,14
57624,14929,Game Packs,8,0,0.0,8
57625,14929,Kits,3,1,0.3333333333333333,2
57626,14929,Stuff Packs,9,0,0.0,9
57627,14930,Expansion Packs,9,0,0.0,9
57628,14930,Game Packs,5,0,0.0,5
57629,14930,Kits,2,0,0.0,2
57630,14930,Stuff Packs,12,0,0.0,12
57631,14931,Expansion Packs,2,0,0.0,2
57632,14931,Stuff Packs,4,1,0.25,3
57633,14932,Expansion Packs,16,0,0.0,16
57634,14932,Game Packs,11,0,0.0,11
57635,14932,Kits,16,1,0.0625,15
57636,14932,Stuff Packs,20,0,0.0,20
57637,14933,Expansion Packs,12,0,0.0,12
57638,14933,Game Packs,7,0,0.0,7
57639,14933,Kits,1,1,1.0,0
57640,14933,Stuff Packs,11,2,0.18181818181818182,9
57641,14934,Expansion Packs,2,2,1.0,0
57642,14934,Stuff Packs,1,1,1.0,0
57643,14935,Expansion Packs,14,0,0.0,14
57644,14935,Game Packs,6,0,0.0,6
57645,14935,Kits,2,0,0.0,2
57646,14935,Stuff Packs,14,1,0.07142857142857142,13
57647,14936,Expansion Packs,4,4,1.0,0
57648,14936,Game Packs,2,2,1.0,0
57649,14936,Kits,2,2,1.0,0
57650,14936,Stuff Packs,3,3,1.0,0
57651,14937,Expansion Packs,1,0,0.0,1
57652,14938,Expansion Packs,14,0,0.0,14
57653,14938,Game Packs,10,0,0.0,10
57654,14938,Kits,5,0,0.0,5
57655,14938,Stuff Packs,17,0,0.0,17
57656,14939,Expansion Packs,9,0,0.0,9
57657,14939,Game Packs,4,0,0.0,4
57658,14939,Stuff Packs,4,0,0.0,4
57659,14940,Expansion Packs,16,0,0.0,16
57660,14940,Game Packs,12,0,0.0,12
57661,14940,Kits,22,0,0.0,22
57662,14940,Stuff Packs,20,1,0.05,19
57663,14941,Expansion Packs,10,0,0.0,10
57664,14941,Game Packs,6,0,0.0,6
57665,14941,Stuff Packs,12,3,0.25,9
57666,14942,Expansion Packs,12,0,0.0,12
57667,14942,Game Packs,6,0,0.0,6
57668,14942,Kits,1,0,0.0,1
57669,14942,Stuff Packs,3,0,0.0,3
57670,14943,Expansion Packs,16,6,0.375,10
57671,14943,Game Packs,12,5,0.4166666666666667,7
57672,14943,Kits,33,0,0.0,33
57673,14943,Stuff Packs,20,8,0.4,12
57674,14944,Expansion Packs,16,0,0.0,16
57675,14944,Game Packs,12,0,0.0,12
57676,14944,Kits,33,0,0.0,33
57677,14944,Stuff Packs,20,0,0.0,20
57678,14945,Expansion Packs,16,0,0.0,16
57679,14945,Game Packs,12,0,0.0,12
57680,14945,Kits,30,1,0.03333333333333333,29
57681,14945,Stuff Packs,20,0,0.0,20
57682,14946,Expansion Packs,16,0,0.0,16
57683,14946,Game Packs,12,0,0.0,12
57684,14946,Kits,33,0,0.0,33
57685,14946,Stuff Packs,20,0,0.0,20
57686,14947,Expansion Packs,10,0,0.0,10
57687,14947,Game Packs,5,0,0.0,5
57688,14947,Kits,8,0,0.0,8
57689,14947,Stuff Packs,6,0,0.0,6
57690,14948,Expansion Packs,4,0,0.0,4
57691,14948,Game Packs,2,0,0.0,2
57692,14948,Kits,4,0,0.0,4
57693,14948,Stuff Packs,2,0,0.0,2
57694,14949,Expansion Packs,11,0,0.0,11
57695,14949,Game Packs,10,0,0.0,10
57696,14949,Kits,2,1,0.5,1
57697,14949,Stuff Packs,18,0,0.0,18
57698,14950,Expansion Packs,5,0,0.0,5
57699,14950,Game Packs,1,0,0.0,1
57700,14950,Kits,1,0,0.0,1
57701,14950,Stuff Packs,3,0,0.0,3
57702,14951,Expansion Packs,13,0,0.0,13
57703,14951,Game Packs,6,0,0.0,6
57704,14951,Kits,5,0,0.0,5
57705,14951,Stuff Packs,7,2,0.2857142857142857,5
57706,14952,Expansion Packs,15,0,0.0,15
57707,14952,Game Packs,12,0,0.0,12
57708,14952,Kits,13,1,0.07692307692307693,12
57709,14952,Stuff Packs,16,1,0.0625,15
57710,14953,Expansion Packs,7,0,0.0,7
57711,14953,Game Packs,6,0,0.0,6
57712,14953,Kits,3,0,0.0,3
57713,14953,Stuff Packs,7,0,0.0,7
57714,14954,Expansion Packs,6,0,0.0,6
57715,14954,Game Packs,7,0,0.0,7
57716,14954,Kits,6,0,0.0,6
57717,14954,Stuff Packs,7,0,0.0,7
57718,14955,Expansion Packs,6,0,0.0,6
57719,14955,Game Packs,5,0,0.0,5
57720,14955,Stuff Packs,4,0,0.0,4
57721,14956,Expansion Packs,16,0,0.0,16
57722,14956,Game Packs,11,0,0.0,11
57723,14956,Kits,15,1,0.06666666666666667,14
57724,14956,Stuff Packs,16,0,0.0,16
57725,14957,Expansion Packs,16,0,0.0,16
57726,14957,Game Packs,12,1,0.08333333333333333,11
57727,14957,Kits,33,0,0.0,33
57728,14957,Stuff Packs,19,0,0.0,19
57729,14958,Expansion Packs,11,0,0.0,11
57730,14958,Game Packs,4,0,0.0,4
57731,14958,Kits,1,0,0.0,1
57732,14958,Stuff Packs,2,0,0.0,2
57733,14959,Expansion Packs,15,0,0.0,15
57734,14959,Game Packs,11,0,0.0,11
57735,14959,Kits,9,1,0.1111111111111111,8
57736,14959,Stuff Packs,17,1,0.058823529411764705,16
57737,14960,Expansion Packs,16,0,0.0,16
57738,14960,Game Packs,12,0,0.0,12
57739,14960,Kits,33,1,0.030303030303030304,32
57740,14960,Stuff Packs,20,0,0.0,20
57741,14961,Expansion Packs,15,0,0.0,15
57742,14961,Game Packs,4,0,0.0,4
57743,14961,Kits,9,1,0.1111111111111111,8
57744,14961,Stuff Packs,13,0,0.0,13
57745,14962,Expansion Packs,15,0,0.0,15
57746,14962,Game Packs,11,0,0.0,11
57747,14962,Kits,9,1,0.1111111111111111,8
57748,14962,Stuff Packs,18,0,0.0,18
57749,14963,Expansion Packs,16,0,0.0,16
57750,14963,Game Packs,12,0,0.0,12
57751,14963,Kits,33,0,0.0,33
57752,14963,Stuff Packs,20,0,0.0,20
57753,14964,Expansion Packs,16,0,0.0,16
57754,14964,Game Packs,12,0,0.0,12
57755,14964,Kits,17,1,0.058823529411764705,16
57756,14964,Stuff Packs,13,0,0.0,13
57757,14965,Expansion Packs,16,0,0.0,16
57758,14965,Game Packs,12,0,0.0,12
57759,14965,Kits,32,0,0.0,32
57760,14965,Stuff Packs,20,0,0.0,20
57761,14966,Expansion Packs,16,1,0.0625,15
57762,14966,Game Packs,9,0,0.0,9
57763,14966,Kits,13,0,0.0,13
57764,14966,Stuff Packs,9,0,0.0,9
57765,14967,Expansion Packs,13,0,0.0,13
57766,14967,Game Packs,5,0,0.0,5
57767,14967,Kits,5,1,0.2,4
57768,14967,Stuff Packs,6,2,0.3333333333333333,4
57769,14968,Expansion Packs,6,0,0.0,6
57770,14968,Game Packs,8,0,0.0,8
57771,14968,Stuff Packs,10,1,0.1,9
57772,14969,Expansion Packs,15,0,0.0,15
57773,14969,Game Packs,11,1,0.09090909090909091,10
57774,14969,Kits,9,2,0.2222222222222222,7
57775,14969,Stuff Packs,10,2,0.2,8
57776,14970,Expansion Packs,8,0,0.0,8
57777,14970,Game Packs,6,0,0.0,6
57778,14970,Kits,3,1,0.3333333333333333,2
57779,14970,Stuff Packs,6,2,0.3333333333333333,4
57780,14971,Expansion Packs,12,0,0.0,12
57781,14971,Game Packs,10,2,0.2,8
57782,14971,Kits,22,0,0.0,22
57783,14971,Stuff Packs,20,0,0.0,20
57784,14972,Expansion Packs,16,0,0.0,16
57785,14972,Game Packs,12,0,0.0,12
57786,14972,Kits,33,0,0.0,33
57787,14972,Stuff Packs,20,1,0.05,19
57788,14973,Game Packs,1,0,0.0,1
57789,14974,Expansion Packs,11,0,0.0,11
57790,14974,Game Packs,8,0,0.0,8
57791,14974,Kits,3,1,0.3333333333333333,2
57792,14974,Stuff Packs,11,2,0.18181818181818182,9
57793,14975,Expansion Packs,16,0,0.0,16
57794,14975,Game Packs,11,0,0.0,11
57795,14975,Kits,7,1,0.14285714285714285,6
57796,14975,Stuff Packs,9,1,0.1111111111111111,8
57797,14976,Expansion Packs,15,0,0.0,15
57798,14976,Game Packs,9,0,0.0,9
57799,14976,Kits,3,2,0.6666666666666666,1
57800,14976,Stuff Packs,8,1,0.125,7
57801,14977,Expansion Packs,16,0,0.0,16
57802,14977,Game Packs,12,0,0.0,12
57803,14977,Kits,20,0,0.0,20
57804,14977,Stuff Packs,20,1,0.05,19
57805,14978,Expansion Packs,12,0,0.0,12
57806,14978,Game Packs,6,0,0.0,6
57807,14978,Kits,4,2,0.5,2
57808,14978,Stuff Packs,5,3,0.6,2
57809,14979,Expansion Packs,10,0,0.0,10
57810,14979,Game Packs,6,2,0.3333333333333333,4
57811,14979,Kits,1,1,1.0,0
57812,14979,Stuff Packs,8,5,0.625,3
57813,14980,Expansion Packs,13,0,0.0,13
57814,14980,Game Packs,6,0,0.0,6
57815,14980,Kits,1,1,1.0,0
57816,14980,Stuff Packs,8,0,0.0,8
57817,14981,Expansion Packs,16,0,0.0,16
57818,14981,Game Packs,12,0,0.0,12
57819,14981,Kits,33,1,0.030303030303030304,32
57820,14981,Stuff Packs,20,0,0.0,20
57821,14982,Expansion Packs,14,0,0.0,14
57822,14982,Game Packs,11,0,0.0,11
57823,14982,Kits,2,2,1.0,0
57824,14982,Stuff Packs,18,1,0.05555555555555555,17
57825,14983,Expansion Packs,16,0,0.0,16
57826,14983,Game Packs,12,2,0.16666666666666666,10
57827,14983,Kits,20,1,0.05,19
57828,14983,Stuff Packs,20,4,0.2,16
57829,14984,Expansion Packs,16,0,0.0,16
57830,14984,Game Packs,12,0,0.0,12
57831,14984,Kits,6,0,0.0,6
57832,14984,Stuff Packs,16,0,0.0,16
57833,14985,Expansion Packs,14,0,0.0,14
57834,14985,Game Packs,10,0,0.0,10
57835,14985,Kits,3,0,0.0,3
57836,14985,Stuff Packs,18,1,0.05555555555555555,17
57837,14986,Expansion Packs,15,0,0.0,15
57838,14986,Game Packs,12,0,0.0,12
57839,14986,Kits,21,1,0.047619047619047616,20
57840,14986,Stuff Packs,20,0,0.0,20
57841,14987,Expansion Packs,10,0,0.0,10
57842,14987,Game Packs,10,0,0.0,10
57843,14987,Kits,12,1,0.08333333333333333,11
57844,14987,Stuff Packs,12,0,0.0,12
57845,14988,Expansion Packs,15,0,0.0,15
57846,14988,Game Packs,10,0,0.0,10
57847,14988,Kits,2,0,0.0,2
57848,14988,Stuff Packs,20,0,0.0,20
57849,14989,Expansion Packs,16,0,0.0,16
57850,14989,Game Packs,7,0,0.0,7
57851,14989,Kits,4,2,0.5,2
57852,14989,Stuff Packs,12,2,0.16666666666666666,10
57853,14990,Expansion Packs,16,0,0.0,16
57854,14990,Game Packs,12,0,0.0,12
57855,14990,Kits,33,0,0.0,33
57856,14990,Stuff Packs,20,0,0.0,20
57857,14991,Expansion Packs,15,0,0.0,15
57858,14991,Game Packs,11,0,0.0,11
57859,14991,Kits,9,1,0.1111111111111111,8
57860,14991,Stuff Packs,20,0,0.0,20
57861,14992,Expansion Packs,5,0,0.0,5
57862,14992,Game Packs,6,0,0.0,6
57863,14992,Kits,5,0,0.0,5
57864,14992,Stuff Packs,6,0,0.0,6
57865,14993,Expansion Packs,8,0,0.0,8
57866,14993,Game Packs,5,1,0.2,4
57867,14993,Kits,1,1,1.0,0
57868,14993,Stuff Packs,7,4,0.5714285714285714,3
57869,14994,Expansion Packs,8,0,0.0,8
57870,14994,Kits,1,1,1.0,0
57871,14994,Stuff Packs,5,2,0.4,3
57872,14995,Expansion Packs,16,0,0.0,16
57873,14995,Game Packs,10,0,0.0,10
57874,14995,Kits,16,1,0.0625,15
57875,14995,Stuff Packs,10,0,0.0,10
57876,14996,Expansion Packs,16,0,0.0,16
57877,14996,Game Packs,12,0,0.0,12
57878,14996,Kits,21,2,0.09523809523809523,19
57879,14996,Stuff Packs,18,2,0.1111111111111111,16
57880,14997,Expansion Packs,16,3,0.1875,13
57881,14997,Game Packs,12,2,0.16666666666666666,10
57882,14997,Kits,33,27,0.8181818181818182,6
57883,14997,Stuff Packs,20,0,0.0,20
57884,14998,Expansion Packs,16,0,0.0,16
57885,14998,Game Packs,10,0,0.0,10
57886,14998,Kits,28,1,0.03571428571428571,27
57887,14998,Stuff Packs,15,0,0.0,15
57888,14999,Expansion Packs,11,0,0.0,11
57889,14999,Game Packs,7,0,0.0,7
57890,14999,Kits,1,1,1.0,0
57891,14999,Stuff Packs,8,3,0.375,5
57892,15000,Expansion Packs,3,0,0.0,3
57893,15000,Game Packs,1,0,0.0,1
57894,15000,Kits,2,1,0.5,1
57895,15000,Stuff Packs,2,0,0.0,2
57896,15001,Expansion Packs,5,0,0.0,5
57897,15001,Game Packs,2,0,0.0,2
57898,15001,Kits,1,1,1.0,0
57899,15001,Stuff Packs,3,3,1.0,0
57900,15002,Expansion Packs,7,0,0.0,7
57901,15002,Game Packs,4,0,0.0,4
57902,15002,Kits,3,1,0.3333333333333333,2
57903,15002,Stuff Packs,5,0,0.0,5
57904,15003,Expansion Packs,16,0,0.0,16
57905,15003,Game Packs,12,0,0.0,12
57906,15003,Kits,15,1,0.06666666666666667,14
57907,15003,Stuff Packs,20,0,0.0,20
57908,15004,Expansion Packs,16,0,0.0,16
57909,15004,Game Packs,12,0,0.0,12
57910,15004,Kits,33,0,0.0,33
57911,15004,Stuff Packs,20,0,0.0,20
57912,15005,Expansion Packs,16,0,0.0,16
57913,15005,Game Packs,12,0,0.0,12
57914,15005,Kits,33,0,0.0,33
57915,15005,Stuff Packs,20,0,0.0,20
57916,15006,Expansion Packs,2,0,0.0,2
57917,15007,Expansion Packs,10,0,0.0,10
57918,15007,Game Packs,4,0,0.0,4
57919,15007,Kits,8,0,0.0,8
57920,15007,Stuff Packs,11,3,0.2727272727272727,8
57921,15008,Expansion Packs,7,0,0.0,7
57922,15008,Game Packs,1,0,0.0,1
57923,15008,Stuff Packs,3,1,0.3333333333333333,2
57924,15009,Expansion Packs,16,0,0.0,16
57925,15009,Game Packs,12,0,0.0,12
57926,15009,Kits,29,0,0.0,29
57927,15009,Stuff Packs,20,0,0.0,20
57928,15010,Expansion Packs,16,0,0.0,16
57929,15010,Game Packs,10,0,0.0,10
57930,15010,Kits,21,1,0.047619047619047616,20
57931,15010,Stuff Packs,19,0,0.0,19
57932,15011,Expansion Packs,16,0,0.0,16
57933,15011,Game Packs,10,0,0.0,10
57934,15011,Kits,25,0,0.0,25
57935,15011,Stuff Packs,13,3,0.23076923076923078,10
57936,15012,Expansion Packs,16,0,0.0,16
57937,15012,Game Packs,12,0,0.0,12
57938,15012,Kits,20,2,0.1,18
57939,15012,Stuff Packs,20,1,0.05,19
57940,15013,Expansion Packs,4,0,0.0,4
57941,15013,Game Packs,1,1,1.0,0
57942,15013,Kits,2,2,1.0,0
57943,15013,Stuff Packs,4,4,1.0,0
57944,15014,Expansion Packs,16,0,0.0,16
57945,15014,Game Packs,12,0,0.0,12
57946,15014,Kits,32,0,0.0,32
57947,15014,Stuff Packs,20,0,0.0,20
57948,15015,Expansion Packs,15,0,0.0,15
57949,15015,Game Packs,12,0,0.0,12
57950,15015,Kits,10,0,0.0,10
57951,15015,Stuff Packs,20,0,0.0,20
57952,15016,Expansion Packs,5,0,0.0,5
57953,15016,Game Packs,3,0,0.0,3
57954,15016,Kits,1,0,0.0,1
57955,15016,Stuff Packs,3,0,0.0,3
57956,15017,Expansion Packs,14,0,0.0,14
57957,15017,Game Packs,5,0,0.0,5
57958,15017,Kits,1,1,1.0,0
57959,15017,Stuff Packs,4,1,0.25,3
57960,15018,Expansion Packs,10,0,0.0,10
57961,15018,Game Packs,2,0,0.0,2
57962,15018,Kits,8,0,0.0,8
57963,15018,Stuff Packs,8,0,0.0,8
57964,15019,Expansion Packs,14,0,0.0,14
57965,15019,Game Packs,11,0,0.0,11
57966,15019,Kits,8,1,0.125,7
57967,15019,Stuff Packs,18,0,0.0,18
57968,15020,Expansion Packs,13,0,0.0,13
57969,15020,Game Packs,8,0,0.0,8
57970,15020,Kits,3,1,0.3333333333333333,2
57971,15020,Stuff Packs,6,0,0.0,6
57972,15021,Expansion Packs,16,0,0.0,16
57973,15021,Game Packs,7,0,0.0,7
57974,15021,Stuff Packs,7,3,0.42857142857142855,4
57975,15022,Expansion Packs,16,0,0.0,16
57976,15022,Game Packs,12,0,0.0,12
57977,15022,Kits,33,0,0.0,33
57978,15022,Stuff Packs,20,0,0.0,20
57979,15023,Expansion Packs,15,0,0.0,15
57980,15023,Game Packs,12,0,0.0,12
57981,15023,Kits,18,1,0.05555555555555555,17
57982,15023,Stuff Packs,15,1,0.06666666666666667,14
57983,15024,Expansion Packs,14,0,0.0,14
57984,15024,Game Packs,11,0,0.0,11
57985,15024,Kits,10,1,0.1,9
57986,15024,Stuff Packs,14,0,0.0,14
57987,15025,Expansion Packs,10,0,0.0,10
57988,15025,Game Packs,4,0,0.0,4
57989,15025,Kits,3,0,0.0,3
57990,15025,Stuff Packs,6,2,0.3333333333333333,4
57991,15026,Expansion Packs,6,0,0.0,6
57992,15026,Game Packs,4,1,0.25,3
57993,15026,Kits,5,0,0.0,5
57994,15026,Stuff Packs,9,3,0.3333333333333333,6
57995,15027,Expansion Packs,16,0,0.0,16
57996,15027,Game Packs,12,0,0.0,12
57997,15027,Kits,33,1,0.030303030303030304,32
57998,15027,Stuff Packs,19,0,0.0,19
57999,15028,Expansion Packs,16,0,0.0,16
58000,15028,Game Packs,10,0,0.0,10
58001,15028,Kits,13,0,0.0,13
58002,15028,Stuff Packs,11,0,0.0,11
58003,15029,Expansion Packs,12,0,0.0,12
58004,15029,Game Packs,8,0,0.0,8
58005,15029,Kits,3,0,0.0,3
58006,15029,Stuff Packs,17,5,0.29411764705882354,12
58007,15030,Expansion Packs,16,0,0.0,16
58008,15030,Game Packs,12,0,0.0,12
58009,15030,Kits,32,1,0.03125,31
58010,15030,Stuff Packs,18,0,0.0,18
58011,15031,Expansion Packs,13,0,0.0,13
58012,15031,Game Packs,11,0,0.0,11
58013,15031,Kits,2,2,1.0,0
58014,15031,Stuff Packs,19,1,0.05263157894736842,18
58015,15032,Expansion Packs,11,0,0.0,11
58016,15032,Game Packs,6,0,0.0,6
58017,15032,Stuff Packs,6,0,0.0,6
58018,15033,Expansion Packs,13,0,0.0,13
58019,15033,Game Packs,11,0,0.0,11
58020,15033,Kits,2,2,1.0,0
58021,15033,Stuff Packs,10,2,0.2,8
58022,15034,Expansion Packs,11,0,0.0,11
58023,15034,Game Packs,3,0,0.0,3
58024,15034,Kits,1,1,1.0,0
58025,15034,Stuff Packs,3,2,0.6666666666666666,1
58026,15035,Expansion Packs,14,0,0.0,14
58027,15035,Game Packs,9,0,0.0,9
58028,15035,Kits,5,0,0.0,5
58029,15035,Stuff Packs,6,0,0.0,6
58030,15036,Expansion Packs,8,0,0.0,8
58031,15036,Game Packs,4,2,0.5,2
58032,15036,Kits,4,2,0.5,2
58033,15036,Stuff Packs,7,1,0.14285714285714285,6
58034,15037,Expansion Packs,16,0,0.0,16
58035,15037,Game Packs,12,0,0.0,12
58036,15037,Kits,13,1,0.07692307692307693,12
58037,15037,Stuff Packs,18,0,0.0,18
58038,15038,Expansion Packs,6,0,0.0,6
58039,15038,Game Packs,3,0,0.0,3
58040,15038,Stuff Packs,3,0,0.0,3
58041,15039,Expansion Packs,14,0,0.0,14
58042,15039,Game Packs,11,0,0.0,11
58043,15039,Kits,1,0,0.0,1
58044,15039,Stuff Packs,19,1,0.05263157894736842,18
58045,15040,Expansion Packs,14,0,0.0,14
58046,15040,Game Packs,9,0,0.0,9
58047,15040,Kits,2,0,0.0,2
58048,15040,Stuff Packs,16,0,0.0,16
58049,15041,Expansion Packs,16,0,0.0,16
58050,15041,Game Packs,12,0,0.0,12
58051,15041,Kits,29,3,0.10344827586206896,26
58052,15041,Stuff Packs,20,0,0.0,20
58053,15042,Expansion Packs,10,0,0.0,10
58054,15042,Game Packs,7,1,0.14285714285714285,6
58055,15042,Kits,12,1,0.08333333333333333,11
58056,15042,Stuff Packs,10,2,0.2,8
58057,15043,Expansion Packs,13,1,0.07692307692307693,12
58058,15043,Game Packs,11,0,0.0,11
58059,15043,Kits,6,0,0.0,6
58060,15043,Stuff Packs,16,0,0.0,16
58061,15044,Expansion Packs,15,0,0.0,15
58062,15044,Game Packs,9,0,0.0,9
58063,15044,Kits,4,1,0.25,3
58064,15044,Stuff Packs,12,2,0.16666666666666666,10
58065,15045,Expansion Packs,8,0,0.0,8
58066,15045,Game Packs,4,0,0.0,4
58067,15045,Stuff Packs,4,1,0.25,3
58068,15046,Expansion Packs,13,0,0.0,13
58069,15046,Game Packs,10,0,0.0,10
58070,15046,Kits,9,0,0.0,9
58071,15046,Stuff Packs,14,0,0.0,14
58072,15047,Expansion Packs,15,0,0.0,15
58073,15047,Game Packs,11,0,0.0,11
58074,15047,Kits,2,1,0.5,1
58075,15047,Stuff Packs,17,0,0.0,17
58076,15048,Expansion Packs,14,1,0.07142857142857142,13
58077,15048,Game Packs,11,0,0.0,11
58078,15048,Kits,12,0,0.0,12
58079,15048,Stuff Packs,18,0,0.0,18
58080,15049,Expansion Packs,16,0,0.0,16
58081,15049,Game Packs,12,0,0.0,12
58082,15049,Kits,24,0,0.0,24
58083,15049,Stuff Packs,20,0,0.0,20
58084,15050,Expansion Packs,4,0,0.0,4
58085,15050,Game Packs,2,0,0.0,2
58086,15050,Stuff Packs,3,1,0.3333333333333333,2
58087,15051,Expansion Packs,16,0,0.0,16
58088,15051,Game Packs,12,0,0.0,12
58089,15051,Kits,33,0,0.0,33
58090,15051,Stuff Packs,20,0,0.0,20
58091,15052,Expansion Packs,12,1,0.08333333333333333,11
58092,15052,Game Packs,3,0,0.0,3
58093,15052,Kits,2,2,1.0,0
58094,15052,Stuff Packs,6,3,0.5,3
58095,15053,Expansion Packs,16,0,0.0,16
58096,15053,Game Packs,10,0,0.0,10
58097,15053,Stuff Packs,5,0,0.0,5
58098,15054,Expansion Packs,16,0,0.0,16
58099,15054,Game Packs,11,0,0.0,11
58100,15054,Kits,7,0,0.0,7
58101,15054,Stuff Packs,19,0,0.0,19
58102,15055,Expansion Packs,8,0,0.0,8
58103,15055,Game Packs,3,0,0.0,3
58104,15055,Stuff Packs,1,0,0.0,1
58105,15056,Expansion Packs,6,0,0.0,6
58106,15056,Game Packs,1,0,0.0,1
58107,15056,Kits,1,0,0.0,1
58108,15056,Stuff Packs,4,0,0.0,4
58109,15057,Expansion Packs,11,0,0.0,11
58110,15057,Game Packs,11,1,0.09090909090909091,10
58111,15057,Kits,3,1,0.3333333333333333,2
58112,15057,Stuff Packs,13,0,0.0,13
58113,15058,Expansion Packs,16,0,0.0,16
58114,15058,Game Packs,10,0,0.0,10
58115,15058,Kits,5,1,0.2,4
58116,15058,Stuff Packs,15,0,0.0,15
58117,15059,Expansion Packs,15,0,0.0,15
58118,15059,Game Packs,6,0,0.0,6
58119,15059,Kits,11,0,0.0,11
58120,15059,Stuff Packs,19,0,0.0,19
58121,15060,Expansion Packs,16,0,0.0,16
58122,15060,Game Packs,12,0,0.0,12
58123,15060,Kits,31,0,0.0,31
58124,15060,Stuff Packs,20,0,0.0,20
58125,15061,Expansion Packs,7,0,0.0,7
58126,15061,Game Packs,6,0,0.0,6
58127,15061,Kits,2,1,0.5,1
58128,15061,Stuff Packs,7,3,0.42857142857142855,4
58129,15062,Expansion Packs,7,0,0.0,7
58130,15062,Game Packs,6,0,0.0,6
58131,15062,Kits,1,1,1.0,0
58132,15062,Stuff Packs,9,1,0.1111111111111111,8
58133,15063,Expansion Packs,11,0,0.0,11
58134,15063,Game Packs,6,0,0.0,6
58135,15063,Kits,3,1,0.3333333333333333,2
58136,15063,Stuff Packs,10,1,0.1,9
58137,15064,Expansion Packs,9,0,0.0,9
58138,15064,Game Packs,3,1,0.3333333333333333,2
58139,15064,Kits,1,1,1.0,0
58140,15064,Stuff Packs,3,2,0.6666666666666666,1
58141,15065,Expansion Packs,15,0,0.0,15
58142,15065,Game Packs,11,0,0.0,11
58143,15065,Kits,12,1,0.08333333333333333,11
58144,15065,Stuff Packs,19,0,0.0,19
58145,15066,Expansion Packs,13,0,0.0,13
58146,15066,Game Packs,6,0,0.0,6
58147,15066,Kits,3,1,0.3333333333333333,2
58148,15066,Stuff Packs,7,3,0.42857142857142855,4
58149,15067,Expansion Packs,16,0,0.0,16
58150,15067,Game Packs,11,0,0.0,11
58151,15067,Kits,9,2,0.2222222222222222,7
58152,15067,Stuff Packs,11,3,0.2727272727272727,8
58153,15068,Expansion Packs,16,0,0.0,16
58154,15068,Game Packs,12,0,0.0,12
58155,15068,Kits,33,1,0.030303030303030304,32
58156,15068,Stuff Packs,20,0,0.0,20
58157,15069,Expansion Packs,14,0,0.0,14
58158,15069,Game Packs,7,0,0.0,7
58159,15069,Stuff Packs,15,0,0.0,15
58160,15070,Expansion Packs,16,0,0.0,16
58161,15070,Game Packs,11,0,0.0,11
58162,15070,Kits,16,0,0.0,16
58163,15070,Stuff Packs,17,0,0.0,17
58164,15071,Expansion Packs,12,0,0.0,12
58165,15071,Game Packs,8,0,0.0,8
58166,15071,Stuff Packs,16,0,0.0,16
58167,15072,Expansion Packs,7,0,0.0,7
58168,15072,Game Packs,6,0,0.0,6
58169,15072,Kits,2,1,0.5,1
58170,15072,Stuff Packs,6,2,0.3333333333333333,4
58171,15073,Expansion Packs,10,0,0.0,10
58172,15073,Game Packs,6,0,0.0,6
58173,15073,Kits,1,0,0.0,1
58174,15073,Stuff Packs,5,0,0.0,5
58175,15074,Expansion Packs,1,0,0.0,1
58176,15074,Stuff Packs,2,0,0.0,2
58177,15075,Expansion Packs,15,0,0.0,15
58178,15075,Game Packs,8,0,0.0,8
58179,15075,Kits,8,1,0.125,7
58180,15075,Stuff Packs,12,2,0.16666666666666666,10
58181,15076,Expansion Packs,15,0,0.0,15
58182,15076,Game Packs,10,2,0.2,8
58183,15076,Kits,3,0,0.0,3
58184,15076,Stuff Packs,19,3,0.15789473684210525,16
58185,15077,Expansion Packs,16,0,0.0,16
58186,15077,Game Packs,7,0,0.0,7
58187,15077,Kits,11,3,0.2727272727272727,8
58188,15077,Stuff Packs,9,0,0.0,9
58189,15078,Expansion Packs,16,0,0.0,16
58190,15078,Game Packs,12,0,0.0,12
58191,15078,Kits,14,2,0.14285714285714285,12
58192,15078,Stuff Packs,20,0,0.0,20
58193,15079,Expansion Packs,16,0,0.0,16
58194,15079,Game Packs,11,0,0.0,11
58195,15079,Kits,33,1,0.030303030303030304,32
58196,15079,Stuff Packs,20,0,0.0,20
58197,15080,Expansion Packs,15,0,0.0,15
58198,15080,Game Packs,10,0,0.0,10
58199,15080,Kits,25,0,0.0,25
58200,15080,Stuff Packs,20,0,0.0,20
58201,15081,Expansion Packs,15,0,0.0,15
58202,15081,Game Packs,11,0,0.0,11
58203,15081,Kits,10,0,0.0,10
58204,15081,Stuff Packs,14,1,0.07142857142857142,13
58205,15082,Expansion Packs,2,0,0.0,2
58206,15082,Game Packs,1,0,0.0,1
58207,15082,Kits,1,1,1.0,0
58208,15082,Stuff Packs,1,0,0.0,1
58209,15083,Expansion Packs,13,0,0.0,13
58210,15083,Game Packs,9,0,0.0,9
58211,15083,Kits,11,0,0.0,11
58212,15083,Stuff Packs,19,1,0.05263157894736842,18
58213,15084,Expansion Packs,9,1,0.1111111111111111,8
58214,15084,Game Packs,4,0,0.0,4
58215,15084,Kits,9,0,0.0,9
58216,15084,Stuff Packs,8,3,0.375,5
58217,15085,Expansion Packs,16,0,0.0,16
58218,15085,Game Packs,5,0,0.0,5
58219,15085,Kits,8,1,0.125,7
58220,15085,Stuff Packs,17,0,0.0,17
58221,15086,Expansion Packs,6,0,0.0,6
58222,15086,Game Packs,5,0,0.0,5
58223,15086,Stuff Packs,8,0,0.0,8
58224,15087,Expansion Packs,16,0,0.0,16
58225,15087,Game Packs,11,0,0.0,11
58226,15087,Kits,25,0,0.0,25
58227,15087,Stuff Packs,19,0,0.0,19
58228,15088,Expansion Packs,16,0,0.0,16
58229,15088,Game Packs,12,0,0.0,12
58230,15088,Kits,33,0,0.0,33
58231,15088,Stuff Packs,20,0,0.0,20
58232,15089,Expansion Packs,16,0,0.0,16
58233,15089,Game Packs,11,1,0.09090909090909091,10
58234,15089,Kits,25,2,0.08,23
58235,15089,Stuff Packs,17,1,0.058823529411764705,16
58236,15090,Expansion Packs,10,0,0.0,10
58237,15090,Game Packs,5,0,0.0,5
58238,15090,Kits,25,1,0.04,24
58239,15090,Stuff Packs,10,1,0.1,9
58240,15091,Expansion Packs,15,0,0.0,15
58241,15091,Game Packs,10,0,0.0,10
58242,15091,Kits,14,0,0.0,14
58243,15091,Stuff Packs,9,0,0.0,9
58244,15092,Expansion Packs,9,0,0.0,9
58245,15092,Game Packs,1,0,0.0,1
58246,15092,Kits,2,0,0.0,2
58247,15092,Stuff Packs,3,2,0.6666666666666666,1
58248,15093,Expansion Packs,7,0,0.0,7
58249,15093,Game Packs,3,1,0.3333333333333333,2
58250,15093,Kits,2,2,1.0,0
58251,15093,Stuff Packs,8,2,0.25,6
58252,15094,Expansion Packs,16,0,0.0,16
58253,15094,Game Packs,12,0,0.0,12
58254,15094,Kits,33,0,0.0,33
58255,15094,Stuff Packs,20,0,0.0,20
58256,15095,Expansion Packs,14,3,0.21428571428571427,11
58257,15095,Game Packs,11,4,0.36363636363636365,7
58258,15095,Kits,6,1,0.16666666666666666,5
58259,15095,Stuff Packs,18,2,0.1111111111111111,16
58260,15096,Expansion Packs,10,0,0.0,10
58261,15096,Game Packs,4,0,0.0,4
58262,15096,Kits,11,1,0.09090909090909091,10
58263,15096,Stuff Packs,14,2,0.14285714285714285,12
58264,15097,Expansion Packs,15,1,0.06666666666666667,14
58265,15097,Game Packs,12,0,0.0,12
58266,15097,Kits,27,1,0.037037037037037035,26
58267,15097,Stuff Packs,20,0,0.0,20
58268,15098,Expansion Packs,13,0,0.0,13
58269,15098,Game Packs,7,0,0.0,7
58270,15098,Kits,22,2,0.09090909090909091,20
58271,15098,Stuff Packs,11,3,0.2727272727272727,8
58272,15099,Expansion Packs,2,0,0.0,2
58273,15099,Kits,1,1,1.0,0
58274,15099,Stuff Packs,3,0,0.0,3
58275,15100,Expansion Packs,12,12,1.0,0
58276,15100,Game Packs,7,7,1.0,0
58277,15100,Kits,16,16,1.0,0
58278,15100,Stuff Packs,15,15,1.0,0
58279,15101,Expansion Packs,16,0,0.0,16
58280,15101,Game Packs,12,0,0.0,12
58281,15101,Kits,33,0,0.0,33
58282,15101,Stuff Packs,20,0,0.0,20
58283,15102,Expansion Packs,14,0,0.0,14
58284,15102,Game Packs,10,0,0.0,10
58285,15102,Kits,16,1,0.0625,15
58286,15102,Stuff Packs,17,1,0.058823529411764705,16
58287,15103,Expansion Packs,15,0,0.0,15
58288,15103,Game Packs,11,0,0.0,11
58289,15103,Kits,3,0,0.0,3
58290,15103,Stuff Packs,11,2,0.18181818181818182,9
58291,15104,Expansion Packs,4,0,0.0,4
58292,15104,Game Packs,3,2,0.6666666666666666,1
58293,15104,Kits,1,0,0.0,1
58294,15104,Stuff Packs,4,2,0.5,2
58295,15105,Expansion Packs,1,0,0.0,1
58296,15105,Game Packs,1,1,1.0,0
58297,15105,Kits,2,2,1.0,0
58298,15105,Stuff Packs,4,4,1.0,0
58299,15106,Expansion Packs,9,0,0.0,9
58300,15106,Game Packs,2,0,0.0,2
58301,15106,Kits,3,3,1.0,0
58302,15106,Stuff Packs,4,4,1.0,0
58303,15107,Expansion Packs,15,0,0.0,15
58304,15107,Game Packs,6,1,0.16666666666666666,5
58305,15107,Kits,3,0,0.0,3
58306,15107,Stuff Packs,6,1,0.16666666666666666,5
58307,15108,Expansion Packs,16,0,0.0,16
58308,15108,Game Packs,12,0,0.0,12
58309,15108,Kits,33,0,0.0,33
58310,15108,Stuff Packs,20,0,0.0,20
58311,15109,Expansion Packs,13,1,0.07692307692307693,12
58312,15109,Game Packs,8,0,0.0,8
58313,15109,Kits,13,0,0.0,13
58314,15109,Stuff Packs,10,0,0.0,10
58315,15110,Expansion Packs,16,0,0.0,16
58316,15110,Game Packs,12,0,0.0,12
58317,15110,Kits,33,0,0.0,33
58318,15110,Stuff Packs,20,0,0.0,20
58319,15111,Expansion Packs,4,0,0.0,4
58320,15111,Game Packs,1,0,0.0,1
58321,15111,Kits,1,0,0.0,1
58322,15111,Stuff Packs,3,1,0.3333333333333333,2
58323,15112,Expansion Packs,12,0,0.0,12
58324,15112,Game Packs,11,0,0.0,11
58325,15112,Kits,7,0,0.0,7
58326,15112,Stuff Packs,20,0,0.0,20
58327,15113,Expansion Packs,14,0,0.0,14
58328,15113,Game Packs,12,0,0.0,12
58329,15113,Kits,2,1,0.5,1
58330,15113,Stuff Packs,20,0,0.0,20
58331,15114,Expansion Packs,10,0,0.0,10
58332,15114,Game Packs,4,0,0.0,4
58333,15114,Stuff Packs,4,1,0.25,3
58334,15115,Expansion Packs,14,0,0.0,14
58335,15115,Game Packs,6,0,0.0,6
58336,15115,Kits,2,1,0.5,1
58337,15115,Stuff Packs,8,1,0.125,7
58338,15116,Expansion Packs,16,0,0.0,16
58339,15116,Game Packs,12,0,0.0,12
58340,15116,Kits,33,1,0.030303030303030304,32
58341,15116,Stuff Packs,20,0,0.0,20
58342,15117,Expansion Packs,16,1,0.0625,15
58343,15117,Game Packs,11,0,0.0,11
58344,15117,Kits,6,0,0.0,6
58345,15117,Stuff Packs,16,0,0.0,16
58346,15118,Expansion Packs,16,0,0.0,16
58347,15118,Game Packs,10,0,0.0,10
58348,15118,Kits,4,0,0.0,4
58349,15118,Stuff Packs,11,0,0.0,11
58350,15119,Expansion Packs,16,0,0.0,16
58351,15119,Game Packs,12,0,0.0,12
58352,15119,Kits,33,0,0.0,33
58353,15119,Stuff Packs,20,0,0.0,20
58354,15120,Expansion Packs,11,0,0.0,11
58355,15120,Game Packs,4,0,0.0,4
58356,15120,Kits,2,0,0.0,2
58357,15120,Stuff Packs,5,0,0.0,5
58358,15121,Expansion Packs,2,0,0.0,2
58359,15121,Kits,3,0,0.0,3
58360,15122,Expansion Packs,9,0,0.0,9
58361,15122,Game Packs,5,1,0.2,4
58362,15122,Kits,18,4,0.2222222222222222,14
58363,15122,Stuff Packs,17,6,0.35294117647058826,11
58364,15123,Expansion Packs,11,0,0.0,11
58365,15123,Game Packs,7,0,0.0,7
58366,15123,Kits,6,0,0.0,6
58367,15123,Stuff Packs,11,1,0.09090909090909091,10
58368,15124,Expansion Packs,5,0,0.0,5
58369,15124,Game Packs,3,0,0.0,3
58370,15124,Kits,1,0,0.0,1
58371,15124,Stuff Packs,6,3,0.5,3
58372,15125,Expansion Packs,1,0,0.0,1
58373,15125,Game Packs,1,1,1.0,0
58374,15125,Stuff Packs,2,2,1.0,0
58375,15126,Expansion Packs,13,0,0.0,13
58376,15126,Game Packs,11,0,0.0,11
58377,15126,Kits,4,1,0.25,3
58378,15126,Stuff Packs,18,0,0.0,18
58379,15127,Expansion Packs,15,2,0.13333333333333333,13
58380,15127,Game Packs,8,1,0.125,7
58381,15127,Kits,13,8,0.6153846153846154,5
58382,15127,Stuff Packs,9,1,0.1111111111111111,8
58383,15128,Expansion Packs,15,0,0.0,15
58384,15128,Game Packs,12,0,0.0,12
58385,15128,Kits,30,0,0.0,30
58386,15128,Stuff Packs,20,0,0.0,20
58387,15129,Expansion Packs,15,0,0.0,15
58388,15129,Game Packs,7,0,0.0,7
58389,15129,Kits,3,0,0.0,3
58390,15129,Stuff Packs,6,3,0.5,3
58391,15130,Expansion Packs,14,0,0.0,14
58392,15130,Game Packs,10,0,0.0,10
58393,15130,Kits,15,1,0.06666666666666667,14
58394,15130,Stuff Packs,15,5,0.3333333333333333,10
58395,15131,Expansion Packs,14,0,0.0,14
58396,15131,Game Packs,5,0,0.0,5
58397,15131,Kits,13,0,0.0,13
58398,15131,Stuff Packs,11,0,0.0,11
58399,15132,Expansion Packs,16,0,0.0,16
58400,15132,Game Packs,12,0,0.0,12
58401,15132,Kits,33,0,0.0,33
58402,15132,Stuff Packs,20,0,0.0,20
58403,15133,Expansion Packs,16,0,0.0,16
58404,15133,Game Packs,11,0,0.0,11
58405,15133,Kits,23,0,0.0,23
58406,15133,Stuff Packs,19,3,0.15789473684210525,16
58407,15134,Expansion Packs,6,0,0.0,6
58408,15134,Game Packs,5,0,0.0,5
58409,15134,Stuff Packs,12,0,0.0,12
58410,15135,Expansion Packs,4,0,0.0,4
58411,15135,Game Packs,3,0,0.0,3
58412,15135,Stuff Packs,1,0,0.0,1
58413,15136,Expansion Packs,14,0,0.0,14
58414,15136,Game Packs,3,0,0.0,3
58415,15136,Kits,2,0,0.0,2
58416,15136,Stuff Packs,5,0,0.0,5
58417,15137,Expansion Packs,16,0,0.0,16
58418,15137,Game Packs,11,0,0.0,11
58419,15137,Kits,19,1,0.05263157894736842,18
58420,15137,Stuff Packs,16,1,0.0625,15
58421,15138,Expansion Packs,16,0,0.0,16
58422,15138,Game Packs,11,0,0.0,11
58423,15138,Kits,2,0,0.0,2
58424,15138,Stuff Packs,18,0,0.0,18
58425,15139,Expansion Packs,16,0,0.0,16
58426,15139,Game Packs,12,0,0.0,12
58427,15139,Kits,8,1,0.125,7
58428,15139,Stuff Packs,20,0,0.0,20
58429,15140,Expansion Packs,16,0,0.0,16
58430,15140,Game Packs,8,0,0.0,8
58431,15140,Kits,13,0,0.0,13
58432,15140,Stuff Packs,10,0,0.0,10
58433,15141,Expansion Packs,8,0,0.0,8
58434,15141,Game Packs,2,0,0.0,2
58435,15141,Stuff Packs,4,1,0.25,3
58436,15142,Expansion Packs,7,0,0.0,7
58437,15142,Game Packs,3,0,0.0,3
58438,15142,Kits,1,0,0.0,1
58439,15142,Stuff Packs,8,1,0.125,7
58440,15143,Expansion Packs,11,0,0.0,11
58441,15143,Game Packs,8,0,0.0,8
58442,15143,Stuff Packs,6,0,0.0,6
58443,15144,Expansion Packs,14,0,0.0,14
58444,15144,Game Packs,9,0,0.0,9
58445,15144,Kits,9,1,0.1111111111111111,8
58446,15144,Stuff Packs,20,0,0.0,20
58447,15145,Expansion Packs,13,0,0.0,13
58448,15145,Game Packs,6,0,0.0,6
58449,15145,Kits,16,0,0.0,16
58450,15145,Stuff Packs,14,0,0.0,14
58451,15146,Expansion Packs,16,0,0.0,16
58452,15146,Game Packs,11,0,0.0,11
58453,15146,Kits,28,1,0.03571428571428571,27
58454,15146,Stuff Packs,19,0,0.0,19
58455,15147,Expansion Packs,16,0,0.0,16
58456,15147,Game Packs,12,0,0.0,12
58457,15147,Kits,33,0,0.0,33
58458,15147,Stuff Packs,20,0,0.0,20
58459,15148,Expansion Packs,16,0,0.0,16
58460,15148,Game Packs,12,0,0.0,12
58461,15148,Kits,33,0,0.0,33
58462,15148,Stuff Packs,20,0,0.0,20
58463,15149,Expansion Packs,4,0,0.0,4
58464,15149,Game Packs,1,0,0.0,1
58465,15149,Stuff Packs,3,0,0.0,3
58466,15150,Expansion Packs,12,0,0.0,12
58467,15150,Game Packs,9,0,0.0,9
58468,15150,Kits,1,0,0.0,1
58469,15150,Stuff Packs,11,0,0.0,11
58470,15151,Expansion Packs,16,0,0.0,16
58471,15151,Game Packs,11,0,0.0,11
58472,15151,Kits,8,2,0.25,6
58473,15151,Stuff Packs,20,0,0.0,20
58474,15152,Expansion Packs,15,0,0.0,15
58475,15152,Game Packs,11,1,0.09090909090909091,10
58476,15152,Kits,32,1,0.03125,31
58477,15152,Stuff Packs,20,0,0.0,20
58478,15153,Expansion Packs,9,0,0.0,9
58479,15153,Game Packs,6,0,0.0,6
58480,15153,Kits,3,0,0.0,3
58481,15153,Stuff Packs,5,0,0.0,5
58482,15154,Expansion Packs,14,0,0.0,14
58483,15154,Game Packs,10,0,0.0,10
58484,15154,Stuff Packs,5,0,0.0,5
58485,15155,Expansion Packs,16,0,0.0,16
58486,15155,Game Packs,10,0,0.0,10
58487,15155,Kits,19,1,0.05263157894736842,18
58488,15155,Stuff Packs,17,2,0.11764705882352941,15
58489,15156,Stuff Packs,3,3,1.0,0
